,Player,90s,Tackles - Tkl,Tackles - TklW,Tackles - Def 3rd,Tackles - Mid 3rd,Tackles - Att 3rd,Challenges - Tkl,Challenges - Att,Challenges - Tkl%,Challenges - Lost,Blocks - Blocks,Blocks - Sh,Blocks - Pass,Int,Tkl+Int,Clr,Err
0,Patrick van Aanholt,24.3,47,32,29,15,3,16,34,47.1,18,24,5,19,47,94,64,2
1,Rolando Aarons,1.5,4,4,3,1,0,4,6,66.7,2,3,0,3,1,5,0,0
2,Rolando Aarons,5.7,13,8,4,4,5,1,7,14.3,6,3,1,2,2,15,0,0
3,Ignazio Abate,11.7,20,17,10,9,1,6,11,54.5,5,22,2,20,8,28,29,0
4,Aymen Abdennour,5.5,7,3,5,2,0,4,7,57.1,3,5,5,0,4,11,20,0
5,Aly Abeid,0.9,2,1,1,1,0,0,1,0.0,1,1,0,1,3,5,3,0
6,Mehdi Abeid,13.1,23,15,8,14,1,8,32,25.0,24,11,6,5,18,41,25,2
7,David Abraham,25.6,40,32,29,10,1,27,36,75.0,9,29,15,14,40,80,141,1
8,Tammy Abraham,19.2,10,8,1,7,2,1,13,7.7,12,8,1,7,1,11,11,0
9,Amir Abrashi,9.4,35,32,15,18,2,16,23,69.6,7,22,5,17,19,54,20,0
10,Francesco Acerbi,38.0,51,32,26,22,3,22,36,61.1,14,42,21,21,88,139,255,1
11,Afriyie Acquah,10.6,8,6,2,6,0,1,7,14.3,6,8,1,7,16,24,10,2
12,Charlie Adam,4.6,9,5,2,5,2,5,17,29.4,12,2,0,2,9,18,11,2
13,Antonio Adan,30.0,1,0,1,0,0,1,1,100.0,0,1,0,1,0,1,11,2
14,Aday,20.4,17,15,11,4,2,6,17,35.3,11,19,3,16,25,42,52,1
15,Khaled Adenon,32.5,38,24,26,12,0,15,32,46.9,17,42,26,16,65,103,221,1
16,Claud Adjapong,13.6,35,26,24,5,6,11,13,84.6,2,16,3,13,23,58,37,0
17,Rene Adler,14.0,1,1,1,0,0,1,1,100.0,0,0,0,0,0,1,8,1
19,Ali Adnan Kadhim,18.6,54,35,35,14,5,29,50,58.0,21,31,6,25,41,95,90,0
20,Adrian,19.0,2,1,2,0,0,1,4,25.0,3,1,0,1,0,2,15,1
21,Aritz Aduriz,23.9,11,8,2,6,3,1,6,16.7,5,6,0,6,3,14,18,0
22,Ibrahim Afellay,1.8,3,3,0,3,0,1,2,50.0,1,1,0,1,1,4,1,0
23,Benik Afobe,6.8,4,3,1,2,1,1,6,16.7,5,4,0,4,0,4,6,0
24,Martin Agirregabiria,20.3,50,33,31,17,2,32,50,64.0,18,13,7,6,41,91,66,0
26,Imanol Agirretxe,2.6,0,0,0,0,0,0,1,0.0,1,0,0,0,0,0,2,0
27,Sergio Aguero,21.8,9,6,2,6,1,2,17,11.8,15,12,1,11,6,15,3,0
28,Ruben Aguilar,27.3,91,50,37,41,13,36,71,50.7,35,25,3,22,37,128,90,0
29,Matias Aguirregaray,12.8,26,20,12,12,2,12,32,37.5,20,13,1,12,24,50,25,0
30,Jean-Eudes Aholou,33.4,70,34,32,37,1,17,55,30.9,38,29,7,22,75,145,58,1
31,Ailton,1.2,8,5,3,5,0,4,8,50.0,4,5,0,5,2,10,5,0
32,Youssef Ait Bennasser,22.7,47,28,17,27,3,15,64,23.4,49,35,2,33,32,79,30,0
33,Arlind Ajeti,14.1,42,23,25,14,3,18,30,60.0,12,27,15,12,34,76,82,0
34,Manuel Akanji,10.0,22,15,14,8,0,15,17,88.2,2,11,4,7,7,29,43,2
35,Nathan Ake,37.3,53,32,34,16,3,22,40,55.0,18,47,24,23,48,101,246,2
36,Ager Aketxe,0.4,1,1,1,0,0,1,2,50.0,1,1,0,1,1,2,0,0
37,Chadrac Akolo,12.2,20,14,3,12,5,6,14,42.9,8,19,0,19,5,25,5,0
38,Kevin Akpoguma,18.8,47,39,29,16,2,24,35,68.6,11,18,4,14,22,69,60,1
39,David Alaba,17.2,23,14,11,9,3,14,20,70.0,6,21,6,15,10,33,23,0
40,Lucas Alario,17.2,16,10,2,12,2,3,8,37.5,5,17,4,13,4,20,16,0
41,David Alba,0.7,1,1,1,0,0,1,1,100.0,0,0,0,0,0,1,7,1
42,Jordi Alba,30.5,63,42,35,22,6,26,52,50.0,26,34,5,29,68,131,67,1
43,Raul Albentosa,19.4,13,6,9,4,0,7,20,35.0,13,26,19,7,26,39,92,1
44,Luis Alberto,29.7,39,28,8,23,8,10,44,22.7,34,30,2,28,16,55,7,0
45,Raul Albiol,30.5,29,19,15,14,0,13,19,68.4,6,18,13,5,32,61,129,1
46,Miiko Albornoz,7.8,24,20,17,4,3,11,16,68.8,5,15,2,13,5,29,23,0
47,Marc Albrighton,28.2,52,33,16,29,7,16,52,30.8,36,32,4,28,27,79,34,0
48,Paco Alcacer,7.7,4,3,0,2,2,0,6,0.0,6,5,0,5,11,15,3,0
49,Pedro Alcala,7.7,9,5,5,4,0,1,3,33.3,2,7,3,4,14,23,41,0
50,Thiago Alcantara,13.9,45,35,11,25,9,15,26,57.7,11,22,3,19,27,72,6,1
52,David Alcibiade,2.3,9,5,5,3,1,2,4,50.0,2,5,3,2,7,16,8,0
53,Toby Alderweireld,13.1,19,13,7,11,1,8,15,53.3,7,11,5,6,4,23,55,0
55,Alex Alegria,7.0,8,5,1,3,4,2,6,33.3,4,7,0,7,4,12,9,0
56,Ivan Alejo,12.2,20,16,4,9,7,1,10,10.0,9,9,0,9,5,25,1,0
57,Alexander,11.8,14,11,2,11,1,2,12,16.7,10,11,0,11,22,36,4,0
58,Trent Alexander-Arnold,17.5,37,25,23,9,5,22,36,61.1,14,20,5,15,28,65,46,1
59,Alexis,24.3,33,24,24,7,2,20,45,44.4,25,28,14,14,30,63,114,3
60,Alisson,37.0,1,0,1,0,0,0,1,0.0,1,0,0,0,2,3,22,4
61,Allan,31.7,107,68,24,65,18,36,104,34.6,68,52,3,49,28,135,16,0
62,Joe Allen,34.9,96,62,41,43,12,27,87,31.0,60,43,9,34,58,154,68,1
63,Dele Alli,32.9,46,30,15,21,10,8,34,23.5,26,33,7,26,19,65,22,1
64,Junior Alonso,30.9,58,31,36,22,0,28,50,56.0,22,26,16,10,56,114,153,1
66,Marcos Alonso,31.7,51,33,30,18,3,23,44,52.3,21,36,5,31,47,98,76,1
67,Ricky Alvarez,3.0,4,2,1,3,0,1,4,25.0,3,5,0,5,2,6,3,0
68,Sergio Alvarez,16.4,0,0,0,0,0,0,1,0.0,1,1,0,1,0,0,11,1
69,Yeray Alvarez,7.5,12,7,8,4,0,6,9,66.7,3,8,2,6,11,23,18,0
70,Dani Alves,22.9,80,57,45,27,8,33,58,56.9,25,24,3,21,28,108,21,0
71,Ibrahim Amadou,26.7,43,29,24,19,0,14,27,51.9,13,30,13,17,41,84,70,3
72,Eloi Amagat,0.2,0,0,0,0,0,0,1,0.0,1,0,0,0,0,0,0,0
73,Morgan Amalfitano,8.3,8,5,3,3,2,2,5,40.0,3,6,0,6,4,12,7,0
74,Romain Amalfitano,30.0,59,37,18,38,3,25,69,36.2,44,29,7,22,85,144,35,2
75,Daniel Amartey,5.4,8,4,7,1,0,3,7,42.9,4,7,3,4,7,15,21,1
76,Jordi Amat,22.7,32,23,15,16,1,11,24,45.8,13,14,4,10,38,70,77,2
78,Amath,31.8,78,53,32,28,18,24,89,27.0,65,36,3,33,33,111,20,0
79,Jordan Amavi,24.4,52,35,32,12,8,23,56,41.1,33,28,11,17,45,97,86,1
81,Kelvin Amian,35.0,59,43,45,10,4,22,31,71.0,9,25,7,18,45,104,127,1
82,Nadiem Amiri,19.4,39,26,13,21,5,19,42,45.2,23,33,4,29,17,56,7,0
84,Nordin Amrabat,2.2,6,3,1,5,0,1,3,33.3,2,1,0,1,0,6,2,0
85,Nordin Amrabat,18.0,19,10,5,10,4,5,17,29.4,12,13,0,13,5,24,2,0
87,Joachim Andersen,6.1,8,3,6,2,0,4,4,100.0,0,6,4,2,9,17,41,1
88,Felipe Anderson,12.9,34,21,7,11,16,6,35,17.1,29,17,0,17,11,45,8,1
89,Florin Andone,18.2,9,7,4,4,1,4,17,23.5,13,9,2,7,3,12,12,0
90,Nicolas Andrade,36.0,2,1,2,0,0,1,4,25.0,3,2,0,2,2,4,16,7
91,Benjamin Andre,33.5,93,54,36,50,7,43,113,38.1,70,56,4,52,57,150,96,1
92,Marco Andreolli,20.3,25,17,20,4,1,12,20,60.0,8,24,17,7,30,55,139,0
93,Yoann Andreu,23.0,48,30,40,6,2,16,39,41.0,23,23,5,18,37,85,75,1
94,Miguel Angel Guerrero,16.0,7,5,0,2,5,1,11,9.1,10,11,0,11,9,16,16,0
95,Jose Angel,27.0,61,44,36,19,6,38,58,65.5,20,31,1,30,38,99,76,0
96,Miguel Angel Moya,8.5,0,0,0,0,0,0,1,0.0,1,0,0,0,2,2,7,0
98,Gabriele Angella,9.9,15,13,11,3,1,8,11,72.7,3,11,9,2,21,36,66,0
99,Cristian Ansaldi,20.8,49,33,25,20,4,14,37,37.8,23,23,5,18,20,69,61,0
100,Luca Antei,6.6,19,14,12,7,0,6,11,54.5,5,10,8,2,26,45,35,0
101,Mirco Antenucci,28.6,16,13,6,8,2,0,21,0.0,21,14,0,14,11,27,15,0
102,Waldemar Anton,25.3,65,49,39,21,5,41,65,63.1,24,56,27,29,39,104,112,3
104,Luca Antonelli,1.6,1,1,0,0,1,0,2,0.0,2,1,0,1,1,2,8,0
105,Michail Antonio,15.0,15,9,7,6,2,4,14,28.6,10,14,0,14,13,28,16,0
107,Vitorino Antunes,31.1,58,44,42,14,2,38,74,51.4,36,31,3,28,58,116,89,1
108,Dennis Aogo,21.7,35,26,17,18,0,14,22,63.6,8,27,3,24,29,64,27,1
109,Houssem Aouar,27.0,66,42,22,39,5,20,66,30.3,46,30,0,30,39,105,34,0
110,Alberto Aquilani,14.4,33,19,13,17,3,11,31,35.5,20,20,4,16,23,56,23,0
111,Mauro Arambarri,23.6,56,41,19,30,7,14,47,29.8,33,26,3,23,25,81,36,0
112,Guilherme Arana,2.1,4,2,3,1,0,1,1,100.0,0,0,0,0,5,9,8,0
113,Charles Aranguiz,25.6,75,61,17,50,8,33,62,53.2,29,46,5,41,48,123,27,2
114,Luiz Araujo,22.4,41,31,23,17,1,10,47,21.3,37,24,0,24,16,57,11,1
115,Sergio Araujo,0.4,3,2,0,0,3,1,1,100.0,0,0,0,0,0,3,0,0
116,Anaitz Arbilla,26.8,38,30,24,12,2,21,40,52.5,19,21,10,11,78,116,108,2
117,Alphonse Areola,34.0,0,0,0,0,0,0,1,0.0,1,0,0,0,0,0,7,4
118,Scott Arfield,14.8,36,26,20,13,3,19,44,43.2,25,22,1,21,11,47,24,0
119,Samuel Armenteros,4.8,4,2,1,3,0,0,3,0.0,3,1,1,0,1,5,3,0
120,Yoel Armougom,1.5,2,1,0,1,1,1,1,100.0,0,1,1,0,1,3,2,1
122,Marko Arnautovic,25.7,21,16,9,8,4,7,19,36.8,12,20,3,17,13,34,35,0
123,Maximilian Arnold,27.3,51,41,23,23,5,25,57,43.9,32,31,4,27,28,79,34,0
124,Jann-Fiete Arp,9.4,7,5,0,3,4,1,7,14.3,6,6,0,6,2,9,7,0
125,Alejandro Arribas,3.0,2,2,1,1,0,1,5,20.0,4,5,3,2,6,8,8,0
126,Kepa Arrizabalaga,30.0,0,0,0,0,0,0,2,0.0,2,0,0,0,2,2,6,2
127,Harry Arter,10.7,19,16,10,7,2,6,23,26.1,17,18,5,13,9,28,6,0
128,Aythami Artiles,2.0,2,2,2,0,0,0,1,0.0,1,2,1,1,2,4,19,0
130,Kwadwo Asamoah,17.4,28,21,12,14,2,15,23,65.2,8,11,0,11,18,46,30,0
131,Takuma Asano,8.0,7,5,3,3,1,2,8,25.0,6,7,0,7,3,10,2,0
132,Santiago Ascacibar,26.5,91,65,41,43,7,41,74,55.4,33,45,10,35,47,138,38,1
133,Sergio Asenjo,23.0,2,2,2,0,0,1,5,20.0,4,0,0,0,0,2,11,2
134,Marco Asensio,20.5,26,17,7,13,6,11,26,42.3,15,15,0,15,9,35,2,0
135,Iago Aspas,32.6,26,22,10,10,6,5,34,14.7,29,15,1,14,23,49,11,1
136,Benoit Assou-Ekotto,11.7,12,9,5,6,1,5,15,33.3,10,7,4,3,46,58,21,0
137,Simon Asta,0.1,2,1,2,0,0,2,2,100.0,0,1,0,1,0,2,0,0
138,Davide Astori,25.0,47,31,33,13,1,18,29,62.1,11,29,17,12,51,98,131,2
139,Christian Atsu,19.8,17,16,10,7,0,7,20,35.0,13,35,5,30,13,30,27,1
140,Pierre-Emerick Aubameyang,11.7,5,4,3,2,0,1,7,14.3,6,14,1,13,3,8,7,0
141,Pierre-Emerick Aubameyang,15.7,5,5,1,1,3,2,8,25.0,6,16,1,15,3,8,1,0
142,Jean-Kevin Augustin,14.1,16,11,4,11,1,3,7,42.9,4,17,1,16,4,20,4,0
143,Ludwig Augustinsson,28.1,45,34,22,20,3,22,32,68.8,10,25,3,22,39,84,53,0
144,Yann Aurel Bisseck,1.7,2,2,2,0,0,1,1,100.0,0,1,1,0,3,5,8,0
145,Serge Aurier,15.9,48,27,27,13,8,11,31,35.5,20,20,1,19,31,79,54,1
146,Charlie Austin,11.5,7,5,1,3,3,3,10,30.0,7,15,3,12,1,8,10,0
147,Danilo Avelar,19.2,41,33,27,9,5,14,45,31.1,31,16,7,9,37,78,83,1
148,Felipe Avenatti,5.2,6,4,1,5,0,1,2,50.0,1,7,1,6,1,7,6,0
149,Durel Avounou,7.2,16,11,6,9,1,5,17,29.4,12,12,1,11,10,26,25,0
150,Chidozie Awaziem,16.8,43,30,33,10,0,28,40,70.0,12,18,11,7,16,59,97,0
151,Andre Ayew,9.9,19,14,6,10,3,6,19,31.6,13,5,0,5,4,23,3,0
152,Andre Ayew,10.6,15,10,3,10,2,2,13,15.4,11,13,1,12,5,20,8,0
153,Jordan Ayew,31.7,82,60,20,35,27,15,54,27.8,39,43,3,40,24,106,20,1
154,Karim Azamoum,25.0,84,57,41,37,6,27,68,39.7,41,30,11,19,26,110,61,3
156,Cesar Azpilicueta,37.0,80,59,47,26,7,27,54,50.0,27,48,22,26,54,134,135,1
157,Ludovic Baal,12.9,41,27,29,8,4,13,35,37.1,22,13,2,11,15,56,37,1
158,Khouma Babacar,5.0,4,4,3,0,1,2,4,50.0,2,0,0,0,2,6,5,0
159,Khouma Babacar,8.3,10,6,2,4,4,2,6,33.3,4,8,0,8,3,13,1,0
160,Carlos Bacca,27.7,10,2,2,4,4,1,12,8.3,11,16,1,15,8,18,16,0
161,Milan Badelj,26.1,71,41,26,38,7,28,71,39.4,43,48,2,46,71,142,52,3
162,Holger Badstuber,24.1,44,32,29,14,1,22,39,56.4,17,27,14,13,41,85,111,4
164,Fares Bahlouli,3.4,10,8,4,3,3,2,7,28.6,5,7,0,7,1,11,1,0
165,Stephane Bahoken,18.5,16,11,3,8,5,4,22,18.2,18,18,1,17,9,25,1,0
166,Daniel Baier,28.2,83,62,38,40,5,46,83,55.4,37,26,5,21,57,140,41,1
167,Leon Bailey,24.6,16,12,7,4,5,8,13,61.5,5,28,0,28,15,31,6,0
168,Eric Bailly,11.1,17,10,10,5,2,5,12,41.7,7,11,6,5,25,42,58,1
169,Leighton Baines,21.2,25,13,18,3,4,9,14,64.3,5,18,6,12,25,50,56,0
171,Marvin Bakalorz,22.8,44,25,19,23,2,22,37,59.5,15,38,7,31,20,64,46,1
172,Cedric Bakambu,14.0,10,7,3,6,1,1,7,14.3,6,9,1,8,3,13,27,0
173,Tiemoue Bakayoko,23.6,64,41,25,32,7,16,48,33.3,32,23,6,17,37,101,38,4
174,Zakaria Bakkali,10.1,12,10,7,4,1,4,14,28.6,10,5,0,5,4,16,6,0
175,Ridle Baku,2.6,3,3,1,1,1,0,1,0.0,1,3,0,3,3,6,2,0
176,Keita Balde,16.4,12,8,5,6,1,1,11,9.1,10,10,1,9,6,18,5,0
178,Gareth Bale,20.0,19,13,7,8,4,3,14,21.4,11,13,1,12,12,31,18,0
179,Mikel Balenziaga,17.2,34,24,17,13,4,15,27,55.6,12,24,5,19,17,51,61,0
180,Andrija Balic,12.0,18,9,5,12,1,8,27,29.6,19,6,3,3,16,34,13,0
182,Ivan Balliu,21.7,34,22,22,6,6,12,28,42.9,16,23,9,14,27,61,64,1
183,Fode Ballo-Toure,22.8,50,36,29,16,5,21,47,44.7,26,27,2,25,28,78,47,1
184,Florent Balmont,9.6,14,9,4,9,1,4,25,16.0,21,15,1,14,8,22,5,0
185,Leon Balogun,13.0,39,32,27,11,1,22,31,71.0,9,21,9,12,32,71,64,0
186,Mario Balotelli,25.2,7,4,1,3,3,0,6,0.0,6,9,2,7,8,15,26,0
187,Abdoulaye Bamba,17.0,29,22,23,6,0,16,30,53.3,14,8,1,7,11,40,52,0
188,Jonathan Bamba,28.6,30,21,18,11,1,12,61,19.7,49,30,4,26,19,49,17,0
189,Yacine Bammou,8.1,18,11,6,10,2,4,14,28.6,10,16,4,12,6,24,9,0
190,Ever Banega,26.7,71,53,25,37,9,22,63,34.9,41,23,1,22,12,83,17,3
191,Mattia Bani,14.6,28,20,22,6,0,11,26,42.3,15,19,10,9,27,55,111,0
192,Beni Baningime,2.2,6,2,1,2,3,0,4,0.0,4,5,1,4,2,8,2,0
193,Leo Baptistao,29.7,54,34,12,28,14,13,52,25.0,39,22,1,21,23,77,25,0
195,Antonin Barak,30.1,58,38,22,27,9,21,58,36.2,37,34,2,32,18,76,26,1
196,Andrea Barberis,33.7,80,44,33,42,5,16,68,23.5,52,52,5,47,58,138,67,1
198,Enis Bardhi,17.6,39,26,14,16,9,10,38,26.3,28,11,0,11,16,55,7,0
199,Phil Bardsley,12.5,17,16,9,7,1,4,11,36.4,7,22,6,16,22,39,77,0
200,Nicolo Barella,32.8,92,69,37,43,12,25,78,32.1,53,48,6,42,45,137,53,0
201,Philipp Bargfrede,20.7,60,45,29,30,1,33,55,60.0,22,35,12,23,47,107,52,0
202,Ross Barkley,1.4,0,0,0,0,0,0,1,0.0,1,3,1,2,0,0,2,0
203,Aymen Barkok,3.5,11,11,6,4,1,5,7,71.4,2,8,2,6,2,13,3,0
204,Ashley Barnes,24.1,21,14,1,14,6,5,29,17.2,24,26,5,21,2,23,19,0
206,Antonio Barragan,26.4,59,42,40,11,8,24,36,66.7,12,22,5,17,24,83,66,0
208,Antonio Barreca,5.2,9,8,3,5,1,4,4,100.0,0,3,0,3,5,14,16,0
209,Edgar Barreto,21.8,67,42,23,32,12,18,70,25.7,52,45,2,43,21,88,29,3
210,Barri,1.3,1,0,0,1,0,0,4,0.0,4,1,1,0,1,2,3,0
211,Musa Barrow,4.9,5,2,1,3,1,2,4,50.0,2,2,0,2,1,6,2,0
212,Gareth Barry,21.4,35,19,17,14,4,15,45,33.3,30,19,11,8,14,49,34,0
213,Fin Bartels,12.5,12,9,4,3,5,4,12,33.3,8,5,1,4,7,19,1,1
214,Kyle Bartley,2.6,3,2,3,0,0,2,2,100.0,0,6,6,0,4,7,21,0
215,Marc Bartra,15.8,38,28,30,8,0,21,39,53.8,18,19,10,9,32,70,97,1
216,Marc Bartra,9.0,28,19,16,12,0,15,24,62.5,9,14,2,12,28,56,43,1
217,Andrea Barzagli,16.1,26,15,14,11,1,9,16,56.3,7,14,7,7,17,43,46,0
218,Daniele Baselli,28.0,63,33,23,36,4,20,56,35.7,36,29,5,24,57,120,40,1
219,Nicolas Basin,3.5,9,7,5,3,1,4,9,44.4,5,6,3,3,8,17,14,0
220,Dusan Basta,8.6,9,7,4,3,2,6,14,42.9,8,10,3,7,13,22,15,0
221,Gil Bastiao Dias,13.2,49,31,28,15,6,19,48,39.6,29,23,0,23,19,68,12,1
223,Samuel Bastien,15.1,17,13,7,8,2,7,23,30.4,16,23,2,21,18,35,25,0
224,Borja Baston,10.9,9,7,1,6,2,1,13,7.7,12,7,0,7,3,12,5,0
225,Alessandro Bastoni,1.0,2,2,2,0,0,1,1,100.0,0,0,0,0,1,3,3,0
226,Bastos,15.6,33,24,19,13,1,19,30,63.3,11,13,8,5,24,57,67,0
227,Michy Batshuayi,4.0,5,4,2,3,0,1,3,33.3,2,0,0,0,1,6,3,0
228,Michy Batshuayi,9.3,8,6,1,4,3,2,4,50.0,2,4,0,4,0,8,5,0
229,Moritz Bauer,14.5,24,17,17,7,0,10,26,38.5,16,9,1,8,12,36,48,0
230,Robert Bauer,10.6,31,25,21,9,1,15,25,60.0,10,8,2,6,21,52,25,2
231,Oliver Baumann,34.0,0,0,0,0,0,0,2,0.0,2,0,0,0,1,1,15,6
232,Timo Baumgartl,29.0,87,71,55,29,3,56,75,74.7,19,50,21,29,34,121,132,1
234,Julian Baumgartlinger,15.5,47,37,21,21,5,14,29,48.3,15,25,2,23,18,65,23,0
235,Jon Bautista,2.0,0,0,0,0,0,0,1,0.0,1,2,0,2,0,0,0,0
236,Paul Baysse,13.8,25,16,21,3,1,10,17,58.8,7,10,6,4,20,45,84,0
237,Paul Baysse,6.3,4,2,3,1,0,1,5,20.0,4,4,3,1,7,11,38,1
239,Herve Bazile,9.7,21,15,9,7,5,5,15,33.3,10,22,0,22,15,36,8,0
240,Riechedly Bazoer,6.6,8,7,5,2,1,2,4,50.0,2,2,1,1,8,16,4,1
241,Enrico Bearzotti,4.6,3,2,2,0,1,1,4,25.0,3,3,1,2,4,7,18,0
242,Claudio Beauvue,18.6,5,3,2,2,1,1,12,8.3,11,7,0,7,2,7,16,0
243,Bebe,4.1,9,7,1,4,4,3,8,37.5,5,5,0,5,3,12,1,0
244,Ihlas Bebou,23.8,37,29,15,17,5,14,27,51.9,13,34,3,31,24,61,27,0
245,Andreas Beck,21.4,46,29,27,16,3,21,31,67.7,10,32,2,30,19,65,46,1
246,Henri Bedimo,0.5,0,0,0,0,0,0,1,0.0,1,0,0,0,1,1,1,0
247,Jan Bednarek,4.7,6,3,6,0,0,3,6,50.0,3,2,1,1,5,11,27,0
248,Asmir Begovic,38.0,0,0,0,0,0,0,2,0.0,2,0,0,0,2,2,16,7
249,Valon Behrami,15.5,63,46,30,27,6,8,44,18.2,36,47,15,32,22,85,19,0
252,Ishak Belfodil,15.0,7,6,2,3,2,0,3,0.0,3,10,1,9,1,8,9,0
253,Stefan Bell,24.2,36,25,23,13,0,27,39,69.2,12,35,18,17,46,82,123,2
254,Karim Bellarabi,12.7,22,17,10,9,3,10,19,52.6,9,26,1,25,13,35,5,0
255,Hector Bellerin,33.9,57,43,36,12,9,25,52,48.1,27,42,8,34,23,80,89,4
256,Francois Bellugou,24.2,48,33,23,21,4,21,49,42.9,28,20,6,14,28,76,45,0
257,Andrea Belotti,29.8,32,23,9,15,8,3,30,10.0,27,14,1,13,6,38,19,1
258,Chaouki Ben Saada,3.8,11,8,5,3,3,2,11,18.2,9,3,0,3,2,13,3,0
260,Wissam Ben Yedder,18.9,12,8,2,5,5,1,2,50.0,1,10,0,10,5,17,2,0
262,Ahmad Benali,9.0,19,10,8,10,1,5,27,18.5,22,14,1,13,8,27,15,0
263,Yohan Benalouane,1.0,7,3,6,1,0,4,6,66.7,2,1,1,0,1,8,4,0
264,Marco Benassi,30.9,54,38,18,22,14,17,52,32.7,35,52,2,50,28,82,36,0
265,Medhi Benatia,19.5,28,21,20,6,2,8,15,53.3,7,18,13,5,43,71,89,1
266,Lars Bender,17.7,63,52,26,32,5,35,53,66.0,18,34,7,27,28,91,40,0
267,Sven Bender,26.1,51,37,33,18,0,26,34,76.5,8,49,21,28,50,101,123,1
268,Laszlo Benes,0.4,0,0,0,0,0,0,1,0.0,1,2,1,1,1,1,2,0
269,Nicolas Benezet,18.3,38,30,18,16,4,11,37,29.7,26,8,2,6,12,50,7,0
271,Walter Benitez,28.0,0,0,0,0,0,0,2,0.0,2,0,0,0,0,0,5,3
272,Charlison Benschop,2.0,4,4,1,3,0,3,8,37.5,5,1,0,1,2,6,2,0
273,Ramy Bensebaini,26.0,56,39,31,21,4,26,55,47.3,29,24,16,8,37,93,177,1
274,Nabil Bentaleb,11.2,25,22,7,17,1,8,23,34.8,15,18,6,12,23,48,27,2
275,Rodrigo Bentancur,6.5,18,11,10,7,1,2,16,12.5,14,5,1,4,3,21,14,0
276,Christian Benteke,24.9,11,4,3,7,1,2,17,11.8,15,15,3,12,3,14,44,0
277,Karim Benzema,23.9,14,8,2,6,6,3,20,15.0,17,18,0,18,8,22,19,0
278,Yassine Benzia,25.4,62,41,21,31,10,17,62,27.4,45,31,4,27,28,90,14,0
279,Saido Berahino,5.5,2,2,0,1,1,0,1,0.0,1,4,1,3,1,3,2,0
280,Domenico Berardi,25.5,31,17,9,16,6,11,65,16.9,54,23,0,23,17,48,14,1
281,Yuri Berchiche,19.1,39,27,21,11,7,12,25,48.0,13,15,2,13,24,63,53,0
282,Alex Berenguer,11.6,18,15,7,8,3,5,17,29.4,12,22,3,19,10,28,13,0
283,Bartosz Bereszynski,27.6,63,47,30,28,5,31,53,58.5,22,33,8,25,30,93,98,2
284,Johann Berg Gudmundsson,31.5,43,27,16,19,8,20,47,42.6,27,21,1,20,34,77,43,0
286,Markel Bergara,16.3,35,22,17,17,1,7,25,28.0,18,10,3,7,23,58,20,0
287,Emil Berggreen,7.4,2,2,0,0,2,1,4,25.0,3,7,1,6,1,3,10,0
288,Robert Beric,11.6,6,4,1,3,2,1,16,6.3,15,9,1,8,5,11,4,0
289,Kevin Berigaud,3.0,4,3,1,1,2,2,6,33.3,4,1,0,1,0,4,1,0
290,Etrit Berisha,31.0,1,1,1,0,0,1,1,100.0,0,0,0,0,1,2,5,3
291,Federico Bernardeschi,9.4,8,5,4,3,1,1,7,14.3,6,9,0,9,11,19,18,1
292,Bernardo,15.0,43,30,18,22,3,29,40,72.5,11,30,6,24,18,61,81,0
293,Juan Bernat,9.9,25,19,13,8,4,11,18,61.1,7,11,1,10,10,35,9,1
294,Andrea Bertolacci,32.2,85,53,40,38,7,21,63,33.3,42,46,12,34,46,131,37,1
295,Ryan Bertrand,34.8,48,35,27,17,4,19,31,61.3,12,28,9,19,44,92,74,0
296,Muhamed Besic,0.5,1,1,1,0,0,1,3,33.3,2,2,2,0,0,1,1,0
297,Daniel Bessa,15.4,26,19,9,15,2,8,29,27.6,21,12,2,10,14,40,8,1
298,Daniel Bessa,4.9,6,6,2,2,2,0,1,0.0,1,7,0,7,3,9,6,0
299,Vincent Bessat,17.4,41,27,23,16,2,22,48,45.8,26,19,1,18,18,59,18,0
301,Matteo Bianchetti,1.4,3,1,3,0,0,1,3,33.3,2,3,2,1,2,5,8,0
302,Ermin Bicakcic,6.1,17,15,8,8,1,8,12,66.7,4,4,2,2,9,26,26,0
303,Pedro Bigas,9.9,14,9,10,4,0,7,13,53.8,6,18,11,7,16,30,41,2
304,Lucas Biglia,22.7,59,36,28,26,5,22,61,36.1,39,49,12,37,28,87,51,1
305,Philip Billing,8.5,25,16,11,11,3,8,22,36.4,14,17,1,16,18,43,19,0
306,Jean-Claude Billong,3.3,9,7,5,4,0,5,8,62.5,3,4,3,1,6,15,17,0
307,Davide Biondini,2.3,4,4,2,2,0,1,2,50.0,1,1,0,1,3,7,1,0
308,Cristiano Biraghi,33.1,74,48,33,32,9,36,58,62.1,22,42,5,37,43,117,103,2
309,Mame Biram Diouf,28.8,48,36,26,15,7,8,21,38.1,13,22,0,22,14,62,76,1
310,Davide Biraschi,20.0,33,25,13,19,1,18,25,72.0,7,19,10,9,38,71,78,0
312,Valter Birsa,27.8,28,14,7,18,3,7,54,13.0,47,22,2,20,24,52,20,1
313,Milan Bisevac,7.9,7,5,5,1,1,5,7,71.4,2,2,0,2,5,12,43,0
314,Yves Bissouma,17.3,67,50,30,32,5,19,39,48.7,20,13,2,11,31,98,31,1
315,Leonardo Bittencourt,17.9,49,42,17,21,11,19,43,44.2,24,26,0,26,17,66,11,1
316,Albano Bizzarri,32.0,2,2,2,0,0,2,2,100.0,0,0,0,0,1,3,12,4
317,Ruben Blanco,21.6,0,0,0,0,0,0,2,0.0,2,1,0,1,3,3,16,1
318,Ludovic Blas,19.9,23,14,10,12,1,7,36,19.4,29,15,3,12,19,42,9,1
319,Pablo de Blasis,18.4,39,23,19,11,9,16,33,48.5,17,33,0,33,10,49,34,0
320,Jeremy Blayac,10.2,5,3,0,3,2,2,9,22.2,7,7,2,5,1,6,11,0
321,Alexis Blin,21.0,57,37,23,30,4,22,69,31.9,47,27,6,21,31,88,31,0
322,Daley Blind,4.0,6,4,3,2,1,2,7,28.6,5,3,0,3,7,13,14,0
324,Emmanuel Boateng,14.2,4,3,0,0,4,0,6,0.0,6,8,1,7,5,9,17,0
325,Jerome Boateng,18.2,26,18,18,7,1,19,32,59.4,13,20,12,8,21,47,52,1
326,Kevin-Prince Boateng,26.2,34,22,10,22,2,11,36,30.6,25,29,6,23,23,57,43,1
327,Raul Bobadilla,5.0,7,6,1,3,3,4,8,50.0,4,6,0,6,0,7,1,0
328,Yann Bodiger,2.5,3,1,0,3,0,1,6,16.7,5,0,0,0,2,5,3,0
329,Mathieu Bodmer,4.4,6,3,5,1,0,5,6,83.3,1,6,3,3,1,7,15,0
331,Quentin Boisgard,2.0,2,2,0,2,0,0,3,0.0,3,2,0,2,0,2,1,0
332,Yannick Bolasie,9.5,8,7,4,1,3,2,7,28.6,5,5,0,5,4,12,8,0
333,Deian Boldor,1.0,3,2,3,0,0,2,3,66.7,1,5,2,3,3,6,11,0
334,Giacomo Bonaventura,28.2,31,20,7,19,5,9,45,20.0,36,31,6,25,33,64,17,0
338,Daniele Bonera,13.2,16,11,8,7,1,10,15,66.7,5,17,12,5,12,28,72,0
339,Gaetan Bong,24.8,39,32,25,11,3,15,26,57.7,11,24,6,18,40,79,81,1
340,Kevin Bonifazi,4.5,11,7,6,5,0,4,6,66.7,2,7,5,2,13,24,15,0
342,Leonardo Bonucci,34.3,30,21,22,7,1,11,18,61.1,7,31,22,9,51,81,132,0
343,Wilfried Bony,7.9,5,4,2,2,1,1,5,20.0,4,4,1,3,2,7,15,0
344,Celso Borges,25.6,61,39,34,22,5,15,47,31.9,32,39,7,32,34,95,36,0
345,Fabio Borini,17.9,38,23,12,18,8,16,37,43.2,21,32,6,26,13,51,43,0
346,Marco Borriello,8.6,4,2,2,1,1,0,1,0.0,1,1,0,1,1,5,6,0
347,Gabriel Boschilia,0.9,4,1,1,2,1,1,4,25.0,3,1,0,1,0,4,0,0
348,Ryad Boudebouz,15.1,32,18,6,21,5,6,26,23.1,20,18,1,17,7,39,8,0
350,Sofiane Boufal,13.5,37,24,12,14,11,12,35,34.3,23,20,1,19,6,43,6,0
351,Arnold Bouka Moutou,3.7,8,5,6,0,2,6,8,75.0,2,4,1,3,4,12,5,0
352,Farid Boulaya,2.0,5,1,4,1,0,3,6,50.0,3,1,0,1,1,6,2,0
353,Yassine Bounou,29.5,1,1,1,0,0,0,2,0.0,2,0,0,0,4,5,14,0
354,Emmanuel Bourgaud,6.0,17,11,5,9,3,10,23,43.5,13,5,0,5,6,23,11,0
355,Benjamin Bourigeaud,34.5,55,30,18,30,7,20,93,21.5,73,48,4,44,45,100,29,0
356,Eneko Boveda,7.4,24,16,13,10,1,8,13,61.5,5,18,7,11,16,40,36,2
357,Eneko Boveda,5.8,12,11,7,4,1,5,11,45.5,6,3,0,3,14,26,14,0
358,Lucas Boye,1.7,9,8,5,3,1,1,3,33.3,2,5,0,5,2,11,2,0
359,Lucas Boye,3.1,12,8,3,7,2,3,10,30.0,7,5,0,5,6,18,4,0
360,Robbie Brady,14.2,32,21,14,17,1,8,28,28.6,20,17,3,14,7,39,29,0
361,Martin Braithwaite,10.2,6,4,0,4,2,1,6,16.7,5,6,2,4,0,6,3,0
362,Brandon,4.0,10,9,3,4,3,1,11,9.1,10,11,1,10,5,15,1,0
364,Julian Brandt,25.8,24,18,11,9,4,11,29,37.9,18,23,1,22,16,40,12,1
365,Darko Brasanac,13.4,32,17,11,17,4,13,33,39.4,20,14,3,11,14,46,12,0
366,Claudio Bravo,2.5,0,0,0,0,0,0,1,0.0,1,0,0,0,0,0,0,0
367,Josip Brekalo,9.7,15,12,6,7,2,6,12,50.0,6,17,0,17,4,19,3,0
368,Josip Brekalo,8.1,20,12,7,8,5,6,8,75.0,2,8,2,6,3,23,1,0
369,Jimmy Briand,35.7,33,21,13,15,5,4,42,9.5,38,17,2,15,12,45,51,0
370,Enrico Brignola,15.0,28,21,17,10,1,12,38,31.6,26,13,0,13,6,34,7,0
372,Miguel Britos,8.9,15,11,10,5,0,6,11,54.5,5,9,1,8,12,27,45,1
373,Leon Britton,3.4,6,5,0,5,1,5,8,62.5,3,3,1,2,1,7,1,0
374,Petar Brlek,2.6,9,7,4,5,0,3,7,42.9,4,0,0,0,1,10,3,0
375,John Brooks,8.1,20,13,15,4,1,16,22,72.7,6,11,5,6,10,30,46,0
376,Daniel Brosinski,27.8,45,35,21,18,6,22,44,50.0,22,46,11,35,24,69,75,2
377,Izzy Brown,3.5,3,3,2,1,0,1,7,14.3,6,3,0,3,1,4,3,0
378,Marcelo Brozovic,21.4,60,43,21,31,8,19,63,30.2,44,30,7,23,18,78,18,0
379,Bruma,17.9,18,16,7,7,4,9,18,50.0,9,28,2,26,12,30,11,0
380,Jeffrey Bruma,11.0,13,11,13,0,0,6,14,42.9,8,17,12,5,14,27,43,2
381,Bruno,22.4,30,17,21,6,3,14,22,63.6,8,17,11,6,38,68,76,0
382,Chris Brunt,21.3,41,24,19,21,1,11,31,35.5,20,28,4,24,22,63,45,1
384,Jacob Bruun Larsen,0.1,1,1,1,0,0,1,2,50.0,1,0,0,0,0,1,0,0
385,Marcel Buchel,18.8,37,21,15,21,1,13,48,27.1,35,35,6,29,45,82,46,1
386,Ante Budimir,17.6,28,20,4,16,8,2,20,10.0,18,20,3,17,7,35,27,0
387,Alberto Bueno,2.5,3,2,2,1,0,2,11,18.2,9,2,0,2,1,4,2,0
390,Onur Bulut,0.4,0,0,0,0,0,0,1,0.0,1,0,0,0,0,0,0,0
392,Nicolas Burdisso,23.0,20,11,13,7,0,7,11,63.6,4,23,14,9,30,50,124,3
393,Guido Burgstaller,25.8,14,9,0,10,4,4,14,28.6,10,28,3,25,10,24,9,0
394,Burgui,11.5,10,5,2,4,4,2,6,33.3,4,5,0,5,7,17,1,0
395,Oliver Burke,4.1,6,4,3,2,1,4,12,33.3,8,3,0,3,7,13,3,0
396,Roman Burki,33.0,1,1,1,0,0,1,3,33.3,2,1,0,1,0,1,10,4
397,Patrick Burner,10.0,18,12,13,5,0,7,20,35.0,13,6,0,6,13,31,23,0
398,Dzenis Burnic,3.4,9,6,2,5,2,4,10,40.0,6,2,0,2,4,13,3,0
399,Sergio Busquets,28.8,88,48,27,46,15,39,79,49.4,40,37,10,27,51,139,15,1
400,Unai Bustinza,18.2,36,21,25,8,3,21,38,55.3,17,17,9,8,47,83,64,0
402,Jack Butland,35.0,1,1,1,0,0,1,1,100.0,0,1,0,1,1,2,26,1
403,Sam Byram,2.8,9,5,6,3,0,4,9,44.4,5,6,2,4,9,18,16,0
404,Jakub Blaszczykowski,5.8,12,8,8,2,2,6,13,46.2,7,11,3,8,5,17,3,0
405,Erick Cabaco,11.6,25,14,21,4,0,14,20,70.0,6,10,8,2,17,42,71,2
407,Yohan Cabaye,26.4,70,44,39,28,3,24,97,24.7,73,47,4,43,79,149,29,4
408,Remy Cabella,0.7,7,4,2,2,3,2,4,50.0,2,0,0,0,1,8,0,0
409,Remy Cabella,25.1,58,39,29,22,7,17,73,23.3,56,31,0,31,14,72,4,2
410,Gustavo Cabral,21.0,29,21,14,15,0,14,38,36.8,24,22,11,11,43,72,106,2
411,Leandro Cabrera,4.1,8,5,8,0,0,0,3,0.0,3,5,2,3,6,14,33,0
412,Leandro Cabrera,8.0,19,10,12,7,0,7,17,41.2,10,9,5,4,22,41,37,0
413,Fabrizio Cacciatore,31.9,34,27,20,9,5,15,30,50.0,15,33,11,22,38,72,99,3
414,Martin Caceres,12.9,16,11,14,1,1,7,18,38.9,11,9,5,4,19,35,41,1
416,Martin Caceres,4.9,12,7,9,2,1,10,14,71.4,4,4,4,0,4,16,13,0
417,Cafu,7.6,9,7,3,4,2,3,11,27.3,8,3,1,2,12,21,13,0
418,Jonathan Cafu,7.0,16,9,7,6,3,5,13,38.5,8,6,1,5,10,26,1,0
419,Gary Cahill,23.2,29,21,15,9,5,10,21,47.6,11,21,14,7,27,56,127,1
420,Yannick Cahuzac,16.9,39,28,20,19,0,15,26,57.7,11,29,10,19,30,69,42,0
421,Felipe Caicedo,8.0,11,10,3,5,3,2,7,28.6,5,6,0,6,1,12,4,0
422,Caiuby,31.7,53,40,20,27,6,17,42,40.5,25,36,1,35,15,68,42,2
423,Cala,20.0,21,14,16,5,0,13,27,48.1,14,21,10,11,39,60,124,0
424,Davide Calabria,17.4,64,50,33,24,7,21,41,51.2,20,19,4,15,33,97,82,1
425,Mattia Caldara,24.0,39,26,15,24,0,13,33,39.4,20,31,18,13,41,80,113,1
427,Luca Caldirola,1.0,1,0,0,1,0,1,1,100.0,0,1,0,1,3,4,3,0
428,Hakan Calhanoglu,24.1,37,27,11,18,8,8,31,25.8,23,29,2,27,22,59,15,0
430,Daniel Caligiuri,32.4,100,66,48,43,9,49,94,52.1,45,59,4,55,67,167,71,0
431,Jose Callejon,36.0,33,27,15,14,4,10,47,21.3,37,42,5,37,22,55,31,0
432,Jonathan Calleri,34.5,24,16,5,10,9,4,23,17.4,19,15,2,13,7,31,35,0
433,Simone Calvano,7.2,13,12,4,9,0,3,16,18.8,13,10,4,6,15,28,14,1
434,Dominic Calvert-Lewin,20.9,15,8,5,3,7,2,15,13.3,13,13,1,12,10,25,23,1
435,Ignacio Camacho,10.6,27,21,10,16,1,9,23,39.1,14,14,5,9,41,68,43,0
436,Abdoul Camara,9.9,6,4,2,3,1,3,11,27.3,8,7,1,6,7,13,4,0
437,Souleymane Camara,10.4,6,4,0,5,1,0,3,0.0,3,3,1,2,2,8,15,0
438,Victor Camarasa,13.9,20,15,8,10,2,3,13,23.1,10,8,0,8,15,35,13,0
439,Geoff Cameron,16.9,34,21,20,12,2,11,27,40.7,16,28,8,20,36,70,68,0
440,Jose Campana,30.4,57,36,25,27,5,19,58,32.8,39,31,10,21,45,102,37,0
442,Joel Campbell,2.4,6,2,3,3,0,3,6,50.0,3,2,0,2,0,6,0,0
443,Tyrese Campbell,0.9,2,1,0,2,0,1,1,100.0,0,1,1,0,1,3,0,0
444,Emre Can,23.2,67,54,32,29,6,18,43,41.9,25,32,4,28,28,95,37,1
445,Sergio Canales,21.4,30,24,6,18,6,9,32,28.1,23,25,0,25,11,41,3,0
446,Joao Cancelo,20.6,42,29,27,11,4,17,42,40.5,25,15,2,13,35,77,51,0
447,Joao Cancelo,1.0,1,1,0,1,0,1,1,100.0,0,1,0,1,2,3,0,0
448,Antonio Candreva,28.2,12,7,7,5,0,8,39,20.5,31,20,2,18,22,34,24,0
449,Paolo Cannavaro,16.0,17,9,11,5,1,8,20,40.0,12,17,13,4,27,44,94,1
450,Ander Capa,25.0,57,38,34,14,9,25,38,65.8,13,21,2,19,52,109,50,1
451,Pierrick Capelle,20.9,50,37,29,17,4,16,70,22.9,54,29,0,29,34,84,26,0
452,Leonardo Capezzi,2.4,8,4,5,3,0,4,6,66.7,2,6,0,6,0,8,3,0
453,Etienne Capoue,17.1,43,26,15,25,3,19,47,40.4,28,21,1,20,43,86,38,0
455,Gianluca Caprari,20.1,19,11,2,11,6,0,10,0.0,10,25,2,23,5,24,3,0
456,Marco Capuano,15.6,20,10,14,6,0,5,15,33.3,10,19,13,6,28,48,93,0
457,Marco Capuano,7.7,13,9,6,7,0,4,8,50.0,4,7,2,5,6,19,23,1
458,Antonio Caracciolo,31.7,52,34,41,8,3,17,30,56.7,13,64,44,20,39,91,203,0
460,Diego Carlos,25.5,70,42,51,15,4,28,38,73.7,10,50,29,21,29,99,155,3
461,Lionel Carole,6.0,12,6,7,5,0,5,7,71.4,2,6,3,3,6,18,29,0
462,Yannick Carrasco,10.0,17,13,7,5,5,3,8,37.5,5,9,0,9,4,21,3,0
463,Michael Carrick,1.2,1,1,0,1,0,0,1,0.0,1,2,0,2,1,2,3,0
464,Daniel Carrico,5.1,7,7,6,1,0,4,7,57.1,3,6,3,3,10,17,22,0
465,Andre Carrillo,17.1,31,24,16,12,3,8,33,24.2,25,7,0,7,15,46,16,0
466,Guido Carrillo,5.0,5,1,0,3,2,0,1,0.0,1,4,0,4,0,5,5,0
468,Guido Carrillo,4.7,3,1,0,2,1,0,4,0.0,4,3,1,2,0,3,8,0
469,Thomas Carrique,1.0,1,0,0,1,0,1,3,33.3,2,0,0,0,2,3,3,0
470,Andy Carroll,8.3,3,3,2,0,1,0,1,0.0,1,3,2,1,2,5,15,0
471,Tom Carroll,28.6,53,33,22,23,8,14,53,26.4,39,37,8,29,29,82,18,1
472,Federico Cartabia,14.7,37,23,15,15,7,11,30,36.7,19,15,0,15,18,55,10,0
473,Dani Carvajal,24.7,59,40,27,22,10,22,38,57.9,16,33,15,18,38,97,42,2
474,Casemiro,28.8,109,78,64,39,6,42,84,50.0,42,56,11,45,63,172,49,3
475,Kiko Casilla,10.0,1,0,1,0,0,1,1,100.0,0,0,0,0,2,3,6,2
476,Francesco Cassata,5.1,12,7,6,5,1,2,10,20.0,8,3,0,3,5,17,0,0
477,Timothy Castagne,16.7,54,37,32,14,8,13,27,48.1,14,25,4,21,26,80,48,0
478,Leandro Castan,12.7,24,15,16,8,0,15,20,75.0,5,16,10,6,23,47,48,1
479,Koen Casteels,34.0,2,1,2,0,0,2,2,100.0,0,0,0,0,1,3,16,1
480,Dani Castellano,22.5,46,29,29,16,1,25,48,52.1,23,28,7,21,42,88,64,1
481,Javi Castellano,17.4,47,27,20,25,2,20,37,54.1,17,23,6,17,38,85,16,1
482,Samu Castillejo,23.0,41,28,22,10,9,13,62,21.0,49,39,5,34,22,63,37,0
483,Chory Castro,22.9,37,24,15,14,8,11,32,34.4,21,21,2,19,23,60,13,0
484,Gonzalo Castro,13.4,26,18,7,18,1,5,22,22.7,17,23,3,20,10,36,13,1
485,Jonny Castro,35.6,102,78,60,31,11,43,91,47.3,48,48,8,40,93,195,92,1
486,Lucas Castro,22.1,54,40,14,29,11,16,43,37.2,27,39,7,32,38,92,35,0
488,Danilo Cataldi,25.4,33,25,12,19,2,5,28,17.9,23,18,5,13,37,70,20,1
489,Craig Cathcart,5.8,8,5,5,3,0,4,5,80.0,1,8,6,2,3,11,38,0
490,Edinson Cavani,28.7,15,9,5,4,6,2,16,12.5,14,10,1,9,5,20,22,0
491,Marijan Cavar,0.4,0,0,0,0,0,0,3,0.0,3,0,0,0,0,0,0,0
492,Dani Ceballos,4.5,8,7,3,2,3,4,16,25.0,12,6,0,6,5,13,1,0
494,Federico Ceccherini,35.9,35,21,28,4,3,13,25,52.0,12,39,21,18,83,118,276,1
495,Emanuel Cecchini,0.3,3,1,2,1,0,2,3,66.7,1,0,0,0,2,5,2,0
496,Petr Cech,33.8,1,1,1,0,0,1,1,100.0,0,0,0,0,0,1,23,7
498,Luca Ceppitelli,24.7,45,33,31,12,2,16,34,47.1,18,33,21,12,50,95,156,0
499,Fabio Ceravolo,0.6,0,0,0,0,0,0,1,0.0,1,1,0,1,0,0,0,0
500,Alessio Cerci,18.2,15,10,7,3,5,4,16,25.0,12,4,0,4,4,19,8,0
501,Bostjan Cesar,6.1,4,3,3,1,0,3,4,75.0,1,6,4,2,3,7,40,0
503,Nacer Chadli,2.9,1,0,1,0,0,1,4,25.0,3,0,0,0,0,1,4,0
504,Fouad Chafik,17.9,58,49,31,19,8,20,35,57.1,15,17,1,16,33,91,46,1
505,Nathaniel Chalobah,5.0,9,6,2,6,1,2,5,40.0,3,6,5,1,6,15,6,0
506,Calum Chambers,9.6,17,10,10,6,1,5,14,35.7,9,14,11,3,18,35,47,0
508,Timothy Chandler,21.0,27,21,11,13,3,11,17,64.7,6,15,0,15,33,60,52,0
509,Kwon Chang-hoon,23.7,37,22,10,18,9,11,35,31.4,24,32,1,31,24,61,30,0
510,Charles,17.6,11,8,2,5,4,1,8,12.5,7,7,0,7,7,18,10,0
511,Charly Charrier,1.2,1,0,1,0,0,0,2,0.0,2,1,0,1,2,3,0,0
513,Chema,22.4,20,13,14,6,0,9,18,50.0,9,43,27,16,30,50,110,1
514,Denis Cheryshev,10.3,27,16,12,10,5,6,23,26.1,17,18,1,17,13,40,10,0
515,Raman Chibsah,11.6,20,13,10,7,3,4,14,28.6,10,13,2,11,4,24,16,0
516,Leandro Chichizola,27.0,2,0,2,0,0,2,6,33.3,4,0,0,0,4,6,29,3
517,Giorgio Chiellini,24.0,28,19,17,10,1,7,15,46.7,8,21,14,7,47,75,142,3
518,Federico Chiesa,33.5,62,41,22,22,18,16,54,29.6,38,34,1,33,18,80,16,0
520,Ben Chilwell,20.6,36,26,21,10,5,15,32,46.9,17,31,4,27,28,64,71,3
521,Vlad Chiriches,6.5,8,4,7,1,0,2,5,40.0,3,2,1,1,16,24,19,1
522,Hamza Choudhury,4.2,9,5,6,3,0,2,10,20.0,8,12,1,11,8,17,4,0
523,Andreas Christensen,23.2,26,13,23,3,0,10,15,66.7,5,25,17,8,39,65,109,5
524,Chuca,1.0,1,0,1,0,0,1,3,33.3,2,1,1,0,1,2,1,1
526,Amato Ciciretti,9.0,14,8,5,6,3,2,11,18.2,9,9,0,9,6,20,4,0
527,Cifu,1.2,2,1,0,1,1,1,5,20.0,4,1,1,0,2,4,2,0
528,Luca Cigarini,22.5,42,30,16,25,1,18,64,28.1,46,32,5,27,42,84,27,1
529,Per Ciljan Skjelbred,24.3,89,66,33,54,2,42,64,65.6,22,31,6,25,45,134,23,0
531,Thiago Cionek,15.0,28,21,18,6,4,11,20,55.0,9,19,9,10,35,63,99,0
532,Saliou Ciss,1.6,3,2,1,1,1,2,5,40.0,3,0,0,0,2,5,1,0
534,Issa Cissokho,18.1,31,23,22,9,0,18,32,56.3,14,18,8,10,34,65,87,1
535,Ciaran Clark,19.4,25,17,17,8,0,11,21,52.4,10,15,10,5,17,42,144,1
536,Christian Clemens,7.2,12,11,6,5,1,4,13,30.8,9,8,0,8,4,16,7,0
537,Tom Cleverley,21.1,48,26,25,16,7,21,52,40.4,31,11,1,10,25,73,21,0
538,Sam Clucas,22.7,34,19,21,11,2,10,29,34.5,19,31,7,24,29,63,34,1
539,Nathaniel Clyne,1.9,3,1,2,1,0,0,1,0.0,1,2,1,1,0,3,3,0
540,Marcus Coco,17.6,40,28,17,13,10,7,35,20.0,28,22,3,19,15,55,9,0
541,Massimo Coda,15.7,12,9,3,4,5,2,13,15.4,11,7,2,5,6,18,11,0
542,Isaac Cofie,6.6,13,10,3,9,1,7,15,46.7,8,9,3,6,10,23,7,0
543,Renaud Cohade,36.6,143,86,63,71,9,46,119,38.7,73,70,10,60,53,196,91,0
544,Coke,15.4,35,23,26,7,2,18,39,46.2,21,17,5,12,34,69,46,0
547,Emre Colak,16.1,24,19,4,14,6,7,28,25.0,21,7,1,6,7,31,5,1
548,Seamus Coleman,11.5,14,14,9,3,2,6,11,54.5,5,16,12,4,10,24,29,2
549,James Collins,11.7,15,9,11,4,0,8,11,72.7,3,13,10,3,16,31,120,1
550,Racine Coly,6.9,15,12,9,5,1,9,19,47.4,10,5,2,3,15,30,18,0
551,Kingsley Coman,12.8,11,10,2,6,3,5,10,50.0,5,6,0,6,7,18,1,0
552,Marvin Compper,1.0,2,2,0,2,0,2,3,66.7,1,2,2,0,0,2,8,0
553,Alois Confais,6.8,8,6,7,1,0,3,9,33.3,6,7,4,3,4,12,15,1
554,Daniel Congre,29.3,62,46,36,24,2,31,59,52.5,28,29,16,13,56,118,124,2
555,Andrea Consigli,36.8,0,0,0,0,0,0,2,0.0,2,0,0,0,0,0,27,6
556,Diego Contento,1.2,3,0,1,2,0,1,1,100.0,0,2,1,1,1,4,9,0
557,Andrea Conti,1.7,4,2,1,3,0,2,3,66.7,1,3,0,3,1,5,5,0
558,Lewis Cook,24.9,67,35,37,30,0,26,69,37.7,43,33,12,21,35,102,25,2
559,Steve Cook,30.7,37,19,28,7,2,19,29,65.5,10,63,45,18,54,91,232,4
560,Duje Cop,1.1,1,1,0,0,1,0,1,0.0,1,1,0,1,0,1,0,0
561,Francis Coquelin,1.9,5,4,2,3,0,1,3,33.3,2,1,0,1,3,8,2,0
562,Francis Coquelin,7.3,18,14,11,6,1,9,16,56.3,7,9,2,7,20,38,23,0
563,Sebastien Corchia,9.1,18,13,7,8,3,9,16,56.3,7,18,4,14,16,34,20,0
565,Inigo Cordoba,16.2,44,30,18,21,5,16,58,27.6,42,31,0,31,21,65,9,0
566,Jhon Cordoba,10.6,13,10,0,11,2,1,5,20.0,4,6,2,4,1,14,9,0
567,Sergio Cordova,6.5,5,5,0,2,3,3,4,75.0,1,12,2,10,0,5,6,0
568,Jeremy Cordoval,10.2,20,16,12,7,1,9,14,64.3,5,12,2,10,9,29,35,0
569,Benjamin Corgnet,15.3,28,19,5,16,7,6,28,21.4,22,18,1,17,11,39,11,0
570,Jack Cork,38.0,60,44,25,27,8,20,62,32.3,42,36,15,21,41,101,86,1
572,Andreas Cornelius,10.4,9,5,3,3,3,1,7,14.3,6,7,0,7,2,11,7,0
573,Maxwel Cornet,14.1,17,12,6,9,2,3,25,12.0,22,11,1,10,14,31,14,0
574,Quentin Cornette,5.0,11,8,5,3,3,3,13,23.1,10,7,0,7,3,14,5,0
575,Angel Correa,25.0,41,29,12,16,13,8,57,14.0,49,30,1,29,25,66,17,0
576,Joaquin Correa,13.3,15,10,7,6,2,8,29,27.6,21,15,1,14,2,17,12,0
577,Andrea Cossu,2.7,1,0,0,0,1,0,2,0.0,2,2,0,2,3,4,2,0
578,Andrea Costa,15.3,19,14,13,6,0,9,19,47.4,10,21,15,6,37,56,78,2
579,Danny da Costa,13.4,41,34,17,14,10,24,28,85.7,4,21,4,17,13,54,47,0
580,Diego Costa,11.6,17,11,2,10,5,4,15,26.7,11,14,4,10,5,22,3,0
581,Douglas Costa,19.9,17,14,10,5,2,8,25,32.0,17,15,0,15,7,24,7,0
582,Filippo Costa,16.4,19,12,7,7,5,7,17,41.2,10,23,6,17,22,41,50,0
583,Jaume Costa,28.2,67,43,39,22,6,33,51,64.7,18,30,8,22,46,113,97,0
585,Nuno da Costa,19.2,50,32,12,29,9,7,35,20.0,28,21,0,21,19,69,9,0
586,Benoit Costil,36.0,0,0,0,0,0,0,2,0.0,2,0,0,0,3,3,13,4
587,Kalifa Coulibaly,3.8,6,6,3,1,2,2,4,50.0,2,0,0,0,0,6,6,0
588,Lassana Coulibaly,9.3,26,17,13,10,3,10,35,28.6,25,15,1,14,8,34,10,0
590,Philippe Coutinho,12.3,17,14,4,10,3,3,21,14.3,18,10,0,10,10,27,5,1
591,Philippe Coutinho,14.4,27,14,8,14,5,9,32,28.1,23,14,0,14,6,33,4,0
592,Nicolas Cozza,6.4,21,11,12,8,1,7,16,43.8,9,5,2,3,13,34,12,0
594,Martin Cranie,2.0,3,2,2,1,0,0,1,0.0,1,3,3,0,1,4,10,0
595,Michele Cremonesi,4.3,4,2,2,2,0,1,4,25.0,3,5,3,2,7,11,28,0
596,Aaron Cresswell,34.1,34,21,12,20,2,19,30,63.3,11,42,17,25,44,78,117,1
598,Lorenzo Crisetig,6.2,18,14,8,9,1,7,24,29.2,17,8,2,6,13,31,16,1
599,Bryan Cristante,31.4,66,50,21,32,13,18,59,30.5,41,43,6,37,23,89,27,0
600,Sebastian Cristoforo,3.0,16,12,6,8,2,9,19,47.4,10,4,0,4,4,20,6,0
601,Enzo Crivelli,11.4,13,9,2,6,5,1,5,20.0,4,4,0,4,2,15,6,0
602,Enzo Crivelli,8.1,4,2,2,1,1,1,5,20.0,4,1,0,1,2,6,2,0
603,Giovanni Crociata,3.2,9,6,3,4,2,1,4,25.0,3,7,0,7,4,13,3,0
605,Peter Crouch,17.4,2,0,0,1,1,0,12,0.0,12,7,4,3,1,3,31,0
607,Juan Cuadrado,15.0,28,19,17,9,2,11,27,40.7,16,14,0,14,19,47,14,1
608,Ivan Cuellar,35.0,4,3,4,0,0,3,4,75.0,1,0,0,0,3,7,22,6
609,Mickael Cuisance,13.4,31,20,16,11,4,19,29,65.5,10,22,4,18,10,41,10,1
610,Josh Cullen,0.1,0,0,0,0,0,0,1,0.0,1,1,1,0,2,2,0,0
611,Patrick Cutrone,16.7,11,10,2,7,2,1,10,10.0,9,11,1,10,3,14,12,0
612,Wylan Cyprien,10.6,9,7,4,4,1,2,11,18.2,9,7,1,6,11,20,7,2
613,Marco D'Alessandro,11.6,31,22,15,9,7,8,24,33.3,16,12,1,11,10,41,8,1
614,Danilo D'Ambrosio,33.1,82,64,38,35,9,30,59,50.8,29,31,7,24,45,127,68,1
615,Damien Da Silva,31.5,52,35,40,12,0,20,33,60.6,13,45,25,20,36,88,184,2
616,Kouadio-Yves Dabila,10.5,20,11,14,4,2,6,10,60.0,4,14,6,8,10,30,46,0
617,Bryan Dabo,6.6,17,11,6,10,1,6,15,40.0,9,13,1,12,15,32,24,1
618,Bryan Dabo,14.3,25,16,12,10,3,7,29,24.1,22,12,1,11,11,36,22,0
619,Mahmoud Dahoud,12.7,38,23,11,21,6,13,30,43.3,17,18,2,16,12,50,7,0
620,Dario Dainelli,16.7,19,14,14,4,1,10,21,47.6,11,27,22,5,46,65,126,0
621,Felipe dal Belo,28.6,51,34,32,16,3,25,49,51.0,24,42,24,18,48,99,157,1
622,Charlie Daniels,33.4,48,34,32,12,4,22,41,53.7,19,34,7,27,31,79,114,0
624,Danilo,15.0,43,29,25,12,6,19,35,54.3,16,15,6,9,19,62,33,0
625,Scott Dann,15.9,10,5,8,2,0,7,17,41.2,10,17,14,3,23,33,98,1
626,Kevin Danso,12.3,18,12,13,5,0,12,16,75.0,4,21,14,7,20,38,63,1
627,Dante,32.4,43,28,32,10,1,21,36,58.3,15,44,25,19,47,90,130,2
628,Romain Danze,7.6,12,7,3,4,5,8,13,61.5,5,11,2,9,3,15,34,0
629,Andrea Danzi,4.4,11,6,7,4,0,5,13,38.5,8,3,0,3,5,16,5,1
630,Stephane Darbion,19.0,19,14,13,4,2,5,40,12.5,35,21,2,19,20,39,17,0
632,Sergi Darder,30.9,64,43,29,28,7,19,62,30.6,43,31,5,26,52,116,48,1
633,Sergi Darder,2.3,9,3,1,5,3,1,7,14.3,6,0,0,0,3,12,3,0
634,Vladimir Darida,18.2,38,28,11,18,9,11,26,42.3,15,22,4,18,24,62,23,0
636,Matteo Darmian,4.9,16,14,7,7,2,6,19,31.6,13,5,3,2,7,23,23,0
637,Ben Davies,25.8,47,33,13,21,13,25,48,52.1,23,24,5,19,28,75,70,1
638,Tom Davies,21.1,30,20,14,11,5,12,54,22.2,42,19,5,14,24,54,21,0
639,Steven Davis,16.9,30,21,10,17,3,11,30,36.7,19,22,6,16,15,45,24,1
640,Salem Al-Dawsari,0.4,1,0,0,1,0,1,1,100.0,0,1,0,1,0,1,0,0
641,Craig Dawson,27.9,38,28,25,7,6,13,36,36.1,23,39,26,13,52,90,140,0
642,Kevin De Bruyne,34.1,62,43,23,25,14,23,80,28.8,57,45,2,43,25,87,14,2
643,Sebastien De Maio,22.8,26,17,15,11,0,10,25,40.0,15,35,18,17,36,62,147,0
644,Rodrigo De Paul,25.8,31,18,10,17,4,4,32,12.5,28,34,1,33,16,47,8,0
645,Daniele De Rossi,20.3,23,13,12,9,2,9,33,27.3,24,18,13,5,43,66,45,2
646,Mattia De Sciglio,10.8,22,17,7,13,2,9,13,69.2,4,12,2,10,14,36,32,0
647,Lorenzo De Silvestri,32.8,39,25,19,13,7,16,26,61.5,10,47,10,37,27,66,165,0
648,Lucas Deaux,21.6,62,45,21,37,4,20,67,29.9,47,41,6,35,32,94,19,0
650,Mathieu Debuchy,14.6,34,25,22,8,4,17,30,56.7,13,16,10,6,27,61,73,0
651,Troy Deeney,20.5,15,11,3,8,4,3,11,27.3,8,14,1,13,5,20,20,0
652,Jermain Defoe,12.1,12,9,2,6,4,2,10,20.0,8,10,0,10,4,16,1,0
653,Steven Defour,22.2,33,22,12,18,3,10,46,21.7,36,35,7,28,46,79,25,0
654,Gregoire Defrel,5.4,8,3,1,1,6,2,8,25.0,6,5,0,5,3,11,6,0
655,Alessandro Deiola,5.0,9,7,5,3,1,6,13,46.2,7,8,0,8,4,13,12,0
656,Lorenzo Del Pinto,8.4,23,17,10,10,3,7,25,28.0,18,13,4,9,16,39,7,2
657,Damien Delaney,1.1,2,1,2,0,0,1,1,100.0,0,5,4,1,3,5,7,0
658,Thomas Delaney,31.1,79,61,27,46,6,36,53,67.9,17,37,12,25,43,122,74,4
659,Jonathan Delaplace,6.5,10,8,1,8,1,3,10,30.0,7,13,5,8,8,18,8,0
660,Cristian Dell'Orco,4.7,4,1,1,2,1,1,3,33.3,2,5,1,4,10,14,19,0
661,Andy Delort,25.9,20,13,2,9,9,4,19,21.1,15,10,0,10,12,32,22,0
662,Fabian Delph,19.3,46,34,21,16,9,18,37,48.6,19,16,0,16,30,76,42,2
663,Mousa Dembele,20.9,36,24,19,11,6,9,37,24.3,28,20,0,20,33,69,15,0
664,Ousmane Dembele,10.3,10,7,2,5,3,1,13,7.7,12,8,0,8,5,15,2,0
665,Jessy Deminguet,5.9,12,9,4,6,2,4,14,28.6,10,5,0,5,10,22,13,0
666,Kerem Demirbay,13.5,38,30,15,17,6,12,28,42.9,16,21,3,18,14,52,21,0
667,Ermedin Demirovic,2.0,1,1,0,1,0,0,1,0.0,1,5,0,5,0,1,2,0
668,Diego Demme,25.4,81,57,29,48,4,47,87,54.0,40,31,3,28,48,129,29,0
669,Fabio Depaoli,13.2,31,22,21,7,3,21,40,52.5,19,27,10,17,15,46,42,0
670,Mathieu Deplagne,26.8,52,38,33,14,5,20,48,41.7,28,26,10,16,60,112,95,2
671,Laurent Depoitre,20.2,14,8,4,8,2,3,21,14.3,18,15,3,12,11,25,36,0
672,Mike van der Hoorn,21.6,32,22,23,8,1,16,24,66.7,8,24,14,10,39,71,127,0
673,Gregory van der Wiel,3.2,5,3,4,1,0,3,5,60.0,2,1,0,1,10,15,12,0
674,Daniele Dessena,6.4,18,10,12,5,1,6,12,50.0,6,7,1,6,6,24,17,0
676,Mattia Destro,18.0,15,13,4,9,2,3,11,27.3,8,10,1,9,5,20,26,0
677,Gerard Deulofeu,4.8,5,3,2,2,1,2,11,18.2,9,0,0,0,4,9,3,1
678,Gerard Deulofeu,5.6,8,5,6,1,1,3,4,75.0,1,2,0,2,8,16,0,0
679,Gianluca Di Chiara,11.2,26,19,18,6,2,7,21,33.3,14,10,3,7,11,37,37,1
680,Federico Di Francesco,17.7,26,13,14,8,4,5,20,25.0,15,24,2,22,16,42,25,0
681,Davide Di Gennaro,0.1,1,0,1,0,0,1,1,100.0,0,0,0,0,0,1,0,0
682,Angel Di Maria,23.5,13,10,5,3,5,7,39,17.9,32,18,2,16,10,23,8,0
683,Franco Di Santo,18.4,17,13,3,13,1,7,15,46.7,8,12,1,11,2,19,24,0
684,Cheick Diabate,7.4,1,1,0,1,0,1,3,33.3,2,2,0,2,0,1,6,0
685,Fousseni Diabate,6.5,9,6,5,3,1,1,4,25.0,3,6,0,6,8,17,8,0
686,Moussa Diaby,0.8,1,0,1,0,0,1,4,25.0,3,1,0,1,1,2,0,0
687,Fallou Diagne,24.9,33,20,21,12,0,7,22,31.8,15,33,18,15,46,79,116,3
688,Adama Diakhaby,9.4,23,15,6,12,5,6,16,37.5,10,13,0,13,13,36,5,0
689,Mouctar Diakhaby,8.1,10,6,7,3,0,4,7,57.1,3,14,9,5,12,22,52,1
690,Abdou Diallo,26.8,75,53,45,25,5,38,50,76.0,12,37,14,23,50,125,75,0
693,Mustapha Diallo,15.4,48,36,15,29,4,15,33,45.5,18,20,4,16,20,68,29,0
694,Mohamed Diame,22.7,89,64,33,48,8,16,62,25.8,46,44,7,37,48,137,30,2
695,Lassana Diarra,6.7,12,4,4,7,1,8,12,66.7,4,3,1,2,6,18,6,0
696,Amadou Diawara,7.3,11,9,3,7,1,1,7,14.3,6,12,2,10,9,20,5,0
698,Bakaye Dibassy,30.9,71,51,45,22,4,24,50,48.0,26,52,26,26,58,129,148,0
699,Daniel Didavi,24.9,34,19,10,19,5,14,33,42.4,19,20,1,19,7,41,12,0
700,Thomas Didillon,9.0,0,0,0,0,0,0,1,0.0,1,0,0,0,0,0,5,2
702,Etienne Didot,18.0,54,33,20,33,1,20,43,46.5,23,21,7,14,19,73,29,0
703,Adrian Dieguez,4.8,10,5,5,5,0,6,13,46.2,7,5,0,5,11,21,24,1
704,Dennis Diekmeier,20.8,47,43,31,10,6,25,36,69.4,11,22,11,11,16,63,50,0
705,Eric Dier,31.4,61,43,15,39,7,17,42,40.5,25,32,11,21,48,109,93,7
706,Lucas Digne,7.8,22,17,13,6,3,8,12,66.7,4,15,3,12,12,34,18,0
707,Landry Dimata,10.0,7,6,4,3,0,5,6,83.3,1,6,2,4,2,9,5,0
708,Tristan Dingome,13.2,25,20,12,9,4,5,13,38.5,8,12,0,12,12,37,16,1
709,Ismael Diomande,7.9,14,8,7,6,1,10,15,66.7,5,11,5,6,5,19,20,0
710,Lois Diony,10.3,3,0,1,2,0,0,3,0.0,3,5,1,4,1,4,8,0
711,Issa Diop,34.0,58,43,35,22,1,21,48,43.8,27,38,25,13,76,134,128,0
712,Papakouli Diop,2.9,5,3,1,3,1,0,3,0.0,3,5,2,3,6,11,6,0
713,Papakouli Diop,10.4,26,20,6,16,4,11,26,42.3,15,3,0,3,13,39,10,0
714,Assane Diousse,14.9,32,21,14,14,4,13,34,38.2,21,29,2,27,11,43,16,2
715,Djene,36.0,87,65,71,15,1,34,52,65.4,18,33,14,19,78,165,190,1
716,Koffi Djidji,26.8,55,39,32,20,3,19,29,65.5,10,34,15,19,45,100,126,0
717,Alexander Djiku,28.0,65,43,52,11,2,25,52,48.1,27,34,5,29,57,122,155,2
718,Papy Djilobodji,30.0,45,29,34,11,0,21,43,48.8,22,38,25,13,71,116,211,5
719,Berat Djimsiti,30.0,32,17,28,4,0,12,30,40.0,18,37,23,14,62,94,178,1
720,Marko Dmitrovic,36.0,4,4,4,0,0,4,11,36.4,7,1,0,1,2,6,26,2
721,Keagan Dolly,9.8,12,7,2,7,3,1,11,9.1,10,11,0,11,1,13,2,0
724,Giulio Donati,25.4,56,42,30,21,5,34,50,68.0,16,38,8,30,35,91,66,1
726,Anastasios Donis,10.5,20,14,10,6,4,6,8,75.0,2,2,0,2,9,29,7,0
728,Gianluigi Donnarumma,38.0,1,0,1,0,0,1,1,100.0,0,0,0,0,1,2,13,8
729,Godfred Donsah,19.9,29,20,11,14,4,10,17,58.8,7,25,0,25,22,51,43,0
731,Niklas Dorsch,1.0,1,1,0,1,0,0,2,0.0,2,0,0,0,1,2,0,0
732,Gabriel Dos Santos,0.9,1,1,1,0,0,0,1,0.0,1,2,1,1,0,1,4,1
733,Mauro dos Santos,10.9,16,14,11,5,0,10,15,66.7,5,7,5,2,12,28,53,1
734,Mathieu Dossevi,27.9,35,25,15,15,5,7,39,17.9,32,24,3,21,28,63,12,0
735,Abdoulaye Doucoure,36.9,79,52,28,42,9,27,79,34.2,52,43,10,33,54,133,61,0
736,Cheick Doukoure,11.4,34,19,18,15,1,6,22,27.3,16,15,4,11,14,48,4,0
737,Mohamed Drager,0.6,0,0,0,0,0,0,1,0.0,1,1,0,1,0,0,0,0
738,Aleksandar Dragovic,8.5,13,10,13,0,0,7,13,53.8,6,16,8,8,16,29,46,0
739,Aleksandar Dragovic,0.5,0,0,0,0,0,0,1,0.0,1,0,0,0,0,0,0,1
742,Julian Draxler,18.9,20,14,4,13,3,6,32,18.8,26,18,2,16,28,48,8,0
743,Danny Drinkwater,5.9,15,10,6,8,1,3,17,17.6,14,10,2,8,8,23,7,0
744,Josip Drmic,5.2,0,0,0,0,0,0,4,0.0,4,1,0,1,0,0,1,1
745,Rick van Drongelen,16.0,30,25,23,7,0,21,28,75.0,7,20,11,9,19,49,58,1
746,Oscar Duarte,11.0,12,9,8,4,0,4,11,36.4,7,8,8,0,9,21,60,2
747,Ruben Duarte,23.8,76,40,42,27,7,35,59,59.3,24,40,10,30,44,120,94,0
748,Leo Dubois,33.6,50,39,33,15,2,20,47,42.6,27,47,13,34,50,100,99,2
750,Ondrej Duda,8.3,16,12,7,6,3,6,14,42.9,8,15,0,15,4,20,8,0
751,Shane Duffy,36.6,31,19,22,9,0,7,20,35.0,13,66,59,7,50,81,332,5
752,Paul Dummett,17.8,28,19,21,7,0,13,27,48.1,14,27,10,17,23,51,107,1
754,Alfred Duncan,21.6,39,29,16,18,5,15,52,28.8,37,32,2,30,19,58,29,1
755,Lewis Dunk,38.0,67,33,49,18,0,25,48,52.1,23,73,58,15,71,138,230,2
757,Jimmy Durmaz,11.4,16,9,5,5,6,6,14,42.9,8,2,0,2,14,30,9,0
758,Riza Durmisi,23.1,39,21,24,14,1,10,18,55.6,8,18,7,11,15,54,65,1
759,Hugo Duro,0.2,0,0,0,0,0,0,1,0.0,1,0,0,0,0,0,0,0
761,Paulo Dybala,26.1,19,11,4,10,5,4,32,12.5,28,22,0,22,12,31,4,0
762,Nathan Dyer,14.5,22,16,8,9,5,6,24,25.0,18,13,0,13,11,33,3,0
763,Edin Dzeko,33.5,15,10,1,9,5,3,15,20.0,12,9,1,8,4,19,36,0
764,Blerim Dzemaili,13.3,27,19,11,15,1,9,27,33.3,18,15,4,11,18,45,11,0
765,Felix Eboa Eboa,16.9,19,11,12,7,0,8,16,50.0,8,21,11,10,39,58,119,2
766,Eder,8.9,10,7,2,4,4,0,10,0.0,10,6,1,5,5,15,4,0
767,Simone Edera,3.6,6,2,2,4,0,3,10,30.0,7,0,0,0,2,8,1,0
769,Tom Edwards,5.3,15,9,10,5,0,8,8,100.0,0,5,2,3,5,20,20,0
771,Johannes Eggestein,1.1,0,0,0,0,0,0,1,0.0,1,2,1,1,1,1,0,0
772,Maximilian Eggestein,29.9,70,48,32,34,4,34,58,58.6,24,41,6,35,40,110,51,0
773,Albin Ekdal,12.3,39,28,19,19,1,18,29,62.1,11,20,3,17,21,60,19,0
774,Josip Elez,8.6,12,8,9,2,1,5,9,55.6,4,9,7,2,16,28,39,1
775,Rob Elliot,16.0,0,0,0,0,0,0,1,0.0,1,0,0,0,0,0,8,0
776,Mohamed Elneny,9.6,12,6,6,3,3,6,10,60.0,4,11,0,11,10,22,12,2
777,Aritz Elustondo,17.7,32,20,20,9,3,19,30,63.3,11,20,7,13,45,77,84,0
778,Nico Elvedi,32.4,66,46,41,22,3,37,55,67.3,18,39,9,30,51,117,108,3
780,Rodrigo Ely,29.9,32,18,26,6,0,19,34,55.9,15,45,36,9,50,82,183,0
781,Breel Embolo,10.2,14,10,3,7,4,2,9,22.2,7,13,0,13,6,20,3,0
782,Youssef En-Nesyri,17.7,31,25,10,14,7,6,26,23.1,20,11,0,11,9,40,32,0
783,Sergi Enrich,14.8,11,8,3,3,5,2,8,25.0,6,13,1,12,6,17,8,0
784,Javier Eraso,28.1,32,15,10,18,4,13,42,31.0,29,16,5,11,23,55,17,0
785,Christian Eriksen,35.8,51,29,16,30,5,17,59,28.8,42,38,1,37,31,82,21,0
786,Gonzalo Escalante,17.4,59,35,21,32,6,17,39,43.6,22,26,3,23,32,91,19,0
787,Sergio Escudero,25.9,78,49,40,26,12,32,62,51.6,30,35,6,29,66,144,69,1
788,Bernardo Espinosa,31.9,36,22,29,6,1,18,33,54.5,15,27,19,8,66,102,169,0
789,Michael Esser,3.0,0,0,0,0,0,0,1,0.0,1,0,0,0,0,0,0,0
790,Alexander Esswein,6.9,25,16,13,10,2,12,25,48.0,13,4,0,4,9,34,11,0
791,Oghenekaro Etebo,13.5,24,17,9,12,3,12,26,46.2,14,17,3,14,27,51,10,0
792,Benat Etxebarria,12.4,28,20,12,13,3,13,36,36.1,23,6,1,5,28,56,12,0
793,Xabier Etxeita,4.2,2,2,2,0,0,1,4,25.0,3,3,2,1,7,9,25,1
794,Jonny Evans,25.2,29,22,19,8,2,14,33,42.4,19,22,13,9,48,77,131,1
795,Franck Evina,1.2,2,2,2,0,0,2,2,100.0,0,5,0,5,0,2,0,0
796,Patrice Evra,2.5,6,4,5,1,0,6,8,75.0,2,4,1,3,7,13,6,0
797,Patrice Evra,3.9,6,5,5,1,0,3,6,50.0,3,2,2,0,3,9,16,0
798,Edu Exposito,1.1,1,0,0,0,1,0,1,0.0,1,1,0,1,2,3,2,0
799,Erik Exposito,5.2,1,1,0,1,0,0,6,0.0,6,6,0,6,1,2,5,0
800,Valentin Eysseric,7.8,17,13,7,4,6,6,20,30.0,14,10,2,8,6,23,6,0
802,Imoh Ezekiel,5.2,8,6,3,2,3,3,4,75.0,1,4,0,4,2,10,3,0
803,Marco Fabian,4.7,5,3,2,3,0,3,4,75.0,1,2,0,2,3,8,1,0
806,Fabinho,34.0,114,64,38,67,9,48,112,42.9,64,48,13,35,43,157,62,0
807,Cesc Fabregas,25.6,68,49,30,29,9,18,69,26.1,51,25,4,21,22,90,26,2
808,Ralf Fahrmann,33.5,1,0,1,0,0,1,3,33.3,2,1,0,1,1,2,12,7
809,Faycal Fajr,26.5,62,45,22,34,6,17,66,25.8,49,26,4,22,30,92,42,0
810,Radamel Falcao,23.7,11,6,0,8,3,2,13,15.4,11,13,3,10,10,21,11,0
811,Diego Falcinelli,4.9,1,1,1,0,0,0,5,0.0,5,5,1,4,1,2,4,0
812,Diego Falcinelli,14.6,4,4,1,2,1,1,13,7.7,12,12,2,10,2,6,9,0
814,Simon Falette,24.6,34,30,23,10,1,19,31,61.3,12,37,15,22,58,92,134,1
815,Cesar Falletti,3.6,11,7,4,6,1,4,8,50.0,4,10,0,10,0,11,5,0
816,Iago Falque,31.3,41,31,15,20,6,6,43,14.0,37,22,0,22,15,56,15,0
817,Paolo Farago,27.3,92,67,53,24,15,24,60,40.0,36,41,5,36,23,115,76,0
818,Imad Faraj,1.8,5,2,2,1,2,4,8,50.0,4,1,0,1,4,9,3,0
819,Davide Faraoni,19.5,62,39,36,20,6,28,47,59.6,19,30,8,22,58,120,76,0
820,Mohamed Fares,28.9,50,33,29,17,4,16,42,38.1,26,24,5,19,50,100,132,2
821,Diego Farias,17.9,21,15,3,9,9,6,24,25.0,18,17,0,17,8,29,6,0
822,Federico Fazio,32.5,56,43,38,18,0,25,31,80.6,6,30,22,8,46,102,161,3
823,Zouhair Feddal,14.0,22,14,14,6,2,7,12,58.3,5,17,13,4,36,58,95,2
824,Nabil Fekir,27.5,45,33,11,24,10,8,40,20.0,32,11,0,11,8,53,5,0
825,Felipe,5.1,8,8,4,4,0,2,4,50.0,2,4,3,1,11,19,29,0
826,Luiz Felipe,13.0,40,28,24,16,0,15,25,60.0,10,26,14,12,18,58,50,1
827,Ohis Felix Uduokhai,17.3,42,23,27,13,2,17,24,70.8,7,23,10,13,34,76,66,6
828,Marouane Fellaini,7.6,15,8,6,8,1,2,11,18.2,9,12,3,9,14,29,19,1
829,Kiko Femenia,19.0,36,28,22,11,3,14,27,51.9,13,15,2,13,34,70,31,1
830,Leroy Fer,15.5,44,32,18,21,5,13,30,43.3,17,18,4,14,12,56,24,3
832,Julien Feret,34.0,40,27,10,25,5,14,75,18.7,61,52,7,45,49,89,58,2
833,Edimilson Fernandes,9.4,17,9,10,7,0,9,21,42.9,12,13,1,12,16,33,8,0
834,Gelson Fernandes,11.5,58,46,25,29,4,23,45,51.1,22,23,3,20,16,74,21,0
836,Augusto Fernandez,1.2,3,2,1,2,0,1,3,33.3,2,3,2,1,2,5,3,0
837,Brian Fernandez,1.4,0,0,0,0,0,0,1,0.0,1,2,0,2,0,0,0,0
838,Carlos Fernandez,1.5,2,1,1,1,0,0,2,0.0,2,1,0,1,0,2,0,0
839,Federico Fernandez,29.7,40,29,30,6,4,20,30,66.7,10,35,27,8,38,78,201,1
841,Fernandinho,32.0,62,35,22,28,12,24,65,36.9,41,38,6,32,47,109,68,2
842,Alex Ferrari,23.7,73,54,42,23,8,36,67,53.7,31,41,15,26,47,120,117,4
843,Jordan Ferri,7.1,20,11,8,11,1,7,20,35.0,13,11,1,10,5,25,11,2
844,Sam Field,6.0,14,11,8,4,2,3,10,30.0,7,6,1,5,11,25,8,0
845,Afonso Figueiredo,2.5,6,3,3,3,0,3,5,60.0,2,0,0,0,0,6,4,0
846,Gian Filippo Felicioli,3.1,13,8,5,5,3,0,4,0.0,4,0,0,0,5,18,6,0
847,Alfred Finnbogason,20.2,18,13,7,5,6,8,15,53.3,7,15,1,14,14,32,7,0
848,Roberto Firmino,30.7,65,50,9,36,20,8,58,13.8,50,40,2,38,18,83,10,0
849,Junior Firpo,13.2,26,17,15,8,3,10,18,55.6,8,21,2,19,20,46,37,1
850,Viktor Fischer,3.7,4,4,2,1,1,2,5,40.0,3,2,0,2,3,7,2,0
851,Mathieu Flamini,5.3,11,5,3,7,1,4,9,44.4,5,2,0,2,8,19,8,0
852,Darren Fletcher,24.7,47,26,23,20,4,15,55,27.3,40,13,3,10,26,73,33,3
853,Sergio Floccari,9.8,13,9,7,5,1,6,11,54.5,5,6,1,5,2,15,6,0
854,Alessandro Florenzi,26.5,38,28,20,13,5,18,47,38.3,29,19,8,11,44,82,62,1
855,Phil Foden,0.5,1,1,0,1,0,0,1,0.0,1,0,0,0,0,1,1,0
856,Guessouma Fofana,8.3,20,13,8,12,0,6,13,46.2,7,7,1,6,12,32,11,0
858,Seko Fofana,20.8,20,17,8,12,0,4,20,20.0,16,17,3,14,27,47,26,1
859,Andreu Fontas,9.8,13,9,8,5,0,3,13,23.1,10,9,5,4,14,27,30,0
860,Jose Fonte,7.6,11,6,5,6,0,2,6,33.3,4,12,9,3,14,25,37,1
861,Pablo Fornals,29.1,52,33,19,26,7,18,60,30.0,42,29,3,26,22,74,18,0
862,Emil Forsberg,15.2,24,17,3,15,6,9,21,42.9,12,19,1,18,8,32,4,0
864,Steven Fortes,1.7,4,2,3,1,0,1,3,33.3,2,0,0,0,3,7,6,0
865,Marco Fossati,12.2,27,13,11,14,2,11,33,33.3,22,19,6,13,23,50,31,1
866,Iver Fossum,14.5,27,19,8,13,6,10,31,32.3,21,28,3,25,15,42,14,0
867,Ben Foster,37.0,1,0,1,0,0,0,7,0.0,7,0,0,0,1,2,12,1
868,Timothy Fosu-Mensah,17.7,42,33,33,8,1,21,34,61.8,13,17,9,8,31,73,74,1
869,Dimitri Foulquier,13.8,25,12,15,8,2,7,17,41.2,10,15,4,11,14,39,33,0
871,Raphael Framberger,7.7,22,18,14,6,2,15,16,93.8,1,12,3,9,14,36,15,0
872,Simon Francis,30.1,49,34,26,16,7,24,43,55.8,19,29,18,11,49,98,194,4
873,Mike Frantz,11.6,23,16,9,11,3,6,16,37.5,10,13,3,10,13,36,15,0
874,Ryan Fraser,22.3,11,8,7,2,2,7,20,35.0,13,20,4,16,17,28,34,0
875,Fabian Frei,8.9,22,15,7,12,3,8,15,53.3,7,10,0,10,16,38,17,1
876,Remo Freuler,33.4,89,62,35,41,13,27,82,32.9,55,46,13,33,28,117,37,2
877,Marco Friedl,6.7,9,8,4,4,1,7,10,70.0,3,10,1,9,8,17,17,1
879,Christian Fuchs,21.3,41,27,25,12,4,14,40,35.0,26,23,3,20,58,99,86,0
880,Javi Fuego,6.0,20,13,8,11,1,7,14,50.0,7,7,4,3,3,23,14,0
881,Javi Fuego,14.9,34,25,19,12,3,11,28,39.3,17,15,6,9,19,53,23,0
882,Chris Fuhrich,1.1,4,3,1,2,1,2,5,40.0,3,3,0,3,0,4,1,0
884,Angelo Fulgini,17.0,21,11,9,8,4,8,27,29.6,19,21,2,19,20,41,7,0
885,Niclas Fullkrug,26.5,16,11,4,8,4,10,20,50.0,10,22,3,19,8,24,30,0
888,Manolo Gabbiadini,12.0,3,2,0,2,1,1,15,6.7,14,3,0,3,4,7,6,0
889,Gabi,26.1,80,49,39,37,4,38,104,36.5,66,28,10,18,44,124,38,0
890,Gabriel,26.4,90,69,28,54,8,29,74,39.2,45,38,4,34,38,128,27,0
891,Mijat Gacinovic,20.2,56,44,21,27,8,20,52,38.5,32,38,1,37,39,95,22,1
892,Roberto Gagliardini,22.1,63,45,28,29,6,20,54,37.0,34,18,3,15,45,108,32,2
893,Nicolas Gaitan,2.4,9,6,3,5,1,3,9,33.3,6,2,0,2,1,10,3,0
894,Milan Gajic,4.0,6,3,4,2,0,2,4,50.0,2,7,0,7,4,10,14,0
895,Serge Gakpe,20.3,16,11,9,7,0,6,27,22.2,21,18,1,17,10,26,15,0
896,Andrey Galabinov,12.5,7,5,0,5,2,0,5,0.0,5,17,1,16,2,9,11,0
897,Alex Galvez,18.0,50,36,26,24,0,22,41,53.7,19,20,11,9,43,93,74,2
898,Alex Galvez,4.0,11,4,5,6,0,7,12,58.3,5,5,1,4,13,24,17,0
899,Bruno Gama,1.3,1,1,1,0,0,1,3,33.3,2,0,0,0,0,1,2,0
900,Alessandro Gamberini,20.2,13,8,11,2,0,8,12,66.7,4,32,25,7,16,29,117,1
901,Kevin Gameiro,12.5,11,9,3,4,4,1,10,10.0,9,6,0,6,4,15,11,0
902,Jesus Gamez,1.1,4,2,1,0,3,1,3,33.3,2,2,0,2,2,6,5,0
903,Idrissa Gana Gueye,30.6,117,93,65,41,11,35,86,40.7,51,59,9,50,62,179,48,1
904,Ignatius Ganago,0.8,0,0,0,0,0,0,2,0.0,2,1,0,1,0,0,1,0
905,Najib Gandi,1.1,6,5,3,2,1,4,6,66.7,2,4,1,3,4,10,3,0
906,Ganso,5.8,15,11,3,12,0,3,11,27.3,8,7,0,7,2,17,4,0
907,Ezequiel Garay,22.5,18,12,15,3,0,10,14,71.4,4,22,11,11,24,42,139,0
908,Aleix Garcia,9.5,24,14,13,9,2,12,22,54.5,10,9,1,8,17,41,12,0
910,Borja Garcia,31.1,39,18,15,18,6,13,39,33.3,26,31,2,29,30,69,15,0
911,Dani Garcia,30.8,80,59,23,47,10,31,80,38.8,49,28,4,24,70,150,25,0
912,David Garcia,9.6,16,10,10,4,2,8,12,66.7,4,15,8,7,19,35,33,1
913,Javi Garcia,26.8,34,22,18,16,0,13,40,32.5,27,19,12,7,25,59,78,1
914,Manu Garcia,27.1,95,65,38,51,6,24,89,27.0,65,34,11,23,35,130,67,0
915,Raul Garcia,29.2,82,51,28,36,18,26,71,36.6,45,55,3,52,30,112,23,0
916,Raul Garcia,15.5,34,25,24,9,1,18,30,60.0,12,18,3,15,19,53,50,1
917,Samu Garcia,2.0,8,6,4,3,1,3,10,30.0,7,4,0,4,6,14,3,0
918,Samu Garcia,2.1,9,7,1,6,2,2,5,40.0,3,3,0,3,1,10,2,0
919,Sergio Garcia,18.2,15,12,1,10,4,3,22,13.6,19,6,3,3,10,25,12,0
920,Ulisses Garcia,1.0,1,1,1,0,0,1,2,50.0,1,0,0,0,0,1,3,0
921,Luca Garritano,2.1,4,3,2,1,1,0,4,0.0,4,3,1,2,1,5,6,0
922,Bruno Gaspar,8.7,20,11,13,6,1,9,15,60.0,6,8,1,7,9,29,25,0
923,Mario Gaspar,31.2,110,66,63,37,10,58,87,66.7,29,58,11,47,58,168,114,0
925,Dwight Gayle,21.8,12,10,2,8,2,1,21,4.8,20,16,2,14,6,18,17,0
926,Paulo Gazzaniga,1.0,0,0,0,0,0,0,1,0.0,1,0,0,0,0,0,0,0
927,Marcello Gazzola,8.2,10,9,3,6,1,8,12,66.7,4,10,2,8,8,18,25,0
928,Jean-Philippe Gbamin,28.8,78,63,48,26,4,43,65,66.2,22,50,10,40,50,128,80,0
929,David de Gea,37.0,0,0,0,0,0,0,1,0.0,1,1,0,1,0,0,9,3
930,Theodor Gebre Selassie,31.4,67,41,36,25,6,36,57,63.2,21,34,2,32,51,118,83,1
931,Dennis Geiger,17.6,52,36,19,31,2,16,40,40.0,24,38,2,36,15,67,7,0
932,Johannes Geis,7.5,20,15,12,7,1,11,21,52.4,10,13,5,8,10,30,27,1
933,Jeremy Gelin,25.7,37,18,22,14,1,20,53,37.7,33,22,12,10,37,74,92,3
934,Romain Genevois,20.1,48,28,27,13,8,21,39,53.8,18,25,11,14,31,79,76,0
936,Santiago Gentiletti,3.2,4,3,4,0,0,1,6,16.7,5,1,0,1,3,7,11,1
937,Christian Gentner,26.8,91,67,35,44,12,44,84,52.4,40,41,5,36,35,126,52,0
938,Yannick Gerhardt,13.6,37,28,18,14,5,22,34,64.7,12,25,5,20,15,52,31,0
939,Valere Germain,24.1,16,11,5,7,4,3,18,16.7,15,11,0,11,6,22,19,0
940,Gerson,10.1,20,12,10,8,2,2,7,28.6,5,15,2,13,11,31,11,1
941,Willem Geubbels,0.4,2,2,1,1,0,0,1,0.0,1,0,0,0,0,2,0,0
942,Yassine El Ghanassy,7.2,7,4,1,3,3,1,4,25.0,3,1,0,1,4,11,4,0
943,Anwar El Ghazi,18.3,23,18,7,13,3,9,29,31.0,20,11,1,10,7,30,7,1
944,Rachid Ghezzal,11.2,31,24,6,22,3,7,34,20.6,27,17,0,17,11,42,2,1
945,Faouzi Ghoulam,10.9,8,4,3,5,0,4,6,66.7,2,10,2,8,15,23,19,0
946,Emanuele Giaccherini,10.0,7,4,4,2,1,5,25,20.0,20,9,3,6,5,12,6,0
948,Niccolo Giannetti,3.3,5,4,2,3,0,2,6,33.3,4,1,0,1,1,6,3,0
949,Kieran Gibbs,31.4,41,24,27,10,4,16,30,53.3,14,32,12,20,48,89,102,0
951,Carles Gil,5.3,6,4,1,4,1,1,5,20.0,4,5,0,5,4,10,0,0
952,Nacho Gil,8.1,10,6,6,2,2,5,21,23.8,16,9,0,9,6,16,2,0
953,Nacho Gil,2.5,6,1,2,4,0,1,8,12.5,7,6,0,6,2,8,2,0
956,Daniel Ginczek,16.9,8,4,3,5,0,2,12,16.7,10,16,1,15,5,13,13,0
957,Matthias Ginter,34.0,48,37,27,20,1,35,45,77.8,10,40,17,23,40,88,114,1
958,Jimmy Giraudon,23.2,26,16,20,6,0,10,16,62.5,6,30,22,8,31,57,128,2
960,Andrei Girotto,16.9,57,38,15,37,5,21,52,40.4,31,32,7,25,15,72,45,1
962,Olivier Giroud,4.3,5,4,1,2,2,1,5,20.0,4,1,0,1,1,6,4,0
963,Olivier Giroud,6.8,4,3,1,2,1,1,3,33.3,2,0,0,0,1,5,5,0
964,Kamil Glik,36.0,36,23,22,12,2,15,29,51.7,14,28,18,10,54,90,279,2
965,Serge Gnabry,16.7,32,22,10,18,4,13,24,54.2,11,15,1,14,8,40,9,2
966,Joris Gnagnon,32.4,42,29,29,9,4,21,31,67.7,10,22,16,6,29,71,154,2
967,Massimo Gobbi,22.8,24,18,13,9,2,11,26,42.3,15,20,5,15,22,46,90,1
968,Diego Godin,28.4,50,33,37,11,2,26,47,55.3,21,33,20,13,59,109,145,1
969,Edoardo Goldaniga,12.8,14,8,10,4,0,5,9,55.6,4,10,5,5,19,33,56,0
970,Connor Goldson,2.2,2,2,1,1,0,1,4,25.0,3,3,3,0,1,3,9,0
972,Andre Gomes,7.1,19,12,8,10,1,5,13,38.5,8,7,1,6,4,23,6,0
973,Heurelho Gomes,23.6,0,0,0,0,0,0,1,0.0,1,1,0,1,2,2,15,3
974,Ibai Gomez,25.8,19,15,11,4,4,6,30,20.0,24,16,1,15,15,34,20,1
975,Joe Gomez,21.1,58,45,32,23,3,21,40,52.5,19,19,8,11,34,92,57,1
976,Mario Gomez,10.4,6,6,2,3,1,2,6,33.3,4,10,1,9,0,6,16,0
977,Mario Gomez,15.4,13,11,0,8,5,2,10,20.0,8,6,0,6,4,17,17,0
978,Maxi Gomez,34.1,7,4,1,4,2,0,18,0.0,18,9,4,5,3,10,34,0
979,Papu Gomez,30.6,14,9,6,5,3,5,26,19.2,21,16,1,15,22,36,7,0
980,Sergi Gomez,29.8,52,37,38,13,1,20,34,58.8,14,32,22,10,56,108,118,1
982,Vicente Gomez,16.9,21,13,6,11,4,10,29,34.5,19,18,4,14,17,38,14,1
983,Alfred Gomis,25.1,0,0,0,0,0,0,1,0.0,1,0,0,0,1,1,10,3
984,Maxime Gonalons,12.2,26,18,7,12,7,9,23,39.1,14,15,4,11,23,49,19,1
985,Anthony Goncalves,19.5,50,31,14,32,4,15,50,30.0,35,27,0,27,25,75,27,0
986,Vagner Goncalves,1.2,0,0,0,0,0,0,3,0.0,3,2,0,2,0,0,0,0
988,Jerome Gondorf,8.9,12,9,3,9,0,4,18,22.2,14,11,2,9,6,18,12,0
989,Adrian Gonzalez,26.0,40,25,14,22,4,12,50,24.0,38,25,8,17,38,78,34,0
990,Alvaro Gonzalez,32.2,38,26,30,7,1,22,41,53.7,19,34,23,11,53,91,188,0
991,Bruno Gonzalez,17.1,25,18,18,7,0,13,26,50.0,13,11,3,8,31,56,107,0
992,Diego Gonzalez,15.9,27,19,20,7,0,18,26,69.2,8,25,10,15,19,46,69,0
993,Fabio Gonzalez,0.7,2,1,2,0,0,1,4,25.0,3,1,0,1,1,3,1,0
994,Giancarlo Gonzalez,20.6,20,15,14,5,1,9,13,69.2,4,26,18,8,33,53,152,1
997,Leon Goretzka,22.0,50,34,22,22,6,14,50,28.0,36,45,4,41,41,91,35,0
999,Andoni Gorosabel,0.8,3,2,1,2,0,2,5,40.0,3,1,0,1,4,7,1,0
1000,Robin Gosens,16.1,61,46,35,22,4,27,46,58.7,19,17,2,15,22,83,40,0
1001,Dan Gosling,21.6,50,25,19,26,5,19,68,27.9,49,36,8,28,25,75,35,0
1002,Mario Gotze,17.8,50,43,19,24,7,14,34,41.2,20,17,1,16,8,58,9,0
1004,Prince-Desir Gouano,30.5,42,29,32,8,2,22,31,71.0,9,58,47,11,49,91,191,6
1005,Lemouya Goudiaby,0.9,2,1,0,2,0,1,3,33.3,2,2,1,1,0,2,3,0
1006,Amine Gouiri,0.9,1,1,1,0,0,0,1,0.0,1,0,0,0,2,3,0,0
1007,Yoann Gourcuff,4.7,7,5,1,3,3,0,2,0.0,2,5,0,5,2,9,2,0
1008,Jeffrey Gouweleeuw,26.5,57,44,36,18,3,27,41,65.9,14,36,10,26,54,111,128,0
1010,Max Gradel,26.8,63,36,28,21,14,24,72,33.3,48,39,2,37,14,77,30,0
1011,Samuel Grandsir,28.9,69,43,39,18,12,21,73,28.8,52,31,3,28,23,92,19,1
1012,Alex Granell,31.6,78,53,31,39,8,38,114,33.3,76,46,3,43,47,125,29,0
1014,Esteban Granero,13.7,32,22,15,13,4,9,27,33.3,18,19,0,19,19,51,21,0
1015,Lee Grant,3.0,1,1,1,0,0,1,1,100.0,0,0,0,0,0,1,0,0
1016,Alberto Grassi,25.0,44,33,22,12,10,16,35,45.7,19,27,8,19,47,91,55,0
1017,Andrew Gravillon,0.9,2,1,2,0,0,0,1,0.0,1,1,1,0,3,5,10,0
1018,Andre Gray,16.6,2,1,0,1,1,0,3,0.0,3,11,0,11,4,6,3,0
1019,Demarai Gray,18.9,17,15,6,9,2,4,23,17.4,19,27,0,27,11,28,14,1
1020,Michael Gregoritsch,28.1,35,27,13,15,7,11,26,42.3,15,27,1,26,10,45,56,0
1021,Clement Grenier,13.4,23,14,3,13,7,12,42,28.6,30,16,1,15,14,37,15,1
1024,Antoine Griezmann,28.0,36,24,6,23,7,10,30,33.3,20,20,1,19,10,46,14,0
1025,Vincenzo Grifo,8.7,8,5,3,3,2,4,8,50.0,4,8,1,7,5,13,6,0
1026,Florian Grillitsch,21.0,68,46,30,36,2,35,58,60.3,23,26,3,23,39,107,25,1
1027,Jeremy Grimm,9.0,23,17,15,6,2,9,24,37.5,15,11,3,8,19,42,31,1
1028,Pascal Gross,32.5,36,24,18,16,2,10,67,14.9,57,31,5,26,14,50,20,0
1029,Marko Grujic,0.2,2,2,0,1,1,2,2,100.0,0,0,0,0,0,2,0,0
1031,Andres Guardado,25.2,41,27,17,18,6,15,55,27.3,40,27,5,22,22,63,29,1
1032,Karim Guede,0.7,2,2,2,0,0,2,2,100.0,0,1,1,0,1,3,0,0
1033,Goncalo Guedes,27.1,38,26,18,15,5,16,51,31.4,35,22,0,22,16,54,10,0
1035,Ramiro Guerra,0.8,3,2,1,0,2,2,3,66.7,1,0,0,0,0,3,2,0
1036,Raphael Guerreiro,6.1,10,8,5,4,1,2,5,40.0,3,3,0,3,11,21,8,0
1037,Francis Guerrero,11.0,31,19,22,7,2,16,34,47.1,18,16,4,12,21,52,26,0
1038,John Guidetti,13.6,7,7,3,1,3,2,10,20.0,8,10,1,9,2,9,7,0
1041,Josuha Guilavogui,26.7,65,46,43,20,2,30,50,60.0,20,34,10,24,66,131,63,0
1042,Frederic Guilbert,36.0,136,89,71,58,7,50,105,47.6,55,43,13,30,88,224,136,0
1043,Guilherme,10.5,20,11,7,7,6,3,19,15.8,16,14,1,13,8,28,4,0
1044,Guilherme,29.3,79,56,35,37,7,28,77,36.4,49,36,9,27,46,125,62,0
1045,Baptiste Guillaume,5.1,4,1,0,2,2,0,5,0.0,5,4,1,3,2,6,1,0
1046,Serhou Guirassy,9.5,3,3,0,2,1,1,5,20.0,4,9,1,8,1,4,11,0
1047,Peter Gulacsi,33.0,0,0,0,0,0,0,2,0.0,2,0,0,0,0,0,12,4
1048,Manuel Gulde,17.0,16,10,14,2,0,10,19,52.6,9,24,17,7,14,30,71,0
1049,Gerard Gumbau,15.9,35,26,13,21,1,12,37,32.4,25,12,4,8,14,49,27,0
1050,Ilkay Gundogan,16.9,27,15,8,14,5,9,37,24.3,28,14,1,13,16,43,12,0
1051,Christian Gunter,34.0,73,54,45,21,7,38,63,60.3,25,38,7,31,20,93,68,0
1052,Jon Guridi,0.6,1,0,1,0,0,0,1,0.0,1,1,0,1,0,1,0,0
1053,Regis Gurtner,37.0,1,0,1,0,0,1,1,100.0,0,0,0,0,4,5,15,4
1054,Samuel Gustafson,0.9,3,2,3,0,0,1,3,33.3,2,2,0,2,0,3,0,0
1055,Luiz Gustavo,33.5,89,54,45,40,4,26,62,41.9,36,44,13,31,50,139,56,1
1056,Alejandro Gutierrez Mozo,0.5,3,2,1,2,0,1,4,25.0,3,0,0,0,0,3,0,0
1057,Jonathan de Guzman,12.1,16,16,8,8,0,6,16,37.5,10,13,0,13,13,29,12,0
1058,Bright Gyamfi,3.6,2,2,1,1,0,1,2,50.0,1,3,1,2,7,9,8,0
1059,Nicolas Haas,1.9,1,1,1,0,0,0,2,0.0,2,1,1,0,1,2,4,1
1060,Janik Haberer,30.5,62,49,20,34,8,23,57,40.4,34,43,1,42,30,92,42,0
1062,Alexander Hack,14.3,46,34,25,19,2,24,37,64.9,13,31,18,13,26,72,87,2
1063,Robin Hack,0.8,2,2,1,0,1,0,1,0.0,1,1,1,0,0,2,1,0
1064,Munir El Haddadi,27.2,25,20,8,9,8,5,14,35.7,9,13,2,11,9,34,5,0
1066,Oussama Haddadi,27.8,44,29,33,9,2,14,47,29.8,33,29,12,17,43,87,79,1
1067,Florent Hadergjonaj,18.6,21,16,7,10,4,12,30,40.0,18,22,10,12,17,38,45,0
1068,Andre Hahn,15.1,33,24,15,13,5,10,32,31.3,22,30,2,28,10,43,26,0
1070,Oualid El Hajjam,24.4,64,44,37,22,5,23,49,46.9,26,25,5,20,59,123,91,1
1071,Izet Hajrovic,2.1,1,0,1,0,0,0,1,0.0,1,0,0,0,2,3,1,0
1072,Achraf Hakimi,8.4,21,15,9,6,6,11,25,44.0,14,9,1,8,10,31,19,1
1073,Alen Halilovic,14.5,11,7,5,6,0,4,17,23.5,13,10,1,9,5,16,4,0
1074,Sebastien Haller,26.1,25,16,4,16,5,7,14,50.0,7,17,4,13,8,33,39,0
1075,Emil Hallfredsson,8.5,19,14,9,7,3,7,24,29.2,17,13,2,11,20,39,16,0
1076,Marcel Halstenberg,13.1,29,19,16,9,4,15,19,78.9,4,15,1,14,23,52,42,1
1077,Ben Hamer,3.1,0,0,0,0,0,0,1,0.0,1,0,0,0,0,0,3,1
1078,Romain Hamouma,20.5,19,13,7,6,6,1,22,4.5,21,15,4,11,13,32,8,1
1079,Marek Hamsik,26.3,36,22,10,15,11,15,37,40.5,22,35,2,33,14,50,16,0
1081,Tim Handwerker,4.4,12,7,9,2,1,5,7,71.4,2,3,0,3,6,18,10,0
1082,Genki Haraguchi,2.3,6,6,2,3,1,2,6,33.3,4,4,0,4,2,8,3,0
1083,Amine Harit,22.7,39,27,11,21,7,13,37,35.1,24,23,0,23,19,58,11,0
1084,Martin Harnik,21.0,17,10,4,10,3,4,25,16.0,21,21,2,19,8,25,26,0
1086,Joe Hart,19.0,1,1,1,0,0,1,2,50.0,1,1,0,1,0,1,2,4
1087,Makoto Hasebe,23.2,38,23,19,19,0,21,33,63.6,12,40,19,21,25,63,74,0
1088,Hans Hateboer,26.6,31,25,13,13,5,15,26,57.7,11,32,5,27,30,61,46,1
1089,Kai Havertz,23.8,34,23,8,23,3,12,25,48.0,13,33,2,31,19,53,23,0
1090,Isaac Hayden,15.3,40,23,23,16,1,12,34,35.3,22,21,6,15,23,63,43,0
1092,Eden Hazard,26.9,6,3,2,3,1,3,21,14.3,18,11,0,11,3,9,0,0
1093,Thorgan Hazard,32.7,49,32,16,23,10,20,54,37.0,34,39,1,38,28,77,18,0
1095,Jonas Hector,19.5,47,35,23,18,6,18,40,45.0,22,39,6,33,28,75,65,2
1097,Ahmed Hegazi,37.6,58,38,46,12,0,26,50,52.0,24,55,37,18,60,118,278,2
1098,Gauthier Hein,0.9,2,2,2,0,0,2,4,50.0,2,1,0,1,2,4,1,0
1099,Dominique Heintz,31.0,60,42,47,13,0,38,64,59.4,26,35,17,18,53,113,140,0
1100,Filip Helander,27.8,48,32,33,15,0,15,29,51.7,14,47,25,22,37,85,160,2
1101,Marcel Heller,14.4,37,24,21,14,2,12,28,42.9,16,22,1,21,10,47,7,0
1102,Tomer Hemed,9.4,7,5,3,4,0,2,10,20.0,8,10,1,9,2,9,12,0
1103,Jordan Henderson,24.1,51,33,13,32,6,18,52,34.6,34,33,2,31,31,82,27,0
1104,Jeff Hendrick,25.9,16,10,4,10,2,3,17,17.6,14,11,2,9,8,24,21,1
1106,Benjamin Henrichs,14.1,42,28,23,16,3,27,43,62.8,16,23,3,20,31,73,32,0
1107,Dalbert Henrique,5.9,15,10,11,3,1,7,13,53.8,6,7,4,3,13,28,19,0
1108,Christophe Herelle,32.9,39,26,27,12,0,16,30,53.3,14,38,27,11,56,95,241,1
1109,Mario Hermoso,21.4,14,12,13,1,0,8,21,38.1,13,15,8,7,25,39,122,0
1110,Hernan,3.9,18,9,8,7,3,10,17,58.8,7,2,0,2,8,26,5,0
1111,Hector Hernandez,0.2,1,1,0,1,0,1,1,100.0,0,0,0,0,0,1,1,0
1112,Javier Hernandez,17.2,11,7,2,7,2,3,14,21.4,11,6,1,5,6,17,1,0
1113,Lucas Hernandez,23.5,93,68,51,35,7,55,74,74.3,19,35,10,25,40,133,90,0
1114,Luis Hernandez,36.0,49,43,37,9,3,17,33,51.5,16,32,21,11,77,126,185,1
1115,Pablo Hernandez,20.2,48,33,17,27,4,14,46,30.4,32,29,11,18,40,88,72,0
1116,Theo Hernandez,10.7,21,15,16,2,3,13,25,52.0,12,9,2,7,17,38,20,0
1118,Hernani,6.0,21,13,9,9,3,10,22,45.5,12,15,2,13,6,27,5,0
1119,Ander Herrera,14.1,56,29,32,20,4,20,69,29.0,49,33,6,27,34,90,22,2
1120,Borja Herrera,2.7,2,1,2,0,0,2,7,28.6,5,6,1,5,3,5,4,0
1121,Iago Herrerin,8.0,2,1,2,0,0,2,2,100.0,0,0,0,0,0,2,7,1
1122,Patrick Herrmann,12.5,29,21,9,13,7,17,29,58.6,12,13,0,13,17,46,19,0
1123,Perparim Hetemaj,26.8,74,48,34,25,15,29,78,37.2,49,39,6,33,39,113,47,1
1124,Son Heung-min,25.7,17,10,2,12,3,2,28,7.1,26,18,0,18,10,27,12,0
1125,Thomas Heurtaux,15.5,14,11,12,2,0,4,8,50.0,4,25,16,9,37,51,97,1
1126,Gonzalo Higuain,31.3,19,17,3,7,9,2,19,10.5,17,19,4,15,7,26,20,0
1127,Oscar Hiljemark,14.2,12,8,2,8,2,3,24,12.5,21,14,4,10,9,21,12,0
1128,Vitorino Hilton,27.0,44,26,33,11,0,13,36,36.1,23,28,14,14,58,102,140,5
1130,Martin Hinteregger,29.5,79,51,55,22,2,47,61,77.0,14,40,27,13,49,128,135,3
1131,Marwin Hitz,32.0,1,1,1,0,0,1,3,33.3,2,0,0,0,0,1,12,3
1132,Andrew Hjulsager,0.2,0,0,0,0,0,0,2,0.0,2,1,0,1,0,0,0,0
1133,Wesley Hoedt,28.0,60,51,48,12,0,36,61,59.0,25,32,17,15,40,100,177,2
1134,Nicolas Hofler,25.1,57,36,23,30,4,31,50,62.0,19,42,10,32,44,101,51,2
1135,Jonas Hofmann,11.5,23,19,12,11,0,12,26,46.2,14,15,4,11,12,35,16,0
1136,Marco Hoger,18.6,60,40,31,28,1,30,64,46.9,34,35,5,30,25,85,27,1
1137,Jonathan Hogg,26.6,93,64,29,59,5,26,89,29.2,63,51,12,39,69,162,48,0
1138,Rob Holding,9.1,19,14,13,5,1,4,12,33.3,8,16,10,6,21,40,40,2
1139,Jose Holebas,26.5,51,31,34,14,3,18,44,40.9,26,24,8,16,29,80,95,2
1140,Lucas Holer,10.1,24,20,8,13,3,9,24,37.5,15,10,0,10,7,31,13,0
1141,Mason Holgate,13.2,23,16,15,7,1,10,21,47.6,11,12,9,3,23,46,86,2
1142,Lewis Holtby,13.3,44,29,14,26,4,17,32,53.1,15,23,2,21,10,54,9,0
1144,Gerrit Holtmann,10.0,16,13,8,5,3,11,22,50.0,11,19,2,17,12,28,9,0
1145,Jannes Horn,9.2,16,11,11,4,1,11,14,78.6,3,12,3,9,17,33,26,0
1146,Timo Horn,34.0,3,2,3,0,0,3,6,50.0,3,0,0,0,0,3,18,2
1148,Lukas Hradecky,34.0,0,0,0,0,0,0,2,0.0,2,0,0,0,0,0,23,3
1149,Branimir Hrgota,2.2,5,4,0,3,2,4,7,57.1,3,2,0,2,0,5,1,0
1150,Timo Hubers,5.0,11,10,9,2,0,9,15,60.0,6,13,8,5,9,20,31,0
1151,Benjamin Hubner,25.7,71,56,43,27,1,31,46,67.4,15,40,18,22,51,122,114,0
1152,Florian Hubner,3.6,10,9,8,2,0,5,9,55.6,4,3,2,1,6,16,21,0
1153,Tomas Hubocan,1.0,1,0,1,0,0,0,4,0.0,4,0,0,0,0,1,1,0
1155,Will Hughes,11.0,34,18,7,18,9,9,19,47.4,10,16,1,15,15,49,6,0
1156,Jordan Hugill,0.3,0,0,0,0,0,0,1,0.0,1,0,0,0,0,0,0,0
1157,Vitor Hugo,13.4,32,21,26,6,0,10,17,58.8,7,10,6,4,43,75,92,0
1158,Mats Hummels,24.6,62,52,41,18,3,35,51,68.6,16,31,12,19,55,117,59,2
1160,Adrien Hunou,16.2,27,15,11,8,8,11,42,26.2,31,22,1,21,9,36,8,1
1161,Aaron Hunt,23.1,36,24,12,20,4,11,37,29.7,26,20,2,18,14,50,18,2
1162,Emerson Hyndman,0.6,0,0,0,0,0,0,1,0.0,1,2,0,2,1,1,1,0
1163,Elseid Hysaj,34.7,64,45,28,30,6,32,56,57.1,24,35,4,31,43,107,68,4
1164,Suk Hyun-jun,13.3,6,5,2,2,2,1,9,11.1,8,10,0,10,1,7,7,0
1165,Pierre Hojbjerg,18.6,45,29,24,18,3,13,56,23.2,43,30,3,27,37,82,26,1
1166,Jordon Ibe,22.2,14,12,7,5,2,6,22,27.3,16,5,0,5,10,24,11,0
1167,Vedad Ibisevic,16.1,10,8,1,5,4,4,7,57.1,3,8,1,7,4,14,23,0
1168,Vicente Iborra,15.7,23,18,13,10,0,9,36,25.0,27,25,11,14,19,42,49,1
1170,Zlatan Ibrahimovic,1.2,2,1,1,0,1,0,1,0.0,1,0,0,0,0,2,1,0
1171,Mauro Icardi,32.9,3,2,1,2,0,1,8,12.5,7,14,6,8,5,8,23,1
1172,Brown Ideye,8.1,2,2,0,2,0,0,5,0.0,5,2,0,2,1,3,11,0
1173,Edgar Ie,35.0,74,42,55,18,1,31,69,44.9,38,57,26,31,84,158,135,3
1174,Julien Ielsch,6.8,28,18,12,11,5,7,25,28.0,18,16,3,13,11,39,15,2
1175,Pietro Iemmello,9.8,2,2,1,1,0,2,8,25.0,6,4,0,4,1,3,11,2
1176,Kelechi Iheanacho,9.2,9,6,3,5,1,3,20,15.0,17,10,2,8,3,12,4,0
1177,Jordan Ikoko,26.9,44,29,24,15,5,22,42,52.4,20,20,2,18,48,92,74,0
1178,Jonathan Ikone,11.1,13,10,3,6,4,4,14,28.6,10,8,0,8,6,19,3,0
1179,Josip Ilicic,22.2,24,19,5,13,6,8,29,27.6,21,19,0,19,16,40,2,0
1180,Asier Illarramendi,35.1,85,57,35,41,9,37,90,41.1,53,44,8,36,75,160,35,0
1181,Jules Iloki,15.8,13,9,1,9,3,3,16,18.8,13,8,0,8,12,25,16,0
1182,Stefan Ilsanker,14.3,37,29,23,11,3,22,39,56.4,17,23,10,13,25,62,55,1
1183,Giannelli Imbula,24.9,29,19,10,15,4,7,29,24.1,22,17,2,15,20,49,13,3
1184,Ciro Immobile,29.8,4,2,0,3,1,0,17,0.0,17,14,1,13,0,4,9,0
1186,Tom Ince,27.2,35,27,14,16,5,10,29,34.5,19,20,0,20,12,47,12,0
1187,Svante Ingelsson,3.6,9,6,3,3,3,2,10,20.0,8,4,0,4,6,15,4,0
1188,Roberto Inglese,30.9,31,21,13,9,9,7,30,23.3,23,21,2,19,8,39,17,1
1190,Andres Iniesta,20.3,28,22,11,8,9,6,31,19.4,25,21,2,19,10,38,12,1
1191,Lorenzo Insigne,34.3,29,17,11,13,5,13,33,39.4,20,20,0,20,17,46,4,0
1192,Emiliano Insua,23.4,46,34,27,16,3,17,32,53.1,15,30,4,26,36,82,48,1
1194,Takashi Inui,29.2,39,21,12,19,8,13,42,31.0,29,36,0,36,18,57,10,0
1196,Artur Ionita,29.7,63,45,30,24,9,17,38,44.7,21,39,7,32,28,91,29,0
1197,Gorka Iraizoz,8.5,1,1,1,0,0,1,2,50.0,1,0,0,0,1,2,9,2
1198,Stephen Ireland,1.5,3,1,2,1,0,1,5,20.0,4,4,2,2,1,4,1,0
1199,Carlos Isaac,0.7,1,0,1,0,0,1,3,33.3,2,0,0,0,2,3,1,0
1200,Alexander Isak,1.3,1,0,0,1,0,0,1,0.0,1,1,0,1,0,1,0,0
1201,Isco,19.7,22,12,5,10,7,5,35,14.3,30,11,0,11,15,37,2,0
1202,Tatsuya Ito,11.2,16,13,4,8,4,11,22,50.0,11,28,0,28,6,22,1,0
1203,Gian-Luca Itter,4.6,19,12,15,2,2,14,22,63.6,8,6,0,6,5,24,15,0
1204,Manuel Iturra,17.6,70,45,36,27,7,22,55,40.0,33,19,2,17,29,99,23,0
1205,Ander Iturraspe,21.2,42,31,18,22,2,10,32,31.3,22,22,7,15,35,77,57,0
1206,Ivi,19.6,48,34,19,23,6,21,62,33.9,41,21,1,20,15,63,15,0
1207,Alex Iwobi,20.3,19,15,8,8,3,5,18,27.8,13,19,1,18,7,26,10,1
1208,Jose Izquierdo,22.0,23,15,12,9,2,7,19,36.8,12,6,0,6,16,39,34,0
1209,Armando Izzo,15.4,30,23,14,10,6,12,18,66.7,6,15,6,9,34,64,70,0
1210,Koo Ja-cheol,22.7,54,41,18,31,5,27,44,61.4,17,22,3,19,27,81,34,2
1211,Paul Jaeckel,3.0,3,3,3,0,0,1,2,50.0,1,5,2,3,1,4,8,0
1212,Phil Jagielka,22.9,33,23,24,9,0,8,21,38.1,13,30,20,10,39,72,179,1
1215,Christophe Jallet,13.0,29,21,21,8,0,11,26,42.3,15,18,6,12,16,45,47,0
1216,Ablie Jallow,1.4,1,1,1,0,0,0,5,0.0,5,1,0,1,3,4,1,0
1217,Matty James,11.0,19,10,7,11,1,2,10,20.0,8,14,2,12,17,36,25,0
1218,Vasilije Janjicic,3.6,14,11,5,9,0,2,4,50.0,2,6,1,5,3,17,5,0
1219,Christoph Janker,0.9,4,3,3,1,0,2,3,66.7,1,0,0,0,1,5,4,1
1220,Saidy Janko,15.8,43,30,25,14,4,14,24,58.3,10,21,1,20,14,57,50,0
1222,Jakub Jankto,29.5,29,18,9,14,6,10,46,21.7,36,46,8,38,20,49,27,0
1223,Daryl Janmaat,20.2,46,31,29,10,7,22,52,42.3,30,16,5,11,33,79,61,0
1225,Tony Jantschke,8.1,13,11,9,4,0,8,13,61.5,5,10,1,9,6,19,25,0
1226,Adnan Januzaj,17.5,16,11,2,8,6,5,18,27.8,13,12,0,12,11,27,5,0
1227,Nicolas Janvier,0.8,4,1,1,1,2,1,2,50.0,1,1,0,1,1,5,0,0
1228,Pawel Jaroszynski,9.0,20,12,14,5,1,9,18,50.0,9,11,4,7,21,41,40,1
1229,Rune Jarstein,31.0,1,1,1,0,0,1,2,50.0,1,0,0,0,0,1,8,5
1230,Jason,19.8,32,25,11,14,7,11,38,28.9,27,14,1,13,20,52,8,0
1231,Bakery Jatta,3.3,14,12,2,12,0,4,6,66.7,2,6,1,5,3,17,5,0
1232,Corentin Jean,18.8,12,8,4,7,1,5,21,23.8,16,14,1,13,14,26,10,0
1233,Benjamin Jeannot,15.6,12,7,5,6,1,1,13,7.7,12,9,3,6,6,18,26,0
1234,Tin Jedvaj,6.7,10,6,2,6,2,8,15,53.3,7,9,1,8,9,19,18,0
1235,Jemerson,31.7,48,32,32,15,1,24,31,77.4,7,46,32,14,56,104,169,1
1236,Jese,6.8,10,7,3,5,2,3,13,23.1,10,5,0,5,0,10,3,0
1237,Gabriel Jesus,18.5,23,15,6,10,7,3,22,13.6,19,16,0,16,8,31,6,0
1238,Juan Jesus,18.4,42,30,25,15,2,18,34,52.9,16,18,9,9,39,81,63,0
1239,Alvaro Jimenez,5.9,15,8,5,6,4,8,21,38.1,13,6,0,6,1,16,6,0
1240,Joaquin,27.5,22,19,11,10,1,4,16,25.0,12,17,2,15,15,37,38,0
1241,Aron Johannsson,3.1,4,3,2,2,0,1,7,14.3,6,3,0,3,1,5,5,0
1242,Fabian Johnson,5.2,16,10,7,7,2,6,7,85.7,1,10,2,8,2,18,13,0
1243,Glen Johnson,6.1,7,5,5,2,0,3,12,25.0,9,7,2,5,10,17,23,0
1244,Karl-Johan Johnsson,38.0,0,0,0,0,0,0,1,0.0,1,0,0,0,0,0,14,4
1245,Milos Jojic,16.2,36,26,18,15,3,16,40,40.0,24,31,4,27,15,51,16,0
1246,Jonathas,7.0,7,3,2,4,1,1,2,50.0,1,3,1,2,0,7,9,0
1248,Phil Jones,21.9,25,18,20,5,0,9,20,45.0,11,25,17,8,41,66,133,2
1249,Nigel de Jong,8.2,17,12,7,9,1,10,14,71.4,4,5,1,4,12,29,22,1
1250,Jony,2.4,3,2,2,0,1,0,4,0.0,4,1,0,1,2,5,1,0
1251,Joan Jordan,27.0,31,24,8,19,4,10,68,14.7,58,24,0,24,30,61,12,0
1252,Jorge,21.3,69,40,34,25,10,23,38,60.5,15,19,2,17,66,135,86,0
1253,Jorginho,29.4,62,46,14,39,9,15,68,22.1,53,32,3,29,50,112,12,2
1254,Willian Jose,30.8,10,7,1,5,4,2,9,22.2,7,10,1,9,5,15,31,0
1255,Joselu,19.0,22,17,10,11,1,7,34,20.6,27,25,2,23,11,33,39,0
1256,Yann Jouffre,3.1,3,2,0,2,1,1,6,16.7,5,5,1,4,3,6,2,0
1257,Vukasin Jovanovic,16.0,18,14,11,7,0,6,14,42.9,8,18,10,8,27,45,67,0
1258,Stevan Jovetic,8.4,4,4,0,3,1,0,9,0.0,9,5,0,5,3,7,3,0
1259,Luka Jovic,10.4,5,5,0,5,0,1,3,33.3,2,6,2,4,1,6,2,0
1260,Jozabed,16.4,18,12,7,9,2,3,18,16.7,15,18,2,16,16,34,19,0
1261,Juanfran,34.0,64,44,38,22,4,35,65,53.8,30,29,11,18,63,127,121,0
1262,Juanfran,14.5,33,24,21,9,3,21,32,65.6,11,14,4,10,26,59,35,0
1263,Juankar,8.7,23,17,13,8,2,11,20,55.0,9,8,1,7,19,42,26,0
1264,Juanmi,16.5,22,13,7,12,3,4,22,18.2,18,11,0,11,10,32,6,0
1265,Juanpe,34.1,48,30,28,20,0,30,43,69.8,13,27,19,8,53,101,137,0
1266,Juanpi,6.8,11,8,2,7,2,3,8,37.5,5,7,0,7,6,17,1,0
1267,Mariano Julio Izco,2.0,6,4,2,4,0,2,4,50.0,2,2,0,2,4,10,1,0
1268,Christopher Jullien,28.9,36,25,27,9,0,15,32,46.9,17,29,19,10,40,76,182,5
1269,David Junca,10.0,15,13,9,6,0,7,19,36.8,12,7,1,6,11,26,25,0
1270,Gideon Jung,28.6,59,41,32,24,3,22,38,57.9,16,29,12,17,38,97,71,1
1271,Sebastian Jung,0.9,2,2,1,1,0,1,1,100.0,0,0,0,0,0,2,5,0
1272,Zlatko Junuzovic,18.1,35,23,17,12,6,18,38,47.4,20,23,2,21,18,53,12,0
1274,Mathias Jorgensen,38.0,55,36,40,13,2,19,45,42.2,26,49,20,29,76,131,249,5
1275,Christian Kabasele,25.9,42,25,28,14,0,21,36,58.3,15,37,23,14,34,76,185,0
1277,Alexander Kacaniklic,3.5,8,5,7,1,0,5,10,50.0,5,5,2,3,6,14,7,0
1278,Gojko Kacar,2.5,7,6,6,1,0,3,7,42.9,4,3,2,1,4,11,7,0
1279,Elias Kachunga,14.8,30,26,13,12,5,8,19,42.1,11,14,1,13,2,32,9,0
1280,Pavel Kaderabek,24.4,44,30,22,18,4,20,44,45.5,24,27,8,19,34,78,45,1
1281,Shinji Kagawa,13.0,32,22,11,14,7,18,27,66.7,9,6,0,6,6,38,2,0
1283,Florian Kainz,19.0,33,25,9,18,6,9,19,47.4,10,23,0,23,17,50,13,0
1284,Dominik Kaiser,3.1,5,5,1,3,1,4,11,36.4,7,6,0,6,1,6,8,0
1285,Gael Kakuta,34.3,54,32,14,27,13,9,40,22.5,31,33,3,30,26,80,19,0
1286,Nikola Kalinic,20.1,6,5,1,4,1,0,8,0.0,8,4,1,3,3,9,12,0
1287,Salomon Kalou,24.5,19,11,12,5,2,9,17,52.9,8,37,1,36,10,29,29,0
1289,Francois Kamano,22.4,32,24,11,14,7,10,35,28.6,25,18,2,16,15,47,8,0
1290,Bingourou Kamara,18.8,0,0,0,0,0,0,2,0.0,2,0,0,0,1,1,6,3
1291,Boubacar Kamara,5.1,14,14,9,5,0,8,12,66.7,4,7,3,4,3,17,18,0
1292,Marcin Kaminski,12.6,17,14,5,11,1,12,18,66.7,6,12,3,9,30,47,55,0
1293,Kevin Kampl,22.4,42,33,16,20,6,16,39,41.0,23,37,2,35,33,75,33,0
1294,Kevin Kampl,0.3,1,1,1,0,0,1,1,100.0,0,0,0,0,0,1,0,0
1295,Harry Kane,34.2,17,12,2,8,7,4,15,26.7,11,15,4,11,5,22,19,0
1296,Wilfried Kanga,1.9,2,2,0,2,0,0,2,0.0,2,0,0,0,0,2,1,0
1298,N'Golo Kante,33.3,113,77,55,52,6,33,92,35.9,59,40,4,36,85,198,29,3
1300,Bartosz Kapustka,2.6,9,5,2,6,1,4,6,66.7,2,4,0,4,3,12,0,0
1301,Kenan Karaman,9.5,16,13,9,6,1,6,7,85.7,1,10,4,6,1,17,17,0
1302,Yann Karamoh,5.4,3,1,1,1,1,0,3,0.0,3,4,0,4,4,7,1,1
1304,Orestis Karnezis,14.4,0,0,0,0,0,0,2,0.0,2,0,0,0,1,1,3,3
1306,Aleksandar Katai,0.6,1,1,0,1,0,0,1,0.0,1,0,0,0,0,1,0,0
1307,Florian Kath,7.5,15,10,3,9,3,9,17,52.9,8,9,0,9,8,23,1,0
1308,Ole Kauper,0.8,6,5,2,4,0,1,4,25.0,3,1,0,1,2,8,0,0
1309,Eiji Kawashima,28.5,1,1,1,0,0,1,3,33.3,2,0,0,0,3,4,9,2
1310,Beram Kayal,8.3,18,11,10,7,1,6,26,23.1,20,11,4,7,12,30,9,0
1311,Joris Kayembe,1.0,1,0,1,0,0,0,4,0.0,4,0,0,0,0,1,4,0
1312,Olarenwaju Kayode,4.3,3,3,1,2,0,0,4,0.0,4,1,0,1,1,4,0,0
1313,Moise Kean,12.6,8,5,1,3,4,1,6,16.7,5,6,0,6,7,15,4,0
1314,Michael Keane,28.4,33,25,26,5,2,19,43,44.2,24,39,28,11,53,86,214,0
1315,Thilo Kehrer,26.3,81,64,41,36,4,46,68,67.6,22,42,12,30,35,116,113,2
1316,Cheick Keita,1.4,2,2,1,1,0,1,3,33.3,2,5,0,5,2,4,1,0
1317,Naby Keita,21.8,65,48,25,33,7,17,43,39.5,26,26,3,23,36,101,18,0
1318,Keko,13.4,38,23,17,13,8,15,47,31.9,32,25,3,22,13,51,9,0
1319,Martin Kelly,13.3,19,13,15,4,0,14,26,53.8,12,16,11,5,9,28,67,3
1320,Marc-Oliver Kempf,10.0,13,12,9,4,0,5,8,62.5,3,7,7,0,17,30,52,0
1321,Kenedy,11.4,31,17,16,13,2,12,35,34.3,23,12,1,11,14,45,11,0
1322,Jonjoe Kenny,17.7,41,33,28,10,3,20,32,62.5,12,17,7,10,28,69,95,0
1323,Ryan Kent,2.7,4,3,2,1,1,2,5,40.0,3,6,0,6,1,5,1,0
1324,Christophe Kerbrat,36.9,62,45,47,14,1,35,65,53.8,30,49,40,9,62,124,249,2
1326,Franck Kessie,36.3,48,34,20,19,9,17,44,38.6,27,47,11,36,26,74,45,3
1327,Billy Ketkeophomphone,4.9,14,9,4,5,5,5,15,33.3,10,9,0,9,5,19,8,0
1329,Saif-Eddine Khaoui,21.7,57,25,22,27,8,15,50,30.0,35,12,2,10,27,84,9,0
1330,Wahbi Khazri,21.3,26,18,7,10,9,7,39,17.9,32,29,0,29,7,33,7,0
1331,Rani Khedira,25.3,62,47,25,28,9,33,47,70.2,14,41,18,23,36,98,96,0
1332,Sami Khedira,21.2,14,9,1,9,4,2,23,8.7,21,13,3,10,20,34,20,0
1334,Kike,27.3,14,8,1,7,6,2,11,18.2,9,15,1,14,10,24,14,0
1335,Joshua Kimmich,25.9,32,23,14,13,5,20,38,52.6,18,26,5,21,20,52,40,0
1336,Presnel Kimpembe,26.9,39,28,20,18,1,9,14,64.3,5,17,10,7,24,63,80,1
1337,Andy King,6.0,8,5,0,5,3,0,3,0.0,3,4,2,2,5,13,13,0
1338,Andy King,7.9,18,11,10,8,0,5,14,35.7,9,7,0,7,6,24,14,1
1339,Joshua King,27.3,36,26,11,17,8,4,27,14.8,23,23,3,20,4,40,14,1
1340,Simon Kjaer,17.5,35,24,25,8,2,13,22,59.1,9,16,10,6,32,67,109,0
1341,Davy Klaassen,2.8,3,1,1,2,0,2,6,33.3,4,2,1,1,1,4,2,0
1342,Felix Klaus,22.0,48,38,20,21,7,23,50,46.0,27,29,4,25,8,56,28,0
1343,Ragnar Klavan,16.1,14,10,6,7,1,6,12,50.0,6,11,5,6,15,29,85,1
1344,Tim Kleindienst,12.6,22,15,6,12,4,4,17,23.5,13,17,3,14,6,28,21,0
1345,Lukas Klostermann,24.3,56,41,34,18,4,28,37,75.7,9,33,6,27,33,89,79,0
1346,Lukas Klunter,14.8,25,20,16,8,1,16,24,66.7,8,11,2,9,13,38,28,1
1347,Robin Knoche,23.4,34,20,26,8,0,25,35,71.4,10,36,24,12,25,59,89,1
1348,Anthony Knockaert,26.9,39,26,25,11,3,16,55,29.1,39,29,3,26,23,62,16,0
1350,Robin Koch,21.3,34,24,21,13,0,10,18,55.6,8,27,11,16,35,69,67,0
1354,Dominik Kohr,18.5,49,26,20,25,4,25,41,61.0,16,39,5,34,30,79,24,0
1355,Seybou Koita,2.4,1,1,1,0,0,1,1,100.0,0,0,0,0,0,1,2,0
1356,Koke,30.6,75,45,31,32,12,27,95,28.4,68,40,3,37,24,99,38,0
1357,Aleksandar Kolarov,34.0,58,47,34,16,8,27,49,55.1,22,24,7,17,53,111,100,2
1358,Sead Kolasinac,23.9,49,37,28,13,8,20,39,51.3,19,15,3,12,26,75,56,0
1359,Vincent Kompany,15.5,20,11,14,5,1,13,19,68.4,6,10,8,2,16,36,73,1
1360,Ibrahima Konate,13.6,32,25,20,12,0,18,23,78.3,5,14,3,11,20,52,66,0
1361,Moussa Konate,27.5,8,6,1,4,3,3,23,13.0,20,10,2,8,3,11,11,0
1362,Geoffrey Kondogbia,29.0,88,57,38,43,7,23,68,33.8,45,46,14,32,62,150,66,0
1363,Bakary Kone,27.4,26,17,23,3,0,12,31,38.7,19,20,10,10,33,59,122,2
1364,Terence Kongolo,11.7,33,20,19,13,1,14,22,63.6,8,12,6,6,32,65,71,0
1365,Terence Kongolo,2.9,6,4,4,2,0,0,2,0.0,2,5,3,2,5,11,14,0
1366,Yevhen Konoplyanka,17.4,11,9,3,4,4,3,11,27.3,8,18,1,17,5,16,6,0
1367,Julian Korb,26.0,52,41,27,19,6,37,68,54.4,31,30,2,28,22,74,77,0
1368,Laurent Koscielny,24.7,43,21,27,12,4,19,33,57.6,14,28,15,13,54,97,138,3
1369,Filip Kostic,27.1,48,38,16,21,11,20,41,48.8,21,42,1,41,10,58,12,0
1370,Christian Kouakou,9.4,24,13,14,8,2,5,19,26.3,14,16,1,15,8,32,6,1
1371,Rominigue Kouame,2.2,5,2,2,2,1,2,3,66.7,1,1,0,1,5,10,0,0
1372,Tomas Koubek,34.0,0,0,0,0,0,0,1,0.0,1,0,0,0,3,3,22,3
1373,Kalidou Koulibaly,34.1,54,42,31,19,4,20,40,50.0,20,36,16,20,40,94,119,3
1374,Jules Kounde,17.7,26,19,19,7,0,13,17,76.5,4,14,11,3,14,40,97,0
1375,Cheikhou Kouyate,31.1,71,49,43,26,2,23,62,37.1,39,31,11,20,32,103,56,1
1376,Mateo Kovacic,11.0,37,27,19,18,0,8,27,29.6,19,9,4,5,5,42,5,0
1379,Dawid Kownacki,9.1,8,7,1,4,3,3,11,27.3,8,7,0,7,1,9,5,0
1380,Vincent Koziello,9.0,16,8,9,5,2,5,16,31.3,11,8,3,5,19,35,7,1
1381,Vincent Koziello,8.8,28,21,6,21,1,10,21,47.6,11,9,0,9,10,38,5,1
1383,Emil Krafth,10.5,23,16,14,8,1,10,19,52.6,9,12,4,8,16,39,39,1
1385,Andrej Kramaric,24.8,8,6,4,3,1,3,8,37.5,5,15,0,15,6,14,7,0
1386,Christoph Kramer,23.9,89,70,43,34,12,39,76,51.3,37,29,4,25,43,132,37,1
1387,Ladislav Krejci,4.4,7,5,1,3,3,1,5,20.0,4,3,0,3,2,9,3,0
1388,Rene Krhin,14.6,18,12,7,11,0,3,17,17.6,14,11,2,9,16,34,39,0
1389,Bojan Krkic,0.8,0,0,0,0,0,0,1,0.0,1,1,0,1,0,0,0,0
1390,Bojan Krkic,4.9,2,1,1,1,0,1,2,50.0,1,5,0,5,3,5,0,0
1391,Michael Krohn-Dehli,8.1,12,9,6,5,1,4,17,23.5,13,2,0,2,13,25,7,0
1392,Michael Krohn-Dehli,6.0,13,7,4,5,4,6,11,54.5,5,5,0,5,4,17,7,0
1393,Toni Kroos,25.1,55,35,19,29,7,22,59,37.3,37,20,2,18,16,71,10,1
1394,Max Kruse,27.3,17,12,3,10,4,5,22,22.7,17,9,0,9,11,28,4,1
1395,Grzegorz Krychowiak,18.2,39,24,18,17,4,12,49,24.5,37,23,5,18,45,84,23,0
1396,Lukas Kubler,12.8,31,19,16,15,0,13,23,56.5,10,15,6,9,18,49,41,0
1397,Jasmin Kurtic,16.0,28,18,13,11,4,5,21,23.8,16,13,1,12,17,45,25,0
1398,Jasmin Kurtic,7.4,12,7,6,3,3,3,7,42.9,4,7,0,7,5,17,4,0
1399,Layvin Kurzawa,18.9,44,32,20,15,9,15,39,38.5,24,16,3,13,35,79,41,2
1401,Zdravko Kuzmanovic,5.3,4,4,1,3,0,0,5,0.0,5,2,2,0,4,8,9,0
1402,Han Kwang-song,3.1,1,1,0,0,1,0,4,0.0,4,4,0,4,0,1,0,0
1404,Enock Kwateng,1.0,8,6,6,2,0,7,11,63.6,4,2,0,2,1,9,7,0
1405,Alberto de la Bella,17.0,36,22,25,10,1,16,28,57.1,12,19,5,14,21,57,54,0
1406,Rajiv van La Parra,23.7,41,29,18,15,8,12,41,29.3,29,27,1,26,21,62,8,1
1408,Gaetan Laborde,10.6,9,7,1,6,2,2,7,28.6,5,8,2,6,1,10,7,1
1409,Alexandre Lacazette,24.5,24,17,6,11,7,4,27,14.8,23,19,3,16,7,31,5,0
1410,Mehdi Lacen,11.7,35,19,18,17,0,14,38,36.8,24,13,1,12,15,50,11,0
1412,Leo Lacroix,8.6,13,8,8,5,0,5,9,55.6,4,6,3,3,11,24,54,1
1414,Alban Lafont,38.0,1,0,1,0,0,1,4,25.0,3,0,0,0,2,3,20,5
1415,Victor Laguardia,17.0,20,15,13,5,2,11,19,57.9,8,23,14,9,29,49,109,0
1416,Konrad Laimer,14.9,57,39,31,22,4,28,57,49.1,29,37,2,35,11,68,32,0
1417,Kenny Lala,30.3,87,47,53,28,6,21,47,44.7,26,18,10,8,42,129,70,2
1418,Adam Lallana,3.4,3,1,3,0,0,2,10,20.0,8,3,0,3,1,4,1,0
1420,Erik Lamela,9.4,23,13,9,7,7,3,20,15.0,17,11,1,10,7,30,5,0
1421,Adam Lang,2.6,3,1,3,0,0,3,5,60.0,2,2,1,1,3,6,12,0
1422,Sebastian Langkamp,10.6,15,12,9,6,0,11,18,61.1,7,7,4,3,21,36,58,1
1423,Sebastian Langkamp,4.6,7,3,4,3,0,4,4,100.0,0,7,5,2,8,15,18,0
1424,Manuel Lanzini,22.7,20,11,6,11,3,2,34,5.9,32,7,1,6,30,50,5,2
1425,Gianluca Lapadula,16.6,8,5,4,4,0,1,11,9.1,10,7,1,6,3,11,8,0
1426,Aymeric Laporte,9.0,8,7,6,2,0,3,8,37.5,5,2,1,1,11,19,27,0
1427,Aymeric Laporte,19.0,38,23,27,11,0,14,25,56.0,11,19,13,6,27,65,94,1
1428,Danilo Larangeira,30.8,35,21,26,8,1,16,29,55.2,13,50,38,12,50,85,161,2
1430,Kevin Lasagna,23.7,10,7,0,8,2,2,7,28.6,5,27,4,23,8,18,18,0
1431,Jamaal Lascelles,32.5,31,19,19,11,1,12,19,63.2,7,33,24,9,28,59,232,1
1432,Paul Lasne,34.0,68,45,27,39,2,12,54,22.2,42,20,1,19,57,125,26,0
1433,Borja Lasso,0.6,4,1,2,2,0,1,2,50.0,1,3,0,3,0,4,0,0
1434,Toni Lato,8.9,30,16,22,6,2,16,27,59.3,11,9,3,6,9,39,23,0
1435,Danny Latza,26.1,67,48,28,33,6,33,73,45.2,40,43,8,35,26,93,47,1
1436,Vincent Laurini,17.9,34,23,21,9,4,12,22,54.5,10,20,5,15,11,45,72,1
1437,Wesley Lautoa,6.9,17,13,11,6,0,6,12,50.0,6,10,4,6,19,36,24,1
1438,Diego Laxalt,31.2,54,43,31,17,6,22,59,37.3,37,38,3,35,25,79,55,1
1439,Miguel Layun,13.2,28,19,14,12,2,17,36,47.2,19,18,4,14,15,43,44,1
1440,Achraf Lazaar,5.3,12,8,9,2,1,5,11,45.5,6,5,1,4,6,18,10,0
1441,Valentino Lazaro,20.7,33,28,11,12,10,15,31,48.4,16,35,2,33,15,48,32,0
1442,Darko Lazovic,13.8,19,12,16,2,1,9,18,50.0,9,8,0,8,13,32,12,0
1443,Manuel Lazzari,34.6,61,47,33,21,7,27,62,43.5,35,32,7,25,31,92,73,2
1444,Mickael Le Bihan,1.2,0,0,0,0,0,0,3,0.0,3,0,0,0,1,1,0,0
1445,Maxime Le Marchand,28.2,48,36,28,18,2,20,41,48.8,21,36,13,23,65,113,105,4
1446,James Lea Siliki,20.2,31,21,9,19,3,6,41,14.6,35,21,1,20,18,49,14,1
1447,Mathew Leckie,20.6,35,30,16,15,4,20,35,57.1,15,26,3,23,19,54,32,1
1449,Pierre Lees-Melou,32.1,78,47,29,39,10,27,76,35.5,49,52,11,41,34,112,38,2
1450,Matthias Lehmann,16.8,33,23,14,18,1,17,29,58.6,12,15,7,8,26,59,24,1
1451,Lucas Leiva,32.0,107,80,43,59,5,29,100,29.0,71,33,7,26,70,177,59,0
1452,Florian Lejeune,23.4,34,20,26,8,0,14,30,46.7,16,21,15,6,46,80,154,0
1453,Inigo Lekue,23.5,71,42,37,26,8,34,53,64.2,19,29,3,26,16,87,46,1
1454,Thomas Lemar,26.4,33,17,9,19,5,10,41,24.4,31,22,1,21,18,51,16,1
1456,Mario Lemina,19.1,55,40,21,29,5,12,30,40.0,18,18,6,12,36,91,36,4
1457,Mauricio Lemos,7.8,11,9,8,3,0,7,14,50.0,7,10,5,5,9,20,33,1
1458,Mauricio Lemos,14.0,22,10,17,5,0,15,27,55.6,12,16,13,3,25,47,51,1
1459,Dylan Lempereur,1.6,5,3,3,1,1,2,6,33.3,4,1,0,1,0,5,6,0
1460,Clement Lenglet,33.3,67,50,32,35,0,21,38,55.3,17,44,27,17,35,102,157,1
1461,Aaron Lennon,12.4,20,14,5,14,1,2,20,10.0,18,20,5,15,8,28,18,0
1462,Aaron Lennon,8.8,17,10,10,5,2,5,21,23.8,16,13,1,12,11,28,9,0
1463,Bernd Leno,33.0,0,0,0,0,0,0,1,0.0,1,0,0,0,1,1,11,2
1464,Pedro Leon,10.3,9,4,0,2,7,0,4,0.0,4,18,2,16,9,18,5,0
1465,Sergio Leon,22.0,13,7,3,6,4,3,11,27.3,8,12,1,11,6,19,5,0
1466,Lukas Lerager,36.5,107,74,33,61,13,33,107,30.8,74,44,8,36,67,174,66,1
1467,Mehdi Leris,0.5,1,1,1,0,0,0,1,0.0,1,0,0,0,1,2,0,0
1468,Jefferson Lerma,23.7,51,35,26,23,2,17,45,37.8,28,25,10,15,49,100,43,0
1469,Maxime Lestienne,7.4,8,5,5,0,3,3,15,20.0,12,7,1,6,6,14,6,0
1471,Gaetano Letizia,23.8,36,26,21,14,1,19,49,38.8,30,24,3,21,33,69,47,3
1472,Timo Letschert,4.6,13,8,10,3,0,5,8,62.5,3,9,3,6,7,20,23,0
1473,Robert Lewandowski,24.1,5,3,1,1,3,0,3,0.0,3,6,0,6,5,10,10,0
1474,Igor Lewczuk,4.9,9,7,5,3,1,3,6,50.0,3,2,2,0,7,16,11,0
1475,Stephan Lichtsteiner,18.9,31,27,16,10,5,9,17,52.9,8,11,2,9,15,46,38,1
1476,Dimitri Lienard,28.9,77,51,37,32,8,30,84,35.7,54,35,2,33,52,129,41,1
1477,Philipp Lienhart,9.6,16,14,12,4,0,6,17,35.3,11,14,9,5,11,27,60,0
1478,Lucas Lima,29.5,73,46,40,27,6,31,68,45.6,37,42,6,36,38,111,85,0
1479,Victor Lindelof,14.3,17,11,10,6,1,9,14,64.3,5,15,11,4,13,30,67,1
1480,Karol Linetty,23.8,66,49,25,31,10,17,77,22.1,60,40,2,38,18,84,13,0
1482,Jesse Lingard,20.2,30,21,10,13,7,5,27,18.5,22,18,3,15,9,39,13,0
1483,Pol Lirola,22.5,34,21,26,6,2,20,35,57.1,15,11,4,7,28,62,88,1
1484,Jake Livermore,29.7,72,41,27,35,10,24,64,37.5,40,44,9,35,26,98,36,2
1485,Raul Lizoain,11.0,1,0,1,0,0,1,3,33.3,2,0,0,0,1,2,2,3
1486,Adem Ljajic,24.1,12,9,4,6,2,5,13,38.5,8,11,1,10,9,21,13,0
1487,Diego Llorente,25.8,30,22,16,13,1,18,29,62.1,11,41,18,23,43,73,96,0
1488,Fernando Llorente,2.6,6,3,1,2,3,1,2,50.0,1,0,0,0,0,6,6,0
1489,Marcos Llorente,6.1,15,8,7,8,0,6,11,54.5,5,7,0,7,5,20,8,0
1490,Hugo Lloris,36.0,1,1,1,0,0,1,4,25.0,3,0,0,0,2,3,34,8
1491,Giovani Lo Celso,19.7,77,58,26,36,15,26,74,35.1,48,30,5,25,19,96,12,1
1492,Simone Lo Faso,0.4,1,1,1,0,0,0,1,0.0,1,0,0,0,1,2,0,0
1493,Stanislav Lobotka,34.0,64,45,24,35,5,23,65,35.4,42,25,9,16,39,103,22,0
1494,Jurgen Locadia,2.5,1,0,0,1,0,0,1,0.0,1,0,0,0,1,2,1,1
1495,Manuel Locatelli,7.6,16,13,6,9,1,4,18,22.2,14,10,2,8,9,25,13,0
1496,Ruben Loftus-Cheek,20.8,21,15,7,13,1,7,30,23.3,23,19,2,17,22,43,31,0
1497,Enzo Loiodice,1.9,9,5,4,5,0,4,7,57.1,3,0,0,0,2,11,0,0
1498,Joe Lolley,2.5,2,0,1,1,0,0,2,0.0,2,0,0,0,3,5,2,1
1499,David Lomban,11.0,16,8,12,3,1,10,15,66.7,5,6,4,2,29,45,66,2
1500,Cristiano Lombardi,12.4,25,19,16,7,2,6,27,22.2,21,12,2,10,13,38,22,0
1501,Kevin Long,16.0,32,23,28,4,0,16,26,61.5,10,25,14,11,19,51,129,1
1502,Shane Long,17.6,25,20,1,19,5,10,30,33.3,20,14,2,12,12,37,29,0
1503,Ademola Lookman,1.8,1,1,0,1,0,0,2,0.0,2,2,0,2,1,2,3,0
1506,Rony Lopes,28.1,55,32,15,27,13,21,78,26.9,57,23,2,21,16,71,22,0
1508,Adrian Lopez,26.1,24,14,11,8,5,7,25,28.0,18,22,4,18,10,34,49,0
1509,Alberto Lopez,0.5,1,1,0,1,0,1,1,100.0,0,1,0,1,2,3,2,0
1510,Andoni Lopez,1.0,1,0,1,0,0,1,1,100.0,0,1,0,1,1,2,6,0
1511,David Lopez,37.0,67,49,47,19,1,27,54,50.0,27,43,26,17,67,134,161,0
1512,Diego Lopez,9.5,0,0,0,0,0,0,1,0.0,1,0,0,0,0,0,1,0
1514,Javi Lopez,10.7,47,35,31,12,4,18,35,51.4,17,7,2,5,18,65,48,0
1515,Lisandro Lopez,0.5,2,2,1,1,0,0,2,0.0,2,0,0,0,1,3,3,0
1516,Maxi Lopez,18.7,12,8,2,7,3,0,4,0.0,4,8,2,6,2,14,18,0
1517,Maxime Lopez,15.3,30,20,12,12,6,12,56,21.4,44,16,2,14,7,37,6,1
1518,Pedro Lopez Munoz,17.7,33,23,21,10,2,17,30,56.7,13,22,7,15,26,59,45,0
1521,Victor Lopez,0.7,2,1,0,2,0,0,1,0.0,1,0,0,0,1,3,1,0
1522,Jonas Lossl,38.0,1,0,1,0,0,1,5,20.0,4,0,0,0,4,5,13,6
1523,Dejan Lovren,23.6,26,17,14,11,1,12,22,54.5,10,26,15,11,38,64,146,2
1524,Chris Lowe,17.6,43,29,26,15,2,20,44,45.5,24,21,8,13,34,77,65,3
1525,Matthew Lowton,25.5,55,34,26,27,2,28,60,46.7,32,35,15,20,39,94,141,2
1526,Anthony Lozano,5.2,9,5,2,7,0,1,5,20.0,4,3,0,3,3,12,2,0
1527,Fabio Lucioni,8.0,11,9,7,4,0,7,11,63.6,4,14,11,3,7,18,61,0
1528,Filipe Luis,18.4,83,52,41,33,9,36,49,73.5,13,27,7,20,35,118,34,0
1529,Jose Luis Gaya,32.4,77,60,52,22,3,43,68,63.2,25,43,12,31,56,133,90,1
1530,Jose Luis Morales,34.0,37,23,15,15,7,13,65,20.0,52,28,0,28,26,63,20,0
1531,Jose Luis Palomino,22.0,60,39,36,19,5,24,51,47.1,27,36,21,15,39,99,111,1
1532,Luisinho,29.1,111,77,64,40,7,65,96,67.7,31,24,4,20,55,166,113,0
1534,David Luiz,9.3,18,11,13,4,1,11,21,52.4,10,9,5,4,24,42,45,2
1535,Douglas Luiz,3.4,10,9,4,6,0,3,11,27.3,8,1,0,1,4,14,0,0
1536,Everton Luiz,7.1,22,16,10,10,2,6,29,20.7,23,8,1,7,10,32,8,1
1537,Jordan Lukaku,15.1,28,15,14,11,3,10,16,62.5,6,14,2,12,15,43,23,0
1538,Romelu Lukaku,31.9,7,4,1,3,3,0,13,0.0,13,9,2,7,3,10,22,2
1539,Lars Lukas Mai,2.0,4,4,4,0,0,3,4,75.0,1,3,2,1,3,7,3,0
1541,Sasa Lukic,11.0,21,16,9,8,4,5,16,31.3,11,14,6,8,17,38,13,0
1542,Senad Lulic,27.0,66,40,32,22,12,21,80,26.3,59,32,4,28,36,102,39,0
1544,Antonio Luna,22.5,39,26,23,13,3,24,41,58.5,17,26,9,17,36,75,68,0
1545,Arnaud Lusamba,1.8,12,9,4,6,2,3,7,42.9,4,5,0,5,1,13,1,0
1546,Fabian Lustenberger,17.6,47,34,26,20,1,21,31,67.7,10,31,12,19,24,71,74,1
1548,Lyanco,3.5,11,8,8,3,0,5,8,62.5,3,4,3,1,5,16,17,0
1549,Charalambos Lykogiannis,7.6,16,12,9,5,2,11,18,61.1,7,12,3,9,15,31,28,0
1550,Cheikh M'Bengue,5.4,8,4,8,0,0,4,4,100.0,0,6,4,2,8,16,22,1
1551,Rais M'Bolhi,1.0,0,0,0,0,0,0,1,0.0,1,0,0,0,0,0,0,0
1552,Yann M'Vila,16.4,26,16,11,12,3,7,24,29.2,17,13,1,12,31,57,56,0
1553,Zinedine Machach,2.1,7,3,5,1,1,4,5,80.0,1,1,0,1,2,9,2,0
1554,Pablo Maffeo,29.4,74,55,39,23,12,25,49,51.0,24,28,7,21,50,124,82,0
1555,Christian Maggio,7.1,17,10,9,6,2,7,19,36.8,12,15,4,11,13,30,21,0
1556,Francesco Magnanelli,27.7,56,38,30,20,6,20,65,30.8,45,26,7,19,58,114,78,2
1557,Harry Maguire,38.0,63,46,47,15,1,26,43,60.5,17,35,28,7,48,111,181,1
1558,Hicham Mahou,0.6,1,1,1,0,0,1,3,33.3,2,0,0,0,3,4,0,0
1560,Riyad Mahrez,32.8,39,27,16,17,6,10,63,15.9,53,32,1,31,18,57,15,0
1561,Thiago Maia,27.4,55,40,26,26,3,15,61,24.6,46,32,10,22,61,116,47,1
1562,Arne Maier,13.6,29,23,12,16,1,18,24,75.0,6,19,3,16,24,53,20,0
1563,Sebastian Maier,2.9,11,6,4,7,0,2,12,16.7,10,6,1,5,4,15,1,1
1564,Domenico Maietta,5.2,5,4,4,1,0,3,9,33.3,6,8,6,2,7,12,13,1
1565,Habib Maiga,7.9,29,18,16,10,3,12,30,40.0,18,8,4,4,19,48,10,0
1566,Mike Maignan,33.7,1,1,1,0,0,1,1,100.0,0,0,0,0,0,1,8,6
1568,Ainsley Maitland-Niles,10.2,25,17,12,7,6,14,31,45.2,17,15,1,14,12,37,35,2
1569,Jean-Victor Makengo,2.7,4,2,2,2,0,1,2,50.0,1,1,0,1,3,7,1,1
1570,Nemanja Maksimovic,6.2,21,13,10,8,3,8,16,50.0,8,15,6,9,16,37,8,0
1571,Nikola Maksimovic,1.1,1,1,0,1,0,1,1,100.0,0,1,0,1,0,1,5,0
1572,Malcom,31.7,15,10,3,7,5,1,28,3.6,27,13,1,12,14,29,6,0
1573,Kevin Malcuit,20.2,51,37,31,16,4,17,25,68.0,8,13,5,8,38,89,47,0
1574,Yunus Malli,24.9,25,17,8,14,3,12,25,48.0,13,23,0,23,12,37,17,0
1575,Hugo Mallo,33.3,84,55,55,26,3,35,53,66.0,18,30,15,15,68,152,111,1
1576,Scott Malone,12.4,39,29,27,10,2,17,24,70.8,7,12,2,10,26,65,43,2
1577,Vincent Manceau,33.0,84,49,56,22,6,42,76,55.3,34,34,2,32,34,118,103,0
1578,Gianluca Mancini,7.6,20,14,11,8,1,10,17,58.8,7,8,2,6,15,35,22,0
1580,Aissa Mandi,33.6,54,35,27,25,2,19,34,55.9,15,39,24,15,71,125,133,3
1581,Georges Mandjeck,10.8,25,14,8,16,1,8,18,44.4,10,9,3,6,18,43,21,1
1582,Rolando Mandragora,36.0,91,60,48,34,9,26,69,37.7,43,41,13,28,86,177,75,0
1583,Mario Mandzukic,25.8,36,23,13,11,12,8,29,27.6,21,20,3,17,25,61,42,2
1584,Sadio Mane,24.3,28,20,8,11,9,3,23,13.0,20,20,0,20,9,37,8,0
1587,Eliaquim Mangala,5.4,5,3,5,0,0,1,3,33.3,2,4,3,1,2,7,24,0
1588,Orel Mangala,8.7,28,18,7,19,2,11,21,52.4,10,8,2,6,18,46,15,0
1589,Kader Mangane,19.1,37,24,29,8,0,11,21,52.4,10,28,18,10,24,61,120,4
1590,Thomas Mangani,33.6,92,59,35,46,11,28,120,23.3,92,40,5,35,40,132,45,1
1591,Kostas Manolas,26.0,23,20,14,7,2,9,15,60.0,6,31,24,7,46,69,133,2
1592,Javier Manquillo,19.5,36,22,25,8,3,15,30,50.0,15,25,6,19,18,54,65,0
1593,Martin Mantovani,11.4,12,5,10,2,0,7,10,70.0,3,10,6,4,22,34,67,0
1594,Jose Manuel Jurado,16.7,18,14,8,8,2,5,14,35.7,9,13,1,12,16,34,5,0
1595,Harrison Manzala,20.7,32,23,16,9,7,8,25,32.0,17,22,3,19,18,50,15,0
1596,Myziane Maolida,3.7,5,5,3,2,0,0,2,0.0,2,1,0,1,0,5,0,0
1597,Faitout Maouassa,9.9,6,3,2,3,1,2,10,20.0,8,12,2,10,6,12,5,0
1598,Fernando Marcal,14.4,34,20,22,8,4,14,29,48.3,15,14,6,8,26,60,69,0
1599,Vincent Marcel,0.5,1,1,0,1,0,0,1,0.0,1,1,0,1,0,1,0,0
1600,Marcelo,25.1,53,37,19,23,11,22,58,37.9,36,26,2,24,30,83,23,2
1601,Marcelo,34.5,27,25,16,10,1,9,25,36.0,16,32,18,14,57,84,235,4
1602,Solly March,20.6,54,41,34,14,6,22,54,40.7,32,27,3,24,13,67,49,0
1604,Claudio Marchisio,9.1,17,10,9,5,3,6,21,28.6,15,7,2,5,4,21,7,0
1605,Gian Marco Ferrari,29.4,12,8,8,4,0,5,10,50.0,5,42,38,4,31,43,149,4
1606,Oscar de Marcos,18.4,28,21,11,15,2,13,29,44.8,16,15,2,13,19,47,36,0
1607,Jose Maria Gimenez,18.8,38,27,29,6,3,23,35,65.7,12,28,15,13,30,68,101,1
1608,Mariano,27.9,16,11,0,5,11,2,23,8.7,21,9,1,8,3,19,20,0
1609,Adrian Mariappa,24.6,45,26,33,12,0,14,34,41.2,20,25,16,9,45,90,133,4
1610,Jordan Marie,20.9,63,38,22,36,5,18,66,27.3,48,26,9,17,40,103,25,2
1612,Adrian Marin,2.6,6,4,3,3,0,2,8,25.0,6,2,0,2,3,9,8,0
1613,Joao Mario,11.4,14,11,6,5,3,6,19,31.6,13,7,0,7,8,22,4,1
1614,Joao Mario,6.2,8,4,3,3,2,2,8,25.0,6,6,1,5,4,12,5,0
1615,Guillermo Maripan,17.0,28,16,24,4,0,17,32,53.1,15,19,10,9,36,64,108,0
1616,Marlon,21.4,36,26,22,13,1,15,22,68.2,7,19,15,4,15,51,72,2
1617,Dominic Maroh,10.2,22,15,18,4,0,15,18,83.3,3,17,9,8,21,43,68,1
1618,Marquinhos,25.1,28,14,14,14,0,13,21,61.9,8,36,22,14,14,42,114,2
1619,Bruno Martella,29.1,30,21,19,7,4,12,30,40.0,18,22,9,13,48,78,151,1
1620,Roger Marti,10.7,8,4,2,5,1,2,13,15.4,11,11,0,11,1,9,5,0
1621,Anthony Martial,17.6,15,13,9,2,4,3,12,25.0,9,5,1,4,3,18,7,0
1622,Aaron Martin,31.3,56,36,41,12,3,31,59,52.5,28,26,5,21,49,105,78,0
1623,Jonas Martin,33.6,73,50,41,28,4,17,54,31.5,37,30,3,27,33,106,36,0
1624,Cuco Martina,20.3,61,35,38,15,8,27,46,58.7,19,17,4,13,42,103,130,2
1627,Inigo Martinez,16.0,28,20,20,8,0,18,29,62.1,11,17,8,9,30,58,82,0
1628,Inigo Martinez,11.7,14,9,9,4,1,5,11,45.5,6,9,4,5,23,37,55,0
1629,Javi Martinez,17.9,31,22,11,15,5,9,19,47.4,10,16,5,11,33,64,40,1
1630,Pablo Martinez,23.5,41,34,28,12,1,22,49,44.9,27,25,12,13,51,92,112,3
1631,Roger Martinez,2.6,1,1,0,1,0,0,2,0.0,2,2,0,2,0,1,1,0
1632,Christopher Martins,0.8,3,2,0,3,0,1,2,50.0,1,0,0,0,1,4,0,0
1633,Bruno Martins Indi,13.8,21,12,18,3,0,10,19,52.6,9,16,11,5,21,42,77,1
1634,Jonathan Martins Pereira,12.6,34,18,21,10,3,8,23,34.8,15,9,3,6,37,71,39,1
1635,Adam Marusic,28.0,28,21,17,8,3,12,28,42.9,16,22,2,20,31,59,33,0
1636,Omar Mascarell,8.6,20,16,8,12,0,10,18,55.6,8,14,1,13,21,41,10,0
1638,Javier Mascherano,6.0,15,13,9,6,0,8,9,88.9,1,14,8,6,8,23,20,0
1639,Andrea Masiello,30.1,58,38,34,20,4,30,54,55.6,24,24,6,18,72,130,137,0
1640,Adam Masina,31.4,82,57,49,26,7,36,84,42.9,48,46,7,39,51,133,127,0
1641,Eden Massouema,2.1,2,1,2,0,0,2,2,100.0,0,3,0,3,5,7,2,0
1642,Arthur Masuaku,20.8,58,37,36,16,6,25,58,43.1,33,25,2,23,26,84,38,1
1643,Juan Mata,21.4,18,13,4,12,2,2,24,8.3,22,10,0,10,15,33,10,1
1644,Christian Mathenia,24.0,0,0,0,0,0,0,3,0.0,3,0,0,0,0,0,11,3
1645,Nemanja Matic,34.6,70,42,32,34,4,23,71,32.4,48,50,13,37,64,134,62,2
1646,Joel Matip,22.2,35,24,23,11,1,12,24,50.0,12,26,15,11,35,70,101,1
1647,Ryder Matos,1.9,3,1,1,1,1,1,1,100.0,0,2,0,2,2,5,3,0
1648,Ryder Matos,10.9,18,15,11,5,2,4,9,44.4,5,5,0,5,3,21,9,1
1649,Alessandro Matri,10.2,2,1,1,1,0,0,3,0.0,3,1,0,1,0,2,5,0
1650,Ville Matti Steinmann,6.6,16,10,6,8,2,8,17,47.1,9,6,1,5,18,34,9,1
1651,Federico Mattiello,24.5,59,40,31,22,6,21,44,47.7,23,53,15,38,64,123,66,0
1652,Blaise Matuidi,26.2,49,35,14,25,10,10,35,28.6,25,28,4,24,32,81,22,1
1656,Mergim Mavraj,16.1,45,32,32,11,2,22,37,59.5,15,28,12,16,21,66,91,3
1657,Konstantinos Mavropanos,2.2,1,1,1,0,0,1,2,50.0,1,4,3,1,6,7,11,1
1658,Alfie Mawson,38.0,32,22,24,8,0,16,27,59.3,11,41,32,9,35,67,229,5
1659,Philipp Max,32.9,65,47,36,19,10,34,59,57.6,25,27,8,19,33,98,65,1
1660,Alexandru Maxim,10.6,17,12,6,8,3,7,22,31.8,15,20,2,18,6,23,3,0
1661,Eric Maxim Choupo-Moting,25.7,42,30,21,16,5,9,32,28.1,23,31,3,28,23,65,29,1
1662,Florian Mayer,0.2,1,1,1,0,0,1,1,100.0,0,0,0,0,0,1,1,0
1664,Borja Mayoral,3.8,6,3,0,4,2,1,5,20.0,4,3,0,3,0,6,0,0
1665,Robert Mazan,0.9,0,0,0,0,0,0,1,0.0,1,1,0,1,2,2,0,0
1666,Luca Mazzitelli,11.3,37,24,14,15,8,10,36,27.8,26,21,2,19,21,58,19,0
1668,Kylian Mbappe,23.3,11,8,3,3,5,1,13,7.7,12,4,1,3,0,11,1,0
1669,Ibrahima Mbaye,19.6,59,34,40,17,2,25,36,69.4,11,25,6,19,28,87,95,0
1670,Chancel Mbemba,7.5,16,12,13,3,0,10,17,58.8,7,7,3,4,15,31,44,1
1671,Adama Mbengue,17.7,71,48,48,18,5,41,65,63.1,24,21,1,20,28,99,50,0
1672,Isaac Mbenza,23.3,16,11,4,8,4,6,16,37.5,10,8,1,7,4,20,5,0
1673,Bryan Mbeumo,0.7,0,0,0,0,0,0,3,0.0,3,2,0,2,0,0,2,0
1675,James McArthur,27.0,58,44,28,27,3,23,61,37.7,38,39,2,37,36,94,44,2
1676,Gareth McAuley,5.1,8,7,6,2,0,3,7,42.9,4,7,4,3,11,19,16,0
1677,Oliver McBurnie,3.1,4,3,0,2,2,1,3,33.3,2,2,0,2,0,4,3,0
1679,James McCarthy,2.3,9,9,3,4,2,1,5,20.0,4,9,2,7,5,14,3,1
1680,James McClean,15.6,40,28,23,14,3,10,55,18.2,45,18,4,14,20,60,22,0
1681,Weston McKennie,14.0,36,23,11,21,4,13,32,40.6,19,16,2,14,20,56,32,0
1682,Sam McQueen,1.6,4,4,4,0,0,2,4,50.0,2,2,1,1,3,7,3,0
1683,Scott McTominay,7.0,11,9,4,5,2,5,13,38.5,8,3,0,3,13,24,9,0
1684,Iuri Medeiros,7.1,6,4,3,2,1,4,8,50.0,4,3,1,2,2,8,3,0
1686,Alvaro Medran,10.5,20,14,5,10,5,8,21,38.1,13,7,0,7,13,33,10,0
1687,Alvaro Medran,0.8,1,1,1,0,0,1,2,50.0,1,0,0,0,3,4,1,0
1688,Ben Mee,29.0,33,20,22,11,0,16,29,55.2,13,51,42,9,33,66,217,1
1690,Riccardo Meggiorini,8.7,9,6,3,6,0,1,6,16.7,5,12,3,9,2,11,9,0
1691,Admir Mehmedi,3.2,4,2,3,1,0,2,2,100.0,0,1,1,0,1,5,3,0
1692,Admir Mehmedi,7.8,20,18,6,11,3,4,13,30.8,9,13,0,13,13,33,5,0
1694,Soualiho Meite,14.8,25,13,4,19,2,9,32,28.1,23,22,6,16,23,48,13,1
1695,Soualiho Meite,1.1,2,1,1,1,0,2,5,40.0,3,1,0,1,3,5,3,0
1696,Oscar Melendo,7.6,2,2,2,0,0,0,5,0.0,5,2,0,2,3,5,3,0
1697,Memphis,28.4,13,9,4,3,6,3,28,10.7,25,15,0,15,9,22,5,0
1698,Ledian Memushaj,14.0,28,18,11,13,4,7,30,23.3,23,24,5,19,10,38,10,1
1699,Pedro Mendes,31.7,62,50,37,19,6,23,41,56.1,18,36,25,11,44,106,152,0
1700,Thiago Mendes,25.5,25,16,10,11,4,5,23,21.7,18,21,3,18,25,50,29,0
1701,Brais Mendez,10.5,19,15,9,6,4,7,17,41.2,10,13,0,13,4,23,12,0
1702,Stiven Mendoza,11.5,18,10,7,7,4,2,11,18.2,9,11,1,10,15,33,8,0
1703,Alexandre Mendy,8.8,4,4,1,2,1,1,6,16.7,5,5,1,4,1,5,4,0
1704,Benjamin Mendy,4.0,5,4,2,0,3,5,7,71.4,2,5,0,5,8,13,9,0
1705,Ferland Mendy,23.6,45,28,29,13,3,20,31,64.5,11,18,5,13,25,70,43,0
1706,Nampalys Mendy,10.7,13,6,8,5,0,5,17,29.4,12,9,1,8,13,26,10,1
1707,Hamza Mendyl,9.5,18,10,12,6,0,11,20,55.0,9,5,0,5,17,35,26,0
1708,Gabriel Mercado,23.5,55,37,35,18,2,36,67,53.7,31,32,20,12,42,97,83,1
1709,Jorge Mere,21.0,34,23,25,9,0,23,35,65.7,12,25,13,12,34,68,110,1
1710,Alex Meret,12.9,0,0,0,0,0,0,1,0.0,1,0,0,0,0,0,5,0
1711,Mikel Merino,15.0,56,40,21,32,3,17,56,30.4,39,36,8,28,34,90,25,0
1712,Sabin Merino,4.2,7,3,2,3,2,3,8,37.5,5,6,2,4,1,8,10,0
1713,Dries Mertens,33.4,28,22,5,13,10,5,36,13.9,31,18,2,16,5,33,8,1
1714,Per Mertesacker,4.1,2,2,0,2,0,0,1,0.0,1,4,3,1,6,8,22,2
1716,Roque Mesa,8.4,20,13,8,8,4,10,37,27.0,27,6,0,6,13,33,8,1
1717,Roque Mesa,3.8,13,10,2,7,4,6,8,75.0,2,3,2,1,0,13,5,0
1718,Lionel Messi,33.3,17,8,0,11,6,2,18,11.1,16,11,1,10,7,24,0,0
1719,Thomas Meunier,17.5,38,21,22,12,4,18,34,52.9,16,7,2,5,18,56,54,2
1720,Mexer,13.3,15,12,9,6,0,9,12,75.0,3,13,7,6,16,31,98,2
1721,Max Meyer,19.2,48,38,23,21,4,19,47,40.4,28,25,3,22,54,102,11,0
1722,Senna Miangue,8.9,7,5,4,2,1,3,7,42.9,4,8,1,7,7,14,35,0
1723,Michel,23.7,33,24,21,8,4,14,25,56.0,11,21,11,10,39,72,64,1
1724,Mathieu Michel,6.6,0,0,0,0,0,0,1,0.0,1,0,0,0,0,0,0,1
1725,Clement Michelin,3.1,11,7,7,4,0,7,11,63.6,4,3,1,2,4,15,12,0
1726,Francesco Migliore,3.7,5,5,4,1,0,2,6,33.3,4,1,0,1,3,8,9,1
1727,Simon Mignolet,19.0,2,1,2,0,0,1,3,33.3,2,0,0,0,0,2,5,3
1728,Nikola Milenkovic,13.9,39,25,20,16,3,16,29,55.2,13,18,8,10,23,62,70,0
1729,Danijel Milicevic,7.9,8,4,0,4,4,1,9,11.1,8,5,0,5,3,11,2,0
1730,Arkadiusz Milik,5.0,2,1,0,1,1,0,1,0.0,1,5,0,5,1,3,4,0
1731,Sergej Milinkovic-Savic,31.6,55,39,11,34,10,13,52,25.0,39,29,6,23,33,88,36,1
1733,Luka Milivojevic,34.2,85,52,40,37,8,31,86,36.0,55,50,12,38,71,156,81,3
1734,James Milner,19.7,58,45,18,32,8,15,39,38.5,24,33,5,28,21,79,23,0
1735,Santi Mina,17.3,17,9,4,9,4,4,22,18.2,18,14,1,13,2,19,19,0
1736,Yerry Mina,4.1,10,8,6,4,0,4,6,66.7,2,6,3,3,6,16,16,0
1738,Ignasi Miquel,19.7,19,10,11,7,1,4,15,26.7,11,23,13,10,33,52,113,0
1739,Kevin Mirallas,1.5,4,3,1,2,1,0,1,0.0,1,0,0,0,0,4,3,0
1740,Miranda,30.3,48,37,38,10,0,22,25,88.0,3,30,23,7,38,86,131,2
1742,Antonio Mirante,33.0,0,0,0,0,0,0,3,0.0,3,1,0,1,0,0,11,5
1743,Simone Missiroli,32.4,62,37,25,31,6,14,72,19.4,58,46,8,38,67,129,70,0
1744,Kostas Mitroglou,9.7,3,2,1,2,0,1,4,25.0,3,1,1,0,0,3,2,0
1745,Aleksandar Mitrovic,1.1,1,1,0,1,0,0,1,0.0,1,1,0,1,0,1,2,0
1746,Maximilian Mittelstadt,4.7,19,11,14,4,1,10,19,52.6,9,8,1,7,9,28,11,0
1747,Henrikh Mkhitaryan,8.8,18,13,9,7,2,5,21,23.8,16,16,2,14,8,26,7,0
1748,Henrikh Mkhitaryan,10.2,15,11,4,7,4,5,25,20.0,20,8,0,8,7,22,3,0
1749,Luka Modric,21.9,33,22,14,15,4,15,41,36.6,26,13,4,9,31,64,7,0
1750,Niklas Moisander,25.0,36,28,22,13,1,24,36,66.7,12,21,9,12,38,74,98,2
1751,Johan Mojica,23.7,42,27,31,8,3,21,37,56.8,16,24,3,21,32,74,42,2
1752,Jorge Molina,31.0,18,10,3,6,9,4,27,14.8,23,25,4,21,7,25,27,0
1754,Cristian Molinaro,17.4,37,29,19,14,4,11,18,61.1,7,15,4,11,22,59,70,1
1755,Francisco Molinero,6.4,13,10,10,3,0,7,16,43.8,9,6,0,6,14,27,27,0
1756,Florent Mollet,15.7,25,18,10,12,3,3,25,12.0,22,8,1,7,11,36,8,0
1757,Momo,7.5,14,8,8,3,3,4,13,30.8,9,5,0,5,5,19,1,0
1758,Thomas Monconduit,32.8,81,49,33,43,5,34,87,39.1,53,52,17,35,55,136,81,2
1759,Kevin Monnet-Paquet,19.6,33,25,9,19,5,11,48,22.9,37,15,2,13,13,46,23,1
1760,Nacho Monreal,24.9,54,32,19,29,6,21,48,43.8,27,26,7,19,56,110,83,2
1761,Jefferson Montero,0.6,1,1,1,0,0,1,1,100.0,0,0,0,0,0,1,2,0
1762,Riccardo Montolivo,12.1,29,21,11,15,3,7,24,29.2,17,17,4,13,19,48,15,0
1763,Martin Montoya,23.9,66,48,36,22,8,30,55,54.5,25,35,10,25,53,119,89,0
1764,Walter Montoya,0.8,1,1,1,0,0,1,3,33.3,2,1,0,1,0,1,3,0
1765,Shaquell Moore,4.7,8,6,3,3,2,3,7,42.9,4,4,0,4,13,21,11,0
1766,Aaron Mooy,34.1,102,60,39,51,12,23,55,41.8,32,39,5,34,38,140,52,0
1768,Emre Mor,7.4,14,7,6,7,1,6,11,54.5,5,7,1,6,4,18,7,0
1769,Luca Mora,10.4,19,17,6,8,5,5,17,29.4,12,9,3,6,4,23,20,0
1770,Sergio Mora,9.0,21,15,8,12,1,14,31,45.2,17,10,2,8,15,36,11,0
1771,Erik Moran,2.5,2,2,1,0,1,0,3,0.0,3,1,1,0,4,6,0,0
1772,Alvaro Morata,22.9,13,8,0,7,6,1,21,4.8,20,17,4,13,6,19,20,0
1773,Jan Moravek,7.8,41,37,17,23,1,21,36,58.3,15,19,3,16,11,52,11,0
1774,Jeremy Morel,32.4,39,27,23,15,1,18,23,78.3,5,28,23,5,46,85,129,5
1775,Alberto Moreno,14.1,35,26,21,12,2,13,29,44.8,16,19,2,17,12,47,44,0
1776,Gerard Moreno,37.9,41,28,7,22,12,12,53,22.6,41,27,6,21,19,60,46,0
1777,Hector Moreno,2.6,2,2,1,1,0,0,1,0.0,1,1,1,0,3,5,5,0
1778,Hector Moreno,8.0,7,3,7,0,0,5,7,71.4,2,3,3,0,10,17,17,0
1779,Marlos Moreno,0.3,1,1,0,0,1,0,1,0.0,1,1,0,1,0,1,0,0
1780,Emiliano Moretti,19.8,31,18,25,6,0,14,16,87.5,2,30,23,7,21,52,77,2
1781,Wes Morgan,31.3,35,25,26,8,1,12,18,66.7,6,41,27,14,31,66,146,1
1782,Loren Moron,11.8,14,8,4,5,5,4,17,23.5,13,14,1,13,1,15,12,0
1783,James Morrison,2.3,2,1,0,2,0,1,4,25.0,3,1,1,0,1,3,1,0
1784,Victor Moses,23.4,37,29,21,13,3,14,24,58.3,10,29,4,25,15,52,39,2
1785,Pedro Mosquera,15.5,48,31,15,29,4,13,38,34.2,25,26,6,20,23,71,38,0
1786,Lebo Mothiba,13.2,8,5,4,0,4,0,7,0.0,7,6,2,4,2,10,11,0
1787,Thiago Motta,12.8,28,21,14,11,3,8,24,33.3,16,15,6,9,21,49,26,1
1788,Francois Moubandje,18.9,28,15,20,7,1,10,34,29.4,24,23,7,16,27,55,75,0
1790,Steve Mounie,20.6,11,8,2,4,5,0,19,0.0,19,23,3,20,7,18,30,0
1791,Lucas Moura,2.3,4,2,3,0,1,1,3,33.3,2,2,0,2,2,6,2,0
1792,Lucas Moura,0.8,1,1,0,1,0,0,1,0.0,1,0,0,0,0,1,0,0
1794,Lys Mousset,6.6,9,5,6,3,0,0,8,0.0,8,5,2,3,3,12,9,0
1795,Joao Moutinho,31.1,65,41,19,37,9,27,80,33.8,53,52,12,40,36,101,54,0
1796,Samuel Moutoussamy,4.8,15,7,6,7,2,5,8,62.5,3,7,1,6,3,18,4,0
1798,Ndombe Mubele,4.1,8,4,6,2,0,4,10,40.0,6,11,0,11,9,17,4,0
1799,Ndombe Mubele,13.6,14,8,5,6,3,5,13,38.5,8,9,0,9,3,17,3,0
1800,Nordi Mukiele,31.0,70,55,41,25,4,25,44,56.8,19,26,14,12,73,143,104,2
1801,Alex Mula,6.2,7,3,3,4,0,2,12,16.7,10,5,0,5,6,13,1,0
1804,Thomas Muller,22.3,35,30,10,15,10,13,27,48.1,14,17,1,16,7,42,14,1
1805,Iker Muniain,8.7,10,8,2,6,2,1,7,14.3,6,4,0,4,4,14,3,0
1806,Marc Muniesa,12.5,33,18,17,15,1,11,23,47.8,12,12,5,7,33,66,40,0
1807,Ezequiel Munoz,15.6,36,28,24,12,0,11,20,55.0,9,18,11,7,24,60,84,0
1808,Sulley Muntari,4.5,9,7,2,7,0,1,7,14.3,6,10,4,6,11,20,10,0
1809,Alessandro Murgia,8.6,19,12,9,9,1,5,19,26.3,14,14,3,11,17,36,13,0
1810,Luis Muriel,17.9,16,9,2,8,6,2,23,8.7,21,16,2,14,3,19,4,1
1811,Jeison Murillo,15.3,31,24,25,6,0,14,21,66.7,7,18,9,9,29,60,85,1
1812,Jacob Murphy,12.8,13,10,5,4,4,7,27,25.9,20,16,0,16,6,19,13,2
1813,Jamie Murphy,1.9,2,2,2,0,0,2,4,50.0,2,0,0,0,1,3,3,0
1814,Glenn Murray,24.4,18,12,4,11,3,2,18,11.1,16,16,4,12,5,23,27,0
1815,Nicola Murru,16.1,40,31,18,18,4,24,38,63.2,14,29,4,25,17,57,60,1
1816,Mateo Musacchio,13.4,22,15,13,7,2,8,16,50.0,8,9,3,6,12,34,58,1
1817,Charly Musonda Jr.,0.4,1,0,0,0,1,1,1,100.0,0,0,0,0,0,1,0,0
1818,Shkodran Mustafi,25.3,64,46,42,18,4,28,54,51.9,26,23,15,8,57,121,175,2
1820,Yoshinori Muto,21.2,21,15,6,8,7,5,14,35.7,9,16,0,16,6,27,12,0
1821,Fahad Al Muwallad,0.3,0,0,0,0,0,0,1,0.0,1,0,0,0,1,1,0,0
1824,Alfred N'Diaye,1.1,3,1,1,1,1,1,1,100.0,0,0,0,0,3,6,3,0
1825,Kevin N'Doram,8.0,16,10,6,9,1,6,24,25.0,18,6,2,4,16,32,29,0
1826,Abdallah N'dour,2.8,9,5,6,3,0,5,10,50.0,5,6,1,5,2,11,5,0
1827,Clinton N'Jie,9.7,10,6,2,5,3,2,9,22.2,7,5,0,5,3,13,0,0
1829,Georges-Kevin N'Koudou,2.5,7,6,5,1,1,3,8,37.5,5,4,0,4,1,8,1,0
1830,Stanley N'Soki,0.3,0,0,0,0,0,0,1,0.0,1,0,0,0,0,0,1,0
1831,Nacho,23.0,55,40,29,19,7,20,38,52.6,18,21,9,12,46,101,51,0
1832,Yuto Nagatomo,8.8,10,6,4,5,1,5,14,35.7,9,8,3,5,10,20,28,0
1833,Adam Nagy,7.9,16,9,6,8,2,7,13,53.8,6,11,0,11,7,23,5,0
1834,Matias Nahuel,2.8,4,4,1,1,2,2,5,40.0,3,2,0,2,2,6,1,0
1835,Radja Nainggolan,29.0,49,36,14,28,7,9,33,27.3,24,18,1,17,18,67,31,1
1836,Prejuce Nakoulma,12.8,10,8,3,6,1,2,7,28.6,5,2,0,2,5,15,0,0
1837,Naldo,10.2,14,8,12,1,1,5,10,50.0,5,13,10,3,16,30,57,1
1838,Naldo,34.0,51,36,38,12,1,31,46,67.4,15,39,21,18,55,106,200,1
1839,Andrea Nalini,18.2,43,32,22,16,5,16,25,64.0,9,25,2,23,15,58,19,1
1840,Nani,4.3,9,6,2,2,5,3,9,33.3,6,8,0,8,2,11,0,0
1841,Nano,3.1,7,6,2,4,1,1,1,100.0,0,4,0,4,0,7,0,0
1842,Naranjo,6.2,17,10,3,12,2,4,12,33.3,8,11,1,10,3,20,4,0
1843,Luciano Narsingh,6.9,7,5,1,5,1,2,7,28.6,5,7,0,7,3,10,3,0
1846,Juanjo Narvaez,3.4,8,6,4,4,0,3,6,50.0,3,3,0,3,8,16,4,0
1847,Matija Nastasic,22.1,48,38,37,10,1,28,37,75.7,9,40,22,18,36,84,85,0
1849,Kyle Naughton,33.7,92,60,49,35,8,54,100,54.0,46,60,13,47,60,152,144,4
1850,Fernando Navarro,11.6,32,22,24,7,1,16,25,64.0,9,13,3,10,29,61,49,0
1851,Marc Navarro,12.3,20,13,12,8,0,10,20,50.0,10,11,6,5,22,42,17,0
1852,Rafa Navarro,1.5,3,2,3,0,0,0,4,0.0,4,0,0,0,1,4,6,0
1853,Ximo Navarro,29.0,63,43,44,19,0,28,50,56.0,22,27,16,11,66,129,131,4
1854,Jesus Navas,19.6,32,25,17,9,6,12,26,46.2,14,14,5,9,19,51,37,0
1855,Keylor Navas,27.0,2,1,2,0,0,1,1,100.0,0,0,0,0,3,5,10,2
1856,Raul Navas,19.9,22,15,18,4,0,14,26,53.8,12,23,13,10,30,52,73,0
1857,Badou Ndiaye,12.6,53,28,22,25,6,16,41,39.0,25,21,9,12,13,66,18,0
1858,Wilfred Ndidi,32.2,138,89,68,65,5,45,119,37.8,74,67,10,57,51,189,103,2
1859,Merveille Ndockyt,0.8,1,1,0,1,0,0,1,0.0,1,2,0,2,2,3,0,0
1860,Tanguy Ndombele,2.6,6,5,2,4,0,1,4,25.0,3,4,0,4,5,11,3,0
1861,Tanguy Ndombele,26.1,62,39,23,31,8,11,40,27.5,29,53,8,45,36,98,9,0
1863,Neto,33.0,1,1,1,0,0,1,2,50.0,1,1,0,1,1,2,8,3
1865,Neymar,19.8,20,14,3,11,6,7,40,17.5,33,4,0,4,5,25,2,0
1866,Yeni Ngbakoto,6.4,11,10,4,6,1,3,10,30.0,7,10,0,10,9,20,6,0
1867,Santy Ngom,5.2,10,5,5,5,0,1,8,12.5,7,9,1,8,2,12,2,0
1868,Guy Ngosso,6.8,8,5,4,4,0,4,20,20.0,16,5,3,2,9,17,19,0
1869,Julien Ngoy,0.2,1,1,0,1,0,1,2,50.0,1,0,0,0,0,1,0,0
1870,Opa Nguette,11.4,27,22,11,12,4,5,21,23.8,16,10,0,10,18,45,13,0
1872,Moussa Niakhate,34.5,57,38,44,12,1,22,37,59.5,15,27,14,13,55,112,139,1
1873,Adama Niane,24.0,22,12,5,10,7,6,26,23.1,20,11,2,9,9,31,13,0
1874,Ibrahima Niane,9.4,6,5,4,1,1,2,8,25.0,6,6,0,6,4,10,8,0
1875,M'Baye Niang,17.0,29,23,11,9,9,6,18,33.3,12,17,3,14,13,42,15,0
1876,Oumar Niasse,12.1,10,6,2,5,3,4,19,21.1,15,3,2,1,2,12,6,0
1877,Florian Niederlechner,7.7,8,6,1,5,2,2,5,40.0,3,5,1,4,3,11,6,0
1878,Saul Niguez,35.1,132,90,53,69,10,40,104,38.5,64,61,12,49,55,187,77,0
1879,Casimir Ninga,14.3,12,7,1,6,5,2,10,20.0,8,12,2,10,4,16,13,0
1880,Benjamin Nivet,15.2,31,14,12,14,5,11,51,21.6,40,18,1,17,16,47,20,0
1882,Jordan Nkololo,4.7,9,6,4,5,0,1,4,25.0,3,7,1,6,1,10,0,0
1883,Nicolas Nkoulou,36.2,56,40,40,15,1,22,33,66.7,11,44,22,22,57,113,163,1
1884,Christopher Nkunku,7.0,5,2,2,2,1,3,14,21.4,11,8,2,6,5,10,2,1
1886,Mark Noble,26.7,61,36,32,22,7,16,76,21.1,60,28,10,18,47,108,32,1
1888,Nolito,17.8,49,36,21,21,7,14,33,42.4,19,17,2,15,10,59,17,0
1889,Havard Nordtveit,10.8,19,16,10,9,0,13,18,72.2,5,19,8,11,10,29,50,0
1890,Paul-Georges Ntep,5.7,14,8,8,5,1,8,17,47.1,9,4,1,3,3,17,4,0
1891,Paul-Georges Ntep,1.8,2,2,0,0,2,0,1,0.0,1,3,1,2,1,3,0,0
1893,Unai Nunez,32.7,73,52,54,19,0,38,56,67.9,18,52,27,25,67,140,155,2
1894,Bram Nuytinck,26.2,65,41,40,24,1,25,39,64.1,14,43,24,19,37,102,124,1
1895,Simeon Nwankwo,13.5,12,9,1,5,6,1,12,8.3,11,16,3,13,1,13,20,0
1896,Gerzino Nyamsi,3.0,4,2,4,0,0,0,3,0.0,3,2,2,0,3,7,18,2
1898,Allan Nyom,25.7,64,39,43,17,4,28,43,65.1,15,20,9,11,27,91,93,0
1899,Steven Nzonzi,24.6,39,26,14,19,6,20,30,66.7,10,27,8,19,28,67,36,2
1902,Joel Obi,13.9,45,25,20,20,5,8,26,30.8,18,17,3,14,24,69,15,0
1903,Johann Obiang,5.2,13,9,9,2,2,6,13,46.2,7,9,1,8,7,20,15,0
1904,Pedro Obiang,17.4,53,34,20,29,4,17,51,33.3,34,37,16,21,24,77,27,1
1906,Lucas Ocampos,22.6,83,57,30,44,9,30,93,32.3,63,42,3,39,30,113,26,0
1907,Philipp Ochs,0.8,5,4,1,3,1,1,2,50.0,1,0,0,0,1,6,0,0
1908,Bastian Oczipka,25.8,60,48,29,26,5,29,37,78.4,8,41,2,39,40,100,40,1
1909,Alvaro Odriozola,32.4,41,27,22,15,4,20,35,57.1,15,25,7,18,26,67,50,0
1910,Ebenezer Ofori,0.1,0,0,0,0,0,0,1,0.0,1,1,0,1,0,0,0,0
1911,Angelo Ogbonna,32.0,30,24,18,10,2,8,18,44.4,10,40,27,13,58,88,197,1
1912,Marios Oikonomou,1.9,5,3,4,1,0,0,2,0.0,2,0,0,0,4,9,12,0
1913,Stefano Okaka,5.0,6,4,0,6,0,3,6,50.0,3,3,0,3,0,6,0,0
1914,Shinji Okazaki,14.7,25,16,3,18,4,4,28,14.3,24,15,1,14,8,33,6,0
1915,Orji Okwonkwo,2.9,9,3,6,3,0,1,4,25.0,3,2,0,2,1,10,1,0
1917,Oier Olazabal,26.0,0,0,0,0,0,0,2,0.0,2,1,0,1,1,1,12,3
1918,Paulo Oliveira,24.6,41,22,28,13,0,16,22,72.7,6,23,9,14,62,103,140,0
1919,Mathias Olivera,1.1,3,1,1,0,2,3,5,60.0,2,3,0,3,1,4,2,0
1920,Maximiliano Olivera,4.6,12,9,5,4,3,3,8,37.5,5,4,1,3,11,23,11,0
1921,Pawel Olkowski,5.0,17,12,9,8,0,5,9,55.6,4,11,2,9,3,20,17,0
1922,Martin Olsson,35.0,34,26,18,10,6,12,29,41.4,17,21,4,17,31,65,81,0
1924,Michael Olunga,4.8,6,5,1,3,2,1,3,33.3,2,5,0,5,3,9,5,0
1925,Stephane Omeonga,8.9,25,15,16,8,1,7,18,38.9,11,20,1,19,5,30,6,0
1926,Prince Oniangue,11.7,16,11,5,9,2,8,31,25.8,23,20,4,16,11,27,8,0
1927,Karim Onisiwo,2.8,7,5,5,1,1,3,7,42.9,4,4,0,4,1,8,8,0
1928,Javier Ontiveros,4.3,10,7,8,2,0,2,4,50.0,2,4,2,2,4,14,4,0
1929,Daniel Opare,15.7,31,27,20,10,1,21,27,77.8,6,14,5,9,28,59,56,0
1930,Willi Orban,23.6,49,30,35,14,0,29,43,67.4,14,45,18,27,28,77,155,1
1931,Fabian Orellana,13.1,14,8,5,8,1,4,23,17.4,19,10,1,9,7,21,3,0
1933,Divock Origi,21.9,6,5,2,3,1,1,7,14.3,6,16,2,14,3,9,17,0
1934,Riccardo Orsolini,3.8,5,5,4,1,0,1,5,20.0,4,2,1,1,3,8,4,0
1935,Riccardo Orsolini,1.4,3,2,3,0,0,1,1,100.0,0,1,0,1,0,3,0,0
1936,Yuya Osako,21.1,13,10,4,9,0,4,18,22.2,14,13,2,11,8,21,22,0
1937,Victor Osimhen,3.2,4,4,3,1,0,2,5,40.0,3,2,1,1,2,6,7,0
1939,Matthias Ostrzolek,26.4,68,53,43,20,5,38,57,66.7,19,39,10,29,30,98,58,1
1940,Nicolas Otamendi,33.0,58,43,35,22,1,19,44,43.2,25,21,10,11,48,106,129,3
1941,Otavio,16.5,64,42,25,37,2,20,61,32.8,41,26,4,22,32,96,35,0
1942,Anas Ouahim,0.2,1,1,0,1,0,1,1,100.0,0,0,0,0,0,1,0,0
1943,Alexandre Oukidja,16.2,0,0,0,0,0,0,1,0.0,1,0,0,0,3,3,9,1
1944,Adam Ounas,1.1,4,3,0,2,2,1,4,25.0,3,2,0,2,0,4,2,0
1945,Reece Oxford,0.1,2,1,1,1,0,1,1,100.0,0,0,0,0,0,2,0,0
1946,Reece Oxford,5.1,8,6,3,4,1,3,4,75.0,1,4,0,4,9,17,26,1
1947,Alex Oxlade-Chamberlain,2.7,5,3,2,2,1,2,3,66.7,1,5,2,3,6,11,8,0
1948,Alex Oxlade-Chamberlain,16.6,32,21,13,14,5,6,21,28.6,15,24,0,24,20,52,14,0
1950,Mikel Oyarzabal,30.8,33,23,10,13,10,7,39,17.9,32,32,2,30,18,51,19,0
1951,Ambroise Oyongo,2.2,2,1,1,1,0,0,1,0.0,1,2,1,1,6,8,6,0
1952,Berkay Ozcan,11.1,19,10,7,9,3,7,11,63.6,4,14,2,12,3,22,8,0
1953,Ramazan Ozcan,1.0,0,0,0,0,0,0,1,0.0,1,0,0,0,0,0,0,0
1954,Salih Ozcan,18.6,56,42,24,29,3,28,54,51.9,26,27,5,22,29,85,22,1
1955,Mesut Ozil,24.0,20,13,6,10,4,5,22,22.7,17,11,1,10,12,32,9,0
1956,Levin Oztunali,19.3,26,19,8,15,3,10,20,50.0,10,25,0,25,11,37,9,0
1957,Pablo,14.3,16,15,13,3,0,10,16,62.5,6,13,7,6,16,32,96,1
1958,Daniel Pacheco,1.9,4,4,1,2,1,0,1,0.0,1,2,0,2,2,6,1,0
1960,Simone Padoin,34.5,22,18,8,10,4,12,28,42.9,16,38,14,24,24,46,74,0
1961,Vincent Pajot,14.3,24,16,9,13,2,3,17,17.6,14,21,9,12,24,48,34,0
1962,Rodrigo Palacio,22.9,25,18,6,12,7,10,28,35.7,18,16,2,14,12,37,14,0
1963,Raffaele Palladino,2.6,1,1,1,0,0,0,1,0.0,1,0,0,0,1,2,0,0
1964,Nicolas Pallois,27.0,39,28,25,9,5,18,36,50.0,18,34,19,15,35,74,182,3
1965,Kasey Palmer,1.9,6,3,2,3,1,2,8,25.0,6,5,0,5,0,6,2,0
1966,Emerson Palmieri,3.1,6,4,4,2,0,5,5,100.0,0,2,0,2,2,8,10,0
1968,Julian Palmieri,12.5,29,15,17,9,3,17,29,58.6,12,16,2,14,22,51,31,0
1970,Alberto Paloschi,24.3,10,7,0,9,1,0,10,0.0,10,2,1,1,4,14,11,0
1971,Goran Pandev,20.0,10,9,3,6,1,2,13,15.4,11,8,0,8,4,14,5,0
1972,Costel Pantilimon,6.0,0,0,0,0,0,0,1,0.0,1,0,0,0,0,0,0,1
1973,Kyriakos Papadopoulos,29.0,60,54,36,24,0,41,69,59.4,28,54,35,19,43,103,181,2
1974,Sokratis Papastathopoulos,26.4,65,47,50,13,2,39,47,83.0,8,36,11,25,30,95,112,0
1976,Ruben Pardo,2.5,1,0,0,1,0,1,2,50.0,1,5,0,5,5,6,1,0
1977,Nicolas Pareja,4.5,11,8,7,3,1,3,5,60.0,2,8,1,7,13,24,24,0
1978,Daniel Parejo,33.3,88,57,35,43,10,31,87,35.6,56,37,10,27,34,122,27,1
1979,Vittorio Parigini,9.5,18,11,11,6,1,6,17,35.3,11,8,1,7,5,23,1,0
1981,Marco Parolo,29.0,70,37,27,36,7,14,58,24.1,44,49,8,41,43,113,64,0
1982,Thomas Partey,26.4,94,64,48,39,7,33,69,47.8,36,32,7,25,53,147,34,1
1983,Felix Passlack,0.7,2,2,2,0,0,2,3,66.7,1,0,0,0,0,2,2,0
1985,Javier Pastore,15.0,33,21,9,16,8,5,23,21.7,18,13,0,13,10,43,14,1
1986,Patric,6.6,11,6,8,2,1,4,6,66.7,2,3,0,3,3,14,32,0
1987,Paulinho,21.6,39,28,17,15,7,11,38,28.9,27,25,3,22,15,54,16,1
1988,Gabriel Paulista,28.7,47,27,41,4,2,32,46,69.6,14,30,14,16,51,98,142,2
1989,Benjamin Pavard,34.0,55,40,40,13,2,36,47,76.6,11,59,34,25,70,125,192,1
1991,Daniel Pavlovic,8.4,10,5,9,0,1,5,10,50.0,5,4,3,1,5,15,22,0
1992,Daniel Pavlovic,1.0,3,1,1,1,1,1,1,100.0,0,0,0,0,0,3,5,0
1993,Mateo Pavlovic,21.8,13,7,10,3,0,7,20,35.0,13,14,11,3,21,34,120,0
1994,Leonardo Pavoletti,30.2,27,13,5,14,8,2,21,9.5,19,13,5,8,13,40,28,0
1995,Dimitri Payet,26.1,22,11,5,13,4,8,37,21.6,29,19,2,17,19,41,7,1
1996,Giampaolo Pazzini,11.0,0,0,0,0,0,0,4,0.0,4,2,0,2,1,1,13,0
1998,Alfonso Pedraza,27.1,57,40,24,21,12,19,56,33.9,37,39,5,34,32,89,26,0
1999,Pedro,16.9,20,11,6,8,6,5,18,27.8,13,13,1,12,13,33,7,1
2000,Joao Pedro,18.4,15,9,4,9,2,0,12,0.0,12,9,1,8,11,26,24,0
2002,Stef Peeters,12.3,22,11,6,14,2,6,31,19.4,25,17,3,14,7,29,11,0
2004,Peter Pekarik,15.3,42,33,17,21,4,21,29,72.4,8,23,3,20,18,60,44,0
2005,Bryan Pele,17.9,20,9,9,8,3,4,28,14.3,24,11,0,11,15,35,13,0
2006,Yohann Pele,8.2,0,0,0,0,0,0,1,0.0,1,0,0,0,1,1,2,0
2007,Pietro Pellegri,3.1,1,0,0,0,1,0,5,0.0,5,3,0,3,2,3,1,0
2008,Pietro Pellegri,0.3,0,0,0,0,0,0,2,0.0,2,1,0,1,0,0,0,0
2009,Lorenzo Pellegrini,20.0,36,20,16,11,9,10,35,28.6,25,21,2,19,41,77,21,1
2010,Theo Pellenard,15.9,32,20,13,15,4,10,28,35.7,18,15,6,9,32,64,31,0
2011,Sergio Pellissier,6.2,6,2,1,3,2,1,3,33.3,2,3,0,3,1,7,2,0
2012,Federico Peluso,28.8,46,34,29,13,4,14,26,53.8,12,39,13,26,40,86,132,1
2013,Ruben Pena,19.2,41,28,20,17,4,20,42,47.6,22,24,6,18,30,71,31,0
2014,Gabriel Penalba,6.3,6,5,4,2,0,5,11,45.5,6,7,4,3,8,14,15,0
2015,Adalberto Penaranda,8.9,10,6,2,6,2,2,3,66.7,1,8,1,7,0,10,1,0
2016,Nicolas Pepe,31.6,30,18,14,11,5,11,42,26.2,31,23,0,23,10,40,20,0
2017,Andreas Pereira,12.0,26,15,12,11,3,10,30,33.3,20,9,1,8,11,37,5,0
2018,Pedro Pereira,4.2,5,4,2,1,2,3,5,60.0,2,5,2,3,5,10,15,0
2019,Bruno Peres,12.8,26,17,16,7,3,10,23,43.5,13,9,2,7,22,48,28,1
2020,Roberto Pereyra,18.0,10,8,4,5,1,2,13,15.4,11,16,0,16,9,19,6,0
2021,Ayoze Perez,27.7,39,21,11,15,13,12,54,22.2,42,36,1,35,24,63,28,0
2022,Hernan Perez,4.2,11,8,6,4,1,2,19,10.5,17,5,0,5,3,14,6,0
2023,Hernan Perez,1.6,4,3,1,1,2,2,3,66.7,1,1,0,1,1,5,1,0
2024,Lucas Perez,31.1,17,12,5,8,4,1,32,3.1,31,19,1,18,9,26,1,0
2025,Ruben Perez,28.0,99,61,47,48,4,48,101,47.5,53,30,5,25,77,176,40,0
2026,Stipe Perica,10.5,8,5,2,5,1,2,13,15.4,11,7,1,6,3,11,9,0
2028,Mattia Perin,37.0,0,0,0,0,0,0,1,0.0,1,0,0,0,1,1,14,2
2029,Ivan Perisic,36.8,47,31,15,23,9,8,56,14.3,48,47,6,41,45,92,62,0
2030,Diego Perotti,17.9,25,17,6,14,5,8,20,40.0,12,19,0,19,11,36,13,0
2032,Loic Perrin,27.4,39,26,28,10,1,21,31,67.7,10,35,22,13,36,75,142,1
2033,Andrea Petagna,18.0,8,3,2,4,2,1,11,9.1,10,14,3,11,4,12,5,0
2034,Nils Petersen,24.9,27,18,7,18,2,10,27,37.0,17,28,2,26,17,44,33,0
2035,Bruno Petkovic,10.2,14,12,3,8,3,6,13,46.2,7,11,1,10,7,21,12,0
2036,Bruno Petkovic,3.7,7,6,0,5,2,1,1,100.0,0,3,0,3,4,11,5,0
2037,German Pezzella,33.1,63,47,42,19,2,19,41,46.3,22,33,16,17,63,126,185,1
2038,Giuseppe Pezzella,10.0,19,11,10,4,5,7,19,36.8,12,8,1,7,6,25,32,0
2039,Maximilian Philipp,13.4,24,19,9,12,3,6,19,31.6,13,12,0,12,6,30,7,0
2040,Chris Philipps,9.4,22,12,10,10,2,5,26,19.2,21,13,5,8,30,52,18,0
2041,Matt Phillips,23.3,27,16,17,5,5,10,29,34.5,19,21,1,20,24,51,43,0
2042,Lebogang Phiri,11.5,28,17,14,12,2,11,43,25.6,32,9,2,7,19,47,13,0
2043,Pablo Piatti,19.3,45,32,14,21,10,17,57,29.8,40,28,3,25,22,67,16,0
2044,Jordan Pickford,38.0,0,0,0,0,0,0,2,0.0,2,0,0,0,2,2,26,5
2045,Jeremy Pied,2.0,9,6,8,1,0,6,9,66.7,3,3,2,1,8,17,4,0
2047,Ronael Pierre-Gabriel,13.0,43,31,33,7,3,17,28,60.7,11,11,2,9,9,52,35,0
2048,Erik Pieters,30.2,71,47,43,26,2,24,51,47.1,27,70,25,45,61,132,127,5
2049,Tomas Pina Isla,26.5,71,49,27,38,6,20,40,50.0,20,28,10,18,43,114,37,0
2052,Gerard Pique,29.2,31,22,22,9,0,16,36,44.4,20,40,27,13,30,61,127,0
2054,Facundo Piriz,9.0,25,16,9,12,4,6,35,17.1,29,10,1,9,18,43,14,0
2055,Fabio Pisacane,21.4,52,39,36,13,3,15,41,36.6,26,29,16,13,38,90,105,1
2056,Lukasz Piszczek,23.8,51,37,23,23,5,30,52,57.7,22,39,11,28,42,93,64,1
2057,Claudio Pizarro,6.4,11,9,3,6,2,6,9,66.7,3,10,2,8,3,14,5,0
2058,Guido Pizarro,19.5,75,47,36,36,3,29,67,43.3,38,20,7,13,26,101,48,0
2059,Marko Pjaca,2.9,5,3,2,3,0,4,6,66.7,2,3,0,3,1,6,2,0
2060,Miralem Pjanic,27.6,36,30,13,18,5,13,51,25.5,38,25,5,20,64,100,27,2
2061,Carles Planas,2.1,5,2,4,1,0,3,6,50.0,3,1,0,1,5,10,6,0
2062,Jaroslav Plasil,11.6,24,14,7,17,0,7,31,22.6,24,18,6,12,21,45,15,0
2063,Marvin Plattenhardt,33.0,57,43,39,15,3,35,50,70.0,15,24,7,17,27,84,92,0
2064,Alassane Plea,33.8,15,9,5,7,3,5,32,15.6,27,14,3,11,8,23,21,0
2065,Morgan Poaty,1.9,0,0,0,0,0,0,1,0.0,1,5,3,2,1,1,2,0
2066,Geronimo Poblete,18.4,58,37,23,29,6,25,66,37.9,41,19,0,19,24,82,22,1
2067,Florentin Pogba,3.6,6,0,4,2,0,3,5,60.0,2,2,2,0,1,7,12,0
2068,Paul Pogba,23.9,33,23,13,15,5,5,33,15.2,28,16,0,16,21,54,26,0
2069,Joel Pohjanpalo,1.3,0,0,0,0,0,0,2,0.0,2,1,1,0,0,0,2,0
2070,Eugen Polanski,2.9,8,7,3,4,1,5,6,83.3,1,6,1,5,4,12,4,0
2071,Andrea Poli,28.3,66,53,33,27,6,18,64,28.1,46,55,3,52,43,109,27,0
2072,Matteo Politano,31.2,23,16,8,10,5,3,32,9.4,29,13,2,11,14,37,13,0
2073,Julian Pollersbeck,10.0,0,0,0,0,0,0,1,0.0,1,0,0,0,0,0,4,1
2074,Ezequiel Ponce,12.2,9,8,3,5,1,0,7,0.0,7,2,1,1,3,12,11,0
2075,Pere Pons,28.4,80,54,28,48,4,23,87,26.4,64,28,3,25,30,110,25,0
2077,Nick Pope,34.6,0,0,0,0,0,0,1,0.0,1,0,0,0,0,0,21,0
2078,Jeremie Porsan-Clemente,1.0,3,2,1,2,0,2,2,100.0,0,1,0,1,1,4,4,1
2080,Francisco Portillo,27.3,38,23,15,18,5,11,45,24.4,34,25,1,24,22,60,21,0
2081,Portu,33.3,30,24,9,11,10,8,33,24.2,25,14,0,14,12,42,1,0
2082,Stefan Posch,8.4,28,21,18,7,3,15,27,55.6,12,15,4,11,24,52,30,0
2083,Sergio Postigo,26.9,36,23,30,5,1,18,32,56.3,14,27,13,14,40,76,140,1
2084,Yussuf Poulsen,18.5,23,19,2,13,8,7,12,58.3,5,24,5,19,9,32,8,0
2085,Maxime Poundje,18.9,53,29,32,16,5,28,51,54.9,23,14,6,8,35,88,63,1
2086,Dario Poveda,0.0,1,0,0,1,0,1,1,100.0,0,0,0,0,0,1,0,0
2087,Dennis Praet,29.5,85,57,34,36,15,38,73,52.1,35,49,1,48,37,122,22,0
2088,Sanjin Prcic,17.4,37,18,9,24,4,8,39,20.5,31,19,5,14,30,67,25,0
2089,Nicolas de Preville,21.5,34,27,10,15,9,9,33,27.3,24,25,4,21,21,55,12,0
2090,Nicolas de Preville,3.2,3,3,0,1,2,1,5,20.0,4,3,0,3,0,3,2,0
2092,Xabi Prieto,21.4,18,14,5,9,4,2,10,20.0,8,8,2,6,7,25,20,0
2094,Alex Pritchard,11.1,18,8,2,6,10,10,21,47.6,11,6,1,5,5,23,11,0
2096,Sebastian Prodl,17.4,22,17,19,3,0,8,15,53.3,7,20,9,11,31,53,92,1
2097,Davy Propper,34.7,73,44,35,35,3,18,83,21.7,65,35,11,24,60,133,80,2
2098,Manuel Pucciarelli,15.3,23,14,3,11,9,8,21,38.1,13,15,0,15,7,30,4,0
2101,Marc Pugh,10.9,7,3,2,4,1,2,10,20.0,8,6,1,5,13,20,13,2
2102,Erick Pulgar,30.8,70,48,41,29,0,24,75,32.0,51,49,13,36,46,116,83,1
2103,Christian Pulisic,25.6,46,30,12,20,14,26,44,59.1,18,24,2,22,16,62,11,0
2104,Jason Puncheon,7.2,13,4,3,7,3,1,5,20.0,4,3,0,3,5,18,4,0
2106,George Puscas,7.8,0,0,0,0,0,0,3,0.0,3,0,0,0,1,1,13,0
2107,Loic Puyo,1.9,9,5,2,5,2,3,4,75.0,1,7,3,4,4,13,2,0
2108,Fabio Quagliarella,30.2,11,9,1,3,7,2,25,8.0,23,34,0,34,7,18,23,0
2109,Robin Quaison,15.7,17,14,1,10,6,7,11,63.6,4,16,2,14,7,24,9,0
2110,Collin Quaner,14.2,22,15,8,8,6,9,26,34.6,17,24,4,20,11,33,15,0
2111,Dani Raba,12.3,25,21,9,12,4,9,45,20.0,36,21,1,20,17,42,10,0
2112,Adrien Rabiot,26.2,59,36,27,23,9,15,36,41.7,21,29,10,19,33,92,22,1
2113,Nemanja Radoja,12.3,18,16,6,8,4,3,8,37.5,5,8,2,6,10,28,11,0
2114,Ivan Radovanovic,34.9,55,35,30,22,3,18,48,37.5,30,39,16,23,47,102,107,1
2115,Stefan Radu,28.8,53,38,36,16,1,25,41,61.0,16,30,14,16,55,108,105,1
2117,Rafael,20.1,54,28,30,18,6,22,43,51.2,21,20,3,17,42,96,53,0
2118,Raffael,23.0,40,32,12,23,5,17,36,47.2,19,18,0,18,8,48,2,0
2119,Rafinha,11.6,14,9,1,10,3,3,16,18.8,13,15,0,15,7,21,9,0
2120,Rafinha,20.6,39,33,24,11,4,28,47,59.6,19,17,6,11,32,71,30,0
2121,Andrea Raggi,17.9,20,10,15,4,1,10,27,37.0,17,12,6,6,31,51,66,0
2122,Antonino Ragusa,9.2,17,7,11,4,2,8,23,34.8,15,12,1,11,6,23,16,0
2124,Ivan Rakitic,31.5,52,31,16,30,6,15,45,33.3,30,42,7,35,44,96,16,0
2125,Andre Ramalho,0.4,3,1,2,1,0,2,2,100.0,0,1,0,1,1,4,1,0
2126,Jonas Ramalho,25.5,25,16,20,5,0,15,24,62.5,9,25,11,14,35,60,115,0
2127,Adil Rami,32.8,39,29,22,15,2,22,41,53.7,19,25,19,6,45,84,163,3
2128,Benito Ramirez,1.8,6,3,2,3,1,1,5,20.0,4,0,0,0,2,8,3,0
2129,Gaston Ramirez,24.6,33,20,4,15,14,9,56,16.1,47,30,3,27,18,51,24,0
2130,Sandro Ramirez,3.1,2,1,0,1,1,0,3,0.0,3,1,0,1,1,3,0,0
2132,Sandro Ramirez,8.0,8,8,1,5,2,1,7,14.3,6,2,0,2,4,12,2,0
2133,Tono Ramirez,3.5,0,0,0,0,0,0,1,0.0,1,0,0,0,0,0,1,3
2134,Ivan Ramis,14.5,20,14,8,12,0,8,19,42.1,11,12,5,7,25,45,51,2
2135,Omar Ramos,16.1,22,14,6,8,8,9,22,40.9,13,16,1,15,14,36,15,0
2136,Sergio Ramos,25.4,40,29,22,18,0,19,28,67.9,9,22,12,10,47,87,91,0
2137,Aaron Ramsey,20.5,35,27,18,17,0,8,44,18.2,36,14,3,11,24,59,6,1
2138,Angel Rangel,1.7,4,3,2,2,0,1,3,33.3,2,0,0,0,3,7,4,0
2139,Andrea Ranocchia,7.0,8,4,6,2,0,3,6,50.0,3,6,5,1,12,20,35,0
2140,Marcus Rashford,20.1,14,11,4,5,5,6,18,33.3,12,18,0,18,8,22,19,0
2141,Milot Rashica,4.3,2,2,1,1,0,1,8,12.5,7,3,0,3,3,5,4,0
2142,Konstantin Rausch,10.3,21,16,13,7,1,11,26,42.3,15,9,2,7,17,38,25,0
2143,Yoric Ravet,5.5,9,7,3,6,0,3,7,42.9,4,7,0,7,3,12,6,0
2144,Ante Rebic,19.5,37,29,7,21,9,7,24,29.2,17,27,2,25,6,43,13,0
2145,Pedro Rebocho,19.1,29,22,18,8,3,12,28,42.9,16,20,6,14,19,48,76,0
2146,Recio,20.4,54,42,26,23,5,17,62,27.4,45,15,3,12,30,84,17,0
2147,Nathan Redmond,21.6,32,17,16,14,2,12,31,38.7,19,20,0,20,15,47,17,2
2148,Alberto Redondo,1.0,4,3,4,0,0,2,4,50.0,2,2,1,1,0,4,1,0
2149,Fabian Reese,0.8,2,2,1,1,0,1,2,50.0,1,1,0,1,2,4,1,0
2150,Vasco Regini,12.0,13,7,11,0,2,6,11,54.5,5,14,7,7,11,24,68,0
2152,Winston Reid,16.1,11,9,7,4,0,4,15,26.7,11,27,14,13,22,33,104,0
2153,Pepe Reina,37.0,1,0,1,0,0,1,2,50.0,1,0,0,0,0,1,13,2
2154,Jeff Reine-Adelaide,4.9,13,8,7,5,1,6,17,35.3,11,7,2,5,1,14,9,0
2155,Karim Rekik,25.6,38,29,32,6,0,24,26,92.3,2,27,11,16,28,66,116,2
2156,Loic Remy,8.5,4,3,1,3,0,0,1,0.0,1,0,0,0,1,5,2,0
2158,Loic Remy,5.1,4,2,1,3,0,1,5,20.0,4,4,0,4,1,5,2,0
2159,Jan Repas,10.0,14,11,5,5,4,4,18,22.2,14,10,0,10,7,21,3,0
2160,Panagiotis Retsos,19.1,48,40,32,14,2,33,46,71.7,13,29,8,21,29,77,47,0
2161,Marco Reus,10.3,16,8,2,12,2,5,12,41.7,7,16,3,13,4,20,9,0
2162,Elvis Rexhbecaj,1.4,4,2,1,2,1,1,1,100.0,0,3,0,3,2,6,3,0
2163,Baptiste Reynet,38.0,6,4,5,1,0,5,7,71.4,2,2,0,2,2,8,35,1
2164,Franck Ribery,13.4,19,16,9,5,5,13,17,76.5,4,11,0,11,7,26,3,0
2165,Federico Ricca,12.3,43,24,32,9,2,23,33,69.7,10,10,2,8,24,67,46,0
2166,Federico Ricci,10.2,25,18,9,10,6,9,28,32.1,19,14,0,14,11,36,5,0
2167,Federico Ricci,2.4,2,2,2,0,0,1,3,33.3,2,2,0,2,1,3,1,0
2168,Declan Rice,15.9,36,24,25,10,1,15,25,60.0,10,19,13,6,27,63,77,1
2169,Richarlison,31.4,64,44,26,28,10,10,39,25.6,29,39,5,34,24,88,32,1
2170,Marco Richter,7.2,17,14,8,8,1,8,17,47.1,9,5,1,4,1,18,10,0
2171,Diego Rico,24.8,68,43,37,21,10,36,53,67.9,17,30,6,24,76,144,61,0
2172,Mikel Rico,13.0,24,13,7,16,1,12,34,35.3,22,15,5,10,23,47,12,1
2173,Sergio Rico,24.0,1,1,1,0,0,0,2,0.0,2,0,0,0,1,2,5,3
2174,Jairo Riedewald,4.9,11,8,6,4,1,0,2,0.0,2,7,1,6,12,23,13,0
2176,Luca Rigoni,17.5,32,22,11,20,1,7,35,20.0,28,24,2,22,19,51,13,0
2177,Nicola Rigoni,10.4,29,20,15,12,2,9,26,34.6,17,8,3,5,11,40,22,1
2179,Tomas Rincon,33.3,66,40,30,34,2,24,66,36.4,42,33,8,25,57,123,61,1
2180,Birk Risa,0.9,1,1,0,1,0,0,3,0.0,3,2,1,1,0,1,0,0
2181,Marcel Risse,13.0,21,14,17,4,0,11,19,57.9,8,21,3,18,6,27,10,2
2182,Matt Ritchie,31.2,46,32,22,18,6,14,53,26.4,39,37,5,32,35,81,63,1
2184,Cristian Rivera,2.7,13,10,4,8,1,5,7,71.4,2,2,2,0,3,16,2,0
2185,Emmanuel Riviere,22.3,10,3,1,6,3,1,12,8.3,11,8,0,8,2,12,5,0
2186,Jonathan Rivierez,22.9,81,59,50,26,5,41,80,51.3,39,21,7,14,39,120,73,0
2187,Luca Rizzo,5.4,18,10,7,10,1,5,17,29.4,12,10,0,10,3,21,5,1
2188,Arjen Robben,16.7,14,11,1,7,6,4,12,33.3,8,9,0,9,4,18,4,0
2189,Rober,21.2,35,22,27,8,0,17,32,53.1,15,29,18,11,41,76,75,1
2191,Sergi Roberto,24.7,63,40,30,25,8,25,49,51.0,24,18,8,10,39,102,30,1
2192,Connor Roberts,3.0,6,4,5,1,0,3,3,100.0,0,2,0,2,3,9,6,0
2193,Andrew Robertson,21.6,31,17,19,9,3,15,29,51.7,14,22,2,20,26,57,56,0
2195,Hal Robson-Kanu,9.2,5,4,1,2,2,0,13,0.0,13,9,3,6,4,9,9,0
2196,Marc Roca,2.9,8,7,3,5,0,3,4,75.0,1,4,2,2,4,12,10,0
2197,Ruben Rochina,1.7,8,5,5,2,1,4,6,66.7,2,0,0,0,2,10,0,0
2198,Ronny Rodelin,35.1,33,22,7,18,8,8,42,19.0,34,21,2,19,28,61,41,1
2199,Rodri,35.9,104,71,50,48,6,30,86,34.9,56,49,21,28,52,156,100,1
2200,Rodrigo,29.8,23,13,9,12,2,3,21,14.3,18,14,2,12,17,40,11,1
2201,Kevin Rodrigues,18.2,44,32,18,20,6,19,34,55.9,15,22,6,16,27,71,39,0
2202,Angel Rodriguez,25.5,28,19,3,19,6,3,26,11.5,23,18,3,15,6,34,14,0
2204,James Rodriguez,18.0,35,27,10,15,10,15,30,50.0,15,16,1,15,12,47,4,0
2205,Jay Rodriguez,31.2,31,21,12,11,8,9,50,18.0,41,32,2,30,19,50,41,0
2206,Ricardo Rodriguez,33.4,48,29,24,18,6,18,28,64.3,10,36,6,30,33,81,93,3
2207,Marko Rog,3.2,11,7,3,6,2,1,11,9.1,10,4,1,3,2,13,1,0
2208,Rogerio,10.1,18,14,10,5,3,7,15,46.7,8,11,1,10,9,27,31,0
2210,Marcus Rohden,18.1,33,19,21,10,2,14,50,28.0,36,14,1,13,18,51,30,0
2211,Marcos Rojo,7.1,7,5,6,0,1,1,8,12.5,7,11,6,5,7,14,56,2
2212,Diego Rolan,21.6,33,25,7,13,13,9,44,20.5,35,18,1,17,12,45,9,0
2213,Rolando,27.9,44,29,28,15,1,23,40,57.5,17,22,14,8,37,81,126,0
2214,Esteban Rolon,4.6,6,4,4,2,0,2,4,50.0,2,7,1,6,9,15,8,1
2215,Filippo Romagna,21.0,33,18,20,12,1,16,26,61.5,10,20,11,9,33,66,96,0
2216,Alessio Romagnoli,26.1,20,14,17,2,1,9,14,64.3,5,24,14,10,23,43,154,1
2217,Simone Romagnoli,6.2,12,9,10,2,0,4,9,44.4,5,12,8,4,7,19,41,2
2218,Aristoteles Romero,1.0,11,7,7,4,0,3,5,60.0,2,3,0,3,5,16,0,0
2219,Oscar Romero,2.8,5,2,4,1,0,0,3,0.0,3,3,0,3,3,8,2,0
2221,Oriol Romeu,32.2,93,64,41,44,8,32,100,32.0,68,59,19,40,69,162,77,2
2222,Romulo,35.2,58,44,23,29,6,13,54,24.1,41,29,2,27,43,101,41,0
2223,Cristiano Ronaldo,25.4,7,4,3,3,1,1,6,16.7,5,10,3,7,6,13,14,0
2224,Facundo Roncaglia,16.6,35,25,30,5,0,22,36,61.1,14,18,6,12,31,66,50,1
2225,Salomon Rondon,30.7,14,6,0,7,7,5,26,19.2,21,27,0,27,14,28,20,0
2226,Valentin Rongier,26.1,73,49,25,39,9,17,64,26.6,47,42,6,36,40,113,13,1
2227,Marten de Roon,28.6,77,50,27,44,6,29,82,35.4,53,40,5,35,46,123,36,0
2228,Wayne Rooney,25.2,28,19,11,13,4,10,42,23.8,32,25,6,19,16,44,43,2
2229,Roberto Rosales,34.7,104,69,52,40,12,50,84,59.5,34,37,13,24,58,162,104,1
2230,Danny Rose,8.9,15,11,6,7,2,8,15,53.3,7,12,6,6,9,24,15,0
2231,Liam Rosenior,1.8,4,3,2,1,1,2,5,40.0,3,2,1,1,4,8,7,0
2232,Aleandro Rosi,18.9,24,17,7,13,4,5,19,26.3,14,24,5,19,20,44,61,1
2233,Valentin Rosier,30.9,73,54,47,23,3,26,68,38.2,42,43,9,34,58,131,124,0
2234,Luca Rossettini,22.5,16,8,12,3,1,6,17,35.3,11,31,21,10,29,45,151,1
2237,Giuseppe Rossi,2.9,1,1,0,1,0,0,3,0.0,3,2,0,2,1,2,1,0
2238,Jerome Roussillon,20.9,40,27,17,19,4,15,26,57.7,11,26,3,23,15,55,52,0
2239,Wayne Routledge,4.8,10,5,2,6,2,2,8,25.0,6,5,0,5,2,12,5,0
2240,Nolan Roux,31.5,24,17,8,10,6,7,38,18.4,31,32,2,30,25,49,22,0
2241,Ruben,27.5,1,0,1,0,0,1,3,33.3,2,0,0,0,1,2,5,4
2242,Antonio Rudiger,26.0,31,21,20,10,1,15,31,48.4,16,29,15,14,24,55,115,1
2243,Sebastian Rudy,16.8,50,40,12,33,5,28,55,50.9,27,11,1,10,18,68,7,1
2245,Vincent Rufli,0.3,4,1,3,1,0,3,3,100.0,0,1,0,1,1,5,0,0
2246,Daniele Rugani,21.5,18,12,11,5,2,7,13,53.8,6,18,14,4,20,38,87,1
2247,Mario Rui,23.2,55,39,18,32,5,30,52,57.7,22,30,5,25,14,69,43,1
2249,Fabian Ruiz Pena,29.5,83,53,34,40,9,26,73,35.6,47,35,3,32,42,125,36,1
2250,Victor Ruiz,26.8,33,22,29,4,0,13,25,52.0,12,27,18,9,58,91,134,1
2251,Antonio Rukavina,14.1,25,22,12,9,4,17,25,68.0,8,11,3,8,16,41,68,0
2252,Geronimo Rulli,26.0,2,1,2,0,0,2,6,33.3,4,0,0,0,0,2,10,2
2253,Lukas Rupp,12.9,36,32,18,14,4,19,36,52.8,17,18,0,18,13,49,13,2
2254,Marco Russ,12.7,17,11,9,8,0,13,19,68.4,6,23,11,12,24,41,66,0
2255,Mathew Ryan,38.0,0,0,0,0,0,0,3,0.0,3,0,0,0,3,3,10,3
2256,Idriss Saadi,10.5,6,5,2,3,1,2,11,18.2,9,3,2,1,5,11,1,0
2257,Youssouf Sabaly,34.4,93,61,54,34,5,43,68,63.2,25,26,6,20,54,147,104,0
2258,Abdelhamid Sabiri,2.4,5,4,2,0,3,1,7,14.3,6,4,0,4,1,6,2,0
2259,Marcel Sabitzer,19.9,38,28,12,20,6,23,49,46.9,26,23,2,21,24,62,21,1
2260,Enric Saborit,15.9,50,27,31,17,2,19,29,65.5,10,17,5,12,24,74,55,0
2262,Ihsan Sacko,2.9,1,1,0,1,0,0,1,0.0,1,1,0,1,2,3,1,0
2263,Ihsan Sacko,7.9,10,8,6,0,4,2,10,20.0,8,2,0,2,5,15,6,0
2264,Mujaid Sadick,1.2,4,2,2,2,0,2,3,66.7,1,3,2,1,1,5,4,0
2265,Armando Sadiku,3.0,1,1,0,1,0,0,1,0.0,1,4,2,2,2,3,2,0
2266,Umar Sadiq,2.5,0,0,0,0,0,0,3,0.0,3,1,0,1,1,1,2,0
2267,Bacary Sagna,10.6,9,7,5,3,1,1,7,14.3,6,9,2,7,20,29,28,0
2268,Adrian Sahibeddine,0.4,0,0,0,0,0,0,1,0.0,1,1,0,1,0,0,0,0
2269,Nuri Sahin,13.6,40,34,9,28,3,15,39,38.5,24,12,0,12,20,60,29,1
2270,Wesley Said,20.4,33,22,17,11,5,7,26,26.9,19,15,1,14,15,48,4,0
2271,Allan Saint-Maximin,25.0,18,14,13,2,3,12,28,42.9,16,12,1,11,11,29,10,0
2273,Henri Saivet,0.9,5,3,4,1,0,2,5,40.0,3,0,0,0,4,9,8,1
2274,Gotoku Sakai,25.4,50,40,25,18,7,22,47,46.8,25,40,12,28,44,94,55,0
2275,Hiroki Sakai,28.0,66,45,30,30,6,32,49,65.3,17,32,7,25,45,111,90,1
2276,Diafra Sakho,3.4,5,2,1,4,0,0,3,0.0,3,3,0,3,1,6,2,0
2277,Diafra Sakho,8.6,5,4,1,2,2,0,7,0.0,7,4,0,4,2,7,11,0
2278,Mamadou Sakho,17.8,21,14,15,5,1,9,16,56.3,7,19,11,8,30,51,101,3
2279,Bakary Sako,5.3,7,6,5,0,2,2,9,22.2,7,2,0,2,1,8,2,0
2280,Emiliano Sala,33.7,19,11,3,9,7,5,33,15.2,28,27,3,24,9,28,50,0
2281,Jacopo Sala,11.0,17,10,12,4,1,4,10,40.0,6,9,1,8,8,25,28,2
2282,Mohamed Salah,32.3,12,6,2,5,5,3,23,13.0,20,10,0,10,5,17,5,0
2283,Bartosz Salamon,19.2,28,22,21,7,0,12,21,57.1,9,24,18,6,58,86,148,0
2284,Carlos Salcedo,17.9,26,22,16,9,1,19,29,65.5,10,28,12,16,21,47,94,1
2286,Yannis Salibur,16.9,11,9,4,6,1,4,15,26.7,11,7,1,6,7,18,2,0
2288,Sejad Salihovic,4.1,7,5,3,3,1,0,3,0.0,3,5,0,5,5,12,1,0
2289,Yoann Salmier,12.3,15,13,10,5,0,5,12,41.7,7,11,6,5,26,41,62,1
2290,Mamadou Samassa,21.0,0,0,0,0,0,0,2,0.0,2,0,0,0,0,0,12,3
2292,Junior Sambia,17.1,21,12,6,11,4,6,28,21.4,22,16,0,16,20,41,18,0
2293,Frederic Sammaritano,15.9,29,25,17,9,3,10,36,27.8,26,14,0,14,5,34,15,0
2294,Sergi Samper,1.6,10,4,4,6,0,2,3,66.7,1,0,0,0,0,10,0,0
2295,Jairo Samperio,6.2,9,6,2,6,1,3,13,23.1,10,5,1,4,1,10,5,0
2296,Jairo Samperio,0.4,1,1,0,1,0,1,1,100.0,0,0,0,0,0,1,0,0
2297,Mario Sampirisi,24.4,44,32,29,12,3,13,22,59.1,9,27,14,13,43,87,116,2
2298,Mikel San Jose,23.9,52,37,19,23,10,19,73,26.0,54,43,13,30,41,93,30,0
2299,Antonio Sanabria,9.5,8,8,0,4,4,0,3,0.0,3,5,0,5,4,12,6,0
2300,Renato Sanches,7.8,12,7,6,6,0,6,18,33.3,12,9,1,8,7,19,5,1
2301,Alexis Sanchez,16.7,20,9,9,4,7,7,32,21.9,25,5,2,3,6,26,1,0
2302,Alexis Sanchez,11.6,21,17,10,4,7,4,27,14.8,23,8,0,8,17,38,0,0
2303,Carlos Sanchez,4.1,7,6,2,5,0,4,6,66.7,2,3,1,2,8,15,10,0
2304,Carlos Sanchez,12.5,25,12,6,16,3,9,24,37.5,15,13,5,8,18,43,24,2
2305,Davinson Sanchez,28.2,38,24,28,9,1,18,40,45.0,22,26,10,16,38,76,162,0
2306,Sergio Sanchez,1.1,4,3,4,0,0,3,4,75.0,1,1,0,1,3,7,3,0
2307,Victor Sanchez,27.3,106,72,56,45,5,49,113,43.4,64,38,14,24,79,185,73,1
2308,Jadon Sancho,7.7,5,5,2,2,1,2,7,28.6,5,8,0,8,5,10,2,0
2309,Sandro,12.8,29,21,15,13,1,12,18,66.7,6,23,16,7,18,47,43,1
2310,Alex Sandro,23.5,57,31,33,17,7,20,39,51.3,19,21,1,20,30,87,45,0
2312,Lamine Sane,8.7,19,14,15,4,0,8,10,80.0,2,8,6,2,20,39,49,1
2314,Leroy Sane,26.9,27,21,14,7,6,8,22,36.4,14,22,1,21,13,40,6,0
2315,Salif Sane,32.0,57,43,46,10,1,40,64,62.5,24,49,29,20,57,114,238,6
2316,Ibrahim Sangare,17.6,72,47,35,34,3,29,69,42.0,40,33,7,26,24,96,19,1
2317,Younousse Sankhare,20.9,33,23,10,20,3,4,34,11.8,30,15,4,11,21,54,7,0
2318,Baissama Sankoh,17.1,27,19,8,18,1,8,28,28.6,20,20,8,12,25,52,64,1
2320,Yaya Sanogo,16.8,11,6,1,5,5,3,11,27.3,8,6,1,5,6,17,14,1
2321,Morgan Sanson,24.1,64,40,13,34,17,21,71,29.6,50,30,0,30,25,89,5,1
2322,Nicola Sansone,7.1,8,4,2,4,2,2,17,11.8,15,1,0,1,1,9,2,0
2323,Baptiste Santamaria,28.8,59,40,25,29,5,23,83,27.7,60,39,8,31,43,102,48,2
2324,Ivan Santini,30.9,19,12,5,8,6,4,29,13.8,25,13,5,8,4,23,33,0
2325,Davide Santon,9.3,19,14,13,6,0,9,17,52.9,8,10,3,7,20,39,32,2
2326,Christian Santos,4.8,2,0,1,0,1,0,4,0.0,4,2,1,1,2,4,9,0
2327,Douglas Santos,26.4,90,60,53,34,3,50,87,57.5,37,63,2,61,56,146,96,1
2328,Samir Santos,28.5,55,38,35,17,3,19,38,50.0,19,33,16,17,75,130,161,1
2330,Riccardo Saponara,10.0,12,8,2,8,2,2,11,18.2,9,3,1,2,1,13,5,0
2331,Pablo Sarabia,26.6,27,19,10,13,4,11,49,22.4,38,39,1,38,30,57,34,1
2333,Bouna Sarr,19.9,65,42,42,20,3,22,38,57.9,16,20,4,16,32,97,53,2
2334,Ismaila Sarr,20.6,20,10,5,10,5,7,29,24.1,22,17,0,17,9,29,3,1
2335,Malang Sarr,14.7,24,18,17,7,0,8,18,44.4,10,14,6,8,31,55,44,2
2336,Imanol Sarriegi,0.5,2,2,1,0,1,2,3,66.7,1,2,0,2,1,3,0,0
2337,Marco Sau,14.6,9,6,2,4,3,1,17,5.9,16,10,0,10,9,18,1,0
2338,Stefan Savic,25.5,30,20,23,7,0,16,39,41.0,23,38,23,15,45,75,150,1
2341,Fabian Schar,24.7,59,45,45,14,0,32,61,52.5,29,36,20,16,45,104,141,1
2342,Ezequiel Schelotto,14.6,20,13,14,6,0,12,27,44.4,15,7,3,4,19,39,58,2
2343,Pasquale Schiattarella,22.1,40,31,20,15,5,13,43,30.2,30,7,2,5,24,64,26,0
2344,Eros Schiavon,4.3,6,5,2,3,1,1,7,14.3,6,6,2,4,2,8,4,0
2345,Patrik Schick,11.0,9,7,1,5,3,1,9,11.1,8,14,0,14,2,11,11,0
2346,Julian Schieber,0.6,1,1,0,0,1,1,1,100.0,0,1,0,1,0,1,2,0
2347,Christopher Schindler,36.3,83,61,56,27,0,24,41,58.5,17,54,30,24,75,158,275,1
2348,Sven Schipplock,3.8,7,6,1,5,1,0,1,0.0,1,4,0,4,1,8,3,0
2349,Jeffrey Schlupp,19.4,57,36,35,20,2,23,43,53.5,20,34,8,26,24,81,67,0
2350,Kasper Schmeichel,32.9,1,0,1,0,0,1,3,33.3,2,1,0,1,0,1,18,5
2351,Marcel Schmelzer,16.6,35,27,21,12,2,20,30,66.7,10,27,6,21,30,65,57,1
2352,Jonathan Schmid,16.4,23,16,6,13,4,11,18,61.1,7,16,1,15,10,33,35,1
2353,Manuel Schmiedebach,1.8,5,5,5,0,0,4,9,44.4,5,2,0,2,5,10,6,0
2354,Benno Schmitz,0.9,3,2,2,1,0,2,3,66.7,1,0,0,0,0,3,1,0
2355,Morgan Schneiderlin,23.7,58,40,34,21,3,15,44,34.1,29,18,7,11,61,119,59,1
2356,Alessandro Schopf,9.0,22,17,10,9,3,11,23,47.8,12,16,0,16,15,37,13,1
2357,Nico Schulz,19.8,40,29,17,14,9,20,27,74.1,7,33,5,28,23,63,24,0
2358,Andre Schurrle,13.7,22,19,8,7,7,9,18,50.0,9,13,1,12,7,29,7,1
2359,Julian Schuster,14.5,14,10,6,7,1,6,11,54.5,5,17,10,7,19,33,56,0
2360,Pirmin Schwegler,25.8,81,57,25,55,1,42,70,60.0,28,33,9,24,49,130,46,1
2361,Alexander Schwolow,32.3,0,0,0,0,0,0,1,0.0,1,0,0,0,0,0,9,1
2364,Ernest Seka,24.2,60,47,41,14,5,40,61,65.6,21,25,8,17,51,111,98,1
2366,Vahid Selimovic,11.7,20,14,10,9,1,11,14,78.6,3,10,8,2,17,37,58,1
2367,Davie Selke,21.0,13,10,1,5,7,4,9,44.4,5,26,5,21,2,15,20,1
2368,Ole Selnaes,22.9,73,45,29,42,2,18,61,29.5,43,37,15,22,34,107,53,1
2369,Nelson Semedo,16.6,34,25,19,11,4,17,29,58.6,12,16,2,14,22,56,26,1
2370,Ruben Semedo,2.6,6,5,6,0,0,4,6,66.7,2,5,1,4,5,11,13,2
2371,Stefano Sensi,11.6,17,13,11,6,0,9,22,40.9,13,16,3,13,22,39,10,1
2373,Suat Serdar,18.9,59,47,21,26,12,27,64,42.2,37,38,3,35,21,80,17,1
2374,Jean Seri,29.1,25,14,9,12,4,9,56,16.1,47,16,4,12,26,51,15,4
2375,Julien Serrano,3.1,2,2,1,0,1,1,2,50.0,1,2,0,2,4,6,14,0
2376,Gregory Sertic,3.9,5,3,3,2,0,2,6,33.3,4,8,7,1,6,11,23,0
2377,Stephane Sessegnon,10.9,4,4,2,2,0,1,7,14.3,6,0,0,0,0,4,2,0
2378,Lee Seung-woo,4.0,3,2,0,1,2,0,6,0.0,6,1,0,1,2,5,0,0
2379,Stephan El Shaarawy,23.9,22,16,9,8,5,5,21,23.8,16,16,1,15,24,46,8,0
2380,Meritan Shabani,0.6,2,1,1,0,1,1,2,50.0,1,1,0,1,0,2,0,1
2381,Xherdan Shaqiri,33.8,25,17,9,11,5,10,39,25.6,29,9,1,8,16,41,6,2
2382,Luke Shaw,8.8,18,15,10,7,1,11,18,61.1,7,16,2,14,4,22,22,1
2383,Ryan Shawcross,26.3,36,20,25,9,2,13,25,52.0,12,33,23,10,40,76,224,1
2384,Jonjo Shelvey,25.2,39,24,17,21,1,8,26,30.8,18,26,5,21,28,67,33,0
2385,Gaku Shibasaki,11.1,21,10,8,10,3,6,21,28.6,15,6,1,5,19,40,9,0
2386,Djibril Sidibe,23.9,59,39,24,27,8,23,45,51.1,22,20,4,16,46,105,52,1
2387,Sidnei,19.8,41,28,30,11,0,18,25,72.0,7,26,9,17,31,72,101,1
2388,Jaime Sierra Mateos,0.3,1,1,1,0,0,0,1,0.0,1,0,0,0,1,2,0,0
2389,Vincent Sierro,2.4,8,6,2,6,0,4,9,44.4,5,2,1,1,4,12,0,0
2390,Gylfi Sigurdsson,25.1,38,26,15,14,9,16,57,28.1,41,37,7,30,34,72,36,0
2393,Adrien Silva,8.5,22,13,8,13,1,6,28,21.4,22,12,2,10,14,36,0,0
2394,Andre Silva,10.4,5,4,1,0,4,2,7,28.6,5,10,1,9,4,9,6,0
2395,Bernardo Silva,17.0,27,18,11,9,7,6,30,20.0,24,17,1,16,10,37,12,1
2396,David Silva,27.0,32,21,11,17,4,9,45,20.0,36,28,5,23,18,50,7,0
2397,Gabriel Silva,23.1,28,20,19,4,5,19,31,61.3,12,21,6,15,37,65,83,1
2398,Jonathan Silva,1.2,0,0,0,0,0,0,1,0.0,1,1,1,0,3,3,1,0
2399,Thiago Silva,23.5,31,23,19,12,0,12,21,57.1,9,28,18,10,18,49,114,0
2400,Matias Silvestre,34.0,12,8,10,1,1,6,12,50.0,6,33,26,7,11,23,154,3
2402,Giovanni Simeone,33.3,32,23,9,17,6,8,40,20.0,32,27,1,26,12,44,32,0
2403,Lorenco Simic,3.5,5,3,5,0,0,3,4,75.0,1,7,4,3,11,16,15,0
2404,Stefan Simic,6.2,13,8,11,2,0,10,11,90.9,1,6,3,3,10,23,44,0
2405,David Simon,8.0,24,17,11,10,3,9,16,56.3,7,13,4,9,22,46,11,1
2406,Danny Simpson,25.6,38,22,31,6,1,22,45,48.9,23,31,19,12,34,72,132,1
2407,Jack Simpson,0.8,1,1,1,0,0,0,1,0.0,1,1,0,1,0,1,4,0
2408,Josh Sims,1.8,4,3,1,2,1,2,7,28.6,5,5,0,5,1,5,0,0
2409,Jerome Sinclair,0.3,0,0,0,0,0,0,1,0.0,1,0,0,0,1,1,0,0
2410,Giovanni Sio,24.4,14,8,2,9,3,0,20,0.0,20,11,0,11,6,20,23,1
2411,Dimitris Siovas,22.9,48,33,43,5,0,29,46,63.0,17,27,12,15,62,110,89,0
2412,Tobias Sippel,4.8,1,1,1,0,0,1,2,50.0,1,0,0,0,0,1,5,1
2414,Moussa Sissoko,15.4,23,17,14,5,4,9,12,75.0,3,11,1,10,9,32,23,1
2415,Pione Sisto,28.0,18,12,8,6,4,9,33,27.3,24,12,1,11,12,30,7,1
2418,Ellyes Skhiri,33.9,89,54,34,47,8,37,88,42.0,51,59,10,49,77,166,57,4
2420,Milan Skriniar,38.0,86,55,69,16,1,44,70,62.9,26,38,26,12,35,121,180,0
2421,Islam Slimani,2.8,2,2,1,1,0,1,4,25.0,3,2,0,2,0,2,2,0
2422,Islam Slimani,1.5,0,0,0,0,0,0,2,0.0,2,0,0,0,1,1,1,0
2423,Naim Sliti,25.4,47,32,20,17,10,20,52,38.5,32,22,2,20,13,60,7,0
2424,Chris Smalling,28.2,40,25,28,12,0,16,28,57.1,12,32,28,4,63,103,162,1
2425,Adam Smith,23.0,50,36,33,16,1,24,53,45.3,29,46,8,38,31,81,73,0
2426,Tommy Smith,21.2,38,27,18,14,6,23,36,63.9,13,22,6,16,26,64,80,3
2427,Wesley Sneijder,4.4,0,0,0,0,0,0,3,0.0,3,1,0,1,2,2,2,1
2428,Cedric Soares,31.0,54,34,40,10,4,22,31,71.0,9,32,8,24,24,78,109,2
2429,Ramadan Sobhi,13.8,32,21,17,14,1,11,36,30.6,25,14,0,14,14,46,14,0
2430,Ruben Sobrino,16.3,33,24,12,16,5,6,27,22.2,21,19,2,17,18,51,10,0
2431,Dominic Solanke,6.6,7,4,0,6,1,1,4,25.0,3,5,1,4,2,9,9,0
2432,Carlos Soler,26.3,51,32,21,21,9,22,53,41.5,31,25,1,24,5,56,19,0
2433,Somalia,22.2,65,45,21,36,8,14,54,25.9,40,34,2,32,34,99,35,0
2436,Jeremy Sorbon,29.0,32,19,24,7,1,10,32,31.3,22,37,24,13,53,85,152,4
2437,Oliver Sorg,18.7,46,28,27,18,1,23,53,43.4,30,24,7,17,42,88,71,0
2438,David Soria,14.0,1,0,1,0,0,1,1,100.0,0,0,0,0,2,3,13,2
2439,Roberto Soriano,12.7,30,20,10,16,4,3,16,18.8,13,14,0,14,4,34,9,0
2444,Adama Soumaoro,13.2,9,5,7,2,0,2,3,66.7,1,22,16,6,16,25,50,1
2445,Boubakary Soumare,5.7,13,9,8,5,0,3,14,21.4,11,8,1,7,7,20,6,1
2446,Samuel Souprayen,17.6,29,19,25,3,1,12,19,63.2,7,18,9,9,22,51,67,1
2447,Arnaud Souquet,26.8,89,68,58,26,5,36,56,64.3,20,46,16,30,39,128,72,2
2448,Caglar Soyuncu,23.9,42,26,26,15,1,15,26,57.7,11,30,20,10,54,96,91,2
2449,Luca Sparandeo,0.4,0,0,0,0,0,0,1,0.0,1,1,0,1,0,0,0,0
2451,Leonardo Spinazzola,16.7,14,5,9,4,1,7,15,46.7,8,25,6,19,18,32,44,1
2452,Nicolas Spolli,20.0,27,21,24,2,1,13,22,59.1,9,26,17,9,36,63,120,2
2453,Marco Sportiello,35.6,0,0,0,0,0,0,1,0.0,1,0,0,0,1,1,13,4
2454,Bassem Srarfi,9.7,17,11,6,9,2,4,14,28.6,10,12,0,12,7,24,6,1
2455,Kostas Stafylidis,3.7,12,6,6,4,2,6,9,66.7,3,7,2,5,5,17,19,0
2457,Benjamin Stambouli,24.4,95,75,45,48,2,49,74,66.2,25,39,7,32,64,159,76,1
2458,Junior Stanislas,14.3,16,8,8,4,4,7,15,46.7,8,21,6,15,6,22,15,0
2459,Caleb Stanko,2.1,2,2,1,1,0,1,2,50.0,1,3,0,3,1,3,8,0
2460,Niklas Stark,24.6,49,31,32,17,0,22,30,73.3,8,39,14,25,34,83,165,0
2462,Timo Stavitski,4.5,4,3,1,1,2,1,16,6.3,15,7,0,7,3,7,1,0
2463,Renato Steffen,7.3,10,9,6,3,1,8,12,66.7,4,6,0,6,5,15,6,0
2464,Marc Stendera,4.1,23,20,6,15,2,8,20,40.0,12,10,1,9,8,31,2,0
2465,Pascal Stenzel,21.6,62,45,35,25,2,34,57,59.6,23,20,3,17,35,97,51,1
2466,Dale Stephens,36.0,104,62,63,39,2,32,114,28.1,82,53,16,37,63,167,69,1
2467,Jack Stephens,22.0,29,20,24,5,0,13,25,52.0,12,30,18,12,41,70,108,2
2468,Mariusz Stepinski,7.9,9,5,4,4,1,2,10,20.0,8,5,1,4,4,13,5,0
2471,Raheem Sterling,28.7,19,14,7,7,5,3,32,9.4,29,24,0,24,9,28,9,0
2473,Lars Stindl,30.3,52,39,11,29,12,14,38,36.8,24,53,4,49,31,83,32,1
2475,Adrian Stoian,23.7,23,19,12,10,1,11,44,25.0,33,29,0,29,25,48,26,0
2476,John Stones,14.5,15,11,11,4,0,4,11,36.4,7,8,5,3,19,34,44,0
2478,Ivan Strinic,13.9,35,24,22,12,1,17,38,44.7,21,21,2,19,22,57,46,2
2479,Tobias Strobl,1.3,3,1,0,2,1,0,1,0.0,1,2,0,2,6,9,2,0
2480,Kevin Strootman,25.1,57,38,19,24,14,15,46,32.6,31,27,3,24,27,84,21,0
2481,Jens Stryger Larsen,28.1,36,27,25,10,1,21,39,53.8,18,35,14,21,31,67,82,2
2482,Cristhian Stuani,30.1,22,14,2,17,3,3,29,10.3,26,10,0,10,5,27,32,0
2483,Stefano Sturaro,6.8,17,11,5,9,3,4,11,36.4,7,9,2,7,5,22,18,1
2485,Daniel Sturridge,4.8,0,0,0,0,0,0,1,0.0,1,1,0,1,0,0,1,0
2486,Damian Suarez,32.0,86,64,54,21,11,44,90,48.9,46,34,8,26,46,132,76,1
2487,Denis Suarez,6.6,11,9,3,8,0,3,8,37.5,5,7,0,7,2,13,3,0
2489,Luis Suarez,32.2,17,10,4,5,8,4,19,21.1,15,4,3,1,8,25,31,0
2490,Danijel Subasic,32.7,0,0,0,0,0,0,2,0.0,2,1,0,1,0,0,13,2
2491,Neven Subotic,16.0,23,14,16,7,0,10,27,37.0,17,13,9,4,18,41,96,1
2492,Neven Subotic,3.0,9,9,5,3,1,6,7,85.7,1,6,2,4,5,14,16,0
2493,Isaac Success,5.5,9,7,4,4,1,3,8,37.5,5,2,0,2,5,14,0,0
2494,Niklas Sule,21.4,34,25,25,7,2,24,31,77.4,7,24,16,8,33,67,58,0
2496,Ki Sung-yueng,20.8,25,18,10,13,2,4,16,25.0,12,16,1,15,32,57,23,0
2497,Gilles Sunu,7.3,4,4,1,3,0,0,4,0.0,4,7,0,7,3,7,3,0
2498,Andrew Surman,20.6,16,12,5,8,3,6,23,26.1,17,33,12,21,16,32,52,2
2499,Markel Susaeta,25.2,42,29,16,15,11,16,65,24.6,49,17,0,17,18,60,13,0
2500,Suso,31.4,18,14,3,5,10,4,31,12.9,27,25,0,25,16,34,2,1
2501,Markus Suttner,13.1,25,15,18,4,3,10,22,45.5,12,16,2,14,12,37,49,1
2503,Issiaga Sylla,17.8,44,32,22,16,6,19,47,40.4,28,31,4,27,34,78,65,1
2504,Moussa Sylla,3.4,0,0,0,0,0,0,2,0.0,2,2,0,2,0,0,1,0
2505,Adam Szalai,10.0,8,7,1,4,3,2,5,40.0,3,9,2,7,0,8,10,0
2507,Alexander Soderlund,4.0,1,1,1,0,0,0,2,0.0,2,1,0,1,2,3,2,0
2508,Frederik Sorensen,22.2,56,45,40,14,2,30,41,73.2,11,35,17,18,37,93,130,3
2509,Lasse Sorensen,0.8,2,2,2,0,0,1,5,20.0,4,2,0,2,0,2,3,0
2510,Alexander Sorloth,4.0,6,3,1,4,1,4,12,33.3,8,5,0,5,2,8,5,0
2511,Adel Taarabt,17.9,18,11,5,11,2,7,16,43.8,9,13,3,10,12,30,7,0
2512,Franck Tabanou,11.6,23,17,17,5,1,10,26,38.5,16,5,3,2,26,49,48,0
2513,Dusan Tadic,31.0,46,29,16,22,8,11,35,31.4,24,38,2,36,19,65,29,1
2514,Jonathan Tah,27.0,47,34,35,12,0,30,38,78.9,8,22,13,9,34,81,112,2
2515,Ervin Taha,0.4,1,1,0,1,0,0,1,0.0,1,0,0,0,0,1,0,0
2516,Mehdi Tahrat,4.9,7,6,4,3,0,2,5,40.0,3,3,1,2,9,16,15,1
2517,Saphir Taider,4.3,6,2,4,2,0,1,2,50.0,1,3,2,1,1,7,4,0
2518,Flavien Tait,24.8,50,36,26,18,6,18,78,23.1,60,43,4,39,20,70,17,1
2519,Adrien Tameze,18.7,58,36,32,21,5,26,47,55.3,21,26,5,21,41,99,22,1
2520,Tana,17.2,31,24,13,14,4,12,36,33.3,24,8,0,8,23,54,5,0
2522,Oussama Tannane,6.4,15,13,6,8,1,7,12,58.3,5,5,0,5,5,20,0,0
2523,Oussama Tannane,2.3,12,6,4,5,3,2,5,40.0,3,2,0,2,3,15,2,0
2524,Matt Targett,1.8,6,3,5,0,1,1,3,33.3,2,3,2,1,3,9,7,1
2525,James Tarkowski,31.0,46,26,36,10,0,17,38,44.7,21,55,43,12,50,96,223,2
2526,Ciprian Tatarusanu,37.0,1,0,1,0,0,1,2,50.0,1,0,0,0,1,2,12,3
2527,Julio Tavares,22.8,3,1,1,1,1,1,11,9.1,10,11,6,5,3,6,36,0
2528,Taleb Tawatha,4.9,12,7,7,5,0,5,9,55.6,4,7,1,6,6,18,18,0
2529,Charlie Taylor,10.6,16,4,9,6,1,7,12,58.3,5,13,5,8,15,31,52,0
2530,Jordan Tell,1.3,4,4,1,3,0,0,1,0.0,1,0,0,0,1,5,0,0
2531,Cristian Tello,18.8,32,24,12,14,6,7,37,18.9,30,19,0,19,16,48,4,1
2532,Marc-Andre ter Stegen,37.0,1,0,1,0,0,1,3,33.3,2,1,0,1,4,5,12,1
2533,Simon Terodde,10.6,9,6,1,7,1,2,5,40.0,3,8,2,6,5,14,8,0
2534,Simon Terodde,12.9,11,9,3,8,0,4,11,36.4,7,3,0,3,4,15,7,0
2535,Marco Terrazzino,16.5,31,24,12,13,6,21,39,53.8,18,16,0,16,9,40,19,0
2536,Martin Terrier,18.6,42,30,16,23,3,9,28,32.1,19,11,1,10,14,56,6,0
2537,Kenny Tete,17.9,37,25,24,10,3,15,26,57.7,11,20,7,13,29,66,52,0
2539,Florian Thauvin,32.8,44,28,16,20,8,15,46,32.6,31,22,1,21,17,61,20,0
2540,Kevin Theophile-Catherine,24.1,36,27,23,13,0,11,24,45.8,13,19,15,4,31,67,113,1
2541,Cyril Thereau,2.0,1,1,1,0,0,1,2,50.0,1,0,0,0,0,1,2,0
2542,Cyril Thereau,12.4,11,6,3,6,2,7,19,36.8,12,13,0,13,8,19,9,0
2544,Romain Thomas,27.4,31,21,16,15,0,14,29,48.3,15,32,19,13,34,65,151,1
2545,Adrien Thomasson,28.6,71,52,41,23,7,22,73,30.1,51,58,4,54,18,89,20,0
2546,Erik Thommy,1.9,6,5,1,3,2,3,8,37.5,5,2,0,2,5,11,0,0
2548,Erik Thommy,10.9,19,11,7,7,5,9,17,52.9,8,17,2,15,9,28,8,1
2549,Marcus Thuram,21.4,20,15,6,10,4,6,25,24.0,19,14,0,14,5,25,12,0
2550,Youri Tielemans,17.4,47,24,14,28,5,17,55,30.9,38,24,5,19,34,81,20,1
2551,David Timor,10.3,17,10,7,7,3,7,18,38.9,11,10,5,5,20,37,30,1
2552,Jonathan Tinhan,0.8,1,0,0,1,0,0,1,0.0,1,1,0,1,1,2,0,0
2553,Marcel Tisserand,13.9,15,10,10,4,1,7,14,50.0,7,18,13,5,31,46,50,0
2554,Tito,6.8,8,5,5,3,0,6,18,33.3,12,12,5,7,12,20,16,0
2555,Ola Toivonen,8.9,4,4,1,0,3,0,7,0.0,7,2,0,2,2,6,12,0
2556,Karl Toko Ekambi,33.8,17,8,2,5,10,5,29,17.2,24,13,0,13,15,32,2,0
2557,Hernan Toledo,6.9,5,5,2,2,1,1,11,9.1,10,2,0,2,5,10,5,0
2558,Corentin Tolisso,17.5,33,22,8,18,7,14,32,43.8,18,13,3,10,16,49,8,0
2559,Jeremy Toljan,2.0,3,1,1,2,0,2,3,66.7,1,3,0,3,0,3,3,0
2560,Jeremy Toljan,13.5,29,20,17,11,1,19,32,59.4,13,17,2,15,12,41,45,0
2561,Rafael Toloi,27.2,72,40,34,38,0,35,68,51.5,33,35,14,21,63,135,119,1
2562,James Tomkins,26.5,47,26,36,10,1,16,31,51.6,15,24,12,12,63,110,216,1
2563,Nenad Tomovic,1.5,2,1,1,1,0,0,2,0.0,2,0,0,0,3,5,5,1
2564,Nenad Tomovic,25.6,23,17,17,6,0,10,17,58.8,7,29,21,8,50,73,146,0
2565,Lorenzo Tonelli,3.9,7,1,4,3,0,5,9,55.6,4,2,1,1,7,14,10,0
2566,Aleksandar Tonev,4.5,5,3,1,2,2,0,1,0.0,1,4,1,3,1,6,6,0
2567,Tono,12.0,12,11,11,1,0,5,10,50.0,5,4,0,4,6,18,29,0
2568,Omer Toprak,22.4,36,25,29,6,1,26,29,89.7,3,27,16,11,21,57,104,1
2569,Vasilis Torosidis,9.1,8,7,5,2,1,4,9,44.4,5,8,3,5,15,23,42,0
2571,Lucas Torreira,35.3,101,73,36,57,8,30,77,39.0,47,52,17,35,72,173,36,1
2572,Daniel Torres,13.5,19,11,14,5,0,7,31,22.6,24,15,7,8,19,38,32,2
2574,Fernando Torres,10.9,11,8,3,7,1,2,6,33.3,4,4,1,3,2,13,9,0
2575,Ferran Torres,3.5,8,7,3,5,0,2,6,33.3,4,1,0,1,3,11,1,0
2576,Miguel Torres,7.5,16,13,13,3,0,6,14,42.9,8,9,7,2,13,29,35,0
2577,Pau Torres,0.6,0,0,0,0,0,0,1,0.0,1,1,1,0,0,0,4,0
2578,Jordan Torunarigha,7.4,18,12,16,2,0,7,13,53.8,6,20,13,7,23,41,43,1
2579,Alin Tosca,13.0,11,8,7,4,0,6,12,50.0,6,9,4,5,13,24,69,0
2580,Alin Tosca,4.7,12,9,7,5,0,5,9,55.6,4,7,1,6,5,17,17,1
2581,Cenk Tosun,11.0,6,3,2,2,2,1,11,9.1,10,9,4,5,1,7,13,0
2582,Jeremy Toulalan,21.0,43,25,35,7,1,17,39,43.6,22,25,16,9,28,71,121,0
2583,Abdoulaye Toure,31.2,74,52,28,38,8,23,67,34.3,44,40,10,30,62,136,49,1
2584,Almamy Toure,13.9,51,29,31,13,7,18,30,60.0,12,15,2,13,22,73,61,0
2586,Thomas Toure,1.4,2,1,0,1,1,0,7,0.0,7,5,0,5,1,3,0,0
2587,Yaya Toure,2.6,2,2,1,0,1,1,1,100.0,0,3,1,2,5,7,4,0
2588,Lucas Tousart,34.8,98,59,41,55,2,38,98,38.8,60,41,16,25,52,150,79,0
2589,Andros Townsend,34.7,60,34,35,12,13,24,75,32.0,51,49,1,48,35,95,28,0
2590,Adama Traore,2.1,6,4,0,4,2,1,4,25.0,3,3,0,3,3,9,1,0
2591,Bertrand Traore,25.4,32,20,7,20,5,10,35,28.6,25,24,3,21,39,71,31,1
2592,Charles Traore,33.3,60,32,46,9,5,26,56,46.4,30,52,16,36,57,117,171,0
2593,Hamari Traore,29.3,79,55,43,31,5,41,66,62.1,25,31,12,19,61,140,117,0
2594,Ibrahima Traore,2.2,4,2,2,2,0,4,7,57.1,3,2,0,2,0,4,1,0
2595,Ismael Traore,31.7,54,32,40,13,1,14,29,48.3,15,25,10,15,52,106,132,2
2596,Lacina Traore,8.7,9,9,2,3,4,3,7,42.9,4,6,3,3,2,11,21,0
2598,Manu Trigueros,30.0,61,41,23,34,4,21,71,29.6,50,38,13,25,22,83,44,0
2600,Kieran Trippier,21.3,52,30,29,21,2,21,44,47.7,23,31,6,25,20,72,53,1
2601,Marcello Trotta,25.1,39,21,12,18,9,10,55,18.2,45,22,2,20,14,53,20,0
2602,Philipp Tschauner,31.0,1,0,1,0,0,1,2,50.0,1,2,0,2,0,1,8,5
2604,Marco Tumminello,2.3,2,2,0,1,1,0,2,0.0,2,2,0,2,0,2,0,0
2606,Lubomir Tupta,0.4,0,0,0,0,0,0,3,0.0,3,0,0,0,0,0,0,0
2607,Josh Tymon,1.8,5,1,4,1,0,2,3,66.7,1,1,0,1,1,6,3,0
2609,Matthieu Udol,3.9,14,8,13,1,0,5,14,35.7,9,10,2,8,5,19,17,0
2610,Anthony Ujah,2.3,4,3,0,2,2,1,1,100.0,0,2,0,2,0,4,6,0
2612,Leonardo Ulloa,3.0,3,1,0,1,2,1,7,14.3,6,1,0,1,0,3,3,0
2613,Sven Ulreich,29.0,1,0,1,0,0,1,1,100.0,0,0,0,0,3,4,6,1
2614,Samuel Umtiti,24.3,50,35,35,15,0,20,29,69.0,9,25,17,8,37,87,72,3
2615,Enes Unal,12.5,9,5,0,4,5,0,12,0.0,12,16,3,13,4,13,11,0
2616,Enes Unal,6.6,6,6,2,2,2,1,10,10.0,9,7,1,6,2,8,5,0
2617,Cengiz Under,13.9,10,6,4,6,0,3,18,16.7,15,8,1,7,9,19,10,0
2618,Dayot Upamecano,25.2,57,43,36,17,4,31,45,68.9,14,32,9,23,55,112,141,1
2619,Mark Uth,24.2,32,23,4,21,7,5,22,22.7,17,30,3,27,9,41,19,0
2621,Valentin Vada,9.6,22,11,7,14,1,8,32,25.0,24,8,1,7,6,28,5,1
2622,Josha Vagnoman,0.2,1,1,0,1,0,1,1,100.0,0,0,0,0,0,1,0,0
2623,Sauli Vaisanen,6.0,12,9,9,3,0,6,8,75.0,2,5,4,1,13,25,26,0
2624,Mirko Valdifiori,6.9,13,9,5,7,1,2,11,18.2,9,3,1,2,6,19,9,0
2626,Antonio Valencia,30.4,57,32,21,28,8,16,36,44.4,20,47,6,41,48,105,80,0
2627,Gerard Valentin,1.8,5,4,4,0,1,1,2,50.0,1,1,0,1,3,8,3,0
2628,Borja Valero,28.5,46,31,17,25,4,20,58,34.5,38,15,4,11,18,64,41,1
2629,Borja Valle,5.4,6,6,3,3,0,1,4,25.0,3,2,0,2,3,9,4,0
2630,Jesus Vallejo,7.0,8,7,6,2,0,2,5,40.0,3,6,5,1,16,24,21,1
2631,Mattia Valoti,17.5,62,41,21,35,6,11,53,20.8,42,25,3,22,41,103,37,1
2632,Federico Valverde,13.7,25,16,12,10,3,8,15,53.3,7,12,1,11,21,46,17,0
2633,Virgil van Dijk,11.0,10,7,6,2,2,2,3,66.7,1,14,13,1,29,39,81,1
2634,Virgil van Dijk,14.0,15,8,7,7,1,4,5,80.0,1,8,2,6,18,33,80,1
2635,Raphael Varane,25.8,28,19,20,7,1,8,15,53.3,7,27,10,17,33,61,109,2
2636,Jamie Vardy,36.1,15,9,3,7,5,1,8,12.5,7,21,1,20,2,17,17,0
2637,Cedric Varrault,9.8,13,7,6,7,0,9,12,75.0,3,14,11,3,16,29,72,0
2638,Franco Vazquez,20.4,39,32,16,15,8,6,34,17.6,28,20,2,18,11,50,11,0
2639,Lucas Vazquez,18.7,48,33,16,21,11,12,42,28.6,30,28,2,26,7,55,9,0
2640,Matias Vecino,23.7,54,34,15,30,9,19,49,38.8,30,28,6,22,20,74,31,0
2642,Carlos Vela,4.2,12,7,5,3,4,6,7,85.7,1,2,0,2,0,12,1,0
2643,Milos Veljkovic,29.5,45,32,30,13,2,30,52,57.7,22,34,12,22,34,79,134,1
2644,Miguel Veloso,19.3,40,29,18,19,3,11,41,26.8,30,26,3,23,13,53,35,0
2645,Lorenzo Venuti,26.6,44,34,26,12,6,16,37,43.2,21,40,16,24,40,84,105,3
2646,Remy Vercoutre,34.5,2,2,2,0,0,2,2,100.0,0,0,0,0,2,4,14,2
2647,Daniele Verde,21.7,10,9,8,1,1,6,20,30.0,14,8,0,8,30,40,19,0
2648,Simone Verdi,31.4,33,24,17,13,3,11,43,25.6,32,20,1,19,36,69,12,0
2650,Jordan Veretout,35.7,65,45,34,23,8,20,69,29.0,49,39,4,35,37,102,59,0
2652,Paul Verhaegh,29.0,45,38,21,22,2,24,33,72.7,9,38,10,28,33,78,60,0
2653,Thomas Vermaelen,11.3,13,9,7,5,1,5,11,45.5,6,10,3,7,18,31,28,0
2654,Marco Verratti,19.1,51,33,20,25,6,12,55,21.8,43,25,6,19,26,77,11,3
2655,Valerio Verre,4.0,7,3,3,2,2,2,7,28.6,5,12,0,12,8,15,7,0
2656,Jan Vertonghen,35.6,64,41,40,20,4,25,36,69.4,11,29,11,18,60,124,177,0
2657,Mikel Vesga,9.0,17,8,6,11,0,4,25,16.0,21,14,3,11,8,25,15,0
2658,Jannik Vestergaard,32.0,58,41,43,15,0,32,48,66.7,16,55,39,16,40,98,161,3
2659,Ruben Vezo,17.3,43,24,30,12,1,16,32,50.0,16,25,9,16,23,66,83,0
2660,Francesco Vicari,31.7,38,22,25,13,0,21,39,53.8,18,33,27,6,45,83,210,1
2661,Aleix Vidal,5.1,6,4,2,3,1,1,10,10.0,9,4,0,4,9,15,1,0
2662,Arturo Vidal,16.2,69,51,36,28,5,33,69,47.8,36,22,1,21,28,97,20,1
2663,Nacho Vidal,5.0,17,14,15,1,1,14,22,63.6,8,5,2,3,10,27,18,0
2664,Luca Vido,0.8,5,5,2,3,0,1,1,100.0,0,1,0,1,0,5,0,0
2665,Jonathan Viera,22.1,36,25,10,22,4,3,28,10.7,25,21,0,21,11,47,2,0
2666,Luciano Vietto,3.0,5,4,1,2,2,0,3,0.0,3,3,0,3,3,8,3,0
2667,Luciano Vietto,5.9,8,6,2,3,3,1,4,25.0,3,3,0,3,2,10,5,0
2668,Carlos Vigaray,9.9,27,16,16,9,2,11,16,68.8,5,5,1,4,14,41,13,0
2669,Didac Vila,8.1,29,26,15,9,5,13,18,72.2,5,14,3,11,14,43,27,0
2671,Nicolas Viola,20.6,37,27,20,14,3,15,39,38.5,24,29,8,21,24,61,23,2
2673,Vitolo,7.7,15,12,9,5,1,4,17,23.5,13,10,3,7,6,21,9,0
2674,Vitolo,6.9,9,6,4,3,2,3,15,20.0,12,10,1,9,6,15,5,0
2675,Federico Viviani,27.6,52,36,23,26,3,18,55,32.7,37,39,9,30,58,110,26,2
2678,Oswaldo Vizcarrondo,19.1,21,15,17,3,1,14,37,37.8,23,18,16,2,20,41,129,2
2679,Nikola Vlasic,6.4,9,5,3,6,0,2,9,22.2,7,14,2,12,9,18,10,0
2680,Kevin Vogt,31.0,38,28,30,7,1,23,34,67.6,11,37,23,14,25,63,114,2
2681,Sam Vokes,11.1,3,1,1,2,0,0,3,0.0,3,6,2,4,3,6,15,0
2682,Kevin Volland,28.8,23,20,7,8,8,11,26,42.3,15,16,1,15,3,26,35,0
2683,Giovanni Volpicelli,0.0,0,0,0,0,0,0,1,0.0,1,0,0,0,0,0,0,0
2685,Stefan de Vrij,33.7,31,22,14,17,0,14,23,60.9,9,43,24,19,71,102,156,1
2686,Sime Vrsaljko,18.8,48,30,25,17,6,26,40,65.0,14,24,8,16,36,84,63,0
2687,Jagos Vukovic,14.8,5,4,3,1,1,3,6,50.0,3,19,14,5,20,25,113,0
2688,Sandro Wagner,9.7,8,5,3,5,0,5,6,83.3,1,11,3,8,3,11,13,0
2689,Sandro Wagner,8.1,9,6,3,5,1,1,1,100.0,0,4,0,4,2,11,1,0
2690,Molla Wague,4.9,5,3,3,2,0,2,5,40.0,3,1,0,1,9,14,30,0
2692,Wakaso,12.2,43,30,25,15,3,13,39,33.3,26,22,1,21,35,78,21,0
2693,Walace,14.6,38,25,13,23,2,19,44,43.2,25,25,3,22,21,59,14,1
2695,Theo Walcott,12.8,27,19,12,13,2,7,15,46.7,8,9,0,9,8,35,12,0
2696,Luca Waldschmidt,8.8,10,6,1,8,1,3,10,30.0,7,11,0,11,3,13,2,0
2697,Kyle Walker,30.9,47,31,20,21,6,18,31,58.1,13,21,2,19,29,76,75,2
2698,Kyle Walker-Peters,2.1,5,4,4,1,0,2,4,50.0,2,2,0,2,3,8,8,0
2699,Wallace,11.1,17,7,11,6,0,4,13,30.8,9,13,5,8,29,46,43,3
2701,Remi Walter,5.5,11,7,4,6,1,3,7,42.9,4,2,1,1,5,16,3,0
2702,Remi Walter,11.1,23,10,9,13,1,2,23,8.7,21,7,3,4,11,34,14,0
2705,Aaron Wan-Bissaka,7.0,30,19,20,7,3,15,19,78.9,4,18,7,11,15,45,45,0
2706,Victor Wanyama,9.4,30,20,13,16,1,14,31,45.2,17,13,3,10,10,40,20,1
2707,Joel Ward,17.9,35,30,23,12,0,16,28,57.1,12,27,11,16,28,63,76,0
2708,Stephen Ward,27.3,39,31,27,8,4,20,42,47.6,22,27,12,15,42,81,126,0
2709,James Ward-Prowse,19.1,23,16,9,11,3,3,27,11.1,24,29,1,28,8,31,31,0
2710,Daniel Wass,32.6,30,21,8,18,4,8,25,32.0,17,23,3,20,30,60,47,0
2711,Ben Watson,5.1,19,9,9,9,1,10,31,32.3,21,6,1,5,7,26,10,0
2712,Timothy Weah,1.4,1,1,1,0,0,1,1,100.0,0,0,0,0,0,1,0,0
2714,Julian Weigl,21.6,69,49,20,42,7,42,66,63.6,24,26,6,20,34,103,29,2
2715,Mitchell Weiser,22.0,54,43,20,27,7,17,38,44.7,21,28,1,27,44,98,37,1
2716,Danny Welbeck,13.3,20,13,9,5,6,4,12,33.3,8,22,1,21,11,31,13,0
2717,Nahki Wells,0.6,4,3,0,3,1,1,1,100.0,0,2,0,2,0,4,0,0
2718,Wendell,23.5,54,41,29,20,5,32,58,55.2,26,44,8,36,28,82,58,0
2719,Oscar Wendt,27.3,54,40,31,19,4,30,45,66.7,15,46,12,34,27,81,71,0
2721,Timo Werner,27.7,16,11,2,8,6,3,19,15.8,16,26,0,26,7,23,11,0
2722,Ashley Westwood,12.3,13,10,10,3,0,2,16,12.5,14,17,9,8,19,32,16,0
2723,Dean Whitehead,0.8,0,0,0,0,0,0,1,0.0,1,1,0,1,2,2,0,0
2724,Silvan Widmer,18.1,45,32,30,15,0,22,40,55.0,18,22,5,17,28,73,59,0
2725,Georginio Wijnaldum,26.5,34,23,13,16,5,11,23,47.8,12,20,2,18,25,59,20,0
2726,Jetro Willems,18.5,55,42,28,23,4,27,42,64.3,15,31,1,30,20,75,53,0
2727,William,17.9,76,61,43,26,7,46,86,53.5,40,41,6,35,46,122,65,1
2728,Ashley Williams,20.4,23,13,17,6,0,9,18,50.0,9,31,23,8,36,59,173,3
2730,Danny Williams,12.5,23,14,13,9,1,7,22,31.8,15,12,2,10,26,49,27,0
2731,Inaki Williams,31.7,28,17,11,15,2,8,41,19.5,33,24,2,22,17,45,13,0
2732,Willian,21.0,22,17,7,12,3,0,16,0.0,16,13,1,12,10,32,10,0
2733,Joe Willock,0.9,4,2,4,0,0,1,1,100.0,0,3,0,3,1,5,2,0
2734,Jack Wilshere,13.3,15,10,3,7,5,4,20,20.0,16,10,2,8,8,23,5,0
2735,Callum Wilson,22.0,9,5,2,6,1,1,14,7.1,13,15,3,12,3,12,15,0
2736,Kevin Wimmer,14.7,24,17,17,7,0,9,20,45.0,11,25,12,13,30,54,88,0
2737,Harry Winks,8.6,15,12,8,5,2,8,16,50.0,8,12,2,10,11,26,10,1
2738,Marius Wolf,26.3,37,28,15,18,4,18,46,39.1,28,45,1,44,27,64,46,0
2739,Bobby Wood,17.9,13,8,2,4,7,3,9,33.3,6,4,0,4,2,15,13,0
2740,Chris Wood,18.0,7,3,2,3,2,3,13,23.1,10,12,4,8,0,7,16,0
2742,Xeka,15.5,25,14,10,11,4,10,38,26.3,28,13,2,11,16,41,21,0
2744,Granit Xhaka,36.2,78,57,35,40,3,26,69,37.7,43,30,9,21,37,115,68,4
2745,Claudio Yacob,10.0,36,27,23,13,0,13,27,48.1,14,14,6,8,16,52,25,2
2746,Steeve Yago,17.5,49,36,28,17,4,20,37,54.1,17,16,7,9,34,83,64,1
2747,Cedric Yambere,31.4,58,42,46,12,0,16,34,47.1,18,24,16,8,54,112,138,5
2748,Jawad El Yamiq,4.0,8,5,7,1,0,6,8,75.0,2,11,5,6,5,13,22,1
2749,Mapou Yanga-Mbiwa,1.4,3,2,3,0,0,1,1,100.0,0,0,0,0,1,4,2,0
2750,Andriy Yarmolenko,11.5,17,12,6,6,5,7,16,43.8,9,4,0,4,7,24,4,0
2751,DeAndre Yedlin,31.6,57,33,39,14,4,26,54,48.1,28,37,7,30,44,101,114,0
2753,Maya Yoshida,22.8,27,20,22,5,0,18,25,72.0,7,32,14,18,41,68,133,2
2754,Ashley Young,27.1,53,32,30,17,6,18,47,38.3,29,24,5,19,57,110,86,1
2756,Zaydou Youssouf,1.5,3,1,2,1,0,1,2,50.0,1,1,0,1,1,4,1,0
2757,Pablo Zabaleta,36.5,96,67,54,28,14,48,98,49.0,50,72,13,59,61,157,152,0
2758,Mattia Zaccagni,1.7,7,5,4,0,3,2,3,66.7,1,0,0,0,5,12,0,0
2759,Dan-Axel Zagadou,7.3,9,8,5,3,1,6,7,85.7,1,9,0,9,11,20,20,1
2760,Wilfried Zaha,28.3,30,23,9,13,8,4,23,17.4,19,24,0,24,7,37,4,0
2761,Denis Zakaria,25.5,74,48,38,32,4,40,61,65.6,21,52,9,43,45,119,40,1
2762,Joseba Zaldua,28.4,68,52,31,31,6,39,62,62.9,23,28,5,23,61,129,85,0
2763,Andre-Frank Zambo Anguissa,27.1,88,65,23,57,8,32,94,34.0,62,50,7,43,67,155,46,3
2764,Francesco Zampano,4.6,9,7,5,3,1,5,10,50.0,5,4,0,4,6,15,7,0
2765,Niccolo Zanellato,0.8,3,2,0,3,0,1,2,50.0,1,3,0,3,0,3,0,0
2766,Cristian Zapata,11.0,25,20,21,4,0,15,16,93.8,1,12,6,6,15,40,50,1
2767,Duvan Zapata,23.4,12,7,1,7,4,1,6,16.7,5,13,0,13,5,17,22,1
2768,Davide Zappacosta,12.2,26,11,14,9,3,11,25,44.0,14,11,2,9,6,32,26,0
2770,Simone Zaza,23.1,21,14,4,10,7,1,20,5.0,19,26,1,25,8,29,34,0
2771,Marvin Zeegelaar,11.0,23,18,15,3,5,11,24,45.8,13,5,1,4,20,43,30,0
2772,Mehdi Zeffane,11.0,17,12,10,5,2,9,25,36.0,16,10,2,8,12,29,44,0
2774,Erwin Zelazny,17.0,1,1,1,0,0,1,2,50.0,1,0,0,0,2,3,10,1
2775,Robin Zentner,15.0,0,0,0,0,0,0,1,0.0,1,0,0,0,1,1,10,2
2776,Nabil El Zhar,22.0,11,6,4,6,1,3,18,16.7,15,14,1,13,18,29,3,0
2778,Luca Zidane,1.0,0,0,0,0,0,0,1,0.0,1,0,0,0,0,0,0,0
2779,Ron-Robert Zieler,34.0,1,1,1,0,0,1,1,100.0,0,2,0,2,1,2,14,5
2780,Piotr Zielinski,18.5,31,19,7,21,3,9,24,37.5,15,32,3,29,13,44,19,1
2782,Matthias Zimmermann,0.9,3,1,2,1,0,3,4,75.0,1,0,0,0,1,4,5,1
2783,Oleksandr Zinchenko,5.9,23,16,11,9,3,7,13,53.8,6,3,0,3,6,29,7,0
2785,Simon Zoller,10.7,11,7,3,6,2,7,10,70.0,3,5,2,3,8,19,9,0
2786,Kurt Zouma,32.1,50,38,35,13,2,21,28,75.0,7,42,23,19,61,111,246,2
2787,Igor Zubeldia,17.6,39,29,17,16,6,14,42,33.3,28,20,5,15,32,71,31,0
2788,Steven Zuber,15.9,40,30,22,13,5,26,41,63.4,15,18,3,15,17,57,27,0
2789,Bruno Zuculini,13.5,68,49,37,28,3,20,48,41.7,28,35,8,27,38,106,31,0
2790,Franco Zuculini,3.7,11,8,5,5,1,5,14,35.7,9,4,0,4,5,16,6,1
2791,Ervin Zukanovic,31.9,50,41,33,16,1,20,51,39.2,31,32,19,13,48,98,175,0
2792,Robert Zulj,2.3,3,3,1,2,0,1,1,100.0,0,3,0,3,0,3,2,0
2793,Bongani Zungu,23.2,54,37,21,26,7,24,56,42.9,32,30,5,25,38,92,41,2
2794,David Zurutuza,24.9,49,36,22,25,2,20,49,40.8,29,32,10,22,41,90,24,1
2795,Filip Duricic,10.8,22,14,11,8,3,5,9,55.6,4,7,1,6,9,31,5,0
2796,Filip Duricic,0.1,0,0,0,0,0,0,1,0.0,1,0,0,0,0,0,0,0
