,Player,Squad,90s,Tackles - Tkl,Tackles - TklW,Tackles - Def 3rd,Tackles - Mid 3rd,Tackles - Att 3rd,Challenges - Tkl,Challenges - Att,Challenges - Tkl%,Challenges - Lost,Blocks - Blocks,Blocks - Sh,Blocks - Pass,Int,Tkl+Int,Clr,Err
0,Patrick van Aanholt,Crystal Palace,24.3,47,32,29,15,3,16,34,47.1,18,24,5,19,47,94,64,2
1,Rolando Aarons,Newcastle Utd,1.5,4,4,3,1,0,4,6,66.7,2,3,0,3,1,5,0,0
2,Rolando Aarons,Hellas Verona,5.7,13,8,4,4,5,1,7,14.3,6,3,1,2,2,15,0,0
3,Ignazio Abate,Milan,11.7,20,17,10,9,1,6,11,54.5,5,22,2,20,8,28,29,0
4,Aymen Abdennour,Marseille,5.5,7,3,5,2,0,4,7,57.1,3,5,5,0,4,11,20,0
5,Aly Abeid,Levante,0.9,2,1,1,1,0,0,1,0.0,1,1,0,1,3,5,3,0
6,Mehdi Abeid,Dijon,13.1,23,15,8,14,1,8,32,25.0,24,11,6,5,18,41,25,2
7,David Abraham,Eint Frankfurt,25.6,40,32,29,10,1,27,36,75.0,9,29,15,14,40,80,141,1
8,Tammy Abraham,Swansea City,19.2,10,8,1,7,2,1,13,7.7,12,8,1,7,1,11,11,0
9,Amir Abrashi,Freiburg,9.4,35,32,15,18,2,16,23,69.6,7,22,5,17,19,54,20,0
10,Francesco Acerbi,Sassuolo,38.0,51,32,26,22,3,22,36,61.1,14,42,21,21,88,139,255,1
11,Afriyie Acquah,Torino,10.6,8,6,2,6,0,1,7,14.3,6,8,1,7,16,24,10,2
12,Charlie Adam,Stoke City,4.6,9,5,2,5,2,5,17,29.4,12,2,0,2,9,18,11,2
13,Antonio Adan,Betis,30.0,1,0,1,0,0,1,1,100.0,0,1,0,1,0,1,11,2
14,Aday,Girona,20.4,17,15,11,4,2,6,17,35.3,11,19,3,16,25,42,52,1
15,Khaled Adenon,Amiens,32.5,38,24,26,12,0,15,32,46.9,17,42,26,16,65,103,221,1
16,Claud Adjapong,Sassuolo,13.6,35,26,24,5,6,11,13,84.6,2,16,3,13,23,58,37,0
17,Rene Adler,Mainz 05,14.0,1,1,1,0,0,1,1,100.0,0,0,0,0,0,1,8,1
18,Yacine Adli,Paris S-G,0.1,0,0,0,0,0,0,0,0.0,0,0,0,0,0,0,0,0
19,Ali Adnan Kadhim,Udinese,18.6,54,35,35,14,5,29,50,58.0,21,31,6,25,41,95,90,0
20,Adrian,West Ham,19.0,2,1,2,0,0,1,4,25.0,3,1,0,1,0,2,15,1
21,Aritz Aduriz,Athletic Club,23.9,11,8,2,6,3,1,6,16.7,5,6,0,6,3,14,18,0
22,Ibrahim Afellay,Stoke City,1.8,3,3,0,3,0,1,2,50.0,1,1,0,1,1,4,1,0
23,Benik Afobe,Bournemouth,6.8,4,3,1,2,1,1,6,16.7,5,4,0,4,0,4,6,0
24,Martin Agirregabiria,Alavés,20.3,50,33,31,17,2,32,50,64.0,18,13,7,6,41,91,66,0
26,Imanol Agirretxe,Real Sociedad,2.6,0,0,0,0,0,0,1,0.0,1,0,0,0,0,0,2,0
27,Sergio Aguero,Manchester City,21.8,9,6,2,6,1,2,17,11.8,15,12,1,11,6,15,3,0
28,Ruben Aguilar,Montpellier,27.3,91,50,37,41,13,36,71,50.7,35,25,3,22,37,128,90,0
29,Matias Aguirregaray,Las Palmas,12.8,26,20,12,12,2,12,32,37.5,20,13,1,12,24,50,25,0
30,Jean-Eudes Aholou,Strasbourg,33.4,70,34,32,37,1,17,55,30.9,38,29,7,22,75,145,58,1
31,Ailton,Stuttgart,1.2,8,5,3,5,0,4,8,50.0,4,5,0,5,2,10,5,0
32,Youssef Ait Bennasser,Caen,22.7,47,28,17,27,3,15,64,23.4,49,35,2,33,32,79,30,0
33,Arlind Ajeti,Crotone,14.1,42,23,25,14,3,18,30,60.0,12,27,15,12,34,76,82,0
34,Manuel Akanji,Dortmund,10.0,22,15,14,8,0,15,17,88.2,2,11,4,7,7,29,43,2
35,Nathan Ake,Bournemouth,37.3,53,32,34,16,3,22,40,55.0,18,47,24,23,48,101,246,2
36,Ager Aketxe,Athletic Club,0.4,1,1,1,0,0,1,2,50.0,1,1,0,1,1,2,0,0
37,Chadrac Akolo,Stuttgart,12.2,20,14,3,12,5,6,14,42.9,8,19,0,19,5,25,5,0
38,Kevin Akpoguma,Hoffenheim,18.8,47,39,29,16,2,24,35,68.6,11,18,4,14,22,69,60,1
39,David Alaba,Bayern Munich,17.2,23,14,11,9,3,14,20,70.0,6,21,6,15,10,33,23,0
40,Lucas Alario,Leverkusen,17.2,16,10,2,12,2,3,8,37.5,5,17,4,13,4,20,16,0
41,David Alba,Getafe,0.7,1,1,1,0,0,1,1,100.0,0,0,0,0,0,1,7,1
42,Jordi Alba,Barcelona,30.5,63,42,35,22,6,26,52,50.0,26,34,5,29,68,131,67,1
43,Raul Albentosa,La Coruña,19.4,13,6,9,4,0,7,20,35.0,13,26,19,7,26,39,92,1
44,Luis Alberto,Lazio,29.7,39,28,8,23,8,10,44,22.7,34,30,2,28,16,55,7,0
45,Raul Albiol,Napoli,30.5,29,19,15,14,0,13,19,68.4,6,18,13,5,32,61,129,1
46,Miiko Albornoz,Hannover 96,7.8,24,20,17,4,3,11,16,68.8,5,15,2,13,5,29,23,0
47,Marc Albrighton,Leicester City,28.2,52,33,16,29,7,16,52,30.8,36,32,4,28,27,79,34,0
48,Paco Alcacer,Barcelona,7.7,4,3,0,2,2,0,6,0.0,6,5,0,5,11,15,3,0
49,Pedro Alcala,Girona,7.7,9,5,5,4,0,1,3,33.3,2,7,3,4,14,23,41,0
50,Thiago Alcantara,Bayern Munich,13.9,45,35,11,25,9,15,26,57.7,11,22,3,19,27,72,6,1
52,David Alcibiade,Nantes,2.3,9,5,5,3,1,2,4,50.0,2,5,3,2,7,16,8,0
53,Toby Alderweireld,Tottenham,13.1,19,13,7,11,1,8,15,53.3,7,11,5,6,4,23,55,0
54,Steve Aldo One,La Coruña,1.0,1,0,0,1,0,0,0,0.0,0,0,0,0,0,1,7,0
55,Alex Alegria,Levante,7.0,8,5,1,3,4,2,6,33.3,4,7,0,7,4,12,9,0
56,Ivan Alejo,Eibar,12.2,20,16,4,9,7,1,10,10.0,9,9,0,9,5,25,1,0
57,Alexander,Leganés,11.8,14,11,2,11,1,2,12,16.7,10,11,0,11,22,36,4,0
58,Trent Alexander-Arnold,Liverpool,17.5,37,25,23,9,5,22,36,61.1,14,20,5,15,28,65,46,1
59,Alexis,Alavés,24.3,33,24,24,7,2,20,45,44.4,25,28,14,14,30,63,114,3
60,Alisson,Roma,37.0,1,0,1,0,0,0,1,0.0,1,0,0,0,2,3,22,4
61,Allan,Napoli,31.7,107,68,24,65,18,36,104,34.6,68,52,3,49,28,135,16,0
62,Joe Allen,Stoke City,34.9,96,62,41,43,12,27,87,31.0,60,43,9,34,58,154,68,1
63,Dele Alli,Tottenham,32.9,46,30,15,21,10,8,34,23.5,26,33,7,26,19,65,22,1
64,Junior Alonso,Lille,30.9,58,31,36,22,0,28,50,56.0,22,26,16,10,56,114,153,1
65,Jose Alonso Lara,Sevilla,0.1,0,0,0,0,0,0,0,0.0,0,0,0,0,0,0,0,0
66,Marcos Alonso,Chelsea,31.7,51,33,30,18,3,23,44,52.3,21,36,5,31,47,98,76,1
67,Ricky Alvarez,Sampdoria,3.0,4,2,1,3,0,1,4,25.0,3,5,0,5,2,6,3,0
68,Sergio Alvarez,Celta Vigo,16.4,0,0,0,0,0,0,1,0.0,1,1,0,1,0,0,11,1
69,Yeray Alvarez,Athletic Club,7.5,12,7,8,4,0,6,9,66.7,3,8,2,6,11,23,18,0
70,Dani Alves,Paris S-G,22.9,80,57,45,27,8,33,58,56.9,25,24,3,21,28,108,21,0
71,Ibrahim Amadou,Lille,26.7,43,29,24,19,0,14,27,51.9,13,30,13,17,41,84,70,3
72,Eloi Amagat,Girona,0.2,0,0,0,0,0,0,1,0.0,1,0,0,0,0,0,0,0
73,Morgan Amalfitano,Rennes,8.3,8,5,3,3,2,2,5,40.0,3,6,0,6,4,12,7,0
74,Romain Amalfitano,Dijon,30.0,59,37,18,38,3,25,69,36.2,44,29,7,22,85,144,35,2
75,Daniel Amartey,Leicester City,5.4,8,4,7,1,0,3,7,42.9,4,7,3,4,7,15,21,1
76,Jordi Amat,Betis,22.7,32,23,15,16,1,11,24,45.8,13,14,4,10,38,70,77,2
78,Amath,Getafe,31.8,78,53,32,28,18,24,89,27.0,65,36,3,33,33,111,20,0
79,Jordan Amavi,Marseille,24.4,52,35,32,12,8,23,56,41.1,33,28,11,17,45,97,86,1
80,Stephan Ambrosius,Hamburger SV,0.5,0,0,0,0,0,0,0,0.0,0,2,1,1,1,1,4,0
81,Kelvin Amian,Toulouse,35.0,59,43,45,10,4,22,31,71.0,9,25,7,18,45,104,127,1
82,Nadiem Amiri,Hoffenheim,19.4,39,26,13,21,5,19,42,45.2,23,33,4,29,17,56,7,0
83,Ethan Ampadu,Chelsea,0.1,1,1,0,1,0,0,0,0.0,0,0,0,0,0,1,2,0
84,Nordin Amrabat,Watford,2.2,6,3,1,5,0,1,3,33.3,2,1,0,1,0,6,2,0
85,Nordin Amrabat,Leganés,18.0,19,10,5,10,4,5,17,29.4,12,13,0,13,5,24,2,0
86,Jon Ander Serantes,Leganés,1.0,0,0,0,0,0,0,0,0.0,0,0,0,0,0,0,0,1
87,Joachim Andersen,Sampdoria,6.1,8,3,6,2,0,4,4,100.0,0,6,4,2,9,17,41,1
88,Felipe Anderson,Lazio,12.9,34,21,7,11,16,6,35,17.1,29,17,0,17,11,45,8,1
89,Florin Andone,La Coruña,18.2,9,7,4,4,1,4,17,23.5,13,9,2,7,3,12,12,0
90,Nicolas Andrade,Hellas Verona,36.0,2,1,2,0,0,1,4,25.0,3,2,0,2,2,4,16,7
91,Benjamin Andre,Rennes,33.5,93,54,36,50,7,43,113,38.1,70,56,4,52,57,150,96,1
92,Marco Andreolli,Cagliari,20.3,25,17,20,4,1,12,20,60.0,8,24,17,7,30,55,139,0
93,Yoann Andreu,Angers,23.0,48,30,40,6,2,16,39,41.0,23,23,5,18,37,85,75,1
94,Miguel Angel Guerrero,Leganés,16.0,7,5,0,2,5,1,11,9.1,10,11,0,11,9,16,16,0
95,Jose Angel,Eibar,27.0,61,44,36,19,6,38,58,65.5,20,31,1,30,38,99,76,0
96,Miguel Angel Moya,Real Sociedad,8.5,0,0,0,0,0,0,1,0.0,1,0,0,0,2,2,7,0
97,Miguel Angel Rubio,Getafe,0.3,0,0,0,0,0,0,0,0.0,0,0,0,0,0,0,1,0
98,Gabriele Angella,Udinese,9.9,15,13,11,3,1,8,11,72.7,3,11,9,2,21,36,66,0
99,Cristian Ansaldi,Torino,20.8,49,33,25,20,4,14,37,37.8,23,23,5,18,20,69,61,0
100,Luca Antei,Benevento,6.6,19,14,12,7,0,6,11,54.5,5,10,8,2,26,45,35,0
101,Mirco Antenucci,SPAL,28.6,16,13,6,8,2,0,21,0.0,21,14,0,14,11,27,15,0
102,Waldemar Anton,Hannover 96,25.3,65,49,39,21,5,41,65,63.1,24,56,27,29,39,104,112,3
104,Luca Antonelli,Milan,1.6,1,1,0,0,1,0,2,0.0,2,1,0,1,1,2,8,0
105,Michail Antonio,West Ham,15.0,15,9,7,6,2,4,14,28.6,10,14,0,14,13,28,16,0
106,Mirko Antonucci,Roma,0.3,0,0,0,0,0,0,0,0.0,0,0,0,0,0,0,0,0
107,Vitorino Antunes,Getafe,31.1,58,44,42,14,2,38,74,51.4,36,31,3,28,58,116,89,1
108,Dennis Aogo,Stuttgart,21.7,35,26,17,18,0,14,22,63.6,8,27,3,24,29,64,27,1
109,Houssem Aouar,Lyon,27.0,66,42,22,39,5,20,66,30.3,46,30,0,30,39,105,34,0
110,Alberto Aquilani,Las Palmas,14.4,33,19,13,17,3,11,31,35.5,20,20,4,16,23,56,23,0
111,Mauro Arambarri,Getafe,23.6,56,41,19,30,7,14,47,29.8,33,26,3,23,25,81,36,0
112,Guilherme Arana,Sevilla,2.1,4,2,3,1,0,1,1,100.0,0,0,0,0,5,9,8,0
113,Charles Aranguiz,Leverkusen,25.6,75,61,17,50,8,33,62,53.2,29,46,5,41,48,123,27,2
114,Luiz Araujo,Lille,22.4,41,31,23,17,1,10,47,21.3,37,24,0,24,16,57,11,1
115,Sergio Araujo,Las Palmas,0.4,3,2,0,0,3,1,1,100.0,0,0,0,0,0,3,0,0
116,Anaitz Arbilla,Eibar,26.8,38,30,24,12,2,21,40,52.5,19,21,10,11,78,116,108,2
117,Alphonse Areola,Paris S-G,34.0,0,0,0,0,0,0,1,0.0,1,0,0,0,0,0,7,4
118,Scott Arfield,Burnley,14.8,36,26,20,13,3,19,44,43.2,25,22,1,21,11,47,24,0
119,Samuel Armenteros,Benevento,4.8,4,2,1,3,0,0,3,0.0,3,1,1,0,1,5,3,0
120,Yoel Armougom,Caen,1.5,2,1,0,1,1,1,1,100.0,0,1,1,0,1,3,2,1
121,Jose Arnaiz,Barcelona,0.1,1,1,0,1,0,0,0,0.0,0,0,0,0,0,1,0,0
122,Marko Arnautovic,West Ham,25.7,21,16,9,8,4,7,19,36.8,12,20,3,17,13,34,35,0
123,Maximilian Arnold,Wolfsburg,27.3,51,41,23,23,5,25,57,43.9,32,31,4,27,28,79,34,0
124,Jann-Fiete Arp,Hamburger SV,9.4,7,5,0,3,4,1,7,14.3,6,6,0,6,2,9,7,0
125,Alejandro Arribas,La Coruña,3.0,2,2,1,1,0,1,5,20.0,4,5,3,2,6,8,8,0
126,Kepa Arrizabalaga,Athletic Club,30.0,0,0,0,0,0,0,2,0.0,2,0,0,0,2,2,6,2
127,Harry Arter,Bournemouth,10.7,19,16,10,7,2,6,23,26.1,17,18,5,13,9,28,6,0
128,Aythami Artiles,Las Palmas,2.0,2,2,2,0,0,0,1,0.0,1,2,1,1,2,4,19,0
130,Kwadwo Asamoah,Juventus,17.4,28,21,12,14,2,15,23,65.2,8,11,0,11,18,46,30,0
131,Takuma Asano,Stuttgart,8.0,7,5,3,3,1,2,8,25.0,6,7,0,7,3,10,2,0
132,Santiago Ascacibar,Stuttgart,26.5,91,65,41,43,7,41,74,55.4,33,45,10,35,47,138,38,1
133,Sergio Asenjo,Villarreal,23.0,2,2,2,0,0,1,5,20.0,4,0,0,0,0,2,11,2
134,Marco Asensio,Real Madrid,20.5,26,17,7,13,6,11,26,42.3,15,15,0,15,9,35,2,0
135,Iago Aspas,Celta Vigo,32.6,26,22,10,10,6,5,34,14.7,29,15,1,14,23,49,11,1
136,Benoit Assou-Ekotto,Metz,11.7,12,9,5,6,1,5,15,33.3,10,7,4,3,46,58,21,0
137,Simon Asta,Augsburg,0.1,2,1,2,0,0,2,2,100.0,0,1,0,1,0,2,0,0
138,Davide Astori,Fiorentina,25.0,47,31,33,13,1,18,29,62.1,11,29,17,12,51,98,131,2
139,Christian Atsu,Newcastle Utd,19.8,17,16,10,7,0,7,20,35.0,13,35,5,30,13,30,27,1
140,Pierre-Emerick Aubameyang,Arsenal,11.7,5,4,3,2,0,1,7,14.3,6,14,1,13,3,8,7,0
141,Pierre-Emerick Aubameyang,Dortmund,15.7,5,5,1,1,3,2,8,25.0,6,16,1,15,3,8,1,0
142,Jean-Kevin Augustin,RB Leipzig,14.1,16,11,4,11,1,3,7,42.9,4,17,1,16,4,20,4,0
143,Ludwig Augustinsson,Werder Bremen,28.1,45,34,22,20,3,22,32,68.8,10,25,3,22,39,84,53,0
144,Yann Aurel Bisseck,Köln,1.7,2,2,2,0,0,1,1,100.0,0,1,1,0,3,5,8,0
145,Serge Aurier,Tottenham,15.9,48,27,27,13,8,11,31,35.5,20,20,1,19,31,79,54,1
146,Charlie Austin,Southampton,11.5,7,5,1,3,3,3,10,30.0,7,15,3,12,1,8,10,0
147,Danilo Avelar,Amiens,19.2,41,33,27,9,5,14,45,31.1,31,16,7,9,37,78,83,1
148,Felipe Avenatti,Bologna,5.2,6,4,1,5,0,1,2,50.0,1,7,1,6,1,7,6,0
149,Durel Avounou,Caen,7.2,16,11,6,9,1,5,17,29.4,12,12,1,11,10,26,25,0
150,Chidozie Awaziem,Nantes,16.8,43,30,33,10,0,28,40,70.0,12,18,11,7,16,59,97,0
151,Andre Ayew,West Ham,9.9,19,14,6,10,3,6,19,31.6,13,5,0,5,4,23,3,0
152,Andre Ayew,Swansea City,10.6,15,10,3,10,2,2,13,15.4,11,13,1,12,5,20,8,0
153,Jordan Ayew,Swansea City,31.7,82,60,20,35,27,15,54,27.8,39,43,3,40,24,106,20,1
154,Karim Azamoum,Troyes,25.0,84,57,41,37,6,27,68,39.7,41,30,11,19,26,110,61,3
156,Cesar Azpilicueta,Chelsea,37.0,80,59,47,26,7,27,54,50.0,27,48,22,26,54,134,135,1
157,Ludovic Baal,Rennes,12.9,41,27,29,8,4,13,35,37.1,22,13,2,11,15,56,37,1
158,Khouma Babacar,Fiorentina,5.0,4,4,3,0,1,2,4,50.0,2,0,0,0,2,6,5,0
159,Khouma Babacar,Sassuolo,8.3,10,6,2,4,4,2,6,33.3,4,8,0,8,3,13,1,0
160,Carlos Bacca,Villarreal,27.7,10,2,2,4,4,1,12,8.3,11,16,1,15,8,18,16,0
161,Milan Badelj,Fiorentina,26.1,71,41,26,38,7,28,71,39.4,43,48,2,46,71,142,52,3
162,Holger Badstuber,Stuttgart,24.1,44,32,29,14,1,22,39,56.4,17,27,14,13,41,85,111,4
163,Dylan Bahamboula,Dijon,0.3,0,0,0,0,0,0,0,0.0,0,0,0,0,0,0,0,0
164,Fares Bahlouli,Lille,3.4,10,8,4,3,3,2,7,28.6,5,7,0,7,1,11,1,0
165,Stephane Bahoken,Strasbourg,18.5,16,11,3,8,5,4,22,18.2,18,18,1,17,9,25,1,0
166,Daniel Baier,Augsburg,28.2,83,62,38,40,5,46,83,55.4,37,26,5,21,57,140,41,1
167,Leon Bailey,Leverkusen,24.6,16,12,7,4,5,8,13,61.5,5,28,0,28,15,31,6,0
168,Eric Bailly,Manchester Utd,11.1,17,10,10,5,2,5,12,41.7,7,11,6,5,25,42,58,1
169,Leighton Baines,Everton,21.2,25,13,18,3,4,9,14,64.3,5,18,6,12,25,50,56,0
170,Riad Bajic,Udinese,0.9,0,0,0,0,0,0,0,0.0,0,0,0,0,0,0,3,0
171,Marvin Bakalorz,Hannover 96,22.8,44,25,19,23,2,22,37,59.5,15,38,7,31,20,64,46,1
172,Cedric Bakambu,Villarreal,14.0,10,7,3,6,1,1,7,14.3,6,9,1,8,3,13,27,0
173,Tiemoue Bakayoko,Chelsea,23.6,64,41,25,32,7,16,48,33.3,32,23,6,17,37,101,38,4
174,Zakaria Bakkali,La Coruña,10.1,12,10,7,4,1,4,14,28.6,10,5,0,5,4,16,6,0
175,Ridle Baku,Mainz 05,2.6,3,3,1,1,1,0,1,0.0,1,3,0,3,3,6,2,0
176,Keita Balde,Monaco,16.4,12,8,5,6,1,1,11,9.1,10,10,1,9,6,18,5,0
177,Sam Baldock,Brighton,0.4,0,0,0,0,0,0,0,0.0,0,0,0,0,0,0,0,0
178,Gareth Bale,Real Madrid,20.0,19,13,7,8,4,3,14,21.4,11,13,1,12,12,31,18,0
179,Mikel Balenziaga,Athletic Club,17.2,34,24,17,13,4,15,27,55.6,12,24,5,19,17,51,61,0
180,Andrija Balic,Udinese,12.0,18,9,5,12,1,8,27,29.6,19,6,3,3,16,34,13,0
182,Ivan Balliu,Metz,21.7,34,22,22,6,6,12,28,42.9,16,23,9,14,27,61,64,1
183,Fode Ballo-Toure,Lille,22.8,50,36,29,16,5,21,47,44.7,26,27,2,25,28,78,47,1
184,Florent Balmont,Dijon,9.6,14,9,4,9,1,4,25,16.0,21,15,1,14,8,22,5,0
185,Leon Balogun,Mainz 05,13.0,39,32,27,11,1,22,31,71.0,9,21,9,12,32,71,64,0
186,Mario Balotelli,Nice,25.2,7,4,1,3,3,0,6,0.0,6,9,2,7,8,15,26,0
187,Abdoulaye Bamba,Angers,17.0,29,22,23,6,0,16,30,53.3,14,8,1,7,11,40,52,0
188,Jonathan Bamba,Saint-Étienne,28.6,30,21,18,11,1,12,61,19.7,49,30,4,26,19,49,17,0
189,Yacine Bammou,Nantes,8.1,18,11,6,10,2,4,14,28.6,10,16,4,12,6,24,9,0
190,Ever Banega,Sevilla,26.7,71,53,25,37,9,22,63,34.9,41,23,1,22,12,83,17,3
191,Mattia Bani,Chievo,14.6,28,20,22,6,0,11,26,42.3,15,19,10,9,27,55,111,0
192,Beni Baningime,Everton,2.2,6,2,1,2,3,0,4,0.0,4,5,1,4,2,8,2,0
193,Leo Baptistao,Espanyol,29.7,54,34,12,28,14,13,52,25.0,39,22,1,21,23,77,25,0
194,Sekou Baradji,Amiens,0.1,0,0,0,0,0,0,0,0.0,0,0,0,0,1,1,0,0
195,Antonin Barak,Udinese,30.1,58,38,22,27,9,21,58,36.2,37,34,2,32,18,76,26,1
196,Andrea Barberis,Crotone,33.7,80,44,33,42,5,16,68,23.5,52,52,5,47,58,138,67,1
197,Mariano Barbosa,Villarreal,12.5,0,0,0,0,0,0,0,0.0,0,0,0,0,1,1,4,0
198,Enis Bardhi,Levante,17.6,39,26,14,16,9,10,38,26.3,28,11,0,11,16,55,7,0
199,Phil Bardsley,Burnley,12.5,17,16,9,7,1,4,11,36.4,7,22,6,16,22,39,77,0
200,Nicolo Barella,Cagliari,32.8,92,69,37,43,12,25,78,32.1,53,48,6,42,45,137,53,0
201,Philipp Bargfrede,Werder Bremen,20.7,60,45,29,30,1,33,55,60.0,22,35,12,23,47,107,52,0
202,Ross Barkley,Chelsea,1.4,0,0,0,0,0,0,1,0.0,1,3,1,2,0,0,2,0
203,Aymen Barkok,Eint Frankfurt,3.5,11,11,6,4,1,5,7,71.4,2,8,2,6,2,13,3,0
204,Ashley Barnes,Burnley,24.1,21,14,1,14,6,5,29,17.2,24,26,5,21,2,23,19,0
205,Harvey Barnes,Leicester City,0.1,0,0,0,0,0,0,0,0.0,0,0,0,0,0,0,0,0
206,Antonio Barragan,Betis,26.4,59,42,40,11,8,24,36,66.7,12,22,5,17,24,83,66,0
208,Antonio Barreca,Torino,5.2,9,8,3,5,1,4,4,100.0,0,3,0,3,5,14,16,0
209,Edgar Barreto,Sampdoria,21.8,67,42,23,32,12,18,70,25.7,52,45,2,43,21,88,29,3
210,Barri,Getafe,1.3,1,0,0,1,0,0,4,0.0,4,1,1,0,1,2,3,0
211,Musa Barrow,Atalanta,4.9,5,2,1,3,1,2,4,50.0,2,2,0,2,1,6,2,0
212,Gareth Barry,West Brom,21.4,35,19,17,14,4,15,45,33.3,30,19,11,8,14,49,34,0
213,Fin Bartels,Werder Bremen,12.5,12,9,4,3,5,4,12,33.3,8,5,1,4,7,19,1,1
214,Kyle Bartley,Swansea City,2.6,3,2,3,0,0,2,2,100.0,0,6,6,0,4,7,21,0
215,Marc Bartra,Betis,15.8,38,28,30,8,0,21,39,53.8,18,19,10,9,32,70,97,1
216,Marc Bartra,Dortmund,9.0,28,19,16,12,0,15,24,62.5,9,14,2,12,28,56,43,1
217,Andrea Barzagli,Juventus,16.1,26,15,14,11,1,9,16,56.3,7,14,7,7,17,43,46,0
218,Daniele Baselli,Torino,28.0,63,33,23,36,4,20,56,35.7,36,29,5,24,57,120,40,1
219,Nicolas Basin,Metz,3.5,9,7,5,3,1,4,9,44.4,5,6,3,3,8,17,14,0
220,Dusan Basta,Lazio,8.6,9,7,4,3,2,6,14,42.9,8,10,3,7,13,22,15,0
221,Gil Bastiao Dias,Fiorentina,13.2,49,31,28,15,6,19,48,39.6,29,23,0,23,19,68,12,1
222,Gil Bastiao Dias,Monaco,0.1,1,1,0,1,0,0,0,0.0,0,0,0,0,0,1,0,0
223,Samuel Bastien,Chievo,15.1,17,13,7,8,2,7,23,30.4,16,23,2,21,18,35,25,0
224,Borja Baston,Málaga,10.9,9,7,1,6,2,1,13,7.7,12,7,0,7,3,12,5,0
225,Alessandro Bastoni,Atalanta,1.0,2,2,2,0,0,1,1,100.0,0,0,0,0,1,3,3,0
226,Bastos,Lazio,15.6,33,24,19,13,1,19,30,63.3,11,13,8,5,24,57,67,0
227,Michy Batshuayi,Chelsea,4.0,5,4,2,3,0,1,3,33.3,2,0,0,0,1,6,3,0
228,Michy Batshuayi,Dortmund,9.3,8,6,1,4,3,2,4,50.0,2,4,0,4,0,8,5,0
229,Moritz Bauer,Stoke City,14.5,24,17,17,7,0,10,26,38.5,16,9,1,8,12,36,48,0
230,Robert Bauer,Werder Bremen,10.6,31,25,21,9,1,15,25,60.0,10,8,2,6,21,52,25,2
231,Oliver Baumann,Hoffenheim,34.0,0,0,0,0,0,0,2,0.0,2,0,0,0,1,1,15,6
232,Timo Baumgartl,Stuttgart,29.0,87,71,55,29,3,56,75,74.7,19,50,21,29,34,121,132,1
234,Julian Baumgartlinger,Leverkusen,15.5,47,37,21,21,5,14,29,48.3,15,25,2,23,18,65,23,0
235,Jon Bautista,Real Sociedad,2.0,0,0,0,0,0,0,1,0.0,1,2,0,2,0,0,0,0
236,Paul Baysse,Málaga,13.8,25,16,21,3,1,10,17,58.8,7,10,6,4,20,45,84,0
237,Paul Baysse,Bordeaux,6.3,4,2,3,1,0,1,5,20.0,4,4,3,1,7,11,38,1
238,Noah Joel Sarenren Bazee,Hannover 96,1.3,0,0,0,0,0,0,0,0.0,0,3,0,3,0,0,3,0
239,Herve Bazile,Caen,9.7,21,15,9,7,5,5,15,33.3,10,22,0,22,15,36,8,0
240,Riechedly Bazoer,Wolfsburg,6.6,8,7,5,2,1,2,4,50.0,2,2,1,1,8,16,4,1
241,Enrico Bearzotti,Hellas Verona,4.6,3,2,2,0,1,1,4,25.0,3,3,1,2,4,7,18,0
242,Claudio Beauvue,Leganés,18.6,5,3,2,2,1,1,12,8.3,11,7,0,7,2,7,16,0
243,Bebe,Eibar,4.1,9,7,1,4,4,3,8,37.5,5,5,0,5,3,12,1,0
244,Ihlas Bebou,Hannover 96,23.8,37,29,15,17,5,14,27,51.9,13,34,3,31,24,61,27,0
245,Andreas Beck,Stuttgart,21.4,46,29,27,16,3,21,31,67.7,10,32,2,30,19,65,46,1
246,Henri Bedimo,Marseille,0.5,0,0,0,0,0,0,1,0.0,1,0,0,0,1,1,1,0
247,Jan Bednarek,Southampton,4.7,6,3,6,0,0,3,6,50.0,3,2,1,1,5,11,27,0
248,Asmir Begovic,Bournemouth,38.0,0,0,0,0,0,0,2,0.0,2,0,0,0,2,2,16,7
249,Valon Behrami,Udinese,15.5,63,46,30,27,6,8,44,18.2,36,47,15,32,22,85,19,0
250,Vid Belec,Benevento,12.4,0,0,0,0,0,0,0,0.0,0,0,0,0,1,1,6,1
251,Vid Belec,Sampdoria,2.0,0,0,0,0,0,0,0,0.0,0,0,0,0,0,0,1,0
252,Ishak Belfodil,Werder Bremen,15.0,7,6,2,3,2,0,3,0.0,3,10,1,9,1,8,9,0
253,Stefan Bell,Mainz 05,24.2,36,25,23,13,0,27,39,69.2,12,35,18,17,46,82,123,2
254,Karim Bellarabi,Leverkusen,12.7,22,17,10,9,3,10,19,52.6,9,26,1,25,13,35,5,0
255,Hector Bellerin,Arsenal,33.9,57,43,36,12,9,25,52,48.1,27,42,8,34,23,80,89,4
256,Francois Bellugou,Troyes,24.2,48,33,23,21,4,21,49,42.9,28,20,6,14,28,76,45,0
257,Andrea Belotti,Torino,29.8,32,23,9,15,8,3,30,10.0,27,14,1,13,6,38,19,1
258,Chaouki Ben Saada,Troyes,3.8,11,8,5,3,3,2,11,18.2,9,3,0,3,2,13,3,0
260,Wissam Ben Yedder,Sevilla,18.9,12,8,2,5,5,1,2,50.0,1,10,0,10,5,17,2,0
261,Diego Benaglio,Monaco,2.5,0,0,0,0,0,0,0,0.0,0,0,0,0,0,0,0,0
262,Ahmad Benali,Crotone,9.0,19,10,8,10,1,5,27,18.5,22,14,1,13,8,27,15,0
263,Yohan Benalouane,Leicester City,1.0,7,3,6,1,0,4,6,66.7,2,1,1,0,1,8,4,0
264,Marco Benassi,Fiorentina,30.9,54,38,18,22,14,17,52,32.7,35,52,2,50,28,82,36,0
265,Medhi Benatia,Juventus,19.5,28,21,20,6,2,8,15,53.3,7,18,13,5,43,71,89,1
266,Lars Bender,Leverkusen,17.7,63,52,26,32,5,35,53,66.0,18,34,7,27,28,91,40,0
267,Sven Bender,Leverkusen,26.1,51,37,33,18,0,26,34,76.5,8,49,21,28,50,101,123,1
268,Laszlo Benes,M'Gladbach,0.4,0,0,0,0,0,0,1,0.0,1,2,1,1,1,1,2,0
269,Nicolas Benezet,Guingamp,18.3,38,30,18,16,4,11,37,29.7,26,8,2,6,12,50,7,0
270,Marcel Benger,M'Gladbach,0.0,0,0,0,0,0,0,0,0.0,0,0,0,0,0,0,0,0
271,Walter Benitez,Nice,28.0,0,0,0,0,0,0,2,0.0,2,0,0,0,0,0,5,3
272,Charlison Benschop,Hannover 96,2.0,4,4,1,3,0,3,8,37.5,5,1,0,1,2,6,2,0
273,Ramy Bensebaini,Rennes,26.0,56,39,31,21,4,26,55,47.3,29,24,16,8,37,93,177,1
274,Nabil Bentaleb,Schalke 04,11.2,25,22,7,17,1,8,23,34.8,15,18,6,12,23,48,27,2
275,Rodrigo Bentancur,Juventus,6.5,18,11,10,7,1,2,16,12.5,14,5,1,4,3,21,14,0
276,Christian Benteke,Crystal Palace,24.9,11,4,3,7,1,2,17,11.8,15,15,3,12,3,14,44,0
277,Karim Benzema,Real Madrid,23.9,14,8,2,6,6,3,20,15.0,17,18,0,18,8,22,19,0
278,Yassine Benzia,Lille,25.4,62,41,21,31,10,17,62,27.4,45,31,4,27,28,90,14,0
279,Saido Berahino,Stoke City,5.5,2,2,0,1,1,0,1,0.0,1,4,1,3,1,3,2,0
280,Domenico Berardi,Sassuolo,25.5,31,17,9,16,6,11,65,16.9,54,23,0,23,17,48,14,1
281,Yuri Berchiche,Paris S-G,19.1,39,27,21,11,7,12,25,48.0,13,15,2,13,24,63,53,0
282,Alex Berenguer,Torino,11.6,18,15,7,8,3,5,17,29.4,12,22,3,19,10,28,13,0
283,Bartosz Bereszynski,Sampdoria,27.6,63,47,30,28,5,31,53,58.5,22,33,8,25,30,93,98,2
284,Johann Berg Gudmundsson,Burnley,31.5,43,27,16,19,8,20,47,42.6,27,21,1,20,34,77,43,0
286,Markel Bergara,Getafe,16.3,35,22,17,17,1,7,25,28.0,18,10,3,7,23,58,20,0
287,Emil Berggreen,Mainz 05,7.4,2,2,0,0,2,1,4,25.0,3,7,1,6,1,3,10,0
288,Robert Beric,Saint-Étienne,11.6,6,4,1,3,2,1,16,6.3,15,9,1,8,5,11,4,0
289,Kevin Berigaud,Montpellier,3.0,4,3,1,1,2,2,6,33.3,4,1,0,1,0,4,1,0
290,Etrit Berisha,Atalanta,31.0,1,1,1,0,0,1,1,100.0,0,0,0,0,1,2,5,3
291,Federico Bernardeschi,Juventus,9.4,8,5,4,3,1,1,7,14.3,6,9,0,9,11,19,18,1
292,Bernardo,RB Leipzig,15.0,43,30,18,22,3,29,40,72.5,11,30,6,24,18,61,81,0
293,Juan Bernat,Bayern Munich,9.9,25,19,13,8,4,11,18,61.1,7,11,1,10,10,35,9,1
294,Andrea Bertolacci,Genoa,32.2,85,53,40,38,7,21,63,33.3,42,46,12,34,46,131,37,1
295,Ryan Bertrand,Southampton,34.8,48,35,27,17,4,19,31,61.3,12,28,9,19,44,92,74,0
296,Muhamed Besic,Everton,0.5,1,1,1,0,0,1,3,33.3,2,2,2,0,0,1,1,0
297,Daniel Bessa,Hellas Verona,15.4,26,19,9,15,2,8,29,27.6,21,12,2,10,14,40,8,1
298,Daniel Bessa,Genoa,4.9,6,6,2,2,2,0,1,0.0,1,7,0,7,3,9,6,0
299,Vincent Bessat,Caen,17.4,41,27,23,16,2,22,48,45.8,26,19,1,18,18,59,18,0
300,Quentin Beunardeau,Metz,0.4,0,0,0,0,0,0,0,0.0,0,0,0,0,0,0,0,0
301,Matteo Bianchetti,Hellas Verona,1.4,3,1,3,0,0,1,3,33.3,2,3,2,1,2,5,8,0
302,Ermin Bicakcic,Hoffenheim,6.1,17,15,8,8,1,8,12,66.7,4,4,2,2,9,26,26,0
303,Pedro Bigas,Las Palmas,9.9,14,9,10,4,0,7,13,53.8,6,18,11,7,16,30,41,2
304,Lucas Biglia,Milan,22.7,59,36,28,26,5,22,61,36.1,39,49,12,37,28,87,51,1
305,Philip Billing,Huddersfield,8.5,25,16,11,11,3,8,22,36.4,14,17,1,16,18,43,19,0
306,Jean-Claude Billong,Benevento,3.3,9,7,5,4,0,5,8,62.5,3,4,3,1,6,15,17,0
307,Davide Biondini,Sassuolo,2.3,4,4,2,2,0,1,2,50.0,1,1,0,1,3,7,1,0
308,Cristiano Biraghi,Fiorentina,33.1,74,48,33,32,9,36,58,62.1,22,42,5,37,43,117,103,2
309,Mame Biram Diouf,Stoke City,28.8,48,36,26,15,7,8,21,38.1,13,22,0,22,14,62,76,1
310,Davide Biraschi,Genoa,20.0,33,25,13,19,1,18,25,72.0,7,19,10,9,38,71,78,0
312,Valter Birsa,Chievo,27.8,28,14,7,18,3,7,54,13.0,47,22,2,20,24,52,20,1
313,Milan Bisevac,Metz,7.9,7,5,5,1,1,5,7,71.4,2,2,0,2,5,12,43,0
314,Yves Bissouma,Lille,17.3,67,50,30,32,5,19,39,48.7,20,13,2,11,31,98,31,1
315,Leonardo Bittencourt,Köln,17.9,49,42,17,21,11,19,43,44.2,24,26,0,26,17,66,11,1
316,Albano Bizzarri,Udinese,32.0,2,2,2,0,0,2,2,100.0,0,0,0,0,1,3,12,4
317,Ruben Blanco,Celta Vigo,21.6,0,0,0,0,0,0,2,0.0,2,1,0,1,3,3,16,1
318,Ludovic Blas,Guingamp,19.9,23,14,10,12,1,7,36,19.4,29,15,3,12,19,42,9,1
319,Pablo de Blasis,Mainz 05,18.4,39,23,19,11,9,16,33,48.5,17,33,0,33,10,49,34,0
320,Jeremy Blayac,Strasbourg,10.2,5,3,0,3,2,2,9,22.2,7,7,2,5,1,6,11,0
321,Alexis Blin,Toulouse,21.0,57,37,23,30,4,22,69,31.9,47,27,6,21,31,88,31,0
322,Daley Blind,Manchester Utd,4.0,6,4,3,2,1,2,7,28.6,5,3,0,3,7,13,14,0
323,Danny Blum,Eint Frankfurt,0.3,0,0,0,0,0,0,0,0.0,0,0,0,0,1,1,0,0
324,Emmanuel Boateng,Levante,14.2,4,3,0,0,4,0,6,0.0,6,8,1,7,5,9,17,0
325,Jerome Boateng,Bayern Munich,18.2,26,18,18,7,1,19,32,59.4,13,20,12,8,21,47,52,1
326,Kevin-Prince Boateng,Eint Frankfurt,26.2,34,22,10,22,2,11,36,30.6,25,29,6,23,23,57,43,1
327,Raul Bobadilla,M'Gladbach,5.0,7,6,1,3,3,4,8,50.0,4,6,0,6,0,7,1,0
328,Yann Bodiger,Toulouse,2.5,3,1,0,3,0,1,6,16.7,5,0,0,0,2,5,3,0
329,Mathieu Bodmer,Amiens,4.4,6,3,5,1,0,5,6,83.3,1,6,3,3,1,7,15,0
330,Jeremie Boga,Chelsea,0.2,0,0,0,0,0,0,0,0.0,0,0,0,0,0,0,0,0
331,Quentin Boisgard,Toulouse,2.0,2,2,0,2,0,0,3,0.0,3,2,0,2,0,2,1,0
332,Yannick Bolasie,Everton,9.5,8,7,4,1,3,2,7,28.6,5,5,0,5,4,12,8,0
333,Deian Boldor,Hellas Verona,1.0,3,2,3,0,0,2,3,66.7,1,5,2,3,3,6,11,0
334,Giacomo Bonaventura,Milan,28.2,31,20,7,19,5,9,45,20.0,36,31,6,25,33,64,17,0
335,Federico Bonazzoli,SPAL,2.0,1,0,0,1,0,0,0,0.0,0,3,0,3,0,1,0,0
336,Federico Bonazzoli,Sampdoria,0.3,0,0,0,0,0,0,0,0.0,0,0,0,0,0,0,0,0
338,Daniele Bonera,Villarreal,13.2,16,11,8,7,1,10,15,66.7,5,17,12,5,12,28,72,0
339,Gaetan Bong,Brighton,24.8,39,32,25,11,3,15,26,57.7,11,24,6,18,40,79,81,1
340,Kevin Bonifazi,Torino,4.5,11,7,6,5,0,4,6,66.7,2,7,5,2,13,24,15,0
341,Landry Bonnefoi,Strasbourg,3.0,0,0,0,0,0,0,0,0.0,0,0,0,0,0,0,2,0
342,Leonardo Bonucci,Milan,34.3,30,21,22,7,1,11,18,61.1,7,31,22,9,51,81,132,0
343,Wilfried Bony,Swansea City,7.9,5,4,2,2,1,1,5,20.0,4,4,1,3,2,7,15,0
344,Celso Borges,La Coruña,25.6,61,39,34,22,5,15,47,31.9,32,39,7,32,34,95,36,0
345,Fabio Borini,Milan,17.9,38,23,12,18,8,16,37,43.2,21,32,6,26,13,51,43,0
346,Marco Borriello,SPAL,8.6,4,2,2,1,1,0,1,0.0,1,1,0,1,1,5,6,0
347,Gabriel Boschilia,Monaco,0.9,4,1,1,2,1,1,4,25.0,3,1,0,1,0,4,0,0
348,Ryad Boudebouz,Betis,15.1,32,18,6,21,5,6,26,23.1,20,18,1,17,7,39,8,0
349,Jean-Christophe Bouet,Amiens,1.0,0,0,0,0,0,0,0,0.0,0,0,0,0,0,0,0,0
350,Sofiane Boufal,Southampton,13.5,37,24,12,14,11,12,35,34.3,23,20,1,19,6,43,6,0
351,Arnold Bouka Moutou,Dijon,3.7,8,5,6,0,2,6,8,75.0,2,4,1,3,4,12,5,0
352,Farid Boulaya,Metz,2.0,5,1,4,1,0,3,6,50.0,3,1,0,1,1,6,2,0
353,Yassine Bounou,Girona,29.5,1,1,1,0,0,0,2,0.0,2,0,0,0,4,5,14,0
354,Emmanuel Bourgaud,Amiens,6.0,17,11,5,9,3,10,23,43.5,13,5,0,5,6,23,11,0
355,Benjamin Bourigeaud,Rennes,34.5,55,30,18,30,7,20,93,21.5,73,48,4,44,45,100,29,0
356,Eneko Boveda,La Coruña,7.4,24,16,13,10,1,8,13,61.5,5,18,7,11,16,40,36,2
357,Eneko Boveda,Athletic Club,5.8,12,11,7,4,1,5,11,45.5,6,3,0,3,14,26,14,0
358,Lucas Boye,Torino,1.7,9,8,5,3,1,1,3,33.3,2,5,0,5,2,11,2,0
359,Lucas Boye,Celta Vigo,3.1,12,8,3,7,2,3,10,30.0,7,5,0,5,6,18,4,0
360,Robbie Brady,Burnley,14.2,32,21,14,17,1,8,28,28.6,20,17,3,14,7,39,29,0
361,Martin Braithwaite,Bordeaux,10.2,6,4,0,4,2,1,6,16.7,5,6,2,4,0,6,3,0
362,Brandon,Rennes,4.0,10,9,3,4,3,1,11,9.1,10,11,1,10,5,15,1,0
364,Julian Brandt,Leverkusen,25.8,24,18,11,9,4,11,29,37.9,18,23,1,22,16,40,12,1
365,Darko Brasanac,Leganés,13.4,32,17,11,17,4,13,33,39.4,20,14,3,11,14,46,12,0
366,Claudio Bravo,Manchester City,2.5,0,0,0,0,0,0,1,0.0,1,0,0,0,0,0,0,0
367,Josip Brekalo,Wolfsburg,9.7,15,12,6,7,2,6,12,50.0,6,17,0,17,4,19,3,0
368,Josip Brekalo,Stuttgart,8.1,20,12,7,8,5,6,8,75.0,2,8,2,6,3,23,1,0
369,Jimmy Briand,Guingamp,35.7,33,21,13,15,5,4,42,9.5,38,17,2,15,12,45,51,0
370,Enrico Brignola,Benevento,15.0,28,21,17,10,1,12,38,31.6,26,13,0,13,6,34,7,0
371,Alberto Brignoli,Benevento,12.5,0,0,0,0,0,0,0,0.0,0,0,0,0,0,0,15,3
372,Miguel Britos,Watford,8.9,15,11,10,5,0,6,11,54.5,5,9,1,8,12,27,45,1
373,Leon Britton,Swansea City,3.4,6,5,0,5,1,5,8,62.5,3,3,1,2,1,7,1,0
374,Petar Brlek,Genoa,2.6,9,7,4,5,0,3,7,42.9,4,0,0,0,1,10,3,0
375,John Brooks,Wolfsburg,8.1,20,13,15,4,1,16,22,72.7,6,11,5,6,10,30,46,0
376,Daniel Brosinski,Mainz 05,27.8,45,35,21,18,6,22,44,50.0,22,46,11,35,24,69,75,2
377,Izzy Brown,Brighton,3.5,3,3,2,1,0,1,7,14.3,6,3,0,3,1,4,3,0
378,Marcelo Brozovic,Inter,21.4,60,43,21,31,8,19,63,30.2,44,30,7,23,18,78,18,0
379,Bruma,RB Leipzig,17.9,18,16,7,7,4,9,18,50.0,9,28,2,26,12,30,11,0
380,Jeffrey Bruma,Wolfsburg,11.0,13,11,13,0,0,6,14,42.9,8,17,12,5,14,27,43,2
381,Bruno,Brighton,22.4,30,17,21,6,3,14,22,63.6,8,17,11,6,38,68,76,0
382,Chris Brunt,West Brom,21.3,41,24,19,21,1,11,31,35.5,20,28,4,24,22,63,45,1
383,Jacob Bruun Larsen,Stuttgart,1.2,0,0,0,0,0,0,0,0.0,0,1,0,1,1,1,2,0
384,Jacob Bruun Larsen,Dortmund,0.1,1,1,1,0,0,1,2,50.0,1,0,0,0,0,1,0,0
385,Marcel Buchel,Hellas Verona,18.8,37,21,15,21,1,13,48,27.1,35,35,6,29,45,82,46,1
386,Ante Budimir,Crotone,17.6,28,20,4,16,8,2,20,10.0,18,20,3,17,7,35,27,0
387,Alberto Bueno,Málaga,2.5,3,2,2,1,0,2,11,18.2,9,2,0,2,1,4,2,0
388,Gianluigi Buffon,Juventus,20.7,0,0,0,0,0,0,0,0.0,0,0,0,0,0,0,11,2
390,Onur Bulut,Freiburg,0.4,0,0,0,0,0,0,1,0.0,1,0,0,0,0,0,0,0
391,Alessandro Buongiorno,Torino,0.1,0,0,0,0,0,0,0,0.0,0,0,0,0,0,0,1,0
392,Nicolas Burdisso,Torino,23.0,20,11,13,7,0,7,11,63.6,4,23,14,9,30,50,124,3
393,Guido Burgstaller,Schalke 04,25.8,14,9,0,10,4,4,14,28.6,10,28,3,25,10,24,9,0
394,Burgui,Alavés,11.5,10,5,2,4,4,2,6,33.3,4,5,0,5,7,17,1,0
395,Oliver Burke,West Brom,4.1,6,4,3,2,1,4,12,33.3,8,3,0,3,7,13,3,0
396,Roman Burki,Dortmund,33.0,1,1,1,0,0,1,3,33.3,2,1,0,1,0,1,10,4
397,Patrick Burner,Nice,10.0,18,12,13,5,0,7,20,35.0,13,6,0,6,13,31,23,0
398,Dzenis Burnic,Stuttgart,3.4,9,6,2,5,2,4,10,40.0,6,2,0,2,4,13,3,0
399,Sergio Busquets,Barcelona,28.8,88,48,27,46,15,39,79,49.4,40,37,10,27,51,139,15,1
400,Unai Bustinza,Leganés,18.2,36,21,25,8,3,21,38,55.3,17,17,9,8,47,83,64,0
401,Ludovic Butelle,Angers,18.4,0,0,0,0,0,0,0,0.0,0,0,0,0,1,1,10,2
402,Jack Butland,Stoke City,35.0,1,1,1,0,0,1,1,100.0,0,1,0,1,1,2,26,1
403,Sam Byram,West Ham,2.8,9,5,6,3,0,4,9,44.4,5,6,2,4,9,18,16,0
404,Jakub Blaszczykowski,Wolfsburg,5.8,12,8,8,2,2,6,13,46.2,7,11,3,8,5,17,3,0
405,Erick Cabaco,Levante,11.6,25,14,21,4,0,14,20,70.0,6,10,8,2,17,42,71,2
406,Willy Caballero,Chelsea,3.0,0,0,0,0,0,0,0,0.0,0,0,0,0,0,0,3,0
407,Yohan Cabaye,Crystal Palace,26.4,70,44,39,28,3,24,97,24.7,73,47,4,43,79,149,29,4
408,Remy Cabella,Marseille,0.7,7,4,2,2,3,2,4,50.0,2,0,0,0,1,8,0,0
409,Remy Cabella,Saint-Étienne,25.1,58,39,29,22,7,17,73,23.3,56,31,0,31,14,72,4,2
410,Gustavo Cabral,Celta Vigo,21.0,29,21,14,15,0,14,38,36.8,24,22,11,11,43,72,106,2
411,Leandro Cabrera,Crotone,4.1,8,5,8,0,0,0,3,0.0,3,5,2,3,6,14,33,0
412,Leandro Cabrera,Getafe,8.0,19,10,12,7,0,7,17,41.2,10,9,5,4,22,41,37,0
413,Fabrizio Cacciatore,Chievo,31.9,34,27,20,9,5,15,30,50.0,15,33,11,22,38,72,99,3
414,Martin Caceres,Hellas Verona,12.9,16,11,14,1,1,7,18,38.9,11,9,5,4,19,35,41,1
416,Martin Caceres,Lazio,4.9,12,7,9,2,1,10,14,71.4,4,4,4,0,4,16,13,0
417,Cafu,Metz,7.6,9,7,3,4,2,3,11,27.3,8,3,1,2,12,21,13,0
418,Jonathan Cafu,Bordeaux,7.0,16,9,7,6,3,5,13,38.5,8,6,1,5,10,26,1,0
419,Gary Cahill,Chelsea,23.2,29,21,15,9,5,10,21,47.6,11,21,14,7,27,56,127,1
420,Yannick Cahuzac,Toulouse,16.9,39,28,20,19,0,15,26,57.7,11,29,10,19,30,69,42,0
421,Felipe Caicedo,Lazio,8.0,11,10,3,5,3,2,7,28.6,5,6,0,6,1,12,4,0
422,Caiuby,Augsburg,31.7,53,40,20,27,6,17,42,40.5,25,36,1,35,15,68,42,2
423,Cala,Getafe,20.0,21,14,16,5,0,13,27,48.1,14,21,10,11,39,60,124,0
424,Davide Calabria,Milan,17.4,64,50,33,24,7,21,41,51.2,20,19,4,15,33,97,82,1
425,Mattia Caldara,Atalanta,24.0,39,26,15,24,0,13,33,39.4,20,31,18,13,41,80,113,1
426,Carlos Calderon,Getafe,0.0,1,1,0,0,1,0,0,0.0,0,0,0,0,0,1,0,0
427,Luca Caldirola,Werder Bremen,1.0,1,0,0,1,0,1,1,100.0,0,1,0,1,3,4,3,0
428,Hakan Calhanoglu,Milan,24.1,37,27,11,18,8,8,31,25.8,23,29,2,27,22,59,15,0
429,Fabrizio Caligara,Cagliari,0.2,0,0,0,0,0,0,0,0.0,0,1,1,0,1,1,1,0
430,Daniel Caligiuri,Schalke 04,32.4,100,66,48,43,9,49,94,52.1,45,59,4,55,67,167,71,0
431,Jose Callejon,Napoli,36.0,33,27,15,14,4,10,47,21.3,37,42,5,37,22,55,31,0
432,Jonathan Calleri,Las Palmas,34.5,24,16,5,10,9,4,23,17.4,19,15,2,13,7,31,35,0
433,Simone Calvano,Hellas Verona,7.2,13,12,4,9,0,3,16,18.8,13,10,4,6,15,28,14,1
434,Dominic Calvert-Lewin,Everton,20.9,15,8,5,3,7,2,15,13.3,13,13,1,12,10,25,23,1
435,Ignacio Camacho,Wolfsburg,10.6,27,21,10,16,1,9,23,39.1,14,14,5,9,41,68,43,0
436,Abdoul Camara,Guingamp,9.9,6,4,2,3,1,3,11,27.3,8,7,1,6,7,13,4,0
437,Souleymane Camara,Montpellier,10.4,6,4,0,5,1,0,3,0.0,3,3,1,2,2,8,15,0
438,Victor Camarasa,Betis,13.9,20,15,8,10,2,3,13,23.1,10,8,0,8,15,35,13,0
439,Geoff Cameron,Stoke City,16.9,34,21,20,12,2,11,27,40.7,16,28,8,20,36,70,68,0
440,Jose Campana,Levante,30.4,57,36,25,27,5,19,58,32.8,39,31,10,21,45,102,37,0
442,Joel Campbell,Betis,2.4,6,2,3,3,0,3,6,50.0,3,2,0,2,0,6,0,0
443,Tyrese Campbell,Stoke City,0.9,2,1,0,2,0,1,1,100.0,0,1,1,0,1,3,0,0
444,Emre Can,Liverpool,23.2,67,54,32,29,6,18,43,41.9,25,32,4,28,28,95,37,1
445,Sergio Canales,Real Sociedad,21.4,30,24,6,18,6,9,32,28.1,23,25,0,25,11,41,3,0
446,Joao Cancelo,Inter,20.6,42,29,27,11,4,17,42,40.5,25,15,2,13,35,77,51,0
447,Joao Cancelo,Valencia,1.0,1,1,0,1,0,1,1,100.0,0,1,0,1,2,3,0,0
448,Antonio Candreva,Inter,28.2,12,7,7,5,0,8,39,20.5,31,20,2,18,22,34,24,0
449,Paolo Cannavaro,Sassuolo,16.0,17,9,11,5,1,8,20,40.0,12,17,13,4,27,44,94,1
450,Ander Capa,Eibar,25.0,57,38,34,14,9,25,38,65.8,13,21,2,19,52,109,50,1
451,Pierrick Capelle,Angers,20.9,50,37,29,17,4,16,70,22.9,54,29,0,29,34,84,26,0
452,Leonardo Capezzi,Sampdoria,2.4,8,4,5,3,0,4,6,66.7,2,6,0,6,0,8,3,0
453,Etienne Capoue,Watford,17.1,43,26,15,25,3,19,47,40.4,28,21,1,20,43,86,38,0
454,Elio Capradossi,Roma,0.9,1,0,1,0,0,0,0,0.0,0,2,2,0,2,3,13,0
455,Gianluca Caprari,Sampdoria,20.1,19,11,2,11,6,0,10,0.0,10,25,2,23,5,24,3,0
456,Marco Capuano,Crotone,15.6,20,10,14,6,0,5,15,33.3,10,19,13,6,28,48,93,0
457,Marco Capuano,Cagliari,7.7,13,9,6,7,0,4,8,50.0,4,7,2,5,6,19,23,1
458,Antonio Caracciolo,Hellas Verona,31.7,52,34,41,8,3,17,30,56.7,13,64,44,20,39,91,203,0
459,Yoan Cardinale,Nice,10.0,0,0,0,0,0,0,0,0.0,0,0,0,0,0,0,0,3
460,Diego Carlos,Nantes,25.5,70,42,51,15,4,28,38,73.7,10,50,29,21,29,99,155,3
461,Lionel Carole,Sevilla,6.0,12,6,7,5,0,5,7,71.4,2,6,3,3,6,18,29,0
462,Yannick Carrasco,Atlético Madrid,10.0,17,13,7,5,5,3,8,37.5,5,9,0,9,4,21,3,0
463,Michael Carrick,Manchester Utd,1.2,1,1,0,1,0,0,1,0.0,1,2,0,2,1,2,3,0
464,Daniel Carrico,Sevilla,5.1,7,7,6,1,0,4,7,57.1,3,6,3,3,10,17,22,0
465,Andre Carrillo,Watford,17.1,31,24,16,12,3,8,33,24.2,25,7,0,7,15,46,16,0
466,Guido Carrillo,Southampton,5.0,5,1,0,3,2,0,1,0.0,1,4,0,4,0,5,5,0
468,Guido Carrillo,Monaco,4.7,3,1,0,2,1,0,4,0.0,4,3,1,2,0,3,8,0
469,Thomas Carrique,Bordeaux,1.0,1,0,0,1,0,1,3,33.3,2,0,0,0,2,3,3,0
470,Andy Carroll,West Ham,8.3,3,3,2,0,1,0,1,0.0,1,3,2,1,2,5,15,0
471,Tom Carroll,Swansea City,28.6,53,33,22,23,8,14,53,26.4,39,37,8,29,29,82,18,1
472,Federico Cartabia,La Coruña,14.7,37,23,15,15,7,11,30,36.7,19,15,0,15,18,55,10,0
473,Dani Carvajal,Real Madrid,24.7,59,40,27,22,10,22,38,57.9,16,33,15,18,38,97,42,2
474,Casemiro,Real Madrid,28.8,109,78,64,39,6,42,84,50.0,42,56,11,45,63,172,49,3
475,Kiko Casilla,Real Madrid,10.0,1,0,1,0,0,1,1,100.0,0,0,0,0,2,3,6,2
476,Francesco Cassata,Sassuolo,5.1,12,7,6,5,1,2,10,20.0,8,3,0,3,5,17,0,0
477,Timothy Castagne,Atalanta,16.7,54,37,32,14,8,13,27,48.1,14,25,4,21,26,80,48,0
478,Leandro Castan,Cagliari,12.7,24,15,16,8,0,15,20,75.0,5,16,10,6,23,47,48,1
479,Koen Casteels,Wolfsburg,34.0,2,1,2,0,0,2,2,100.0,0,0,0,0,1,3,16,1
480,Dani Castellano,Las Palmas,22.5,46,29,29,16,1,25,48,52.1,23,28,7,21,42,88,64,1
481,Javi Castellano,Las Palmas,17.4,47,27,20,25,2,20,37,54.1,17,23,6,17,38,85,16,1
482,Samu Castillejo,Villarreal,23.0,41,28,22,10,9,13,62,21.0,49,39,5,34,22,63,37,0
483,Chory Castro,Málaga,22.9,37,24,15,14,8,11,32,34.4,21,21,2,19,23,60,13,0
484,Gonzalo Castro,Dortmund,13.4,26,18,7,18,1,5,22,22.7,17,23,3,20,10,36,13,1
485,Jonny Castro,Celta Vigo,35.6,102,78,60,31,11,43,91,47.3,48,48,8,40,93,195,92,1
486,Lucas Castro,Chievo,22.1,54,40,14,29,11,16,43,37.2,27,39,7,32,38,92,35,0
487,Ruben Castro,Betis,4.0,1,1,0,0,1,0,0,0.0,0,0,0,0,0,1,2,0
488,Danilo Cataldi,Benevento,25.4,33,25,12,19,2,5,28,17.9,23,18,5,13,37,70,20,1
489,Craig Cathcart,Watford,5.8,8,5,5,3,0,4,5,80.0,1,8,6,2,3,11,38,0
490,Edinson Cavani,Paris S-G,28.7,15,9,5,4,6,2,16,12.5,14,10,1,9,5,20,22,0
491,Marijan Cavar,Eint Frankfurt,0.4,0,0,0,0,0,0,3,0.0,3,0,0,0,0,0,0,0
492,Dani Ceballos,Real Madrid,4.5,8,7,3,2,3,4,16,25.0,12,6,0,6,5,13,1,0
494,Federico Ceccherini,Crotone,35.9,35,21,28,4,3,13,25,52.0,12,39,21,18,83,118,276,1
495,Emanuel Cecchini,Málaga,0.3,3,1,2,1,0,2,3,66.7,1,0,0,0,2,5,2,0
496,Petr Cech,Arsenal,33.8,1,1,1,0,0,1,1,100.0,0,0,0,0,0,1,23,7
497,Ricardo Centurion,Genoa,0.6,0,0,0,0,0,0,0,0.0,0,0,0,0,0,0,0,0
498,Luca Ceppitelli,Cagliari,24.7,45,33,31,12,2,16,34,47.1,18,33,21,12,50,95,156,0
499,Fabio Ceravolo,Benevento,0.6,0,0,0,0,0,0,1,0.0,1,1,0,1,0,0,0,0
500,Alessio Cerci,Hellas Verona,18.2,15,10,7,3,5,4,16,25.0,12,4,0,4,4,19,8,0
501,Bostjan Cesar,Chievo,6.1,4,3,3,1,0,3,4,75.0,1,6,4,2,3,7,40,0
502,Damir Ceter,Cagliari,2.2,2,1,0,2,0,0,0,0.0,0,3,0,3,0,2,1,0
503,Nacer Chadli,West Brom,2.9,1,0,1,0,0,1,4,25.0,3,0,0,0,0,1,4,0
504,Fouad Chafik,Dijon,17.9,58,49,31,19,8,20,35,57.1,15,17,1,16,33,91,46,1
505,Nathaniel Chalobah,Watford,5.0,9,6,2,6,1,2,5,40.0,3,6,5,1,6,15,6,0
506,Calum Chambers,Arsenal,9.6,17,10,10,6,1,5,14,35.7,9,14,11,3,18,35,47,0
507,Nereo Champagne,Leganés,2.0,0,0,0,0,0,0,0,0.0,0,0,0,0,0,0,3,0
508,Timothy Chandler,Eint Frankfurt,21.0,27,21,11,13,3,11,17,64.7,6,15,0,15,33,60,52,0
509,Kwon Chang-hoon,Dijon,23.7,37,22,10,18,9,11,35,31.4,24,32,1,31,24,61,30,0
510,Charles,Eibar,17.6,11,8,2,5,4,1,8,12.5,7,7,0,7,7,18,10,0
511,Charly Charrier,Amiens,1.2,1,0,1,0,0,0,2,0.0,2,1,0,1,2,3,0,0
512,Pape Cheikh Diop,Lyon,0.1,0,0,0,0,0,0,0,0.0,0,0,0,0,0,0,0,0
513,Chema,Levante,22.4,20,13,14,6,0,9,18,50.0,9,43,27,16,30,50,110,1
514,Denis Cheryshev,Villarreal,10.3,27,16,12,10,5,6,23,26.1,17,18,1,17,13,40,10,0
515,Raman Chibsah,Benevento,11.6,20,13,10,7,3,4,14,28.6,10,13,2,11,4,24,16,0
516,Leandro Chichizola,Las Palmas,27.0,2,0,2,0,0,2,6,33.3,4,0,0,0,4,6,29,3
517,Giorgio Chiellini,Juventus,24.0,28,19,17,10,1,7,15,46.7,8,21,14,7,47,75,142,3
518,Federico Chiesa,Fiorentina,33.5,62,41,22,22,18,16,54,29.6,38,34,1,33,18,80,16,0
520,Ben Chilwell,Leicester City,20.6,36,26,21,10,5,15,32,46.9,17,31,4,27,28,64,71,3
521,Vlad Chiriches,Napoli,6.5,8,4,7,1,0,2,5,40.0,3,2,1,1,16,24,19,1
522,Hamza Choudhury,Leicester City,4.2,9,5,6,3,0,2,10,20.0,8,12,1,11,8,17,4,0
523,Andreas Christensen,Chelsea,23.2,26,13,23,3,0,10,15,66.7,5,25,17,8,39,65,109,5
524,Chuca,Villarreal,1.0,1,0,1,0,0,1,3,33.3,2,1,1,0,1,2,1,1
525,Lee Chung-yong,Crystal Palace,1.5,2,0,0,1,1,0,0,0.0,0,3,0,3,2,4,0,1
526,Amato Ciciretti,Benevento,9.0,14,8,5,6,3,2,11,18.2,9,9,0,9,6,20,4,0
527,Cifu,Málaga,1.2,2,1,0,1,1,1,5,20.0,4,1,1,0,2,4,2,0
528,Luca Cigarini,Cagliari,22.5,42,30,16,25,1,18,64,28.1,46,32,5,27,42,84,27,1
529,Per Ciljan Skjelbred,Hertha BSC,24.3,89,66,33,54,2,42,64,65.6,22,31,6,25,45,134,23,0
530,Jasper Cillessen,Barcelona,1.0,0,0,0,0,0,0,0,0.0,0,0,0,0,0,0,0,0
531,Thiago Cionek,SPAL,15.0,28,21,18,6,4,11,20,55.0,9,19,9,10,35,63,99,0
532,Saliou Ciss,Angers,1.6,3,2,1,1,1,2,5,40.0,3,0,0,0,2,5,1,0
533,Karamoko Cisse,Benevento,0.2,1,1,1,0,0,0,0,0.0,0,0,0,0,0,1,0,0
534,Issa Cissokho,Amiens,18.1,31,23,22,9,0,18,32,56.3,14,18,8,10,34,65,87,1
535,Ciaran Clark,Newcastle Utd,19.4,25,17,17,8,0,11,21,52.4,10,15,10,5,17,42,144,1
536,Christian Clemens,Köln,7.2,12,11,6,5,1,4,13,30.8,9,8,0,8,4,16,7,0
537,Tom Cleverley,Watford,21.1,48,26,25,16,7,21,52,40.4,31,11,1,10,25,73,21,0
538,Sam Clucas,Swansea City,22.7,34,19,21,11,2,10,29,34.5,19,31,7,24,29,63,34,1
539,Nathaniel Clyne,Liverpool,1.9,3,1,2,1,0,0,1,0.0,1,2,1,1,0,3,3,0
540,Marcus Coco,Guingamp,17.6,40,28,17,13,10,7,35,20.0,28,22,3,19,15,55,9,0
541,Massimo Coda,Benevento,15.7,12,9,3,4,5,2,13,15.4,11,7,2,5,6,18,11,0
542,Isaac Cofie,Genoa,6.6,13,10,3,9,1,7,15,46.7,8,9,3,6,10,23,7,0
543,Renaud Cohade,Metz,36.6,143,86,63,71,9,46,119,38.7,73,70,10,60,53,196,91,0
544,Coke,Levante,15.4,35,23,26,7,2,18,39,46.2,21,17,5,12,34,69,46,0
546,Coke,Schalke 04,0.0,0,0,0,0,0,0,0,0.0,0,0,0,0,0,0,0,0
547,Emre Colak,La Coruña,16.1,24,19,4,14,6,7,28,25.0,21,7,1,6,7,31,5,1
548,Seamus Coleman,Everton,11.5,14,14,9,3,2,6,11,54.5,5,16,12,4,10,24,29,2
549,James Collins,West Ham,11.7,15,9,11,4,0,8,11,72.7,3,13,10,3,16,31,120,1
550,Racine Coly,Nice,6.9,15,12,9,5,1,9,19,47.4,10,5,2,3,15,30,18,0
551,Kingsley Coman,Bayern Munich,12.8,11,10,2,6,3,5,10,50.0,5,6,0,6,7,18,1,0
552,Marvin Compper,RB Leipzig,1.0,2,2,0,2,0,2,3,66.7,1,2,2,0,0,2,8,0
553,Alois Confais,Troyes,6.8,8,6,7,1,0,3,9,33.3,6,7,4,3,4,12,15,1
554,Daniel Congre,Montpellier,29.3,62,46,36,24,2,31,59,52.5,28,29,16,13,56,118,124,2
555,Andrea Consigli,Sassuolo,36.8,0,0,0,0,0,0,2,0.0,2,0,0,0,0,0,27,6
556,Diego Contento,Bordeaux,1.2,3,0,1,2,0,1,1,100.0,0,2,1,1,1,4,9,0
557,Andrea Conti,Milan,1.7,4,2,1,3,0,2,3,66.7,1,3,0,3,1,5,5,0
558,Lewis Cook,Bournemouth,24.9,67,35,37,30,0,26,69,37.7,43,33,12,21,35,102,25,2
559,Steve Cook,Bournemouth,30.7,37,19,28,7,2,19,29,65.5,10,63,45,18,54,91,232,4
560,Duje Cop,Cagliari,1.1,1,1,0,0,1,0,1,0.0,1,1,0,1,0,1,0,0
561,Francis Coquelin,Arsenal,1.9,5,4,2,3,0,1,3,33.3,2,1,0,1,3,8,2,0
562,Francis Coquelin,Valencia,7.3,18,14,11,6,1,9,16,56.3,7,9,2,7,20,38,23,0
563,Sebastien Corchia,Sevilla,9.1,18,13,7,8,3,9,16,56.3,7,18,4,14,16,34,20,0
564,Alex Cordaz,Crotone,38.0,0,0,0,0,0,0,0,0.0,0,0,0,0,2,2,16,4
565,Inigo Cordoba,Athletic Club,16.2,44,30,18,21,5,16,58,27.6,42,31,0,31,21,65,9,0
566,Jhon Cordoba,Köln,10.6,13,10,0,11,2,1,5,20.0,4,6,2,4,1,14,9,0
567,Sergio Cordova,Augsburg,6.5,5,5,0,2,3,3,4,75.0,1,12,2,10,0,5,6,0
568,Jeremy Cordoval,Troyes,10.2,20,16,12,7,1,9,14,64.3,5,12,2,10,9,29,35,0
569,Benjamin Corgnet,Strasbourg,15.3,28,19,5,16,7,6,28,21.4,22,18,1,17,11,39,11,0
570,Jack Cork,Burnley,38.0,60,44,25,27,8,20,62,32.3,42,36,15,21,41,101,86,1
572,Andreas Cornelius,Atalanta,10.4,9,5,3,3,3,1,7,14.3,6,7,0,7,2,11,7,0
573,Maxwel Cornet,Lyon,14.1,17,12,6,9,2,3,25,12.0,22,11,1,10,14,31,14,0
574,Quentin Cornette,Amiens,5.0,11,8,5,3,3,3,13,23.1,10,7,0,7,3,14,5,0
575,Angel Correa,Atlético Madrid,25.0,41,29,12,16,13,8,57,14.0,49,30,1,29,25,66,17,0
576,Joaquin Correa,Sevilla,13.3,15,10,7,6,2,8,29,27.6,21,15,1,14,2,17,12,0
577,Andrea Cossu,Cagliari,2.7,1,0,0,0,1,0,2,0.0,2,2,0,2,3,4,2,0
578,Andrea Costa,Benevento,15.3,19,14,13,6,0,9,19,47.4,10,21,15,6,37,56,78,2
579,Danny da Costa,Eint Frankfurt,13.4,41,34,17,14,10,24,28,85.7,4,21,4,17,13,54,47,0
580,Diego Costa,Atlético Madrid,11.6,17,11,2,10,5,4,15,26.7,11,14,4,10,5,22,3,0
581,Douglas Costa,Juventus,19.9,17,14,10,5,2,8,25,32.0,17,15,0,15,7,24,7,0
582,Filippo Costa,SPAL,16.4,19,12,7,7,5,7,17,41.2,10,23,6,17,22,41,50,0
583,Jaume Costa,Villarreal,28.2,67,43,39,22,6,33,51,64.7,18,30,8,22,46,113,97,0
584,Angelo da Costa Junior,Bologna,4.0,0,0,0,0,0,0,0,0.0,0,0,0,0,0,0,2,0
585,Nuno da Costa,Strasbourg,19.2,50,32,12,29,9,7,35,20.0,28,21,0,21,19,69,9,0
586,Benoit Costil,Bordeaux,36.0,0,0,0,0,0,0,2,0.0,2,0,0,0,3,3,13,4
587,Kalifa Coulibaly,Nantes,3.8,6,6,3,1,2,2,4,50.0,2,0,0,0,0,6,6,0
588,Lassana Coulibaly,Angers,9.3,26,17,13,10,3,10,35,28.6,25,15,1,14,8,34,10,0
589,Thibaut Courtois,Chelsea,35.0,0,0,0,0,0,0,0,0.0,0,0,0,0,0,0,8,1
590,Philippe Coutinho,Liverpool,12.3,17,14,4,10,3,3,21,14.3,18,10,0,10,10,27,5,1
591,Philippe Coutinho,Barcelona,14.4,27,14,8,14,5,9,32,28.1,23,14,0,14,6,33,4,0
592,Nicolas Cozza,Montpellier,6.4,21,11,12,8,1,7,16,43.8,9,5,2,3,13,34,12,0
593,Alessio Cragno,Cagliari,28.2,0,0,0,0,0,0,0,0.0,0,1,0,1,0,0,12,0
594,Martin Cranie,Huddersfield,2.0,3,2,2,1,0,0,1,0.0,1,3,3,0,1,4,10,0
595,Michele Cremonesi,SPAL,4.3,4,2,2,2,0,1,4,25.0,3,5,3,2,7,11,28,0
596,Aaron Cresswell,West Ham,34.1,34,21,12,20,2,19,30,63.3,11,42,17,25,44,78,117,1
598,Lorenzo Crisetig,Bologna,6.2,18,14,8,9,1,7,24,29.2,17,8,2,6,13,31,16,1
599,Bryan Cristante,Atalanta,31.4,66,50,21,32,13,18,59,30.5,41,43,6,37,23,89,27,0
600,Sebastian Cristoforo,Fiorentina,3.0,16,12,6,8,2,9,19,47.4,10,4,0,4,4,20,6,0
601,Enzo Crivelli,Angers,11.4,13,9,2,6,5,1,5,20.0,4,4,0,4,2,15,6,0
602,Enzo Crivelli,Caen,8.1,4,2,2,1,1,1,5,20.0,4,1,0,1,2,6,2,0
603,Giovanni Crociata,Crotone,3.2,9,6,3,4,2,1,4,25.0,3,7,0,7,4,13,3,0
604,Luca Crosta,Cagliari,1.0,0,0,0,0,0,0,0,0.0,0,0,0,0,0,0,1,0
605,Peter Crouch,Stoke City,17.4,2,0,0,1,1,0,12,0.0,12,7,4,3,1,3,31,0
606,Juan Cruz,Málaga,0.1,2,2,0,2,0,0,0,0.0,0,0,0,0,0,2,0,0
607,Juan Cuadrado,Juventus,15.0,28,19,17,9,2,11,27,40.7,16,14,0,14,19,47,14,1
608,Ivan Cuellar,Leganés,35.0,4,3,4,0,0,3,4,75.0,1,0,0,0,3,7,22,6
609,Mickael Cuisance,M'Gladbach,13.4,31,20,16,11,4,19,29,65.5,10,22,4,18,10,41,10,1
610,Josh Cullen,West Ham,0.1,0,0,0,0,0,0,1,0.0,1,1,1,0,2,2,0,0
611,Patrick Cutrone,Milan,16.7,11,10,2,7,2,1,10,10.0,9,11,1,10,3,14,12,0
612,Wylan Cyprien,Nice,10.6,9,7,4,4,1,2,11,18.2,9,7,1,6,11,20,7,2
613,Marco D'Alessandro,Benevento,11.6,31,22,15,9,7,8,24,33.3,16,12,1,11,10,41,8,1
614,Danilo D'Ambrosio,Inter,33.1,82,64,38,35,9,30,59,50.8,29,31,7,24,45,127,68,1
615,Damien Da Silva,Caen,31.5,52,35,40,12,0,20,33,60.6,13,45,25,20,36,88,184,2
616,Kouadio-Yves Dabila,Lille,10.5,20,11,14,4,2,6,10,60.0,4,14,6,8,10,30,46,0
617,Bryan Dabo,Fiorentina,6.6,17,11,6,10,1,6,15,40.0,9,13,1,12,15,32,24,1
618,Bryan Dabo,Saint-Étienne,14.3,25,16,12,10,3,7,29,24.1,22,12,1,11,11,36,22,0
619,Mahmoud Dahoud,Dortmund,12.7,38,23,11,21,6,13,30,43.3,17,18,2,16,12,50,7,0
620,Dario Dainelli,Chievo,16.7,19,14,14,4,1,10,21,47.6,11,27,22,5,46,65,126,0
621,Felipe dal Belo,SPAL,28.6,51,34,32,16,3,25,49,51.0,24,42,24,18,48,99,157,1
622,Charlie Daniels,Bournemouth,33.4,48,34,32,12,4,22,41,53.7,19,34,7,27,31,79,114,0
624,Danilo,Manchester City,15.0,43,29,25,12,6,19,35,54.3,16,15,6,9,19,62,33,0
625,Scott Dann,Crystal Palace,15.9,10,5,8,2,0,7,17,41.2,10,17,14,3,23,33,98,1
626,Kevin Danso,Augsburg,12.3,18,12,13,5,0,12,16,75.0,4,21,14,7,20,38,63,1
627,Dante,Nice,32.4,43,28,32,10,1,21,36,58.3,15,44,25,19,47,90,130,2
628,Romain Danze,Rennes,7.6,12,7,3,4,5,8,13,61.5,5,11,2,9,3,15,34,0
629,Andrea Danzi,Hellas Verona,4.4,11,6,7,4,0,5,13,38.5,8,3,0,3,5,16,5,1
630,Stephane Darbion,Troyes,19.0,19,14,13,4,2,5,40,12.5,35,21,2,19,20,39,17,0
631,Palko Dardai,Hertha BSC,0.3,0,0,0,0,0,0,0,0.0,0,0,0,0,0,0,1,0
632,Sergi Darder,Espanyol,30.9,64,43,29,28,7,19,62,30.6,43,31,5,26,52,116,48,1
633,Sergi Darder,Lyon,2.3,9,3,1,5,3,1,7,14.3,6,0,0,0,3,12,3,0
634,Vladimir Darida,Hertha BSC,18.2,38,28,11,18,9,11,26,42.3,15,22,4,18,24,62,23,0
635,Karl Darlow,Newcastle Utd,10.0,0,0,0,0,0,0,0,0.0,0,0,0,0,0,0,3,4
636,Matteo Darmian,Manchester Utd,4.9,16,14,7,7,2,6,19,31.6,13,5,3,2,7,23,23,0
637,Ben Davies,Tottenham,25.8,47,33,13,21,13,25,48,52.1,23,24,5,19,28,75,70,1
638,Tom Davies,Everton,21.1,30,20,14,11,5,12,54,22.2,42,19,5,14,24,54,21,0
639,Steven Davis,Southampton,16.9,30,21,10,17,3,11,30,36.7,19,22,6,16,15,45,24,1
640,Salem Al-Dawsari,Villarreal,0.4,1,0,0,1,0,1,1,100.0,0,1,0,1,0,1,0,0
641,Craig Dawson,West Brom,27.9,38,28,25,7,6,13,36,36.1,23,39,26,13,52,90,140,0
642,Kevin De Bruyne,Manchester City,34.1,62,43,23,25,14,23,80,28.8,57,45,2,43,25,87,14,2
643,Sebastien De Maio,Bologna,22.8,26,17,15,11,0,10,25,40.0,15,35,18,17,36,62,147,0
644,Rodrigo De Paul,Udinese,25.8,31,18,10,17,4,4,32,12.5,28,34,1,33,16,47,8,0
645,Daniele De Rossi,Roma,20.3,23,13,12,9,2,9,33,27.3,24,18,13,5,43,66,45,2
646,Mattia De Sciglio,Juventus,10.8,22,17,7,13,2,9,13,69.2,4,12,2,10,14,36,32,0
647,Lorenzo De Silvestri,Torino,32.8,39,25,19,13,7,16,26,61.5,10,47,10,37,27,66,165,0
648,Lucas Deaux,Guingamp,21.6,62,45,21,37,4,20,67,29.9,47,41,6,35,32,94,19,0
650,Mathieu Debuchy,Saint-Étienne,14.6,34,25,22,8,4,17,30,56.7,13,16,10,6,27,61,73,0
651,Troy Deeney,Watford,20.5,15,11,3,8,4,3,11,27.3,8,14,1,13,5,20,20,0
652,Jermain Defoe,Bournemouth,12.1,12,9,2,6,4,2,10,20.0,8,10,0,10,4,16,1,0
653,Steven Defour,Burnley,22.2,33,22,12,18,3,10,46,21.7,36,35,7,28,46,79,25,0
654,Gregoire Defrel,Roma,5.4,8,3,1,1,6,2,8,25.0,6,5,0,5,3,11,6,0
655,Alessandro Deiola,Cagliari,5.0,9,7,5,3,1,6,13,46.2,7,8,0,8,4,13,12,0
656,Lorenzo Del Pinto,Benevento,8.4,23,17,10,10,3,7,25,28.0,18,13,4,9,16,39,7,2
657,Damien Delaney,Crystal Palace,1.1,2,1,2,0,0,1,1,100.0,0,5,4,1,3,5,7,0
658,Thomas Delaney,Werder Bremen,31.1,79,61,27,46,6,36,53,67.9,17,37,12,25,43,122,74,4
659,Jonathan Delaplace,Caen,6.5,10,8,1,8,1,3,10,30.0,7,13,5,8,8,18,8,0
660,Cristian Dell'Orco,Sassuolo,4.7,4,1,1,2,1,1,3,33.3,2,5,1,4,10,14,19,0
661,Andy Delort,Toulouse,25.9,20,13,2,9,9,4,19,21.1,15,10,0,10,12,32,22,0
662,Fabian Delph,Manchester City,19.3,46,34,21,16,9,18,37,48.6,19,16,0,16,30,76,42,2
663,Mousa Dembele,Tottenham,20.9,36,24,19,11,6,9,37,24.3,28,20,0,20,33,69,15,0
664,Ousmane Dembele,Barcelona,10.3,10,7,2,5,3,1,13,7.7,12,8,0,8,5,15,2,0
665,Jessy Deminguet,Caen,5.9,12,9,4,6,2,4,14,28.6,10,5,0,5,10,22,13,0
666,Kerem Demirbay,Hoffenheim,13.5,38,30,15,17,6,12,28,42.9,16,21,3,18,14,52,21,0
667,Ermedin Demirovic,Alavés,2.0,1,1,0,1,0,0,1,0.0,1,5,0,5,0,1,2,0
668,Diego Demme,RB Leipzig,25.4,81,57,29,48,4,47,87,54.0,40,31,3,28,48,129,29,0
669,Fabio Depaoli,Chievo,13.2,31,22,21,7,3,21,40,52.5,19,27,10,17,15,46,42,0
670,Mathieu Deplagne,Troyes,26.8,52,38,33,14,5,20,48,41.7,28,26,10,16,60,112,95,2
671,Laurent Depoitre,Huddersfield,20.2,14,8,4,8,2,3,21,14.3,18,15,3,12,11,25,36,0
672,Mike van der Hoorn,Swansea City,21.6,32,22,23,8,1,16,24,66.7,8,24,14,10,39,71,127,0
673,Gregory van der Wiel,Cagliari,3.2,5,3,4,1,0,3,5,60.0,2,1,0,1,10,15,12,0
674,Daniele Dessena,Cagliari,6.4,18,10,12,5,1,6,12,50.0,6,7,1,6,6,24,17,0
676,Mattia Destro,Bologna,18.0,15,13,4,9,2,3,11,27.3,8,10,1,9,5,20,26,0
677,Gerard Deulofeu,Watford,4.8,5,3,2,2,1,2,11,18.2,9,0,0,0,4,9,3,1
678,Gerard Deulofeu,Barcelona,5.6,8,5,6,1,1,3,4,75.0,1,2,0,2,8,16,0,0
679,Gianluca Di Chiara,Benevento,11.2,26,19,18,6,2,7,21,33.3,14,10,3,7,11,37,37,1
680,Federico Di Francesco,Bologna,17.7,26,13,14,8,4,5,20,25.0,15,24,2,22,16,42,25,0
681,Davide Di Gennaro,Lazio,0.1,1,0,1,0,0,1,1,100.0,0,0,0,0,0,1,0,0
682,Angel Di Maria,Paris S-G,23.5,13,10,5,3,5,7,39,17.9,32,18,2,16,10,23,8,0
683,Franco Di Santo,Schalke 04,18.4,17,13,3,13,1,7,15,46.7,8,12,1,11,2,19,24,0
684,Cheick Diabate,Benevento,7.4,1,1,0,1,0,1,3,33.3,2,2,0,2,0,1,6,0
685,Fousseni Diabate,Leicester City,6.5,9,6,5,3,1,1,4,25.0,3,6,0,6,8,17,8,0
686,Moussa Diaby,Crotone,0.8,1,0,1,0,0,1,4,25.0,3,1,0,1,1,2,0,0
687,Fallou Diagne,Metz,24.9,33,20,21,12,0,7,22,31.8,15,33,18,15,46,79,116,3
688,Adama Diakhaby,Monaco,9.4,23,15,6,12,5,6,16,37.5,10,13,0,13,13,36,5,0
689,Mouctar Diakhaby,Lyon,8.1,10,6,7,3,0,4,7,57.1,3,14,9,5,12,22,52,1
690,Abdou Diallo,Mainz 05,26.8,75,53,45,25,5,38,50,76.0,12,37,14,23,50,125,75,0
691,Abdoulaye Diallo,Rennes,3.0,0,0,0,0,0,0,0,0.0,0,0,0,0,0,0,4,1
692,Habib Diallo,Metz,0.2,0,0,0,0,0,0,0,0.0,0,0,0,0,0,0,0,0
693,Mustapha Diallo,Guingamp,15.4,48,36,15,29,4,15,33,45.5,18,20,4,16,20,68,29,0
694,Mohamed Diame,Newcastle Utd,22.7,89,64,33,48,8,16,62,25.8,46,44,7,37,48,137,30,2
695,Lassana Diarra,Paris S-G,6.7,12,4,4,7,1,8,12,66.7,4,3,1,2,6,18,6,0
696,Amadou Diawara,Napoli,7.3,11,9,3,7,1,1,7,14.3,6,12,2,10,9,20,5,0
697,Brahim Diaz,Manchester City,0.6,1,0,1,0,0,0,0,0.0,0,3,0,3,1,2,0,0
698,Bakaye Dibassy,Amiens,30.9,71,51,45,22,4,24,50,48.0,26,52,26,26,58,129,148,0
699,Daniel Didavi,Wolfsburg,24.9,34,19,10,19,5,14,33,42.4,19,20,1,19,7,41,12,0
700,Thomas Didillon,Metz,9.0,0,0,0,0,0,0,1,0.0,1,0,0,0,0,0,5,2
702,Etienne Didot,Guingamp,18.0,54,33,20,33,1,20,43,46.5,23,21,7,14,19,73,29,0
703,Adrian Dieguez,Alavés,4.8,10,5,5,5,0,6,13,46.2,7,5,0,5,11,21,24,1
704,Dennis Diekmeier,Hamburger SV,20.8,47,43,31,10,6,25,36,69.4,11,22,11,11,16,63,50,0
705,Eric Dier,Tottenham,31.4,61,43,15,39,7,17,42,40.5,25,32,11,21,48,109,93,7
706,Lucas Digne,Barcelona,7.8,22,17,13,6,3,8,12,66.7,4,15,3,12,12,34,18,0
707,Landry Dimata,Wolfsburg,10.0,7,6,4,3,0,5,6,83.3,1,6,2,4,2,9,5,0
708,Tristan Dingome,Troyes,13.2,25,20,12,9,4,5,13,38.5,8,12,0,12,12,37,16,1
709,Ismael Diomande,Caen,7.9,14,8,7,6,1,10,15,66.7,5,11,5,6,5,19,20,0
710,Lois Diony,Saint-Étienne,10.3,3,0,1,2,0,0,3,0.0,3,5,1,4,1,4,8,0
711,Issa Diop,Toulouse,34.0,58,43,35,22,1,21,48,43.8,27,38,25,13,76,134,128,0
712,Papakouli Diop,Espanyol,2.9,5,3,1,3,1,0,3,0.0,3,5,2,3,6,11,6,0
713,Papakouli Diop,Eibar,10.4,26,20,6,16,4,11,26,42.3,15,3,0,3,13,39,10,0
714,Assane Diousse,Saint-Étienne,14.9,32,21,14,14,4,13,34,38.2,21,29,2,27,11,43,16,2
715,Djene,Getafe,36.0,87,65,71,15,1,34,52,65.4,18,33,14,19,78,165,190,1
716,Koffi Djidji,Nantes,26.8,55,39,32,20,3,19,29,65.5,10,34,15,19,45,100,126,0
717,Alexander Djiku,Caen,28.0,65,43,52,11,2,25,52,48.1,27,34,5,29,57,122,155,2
718,Papy Djilobodji,Dijon,30.0,45,29,34,11,0,21,43,48.8,22,38,25,13,71,116,211,5
719,Berat Djimsiti,Benevento,30.0,32,17,28,4,0,12,30,40.0,18,37,23,14,62,94,178,1
720,Marko Dmitrovic,Eibar,36.0,4,4,4,0,0,4,11,36.4,7,1,0,1,2,6,26,2
721,Keagan Dolly,Montpellier,9.8,12,7,2,7,3,1,11,9.1,10,11,0,11,1,13,2,0
722,Jaume Domenech,Valencia,5.0,0,0,0,0,0,0,0,0.0,0,0,0,0,0,0,2,0
723,Jean-Luc Dompe,Amiens,0.3,0,0,0,0,0,0,0,0.0,0,0,0,0,0,0,0,0
724,Giulio Donati,Mainz 05,25.4,56,42,30,21,5,34,50,68.0,16,38,8,30,35,91,66,1
725,Ji Dong-won,Augsburg,0.2,2,1,0,1,1,0,0,0.0,0,1,1,0,1,3,0,0
726,Anastasios Donis,Stuttgart,10.5,20,14,10,6,4,6,8,75.0,2,2,0,2,9,29,7,0
728,Gianluigi Donnarumma,Milan,38.0,1,0,1,0,0,1,1,100.0,0,0,0,0,1,2,13,8
729,Godfred Donsah,Bologna,19.9,29,20,11,14,4,10,17,58.8,7,25,0,25,22,51,43,0
730,Doria,Marseille,0.9,2,2,0,2,0,0,0,0.0,0,3,1,2,1,3,1,0
731,Niklas Dorsch,Bayern Munich,1.0,1,1,0,1,0,0,2,0.0,2,0,0,0,1,2,0,0
732,Gabriel Dos Santos,Troyes,0.9,1,1,1,0,0,0,1,0.0,1,2,1,1,0,1,4,1
733,Mauro dos Santos,Leganés,10.9,16,14,11,5,0,10,15,66.7,5,7,5,2,12,28,53,1
734,Mathieu Dossevi,Metz,27.9,35,25,15,15,5,7,39,17.9,32,24,3,21,28,63,12,0
735,Abdoulaye Doucoure,Watford,36.9,79,52,28,42,9,27,79,34.2,52,43,10,33,54,133,61,0
736,Cheick Doukoure,Levante,11.4,34,19,18,15,1,6,22,27.3,16,15,4,11,14,48,4,0
737,Mohamed Drager,Freiburg,0.6,0,0,0,0,0,0,1,0.0,1,1,0,1,0,0,0,0
738,Aleksandar Dragovic,Leicester City,8.5,13,10,13,0,0,7,13,53.8,6,16,8,8,16,29,46,0
739,Aleksandar Dragovic,Leverkusen,0.5,0,0,0,0,0,0,1,0.0,1,0,0,0,0,0,0,1
740,Bartlomiej Dragowski,Fiorentina,2.4,0,0,0,0,0,0,0,0.0,0,0,0,0,0,0,0,1
741,Boukary Drame,SPAL,1.1,1,1,1,0,0,0,0,0.0,0,0,0,0,2,3,4,0
742,Julian Draxler,Paris S-G,18.9,20,14,4,13,3,6,32,18.8,26,18,2,16,28,48,8,0
743,Danny Drinkwater,Chelsea,5.9,15,10,6,8,1,3,17,17.6,14,10,2,8,8,23,7,0
744,Josip Drmic,M'Gladbach,5.2,0,0,0,0,0,0,4,0.0,4,1,0,1,0,0,1,1
745,Rick van Drongelen,Hamburger SV,16.0,30,25,23,7,0,21,28,75.0,7,20,11,9,19,49,58,1
746,Oscar Duarte,Espanyol,11.0,12,9,8,4,0,4,11,36.4,7,8,8,0,9,21,60,2
747,Ruben Duarte,Alavés,23.8,76,40,42,27,7,35,59,59.3,24,40,10,30,44,120,94,0
748,Leo Dubois,Nantes,33.6,50,39,33,15,2,20,47,42.6,27,47,13,34,50,100,99,2
749,Martin Dubravka,Newcastle Utd,12.0,0,0,0,0,0,0,0,0.0,0,0,0,0,0,0,3,2
750,Ondrej Duda,Hertha BSC,8.3,16,12,7,6,3,6,14,42.9,8,15,0,15,4,20,8,0
751,Shane Duffy,Brighton,36.6,31,19,22,9,0,7,20,35.0,13,66,59,7,50,81,332,5
752,Paul Dummett,Newcastle Utd,17.8,28,19,21,7,0,13,27,48.1,14,27,10,17,23,51,107,1
754,Alfred Duncan,Sassuolo,21.6,39,29,16,18,5,15,52,28.8,37,32,2,30,19,58,29,1
755,Lewis Dunk,Brighton,38.0,67,33,49,18,0,25,48,52.1,23,73,58,15,71,138,230,2
756,Maxime Dupe,Nantes,1.0,0,0,0,0,0,0,0,0.0,0,0,0,0,0,0,2,0
757,Jimmy Durmaz,Toulouse,11.4,16,9,5,5,6,6,14,42.9,8,2,0,2,14,30,9,0
758,Riza Durmisi,Betis,23.1,39,21,24,14,1,10,18,55.6,8,18,7,11,15,54,65,1
759,Hugo Duro,Getafe,0.2,0,0,0,0,0,0,1,0.0,1,0,0,0,0,0,0,0
760,Noe Dussenne,Crotone,0.9,2,0,2,0,0,0,0,0.0,0,0,0,0,1,3,8,0
761,Paulo Dybala,Juventus,26.1,19,11,4,10,5,4,32,12.5,28,22,0,22,12,31,4,0
762,Nathan Dyer,Swansea City,14.5,22,16,8,9,5,6,24,25.0,18,13,0,13,11,33,3,0
763,Edin Dzeko,Roma,33.5,15,10,1,9,5,3,15,20.0,12,9,1,8,4,19,36,0
764,Blerim Dzemaili,Bologna,13.3,27,19,11,15,1,9,27,33.3,18,15,4,11,18,45,11,0
765,Felix Eboa Eboa,Guingamp,16.9,19,11,12,7,0,8,16,50.0,8,21,11,10,39,58,119,2
766,Eder,Inter,8.9,10,7,2,4,4,0,10,0.0,10,6,1,5,5,15,4,0
767,Simone Edera,Torino,3.6,6,2,2,4,0,3,10,30.0,7,0,0,0,2,8,1,0
768,Ederson,Manchester City,35.5,1,1,1,0,0,0,0,0.0,0,1,0,1,0,1,15,6
769,Tom Edwards,Stoke City,5.3,15,9,10,5,0,8,8,100.0,0,5,2,3,5,20,20,0
770,Mandela Egbo,M'Gladbach,0.1,0,0,0,0,0,0,0,0.0,0,0,0,0,0,0,2,0
771,Johannes Eggestein,Werder Bremen,1.1,0,0,0,0,0,0,1,0.0,1,2,1,1,1,1,0,0
772,Maximilian Eggestein,Werder Bremen,29.9,70,48,32,34,4,34,58,58.6,24,41,6,35,40,110,51,0
773,Albin Ekdal,Hamburger SV,12.3,39,28,19,19,1,18,29,62.1,11,20,3,17,21,60,19,0
774,Josip Elez,Hannover 96,8.6,12,8,9,2,1,5,9,55.6,4,9,7,2,16,28,39,1
775,Rob Elliot,Newcastle Utd,16.0,0,0,0,0,0,0,1,0.0,1,0,0,0,0,0,8,0
776,Mohamed Elneny,Arsenal,9.6,12,6,6,3,3,6,10,60.0,4,11,0,11,10,22,12,2
777,Aritz Elustondo,Real Sociedad,17.7,32,20,20,9,3,19,30,63.3,11,20,7,13,45,77,84,0
778,Nico Elvedi,M'Gladbach,32.4,66,46,41,22,3,37,55,67.3,18,39,9,30,51,117,108,3
780,Rodrigo Ely,Alavés,29.9,32,18,26,6,0,19,34,55.9,15,45,36,9,50,82,183,0
781,Breel Embolo,Schalke 04,10.2,14,10,3,7,4,2,9,22.2,7,13,0,13,6,20,3,0
782,Youssef En-Nesyri,Málaga,17.7,31,25,10,14,7,6,26,23.1,20,11,0,11,9,40,32,0
783,Sergi Enrich,Eibar,14.8,11,8,3,3,5,2,8,25.0,6,13,1,12,6,17,8,0
784,Javier Eraso,Leganés,28.1,32,15,10,18,4,13,42,31.0,29,16,5,11,23,55,17,0
785,Christian Eriksen,Tottenham,35.8,51,29,16,30,5,17,59,28.8,42,38,1,37,31,82,21,0
786,Gonzalo Escalante,Eibar,17.4,59,35,21,32,6,17,39,43.6,22,26,3,23,32,91,19,0
787,Sergio Escudero,Sevilla,25.9,78,49,40,26,12,32,62,51.6,30,35,6,29,66,144,69,1
788,Bernardo Espinosa,Girona,31.9,36,22,29,6,1,18,33,54.5,15,27,19,8,66,102,169,0
789,Michael Esser,Hannover 96,3.0,0,0,0,0,0,0,1,0.0,1,0,0,0,0,0,0,0
790,Alexander Esswein,Hertha BSC,6.9,25,16,13,10,2,12,25,48.0,13,4,0,4,9,34,11,0
791,Oghenekaro Etebo,Las Palmas,13.5,24,17,9,12,3,12,26,46.2,14,17,3,14,27,51,10,0
792,Benat Etxebarria,Athletic Club,12.4,28,20,12,13,3,13,36,36.1,23,6,1,5,28,56,12,0
793,Xabier Etxeita,Athletic Club,4.2,2,2,2,0,0,1,4,25.0,3,3,2,1,7,9,25,1
794,Jonny Evans,West Brom,25.2,29,22,19,8,2,14,33,42.4,19,22,13,9,48,77,131,1
795,Franck Evina,Bayern Munich,1.2,2,2,2,0,0,2,2,100.0,0,5,0,5,0,2,0,0
796,Patrice Evra,West Ham,2.5,6,4,5,1,0,6,8,75.0,2,4,1,3,7,13,6,0
797,Patrice Evra,Marseille,3.9,6,5,5,1,0,3,6,50.0,3,2,2,0,3,9,16,0
798,Edu Exposito,La Coruña,1.1,1,0,0,0,1,0,1,0.0,1,1,0,1,2,3,2,0
799,Erik Exposito,Las Palmas,5.2,1,1,0,1,0,0,6,0.0,6,6,0,6,1,2,5,0
800,Valentin Eysseric,Fiorentina,7.8,17,13,7,4,6,6,20,30.0,14,10,2,8,6,23,6,0
801,Valentin Eysseric,Nice,1.0,0,0,0,0,0,0,0,0.0,0,4,0,4,1,1,0,0
802,Imoh Ezekiel,Las Palmas,5.2,8,6,3,2,3,3,4,75.0,1,4,0,4,2,10,3,0
803,Marco Fabian,Eint Frankfurt,4.7,5,3,2,3,0,3,4,75.0,1,2,0,2,3,8,1,0
804,Lukasz Fabianski,Swansea City,38.0,0,0,0,0,0,0,0,0.0,0,0,0,0,0,0,10,2
806,Fabinho,Monaco,34.0,114,64,38,67,9,48,112,42.9,64,48,13,35,43,157,62,0
807,Cesc Fabregas,Chelsea,25.6,68,49,30,29,9,18,69,26.1,51,25,4,21,22,90,26,2
808,Ralf Fahrmann,Schalke 04,33.5,1,0,1,0,0,1,3,33.3,2,1,0,1,1,2,12,7
809,Faycal Fajr,Getafe,26.5,62,45,22,34,6,17,66,25.8,49,26,4,22,30,92,42,0
810,Radamel Falcao,Monaco,23.7,11,6,0,8,3,2,13,15.4,11,13,3,10,10,21,11,0
811,Diego Falcinelli,Fiorentina,4.9,1,1,1,0,0,0,5,0.0,5,5,1,4,1,2,4,0
812,Diego Falcinelli,Sassuolo,14.6,4,4,1,2,1,1,13,7.7,12,12,2,10,2,6,9,0
813,Simon Falette,Metz,1.0,0,0,0,0,0,0,0,0.0,0,0,0,0,1,1,8,0
814,Simon Falette,Eint Frankfurt,24.6,34,30,23,10,1,19,31,61.3,12,37,15,22,58,92,134,1
815,Cesar Falletti,Bologna,3.6,11,7,4,6,1,4,8,50.0,4,10,0,10,0,11,5,0
816,Iago Falque,Torino,31.3,41,31,15,20,6,6,43,14.0,37,22,0,22,15,56,15,0
817,Paolo Farago,Cagliari,27.3,92,67,53,24,15,24,60,40.0,36,41,5,36,23,115,76,0
818,Imad Faraj,Lille,1.8,5,2,2,1,2,4,8,50.0,4,1,0,1,4,9,3,0
819,Davide Faraoni,Crotone,19.5,62,39,36,20,6,28,47,59.6,19,30,8,22,58,120,76,0
820,Mohamed Fares,Hellas Verona,28.9,50,33,29,17,4,16,42,38.1,26,24,5,19,50,100,132,2
821,Diego Farias,Cagliari,17.9,21,15,3,9,9,6,24,25.0,18,17,0,17,8,29,6,0
822,Federico Fazio,Roma,32.5,56,43,38,18,0,25,31,80.6,6,30,22,8,46,102,161,3
823,Zouhair Feddal,Betis,14.0,22,14,14,6,2,7,12,58.3,5,17,13,4,36,58,95,2
824,Nabil Fekir,Lyon,27.5,45,33,11,24,10,8,40,20.0,32,11,0,11,8,53,5,0
825,Felipe,Hannover 96,5.1,8,8,4,4,0,2,4,50.0,2,4,3,1,11,19,29,0
826,Luiz Felipe,Lazio,13.0,40,28,24,16,0,15,25,60.0,10,26,14,12,18,58,50,1
827,Ohis Felix Uduokhai,Wolfsburg,17.3,42,23,27,13,2,17,24,70.8,7,23,10,13,34,76,66,6
828,Marouane Fellaini,Manchester Utd,7.6,15,8,6,8,1,2,11,18.2,9,12,3,9,14,29,19,1
829,Kiko Femenia,Watford,19.0,36,28,22,11,3,14,27,51.9,13,15,2,13,34,70,31,1
830,Leroy Fer,Swansea City,15.5,44,32,18,21,5,13,30,43.3,17,18,4,14,12,56,24,3
832,Julien Feret,Caen,34.0,40,27,10,25,5,14,75,18.7,61,52,7,45,49,89,58,2
833,Edimilson Fernandes,West Ham,9.4,17,9,10,7,0,9,21,42.9,12,13,1,12,16,33,8,0
834,Gelson Fernandes,Eint Frankfurt,11.5,58,46,25,29,4,23,45,51.1,22,23,3,20,16,74,21,0
835,Andres Fernandez,Villarreal,2.5,1,0,1,0,0,0,0,0.0,0,0,0,0,0,1,4,0
836,Augusto Fernandez,Atlético Madrid,1.2,3,2,1,2,0,1,3,33.3,2,3,2,1,2,5,3,0
837,Brian Fernandez,Metz,1.4,0,0,0,0,0,0,1,0.0,1,2,0,2,0,0,0,0
838,Carlos Fernandez,Sevilla,1.5,2,1,1,1,0,0,2,0.0,2,1,0,1,0,2,0,0
839,Federico Fernandez,Swansea City,29.7,40,29,30,6,4,20,30,66.7,10,35,27,8,38,78,201,1
840,Raul Fernandez,Levante,11.0,0,0,0,0,0,0,0,0.0,0,1,0,1,0,0,10,1
841,Fernandinho,Manchester City,32.0,62,35,22,28,12,24,65,36.9,41,38,6,32,47,109,68,2
842,Alex Ferrari,Hellas Verona,23.7,73,54,42,23,8,36,67,53.7,31,41,15,26,47,120,117,4
843,Jordan Ferri,Lyon,7.1,20,11,8,11,1,7,20,35.0,13,11,1,10,5,25,11,2
844,Sam Field,West Brom,6.0,14,11,8,4,2,3,10,30.0,7,6,1,5,11,25,8,0
845,Afonso Figueiredo,Rennes,2.5,6,3,3,3,0,3,5,60.0,2,0,0,0,0,6,4,0
846,Gian Filippo Felicioli,Hellas Verona,3.1,13,8,5,5,3,0,4,0.0,4,0,0,0,5,18,6,0
847,Alfred Finnbogason,Augsburg,20.2,18,13,7,5,6,8,15,53.3,7,15,1,14,14,32,7,0
848,Roberto Firmino,Liverpool,30.7,65,50,9,36,20,8,58,13.8,50,40,2,38,18,83,10,0
849,Junior Firpo,Betis,13.2,26,17,15,8,3,10,18,55.6,8,21,2,19,20,46,37,1
850,Viktor Fischer,Mainz 05,3.7,4,4,2,1,1,2,5,40.0,3,2,0,2,3,7,2,0
851,Mathieu Flamini,Getafe,5.3,11,5,3,7,1,4,9,44.4,5,2,0,2,8,19,8,0
852,Darren Fletcher,Stoke City,24.7,47,26,23,20,4,15,55,27.3,40,13,3,10,26,73,33,3
853,Sergio Floccari,SPAL,9.8,13,9,7,5,1,6,11,54.5,5,6,1,5,2,15,6,0
854,Alessandro Florenzi,Roma,26.5,38,28,20,13,5,18,47,38.3,29,19,8,11,44,82,62,1
855,Phil Foden,Manchester City,0.5,1,1,0,1,0,0,1,0.0,1,0,0,0,0,1,1,0
856,Guessouma Fofana,Amiens,8.3,20,13,8,12,0,6,13,46.2,7,7,1,6,12,32,11,0
858,Seko Fofana,Udinese,20.8,20,17,8,12,0,4,20,20.0,16,17,3,14,27,47,26,1
859,Andreu Fontas,Celta Vigo,9.8,13,9,8,5,0,3,13,23.1,10,9,5,4,14,27,30,0
860,Jose Fonte,West Ham,7.6,11,6,5,6,0,2,6,33.3,4,12,9,3,14,25,37,1
861,Pablo Fornals,Villarreal,29.1,52,33,19,26,7,18,60,30.0,42,29,3,26,22,74,18,0
862,Emil Forsberg,RB Leipzig,15.2,24,17,3,15,6,9,21,42.9,12,19,1,18,8,32,4,0
863,Fraser Forster,Southampton,20.0,0,0,0,0,0,0,0,0.0,0,0,0,0,0,0,7,4
864,Steven Fortes,Toulouse,1.7,4,2,3,1,0,1,3,33.3,2,0,0,0,3,7,6,0
865,Marco Fossati,Hellas Verona,12.2,27,13,11,14,2,11,33,33.3,22,19,6,13,23,50,31,1
866,Iver Fossum,Hannover 96,14.5,27,19,8,13,6,10,31,32.3,21,28,3,25,15,42,14,0
867,Ben Foster,West Brom,37.0,1,0,1,0,0,0,7,0.0,7,0,0,0,1,2,12,1
868,Timothy Fosu-Mensah,Crystal Palace,17.7,42,33,33,8,1,21,34,61.8,13,17,9,8,31,73,74,1
869,Dimitri Foulquier,Strasbourg,13.8,25,12,15,8,2,7,17,41.2,10,15,4,11,14,39,33,0
870,Lilian Fournier,Metz,0.2,0,0,0,0,0,0,0,0.0,0,0,0,0,0,0,0,0
871,Raphael Framberger,Augsburg,7.7,22,18,14,6,2,15,16,93.8,1,12,3,9,14,36,15,0
872,Simon Francis,Bournemouth,30.1,49,34,26,16,7,24,43,55.8,19,29,18,11,49,98,194,4
873,Mike Frantz,Freiburg,11.6,23,16,9,11,3,6,16,37.5,10,13,3,10,13,36,15,0
874,Ryan Fraser,Bournemouth,22.3,11,8,7,2,2,7,20,35.0,13,20,4,16,17,28,34,0
875,Fabian Frei,Mainz 05,8.9,22,15,7,12,3,8,15,53.3,7,10,0,10,16,38,17,1
876,Remo Freuler,Atalanta,33.4,89,62,35,41,13,27,82,32.9,55,46,13,33,28,117,37,2
877,Marco Friedl,Werder Bremen,6.7,9,8,4,4,1,7,10,70.0,3,10,1,9,8,17,17,1
878,Marco Friedl,Bayern Munich,0.5,0,0,0,0,0,0,0,0.0,0,1,0,1,1,1,0,0
879,Christian Fuchs,Leicester City,21.3,41,27,25,12,4,14,40,35.0,26,23,3,20,58,99,86,0
880,Javi Fuego,Villarreal,6.0,20,13,8,11,1,7,14,50.0,7,7,4,3,3,23,14,0
881,Javi Fuego,Espanyol,14.9,34,25,19,12,3,11,28,39.3,17,15,6,9,19,53,23,0
882,Chris Fuhrich,Köln,1.1,4,3,1,2,1,2,5,40.0,3,3,0,3,0,4,1,0
884,Angelo Fulgini,Angers,17.0,21,11,9,8,4,8,27,29.6,19,21,2,19,20,41,7,0
885,Niclas Fullkrug,Hannover 96,26.5,16,11,4,8,4,10,20,50.0,10,22,3,19,8,24,30,0
886,Jay Fulton,Swansea City,0.2,0,0,0,0,0,0,0,0.0,0,0,0,0,0,0,1,0
887,Ramiro Funes Mori,Everton,1.3,0,0,0,0,0,0,0,0.0,0,1,1,0,3,3,14,0
888,Manolo Gabbiadini,Southampton,12.0,3,2,0,2,1,1,15,6.7,14,3,0,3,4,7,6,0
889,Gabi,Atlético Madrid,26.1,80,49,39,37,4,38,104,36.5,66,28,10,18,44,124,38,0
890,Gabriel,Leganés,26.4,90,69,28,54,8,29,74,39.2,45,38,4,34,38,128,27,0
891,Mijat Gacinovic,Eint Frankfurt,20.2,56,44,21,27,8,20,52,38.5,32,38,1,37,39,95,22,1
892,Roberto Gagliardini,Inter,22.1,63,45,28,29,6,20,54,37.0,34,18,3,15,45,108,32,2
893,Nicolas Gaitan,Atlético Madrid,2.4,9,6,3,5,1,3,9,33.3,6,2,0,2,1,10,3,0
894,Milan Gajic,Bordeaux,4.0,6,3,4,2,0,2,4,50.0,2,7,0,7,4,10,14,0
895,Serge Gakpe,Amiens,20.3,16,11,9,7,0,6,27,22.2,21,18,1,17,10,26,15,0
896,Andrey Galabinov,Genoa,12.5,7,5,0,5,2,0,5,0.0,5,17,1,16,2,9,11,0
897,Alex Galvez,Las Palmas,18.0,50,36,26,24,0,22,41,53.7,19,20,11,9,43,93,74,2
898,Alex Galvez,Eibar,4.0,11,4,5,6,0,7,12,58.3,5,5,1,4,13,24,17,0
899,Bruno Gama,La Coruña,1.3,1,1,1,0,0,1,3,33.3,2,0,0,0,0,1,2,0
900,Alessandro Gamberini,Chievo,20.2,13,8,11,2,0,8,12,66.7,4,32,25,7,16,29,117,1
901,Kevin Gameiro,Atlético Madrid,12.5,11,9,3,4,4,1,10,10.0,9,6,0,6,4,15,11,0
902,Jesus Gamez,Newcastle Utd,1.1,4,2,1,0,3,1,3,33.3,2,2,0,2,2,6,5,0
903,Idrissa Gana Gueye,Everton,30.6,117,93,65,41,11,35,86,40.7,51,59,9,50,62,179,48,1
904,Ignatius Ganago,Nice,0.8,0,0,0,0,0,0,2,0.0,2,1,0,1,0,0,1,0
905,Najib Gandi,Nantes,1.1,6,5,3,2,1,4,6,66.7,2,4,1,3,4,10,3,0
906,Ganso,Sevilla,5.8,15,11,3,12,0,3,11,27.3,8,7,0,7,2,17,4,0
907,Ezequiel Garay,Valencia,22.5,18,12,15,3,0,10,14,71.4,4,22,11,11,24,42,139,0
908,Aleix Garcia,Girona,9.5,24,14,13,9,2,12,22,54.5,10,9,1,8,17,41,12,0
910,Borja Garcia,Girona,31.1,39,18,15,18,6,13,39,33.3,26,31,2,29,30,69,15,0
911,Dani Garcia,Eibar,30.8,80,59,23,47,10,31,80,38.8,49,28,4,24,70,150,25,0
912,David Garcia,Las Palmas,9.6,16,10,10,4,2,8,12,66.7,4,15,8,7,19,35,33,1
913,Javi Garcia,Betis,26.8,34,22,18,16,0,13,40,32.5,27,19,12,7,25,59,78,1
914,Manu Garcia,Alavés,27.1,95,65,38,51,6,24,89,27.0,65,34,11,23,35,130,67,0
915,Raul Garcia,Athletic Club,29.2,82,51,28,36,18,26,71,36.6,45,55,3,52,30,112,23,0
916,Raul Garcia,Leganés,15.5,34,25,24,9,1,18,30,60.0,12,18,3,15,19,53,50,1
917,Samu Garcia,Málaga,2.0,8,6,4,3,1,3,10,30.0,7,4,0,4,6,14,3,0
918,Samu Garcia,Levante,2.1,9,7,1,6,2,2,5,40.0,3,3,0,3,1,10,2,0
919,Sergio Garcia,Espanyol,18.2,15,12,1,10,4,3,22,13.6,19,6,3,3,10,25,12,0
920,Ulisses Garcia,Werder Bremen,1.0,1,1,1,0,0,1,2,50.0,1,0,0,0,0,1,3,0
921,Luca Garritano,Chievo,2.1,4,3,2,1,1,0,4,0.0,4,3,1,2,1,5,6,0
922,Bruno Gaspar,Fiorentina,8.7,20,11,13,6,1,9,15,60.0,6,8,1,7,9,29,25,0
923,Mario Gaspar,Villarreal,31.2,110,66,63,37,10,58,87,66.7,29,58,11,47,58,168,114,0
924,Gianluca Gaudino,Chievo,0.2,0,0,0,0,0,0,0,0.0,0,1,0,1,0,0,1,0
925,Dwight Gayle,Newcastle Utd,21.8,12,10,2,8,2,1,21,4.8,20,16,2,14,6,18,17,0
926,Paulo Gazzaniga,Tottenham,1.0,0,0,0,0,0,0,1,0.0,1,0,0,0,0,0,0,0
927,Marcello Gazzola,Sassuolo,8.2,10,9,3,6,1,8,12,66.7,4,10,2,8,8,18,25,0
928,Jean-Philippe Gbamin,Mainz 05,28.8,78,63,48,26,4,43,65,66.2,22,50,10,40,50,128,80,0
929,David de Gea,Manchester Utd,37.0,0,0,0,0,0,0,1,0.0,1,1,0,1,0,0,9,3
930,Theodor Gebre Selassie,Werder Bremen,31.4,67,41,36,25,6,36,57,63.2,21,34,2,32,51,118,83,1
931,Dennis Geiger,Hoffenheim,17.6,52,36,19,31,2,16,40,40.0,24,38,2,36,15,67,7,0
932,Johannes Geis,Sevilla,7.5,20,15,12,7,1,11,21,52.4,10,13,5,8,10,30,27,1
933,Jeremy Gelin,Rennes,25.7,37,18,22,14,1,20,53,37.7,33,22,12,10,37,74,92,3
934,Romain Genevois,Caen,20.1,48,28,27,13,8,21,39,53.8,18,25,11,14,31,79,76,0
936,Santiago Gentiletti,Genoa,3.2,4,3,4,0,0,1,6,16.7,5,1,0,1,3,7,11,1
937,Christian Gentner,Stuttgart,26.8,91,67,35,44,12,44,84,52.4,40,41,5,36,35,126,52,0
938,Yannick Gerhardt,Wolfsburg,13.6,37,28,18,14,5,22,34,64.7,12,25,5,20,15,52,31,0
939,Valere Germain,Marseille,24.1,16,11,5,7,4,3,18,16.7,15,11,0,11,6,22,19,0
940,Gerson,Roma,10.1,20,12,10,8,2,2,7,28.6,5,15,2,13,11,31,11,1
941,Willem Geubbels,Lyon,0.4,2,2,1,1,0,0,1,0.0,1,0,0,0,0,2,0,0
942,Yassine El Ghanassy,Nantes,7.2,7,4,1,3,3,1,4,25.0,3,1,0,1,4,11,4,0
943,Anwar El Ghazi,Lille,18.3,23,18,7,13,3,9,29,31.0,20,11,1,10,7,30,7,1
944,Rachid Ghezzal,Monaco,11.2,31,24,6,22,3,7,34,20.6,27,17,0,17,11,42,2,1
945,Faouzi Ghoulam,Napoli,10.9,8,4,3,5,0,4,6,66.7,2,10,2,8,15,23,19,0
946,Emanuele Giaccherini,Chievo,10.0,7,4,4,2,1,5,25,20.0,20,9,3,6,5,12,6,0
947,Emanuele Giaccherini,Napoli,0.7,1,1,0,1,0,0,0,0.0,0,0,0,0,0,1,0,0
948,Niccolo Giannetti,Cagliari,3.3,5,4,2,3,0,2,6,33.3,4,1,0,1,1,6,3,0
949,Kieran Gibbs,West Brom,31.4,41,24,27,10,4,16,30,53.3,14,32,12,20,48,89,102,0
950,Rafal Gikiewicz,Freiburg,1.7,0,0,0,0,0,0,0,0.0,0,0,0,0,0,0,0,0
951,Carles Gil,La Coruña,5.3,6,4,1,4,1,1,5,20.0,4,5,0,5,4,10,0,0
952,Nacho Gil,Las Palmas,8.1,10,6,6,2,2,5,21,23.8,16,9,0,9,6,16,2,0
953,Nacho Gil,Valencia,2.5,6,1,2,4,0,1,8,12.5,7,6,0,6,2,8,2,0
954,Guillaume Gillet,Nantes,0.2,0,0,0,0,0,0,0,0.0,0,1,1,0,0,0,0,0
955,Dani Gimenez,Betis,3.4,0,0,0,0,0,0,0,0.0,0,0,0,0,0,0,0,0
956,Daniel Ginczek,Stuttgart,16.9,8,4,3,5,0,2,12,16.7,10,16,1,15,5,13,13,0
957,Matthias Ginter,M'Gladbach,34.0,48,37,27,20,1,35,45,77.8,10,40,17,23,40,88,114,1
958,Jimmy Giraudon,Troyes,23.2,26,16,20,6,0,10,16,62.5,6,30,22,8,31,57,128,2
959,Thibault Giresse,Guingamp,0.3,0,0,0,0,0,0,0,0.0,0,0,0,0,1,1,0,0
960,Andrei Girotto,Nantes,16.9,57,38,15,37,5,21,52,40.4,31,32,7,25,15,72,45,1
962,Olivier Giroud,Arsenal,4.3,5,4,1,2,2,1,5,20.0,4,1,0,1,1,6,4,0
963,Olivier Giroud,Chelsea,6.8,4,3,1,2,1,1,3,33.3,2,0,0,0,1,5,5,0
964,Kamil Glik,Monaco,36.0,36,23,22,12,2,15,29,51.7,14,28,18,10,54,90,279,2
965,Serge Gnabry,Hoffenheim,16.7,32,22,10,18,4,13,24,54.2,11,15,1,14,8,40,9,2
966,Joris Gnagnon,Rennes,32.4,42,29,29,9,4,21,31,67.7,10,22,16,6,29,71,154,2
967,Massimo Gobbi,Chievo,22.8,24,18,13,9,2,11,26,42.3,15,20,5,15,22,46,90,1
968,Diego Godin,Atlético Madrid,28.4,50,33,37,11,2,26,47,55.3,21,33,20,13,59,109,145,1
969,Edoardo Goldaniga,Sassuolo,12.8,14,8,10,4,0,5,9,55.6,4,10,5,5,19,33,56,0
970,Connor Goldson,Brighton,2.2,2,2,1,1,0,1,4,25.0,3,3,3,0,1,3,9,0
971,Pierluigi Gollini,Atalanta,6.9,0,0,0,0,0,0,0,0.0,0,0,0,0,0,0,1,0
972,Andre Gomes,Barcelona,7.1,19,12,8,10,1,5,13,38.5,8,7,1,6,4,23,6,0
973,Heurelho Gomes,Watford,23.6,0,0,0,0,0,0,1,0.0,1,1,0,1,2,2,15,3
974,Ibai Gomez,Alavés,25.8,19,15,11,4,4,6,30,20.0,24,16,1,15,15,34,20,1
975,Joe Gomez,Liverpool,21.1,58,45,32,23,3,21,40,52.5,19,19,8,11,34,92,57,1
976,Mario Gomez,Wolfsburg,10.4,6,6,2,3,1,2,6,33.3,4,10,1,9,0,6,16,0
977,Mario Gomez,Stuttgart,15.4,13,11,0,8,5,2,10,20.0,8,6,0,6,4,17,17,0
978,Maxi Gomez,Celta Vigo,34.1,7,4,1,4,2,0,18,0.0,18,9,4,5,3,10,34,0
979,Papu Gomez,Atalanta,30.6,14,9,6,5,3,5,26,19.2,21,16,1,15,22,36,7,0
980,Sergi Gomez,Celta Vigo,29.8,52,37,38,13,1,20,34,58.8,14,32,22,10,56,108,118,1
981,Sergio Gomez,Dortmund,0.1,0,0,0,0,0,0,0,0.0,0,0,0,0,0,0,0,0
982,Vicente Gomez,Las Palmas,16.9,21,13,6,11,4,10,29,34.5,19,18,4,14,17,38,14,1
983,Alfred Gomis,SPAL,25.1,0,0,0,0,0,0,1,0.0,1,0,0,0,1,1,10,3
984,Maxime Gonalons,Roma,12.2,26,18,7,12,7,9,23,39.1,14,15,4,11,23,49,19,1
985,Anthony Goncalves,Strasbourg,19.5,50,31,14,32,4,15,50,30.0,35,27,0,27,25,75,27,0
986,Vagner Goncalves,Saint-Étienne,1.2,0,0,0,0,0,0,3,0.0,3,2,0,2,0,0,0,0
988,Jerome Gondorf,Werder Bremen,8.9,12,9,3,9,0,4,18,22.2,14,11,2,9,6,18,12,0
989,Adrian Gonzalez,Málaga,26.0,40,25,14,22,4,12,50,24.0,38,25,8,17,38,78,34,0
990,Alvaro Gonzalez,Villarreal,32.2,38,26,30,7,1,22,41,53.7,19,34,23,11,53,91,188,0
991,Bruno Gonzalez,Getafe,17.1,25,18,18,7,0,13,26,50.0,13,11,3,8,31,56,107,0
992,Diego Gonzalez,Málaga,15.9,27,19,20,7,0,18,26,69.2,8,25,10,15,19,46,69,0
993,Fabio Gonzalez,Las Palmas,0.7,2,1,2,0,0,1,4,25.0,3,1,0,1,1,3,1,0
994,Giancarlo Gonzalez,Bologna,20.6,20,15,14,5,1,9,13,69.2,4,26,18,8,33,53,152,1
995,Mario Gonzalez,Villarreal,0.2,0,0,0,0,0,0,0,0.0,0,1,0,1,0,0,0,0
996,Georges Gope-Fenepej,Amiens,0.5,0,0,0,0,0,0,0,0.0,0,0,0,0,0,0,0,0
997,Leon Goretzka,Schalke 04,22.0,50,34,22,22,6,14,50,28.0,36,45,4,41,41,91,35,0
998,Mathieu Gorgelin,Lyon,4.0,0,0,0,0,0,0,0,0.0,0,0,0,0,0,0,0,1
999,Andoni Gorosabel,Real Sociedad,0.8,3,2,1,2,0,2,5,40.0,3,1,0,1,4,7,1,0
1000,Robin Gosens,Atalanta,16.1,61,46,35,22,4,27,46,58.7,19,17,2,15,22,83,40,0
1001,Dan Gosling,Bournemouth,21.6,50,25,19,26,5,19,68,27.9,49,36,8,28,25,75,35,0
1002,Mario Gotze,Dortmund,17.8,50,43,19,24,7,14,34,41.2,20,17,1,16,8,58,9,0
1003,Mohamed Gouaida,Hamburger SV,0.6,3,3,1,1,1,0,0,0.0,0,0,0,0,0,3,3,0
1004,Prince-Desir Gouano,Amiens,30.5,42,29,32,8,2,22,31,71.0,9,58,47,11,49,91,191,6
1005,Lemouya Goudiaby,Metz,0.9,2,1,0,2,0,1,3,33.3,2,2,1,1,0,2,3,0
1006,Amine Gouiri,Lyon,0.9,1,1,1,0,0,0,1,0.0,1,0,0,0,2,3,0,0
1007,Yoann Gourcuff,Rennes,4.7,7,5,1,3,3,0,2,0.0,2,5,0,5,2,9,2,0
1008,Jeffrey Gouweleeuw,Augsburg,26.5,57,44,36,18,3,27,41,65.9,14,36,10,26,54,111,128,0
1009,Julio Gracia,Betis,0.3,0,0,0,0,0,0,0,0.0,0,0,0,0,1,1,0,0
1010,Max Gradel,Toulouse,26.8,63,36,28,21,14,24,72,33.3,48,39,2,37,14,77,30,0
1011,Samuel Grandsir,Troyes,28.9,69,43,39,18,12,21,73,28.8,52,31,3,28,23,92,19,1
1012,Alex Granell,Girona,31.6,78,53,31,39,8,38,114,33.3,76,46,3,43,47,125,29,0
1014,Esteban Granero,Espanyol,13.7,32,22,15,13,4,9,27,33.3,18,19,0,19,19,51,21,0
1015,Lee Grant,Stoke City,3.0,1,1,1,0,0,1,1,100.0,0,0,0,0,0,1,0,0
1016,Alberto Grassi,SPAL,25.0,44,33,22,12,10,16,35,45.7,19,27,8,19,47,91,55,0
1017,Andrew Gravillon,Benevento,0.9,2,1,2,0,0,0,1,0.0,1,1,1,0,3,5,10,0
1018,Andre Gray,Watford,16.6,2,1,0,1,1,0,3,0.0,3,11,0,11,4,6,3,0
1019,Demarai Gray,Leicester City,18.9,17,15,6,9,2,4,23,17.4,19,27,0,27,11,28,14,1
1020,Michael Gregoritsch,Augsburg,28.1,35,27,13,15,7,11,26,42.3,15,27,1,26,10,45,56,0
1021,Clement Grenier,Guingamp,13.4,23,14,3,13,7,12,42,28.6,30,16,1,15,14,37,15,1
1022,Clement Grenier,Lyon,0.1,1,1,1,0,0,0,0,0.0,0,0,0,0,0,1,0,0
1023,Anto Grgic,Stuttgart,0.1,0,0,0,0,0,0,0,0.0,0,0,0,0,0,0,0,0
1024,Antoine Griezmann,Atlético Madrid,28.0,36,24,6,23,7,10,30,33.3,20,20,1,19,10,46,14,0
1025,Vincenzo Grifo,M'Gladbach,8.7,8,5,3,3,2,4,8,50.0,4,8,1,7,5,13,6,0
1026,Florian Grillitsch,Hoffenheim,21.0,68,46,30,36,2,35,58,60.3,23,26,3,23,39,107,25,1
1027,Jeremy Grimm,Strasbourg,9.0,23,17,15,6,2,9,24,37.5,15,11,3,8,19,42,31,1
1028,Pascal Gross,Brighton,32.5,36,24,18,16,2,10,67,14.9,57,31,5,26,14,50,20,0
1029,Marko Grujic,Liverpool,0.2,2,2,0,1,1,2,2,100.0,0,0,0,0,0,2,0,0
1030,Vicente Guaita,Getafe,33.0,0,0,0,0,0,0,0,0.0,0,0,0,0,3,3,12,1
1031,Andres Guardado,Betis,25.2,41,27,17,18,6,15,55,27.3,40,27,5,22,22,63,29,1
1032,Karim Guede,Freiburg,0.7,2,2,2,0,0,2,2,100.0,0,1,1,0,1,3,0,0
1033,Goncalo Guedes,Valencia,27.1,38,26,18,15,5,16,51,31.4,35,22,0,22,16,54,10,0
1034,Goncalo Guedes,Paris S-G,0.1,0,0,0,0,0,0,0,0.0,0,0,0,0,0,0,0,0
1035,Ramiro Guerra,Villarreal,0.8,3,2,1,0,2,2,3,66.7,1,0,0,0,0,3,2,0
1036,Raphael Guerreiro,Dortmund,6.1,10,8,5,4,1,2,5,40.0,3,3,0,3,11,21,8,0
1037,Francis Guerrero,Betis,11.0,31,19,22,7,2,16,34,47.1,18,16,4,12,21,52,26,0
1038,John Guidetti,Alavés,13.6,7,7,3,1,3,2,10,20.0,8,10,1,9,2,9,7,0
1040,John Guidetti,Celta Vigo,1.3,0,0,0,0,0,0,0,0.0,0,0,0,0,0,0,0,0
1041,Josuha Guilavogui,Wolfsburg,26.7,65,46,43,20,2,30,50,60.0,20,34,10,24,66,131,63,0
1042,Frederic Guilbert,Caen,36.0,136,89,71,58,7,50,105,47.6,55,43,13,30,88,224,136,0
1043,Guilherme,Benevento,10.5,20,11,7,7,6,3,19,15.8,16,14,1,13,8,28,4,0
1044,Guilherme,La Coruña,29.3,79,56,35,37,7,28,77,36.4,49,36,9,27,46,125,62,0
1045,Baptiste Guillaume,Angers,5.1,4,1,0,2,2,0,5,0.0,5,4,1,3,2,6,1,0
1046,Serhou Guirassy,Köln,9.5,3,3,0,2,1,1,5,20.0,4,9,1,8,1,4,11,0
1047,Peter Gulacsi,RB Leipzig,33.0,0,0,0,0,0,0,2,0.0,2,0,0,0,0,0,12,4
1048,Manuel Gulde,Freiburg,17.0,16,10,14,2,0,10,19,52.6,9,24,17,7,14,30,71,0
1049,Gerard Gumbau,Leganés,15.9,35,26,13,21,1,12,37,32.4,25,12,4,8,14,49,27,0
1050,Ilkay Gundogan,Manchester City,16.9,27,15,8,14,5,9,37,24.3,28,14,1,13,16,43,12,0
1051,Christian Gunter,Freiburg,34.0,73,54,45,21,7,38,63,60.3,25,38,7,31,20,93,68,0
1052,Jon Guridi,Real Sociedad,0.6,1,0,1,0,0,0,1,0.0,1,1,0,1,0,1,0,0
1053,Regis Gurtner,Amiens,37.0,1,0,1,0,0,1,1,100.0,0,0,0,0,4,5,15,4
1054,Samuel Gustafson,Torino,0.9,3,2,3,0,0,1,3,33.3,2,2,0,2,0,3,0,0
1055,Luiz Gustavo,Marseille,33.5,89,54,45,40,4,26,62,41.9,36,44,13,31,50,139,56,1
1056,Alejandro Gutierrez Mozo,Leganés,0.5,3,2,1,2,0,1,4,25.0,3,0,0,0,0,3,0,0
1057,Jonathan de Guzman,Eint Frankfurt,12.1,16,16,8,8,0,6,16,37.5,10,13,0,13,13,29,12,0
1058,Bright Gyamfi,Benevento,3.6,2,2,1,1,0,1,2,50.0,1,3,1,2,7,9,8,0
1059,Nicolas Haas,Atalanta,1.9,1,1,1,0,0,0,2,0.0,2,1,1,0,1,2,4,1
1060,Janik Haberer,Freiburg,30.5,62,49,20,34,8,23,57,40.4,34,43,1,42,30,92,42,0
1061,Hacen,Levante,0.9,0,0,0,0,0,0,0,0.0,0,4,2,2,1,1,0,0
1062,Alexander Hack,Mainz 05,14.3,46,34,25,19,2,24,37,64.9,13,31,18,13,26,72,87,2
1063,Robin Hack,Hoffenheim,0.8,2,2,1,0,1,0,1,0.0,1,1,1,0,0,2,1,0
1064,Munir El Haddadi,Alavés,27.2,25,20,8,9,8,5,14,35.7,9,13,2,11,9,34,5,0
1066,Oussama Haddadi,Dijon,27.8,44,29,33,9,2,14,47,29.8,33,29,12,17,43,87,79,1
1067,Florent Hadergjonaj,Huddersfield,18.6,21,16,7,10,4,12,30,40.0,18,22,10,12,17,38,45,0
1068,Andre Hahn,Hamburger SV,15.1,33,24,15,13,5,10,32,31.3,22,30,2,28,10,43,26,0
1069,Massadio Haidara,Newcastle Utd,0.0,0,0,0,0,0,0,0,0.0,0,0,0,0,0,0,0,0
1070,Oualid El Hajjam,Amiens,24.4,64,44,37,22,5,23,49,46.9,26,25,5,20,59,123,91,1
1071,Izet Hajrovic,Werder Bremen,2.1,1,0,1,0,0,0,1,0.0,1,0,0,0,2,3,1,0
1072,Achraf Hakimi,Real Madrid,8.4,21,15,9,6,6,11,25,44.0,14,9,1,8,10,31,19,1
1073,Alen Halilovic,Las Palmas,14.5,11,7,5,6,0,4,17,23.5,13,10,1,9,5,16,4,0
1074,Sebastien Haller,Eint Frankfurt,26.1,25,16,4,16,5,7,14,50.0,7,17,4,13,8,33,39,0
1075,Emil Hallfredsson,Udinese,8.5,19,14,9,7,3,7,24,29.2,17,13,2,11,20,39,16,0
1076,Marcel Halstenberg,RB Leipzig,13.1,29,19,16,9,4,15,19,78.9,4,15,1,14,23,52,42,1
1077,Ben Hamer,Leicester City,3.1,0,0,0,0,0,0,1,0.0,1,0,0,0,0,0,3,1
1078,Romain Hamouma,Saint-Étienne,20.5,19,13,7,6,6,1,22,4.5,21,15,4,11,13,32,8,1
1079,Marek Hamsik,Napoli,26.3,36,22,10,15,11,15,37,40.5,22,35,2,33,14,50,16,0
1080,Samir Handanovic,Inter,38.0,0,0,0,0,0,0,0,0.0,0,1,0,1,0,0,7,1
1081,Tim Handwerker,Köln,4.4,12,7,9,2,1,5,7,71.4,2,3,0,3,6,18,10,0
1082,Genki Haraguchi,Hertha BSC,2.3,6,6,2,3,1,2,6,33.3,4,4,0,4,2,8,3,0
1083,Amine Harit,Schalke 04,22.7,39,27,11,21,7,13,37,35.1,24,23,0,23,19,58,11,0
1084,Martin Harnik,Hannover 96,21.0,17,10,4,10,3,4,25,16.0,21,21,2,19,8,25,26,0
1085,Rekeem Harper,West Brom,0.2,1,1,0,1,0,0,0,0.0,0,0,0,0,0,1,0,0
1086,Joe Hart,West Ham,19.0,1,1,1,0,0,1,2,50.0,1,1,0,1,0,1,2,4
1087,Makoto Hasebe,Eint Frankfurt,23.2,38,23,19,19,0,21,33,63.6,12,40,19,21,25,63,74,0
1088,Hans Hateboer,Atalanta,26.6,31,25,13,13,5,15,26,57.7,11,32,5,27,30,61,46,1
1089,Kai Havertz,Leverkusen,23.8,34,23,8,23,3,12,25,48.0,13,33,2,31,19,53,23,0
1090,Isaac Hayden,Newcastle Utd,15.3,40,23,23,16,1,12,34,35.3,22,21,6,15,23,63,43,0
1092,Eden Hazard,Chelsea,26.9,6,3,2,3,1,3,21,14.3,18,11,0,11,3,9,0,0
1093,Thorgan Hazard,M'Gladbach,32.7,49,32,16,23,10,20,54,37.0,34,39,1,38,28,77,18,0
1094,Tom Heaton,Burnley,3.4,0,0,0,0,0,0,0,0.0,0,0,0,0,0,0,0,0
1095,Jonas Hector,Köln,19.5,47,35,23,18,6,18,40,45.0,22,39,6,33,28,75,65,2
1096,Michael Hefele,Huddersfield,0.4,0,0,0,0,0,0,0,0.0,0,0,0,0,1,1,5,0
1097,Ahmed Hegazi,West Brom,37.6,58,38,46,12,0,26,50,52.0,24,55,37,18,60,118,278,2
1098,Gauthier Hein,Metz,0.9,2,2,2,0,0,2,4,50.0,2,1,0,1,2,4,1,0
1099,Dominique Heintz,Köln,31.0,60,42,47,13,0,38,64,59.4,26,35,17,18,53,113,140,0
1100,Filip Helander,Bologna,27.8,48,32,33,15,0,15,29,51.7,14,47,25,22,37,85,160,2
1101,Marcel Heller,Augsburg,14.4,37,24,21,14,2,12,28,42.9,16,22,1,21,10,47,7,0
1102,Tomer Hemed,Brighton,9.4,7,5,3,4,0,2,10,20.0,8,10,1,9,2,9,12,0
1103,Jordan Henderson,Liverpool,24.1,51,33,13,32,6,18,52,34.6,34,33,2,31,31,82,27,0
1104,Jeff Hendrick,Burnley,25.9,16,10,4,10,2,3,17,17.6,14,11,2,9,8,24,21,1
1105,Wayne Hennessey,Crystal Palace,27.0,0,0,0,0,0,0,0,0.0,0,1,0,1,2,2,5,1
1106,Benjamin Henrichs,Leverkusen,14.1,42,28,23,16,3,27,43,62.8,16,23,3,20,31,73,32,0
1107,Dalbert Henrique,Inter,5.9,15,10,11,3,1,7,13,53.8,6,7,4,3,13,28,19,0
1108,Christophe Herelle,Troyes,32.9,39,26,27,12,0,16,30,53.3,14,38,27,11,56,95,241,1
1109,Mario Hermoso,Espanyol,21.4,14,12,13,1,0,8,21,38.1,13,15,8,7,25,39,122,0
1110,Hernan,Las Palmas,3.9,18,9,8,7,3,10,17,58.8,7,2,0,2,8,26,5,0
1111,Hector Hernandez,Alavés,0.2,1,1,0,1,0,1,1,100.0,0,0,0,0,0,1,1,0
1112,Javier Hernandez,West Ham,17.2,11,7,2,7,2,3,14,21.4,11,6,1,5,6,17,1,0
1113,Lucas Hernandez,Atlético Madrid,23.5,93,68,51,35,7,55,74,74.3,19,35,10,25,40,133,90,0
1114,Luis Hernandez,Málaga,36.0,49,43,37,9,3,17,33,51.5,16,32,21,11,77,126,185,1
1115,Pablo Hernandez,Celta Vigo,20.2,48,33,17,27,4,14,46,30.4,32,29,11,18,40,88,72,0
1116,Theo Hernandez,Real Madrid,10.7,21,15,16,2,3,13,25,52.0,12,9,2,7,17,38,20,0
1118,Hernani,Saint-Étienne,6.0,21,13,9,9,3,10,22,45.5,12,15,2,13,6,27,5,0
1119,Ander Herrera,Manchester Utd,14.1,56,29,32,20,4,20,69,29.0,49,33,6,27,34,90,22,2
1120,Borja Herrera,Las Palmas,2.7,2,1,2,0,0,2,7,28.6,5,6,1,5,3,5,4,0
1121,Iago Herrerin,Athletic Club,8.0,2,1,2,0,0,2,2,100.0,0,0,0,0,0,2,7,1
1122,Patrick Herrmann,M'Gladbach,12.5,29,21,9,13,7,17,29,58.6,12,13,0,13,17,46,19,0
1123,Perparim Hetemaj,Chievo,26.8,74,48,34,25,15,29,78,37.2,49,39,6,33,39,113,47,1
1124,Son Heung-min,Tottenham,25.7,17,10,2,12,3,2,28,7.1,26,18,0,18,10,27,12,0
1125,Thomas Heurtaux,Hellas Verona,15.5,14,11,12,2,0,4,8,50.0,4,25,16,9,37,51,97,1
1126,Gonzalo Higuain,Juventus,31.3,19,17,3,7,9,2,19,10.5,17,19,4,15,7,26,20,0
1127,Oscar Hiljemark,Genoa,14.2,12,8,2,8,2,3,24,12.5,21,14,4,10,9,21,12,0
1128,Vitorino Hilton,Montpellier,27.0,44,26,33,11,0,13,36,36.1,23,28,14,14,58,102,140,5
1129,Kaylen Hinds,Wolfsburg,1.0,1,1,1,0,0,0,0,0.0,0,1,0,1,1,2,0,0
1130,Martin Hinteregger,Augsburg,29.5,79,51,55,22,2,47,61,77.0,14,40,27,13,49,128,135,3
1131,Marwin Hitz,Augsburg,32.0,1,1,1,0,0,1,3,33.3,2,0,0,0,0,1,12,3
1132,Andrew Hjulsager,Celta Vigo,0.2,0,0,0,0,0,0,2,0.0,2,1,0,1,0,0,0,0
1133,Wesley Hoedt,Southampton,28.0,60,51,48,12,0,36,61,59.0,25,32,17,15,40,100,177,2
1134,Nicolas Hofler,Freiburg,25.1,57,36,23,30,4,31,50,62.0,19,42,10,32,44,101,51,2
1135,Jonas Hofmann,M'Gladbach,11.5,23,19,12,11,0,12,26,46.2,14,15,4,11,12,35,16,0
1136,Marco Hoger,Köln,18.6,60,40,31,28,1,30,64,46.9,34,35,5,30,25,85,27,1
1137,Jonathan Hogg,Huddersfield,26.6,93,64,29,59,5,26,89,29.2,63,51,12,39,69,162,48,0
1138,Rob Holding,Arsenal,9.1,19,14,13,5,1,4,12,33.3,8,16,10,6,21,40,40,2
1139,Jose Holebas,Watford,26.5,51,31,34,14,3,18,44,40.9,26,24,8,16,29,80,95,2
1140,Lucas Holer,Freiburg,10.1,24,20,8,13,3,9,24,37.5,15,10,0,10,7,31,13,0
1141,Mason Holgate,Everton,13.2,23,16,15,7,1,10,21,47.6,11,12,9,3,23,46,86,2
1142,Lewis Holtby,Hamburger SV,13.3,44,29,14,26,4,17,32,53.1,15,23,2,21,10,54,9,0
1144,Gerrit Holtmann,Mainz 05,10.0,16,13,8,5,3,11,22,50.0,11,19,2,17,12,28,9,0
1145,Jannes Horn,Köln,9.2,16,11,11,4,1,11,14,78.6,3,12,3,9,17,33,26,0
1146,Timo Horn,Köln,34.0,3,2,3,0,0,3,6,50.0,3,0,0,0,0,3,18,2
1147,Benedikt Howedes,Juventus,2.7,1,1,1,0,0,0,0,0.0,0,0,0,0,8,9,10,1
1148,Lukas Hradecky,Eint Frankfurt,34.0,0,0,0,0,0,0,2,0.0,2,0,0,0,0,0,23,3
1149,Branimir Hrgota,Eint Frankfurt,2.2,5,4,0,3,2,4,7,57.1,3,2,0,2,0,5,1,0
1150,Timo Hubers,Hannover 96,5.0,11,10,9,2,0,9,15,60.0,6,13,8,5,9,20,31,0
1151,Benjamin Hubner,Hoffenheim,25.7,71,56,43,27,1,31,46,67.4,15,40,18,22,51,122,114,0
1152,Florian Hubner,Hannover 96,3.6,10,9,8,2,0,5,9,55.6,4,3,2,1,6,16,21,0
1153,Tomas Hubocan,Marseille,1.0,1,0,1,0,0,0,4,0.0,4,0,0,0,0,1,1,0
1154,Callum Hudson-Odoi,Chelsea,0.3,0,0,0,0,0,0,0,0.0,0,0,0,0,0,0,0,0
1155,Will Hughes,Watford,11.0,34,18,7,18,9,9,19,47.4,10,16,1,15,15,49,6,0
1156,Jordan Hugill,West Ham,0.3,0,0,0,0,0,0,1,0.0,1,0,0,0,0,0,0,0
1157,Vitor Hugo,Fiorentina,13.4,32,21,26,6,0,10,17,58.8,7,10,6,4,43,75,92,0
1158,Mats Hummels,Bayern Munich,24.6,62,52,41,18,3,35,51,68.6,16,31,12,19,55,117,59,2
1159,Uwe Hunemeier,Brighton,0.2,0,0,0,0,0,0,0,0.0,0,0,0,0,0,0,4,0
1160,Adrien Hunou,Rennes,16.2,27,15,11,8,8,11,42,26.2,31,22,1,21,9,36,8,1
1161,Aaron Hunt,Hamburger SV,23.1,36,24,12,20,4,11,37,29.7,26,20,2,18,14,50,18,2
1162,Emerson Hyndman,Bournemouth,0.6,0,0,0,0,0,0,1,0.0,1,2,0,2,1,1,1,0
1163,Elseid Hysaj,Napoli,34.7,64,45,28,30,6,32,56,57.1,24,35,4,31,43,107,68,4
1164,Suk Hyun-jun,Troyes,13.3,6,5,2,2,2,1,9,11.1,8,10,0,10,1,7,7,0
1165,Pierre Hojbjerg,Southampton,18.6,45,29,24,18,3,13,56,23.2,43,30,3,27,37,82,26,1
1166,Jordon Ibe,Bournemouth,22.2,14,12,7,5,2,6,22,27.3,16,5,0,5,10,24,11,0
1167,Vedad Ibisevic,Hertha BSC,16.1,10,8,1,5,4,4,7,57.1,3,8,1,7,4,14,23,0
1168,Vicente Iborra,Leicester City,15.7,23,18,13,10,0,9,36,25.0,27,25,11,14,19,42,49,1
1170,Zlatan Ibrahimovic,Manchester Utd,1.2,2,1,1,0,1,0,1,0.0,1,0,0,0,0,2,1,0
1171,Mauro Icardi,Inter,32.9,3,2,1,2,0,1,8,12.5,7,14,6,8,5,8,23,1
1172,Brown Ideye,Málaga,8.1,2,2,0,2,0,0,5,0.0,5,2,0,2,1,3,11,0
1173,Edgar Ie,Lille,35.0,74,42,55,18,1,31,69,44.9,38,57,26,31,84,158,135,3
1174,Julien Ielsch,Amiens,6.8,28,18,12,11,5,7,25,28.0,18,16,3,13,11,39,15,2
1175,Pietro Iemmello,Benevento,9.8,2,2,1,1,0,2,8,25.0,6,4,0,4,1,3,11,2
1176,Kelechi Iheanacho,Leicester City,9.2,9,6,3,5,1,3,20,15.0,17,10,2,8,3,12,4,0
1177,Jordan Ikoko,Guingamp,26.9,44,29,24,15,5,22,42,52.4,20,20,2,18,48,92,74,0
1178,Jonathan Ikone,Montpellier,11.1,13,10,3,6,4,4,14,28.6,10,8,0,8,6,19,3,0
1179,Josip Ilicic,Atalanta,22.2,24,19,5,13,6,8,29,27.6,21,19,0,19,16,40,2,0
1180,Asier Illarramendi,Real Sociedad,35.1,85,57,35,41,9,37,90,41.1,53,44,8,36,75,160,35,0
1181,Jules Iloki,Nantes,15.8,13,9,1,9,3,3,16,18.8,13,8,0,8,12,25,16,0
1182,Stefan Ilsanker,RB Leipzig,14.3,37,29,23,11,3,22,39,56.4,17,23,10,13,25,62,55,1
1183,Giannelli Imbula,Toulouse,24.9,29,19,10,15,4,7,29,24.1,22,17,2,15,20,49,13,3
1184,Ciro Immobile,Lazio,29.8,4,2,0,3,1,0,17,0.0,17,14,1,13,0,4,9,0
1185,Emmanuel Imorou,Caen,0.4,0,0,0,0,0,0,0,0.0,0,0,0,0,1,1,1,0
1186,Tom Ince,Huddersfield,27.2,35,27,14,16,5,10,29,34.5,19,20,0,20,12,47,12,0
1187,Svante Ingelsson,Udinese,3.6,9,6,3,3,3,2,10,20.0,8,4,0,4,6,15,4,0
1188,Roberto Inglese,Chievo,30.9,31,21,13,9,9,7,30,23.3,23,21,2,19,8,39,17,1
1189,Danny Ings,Liverpool,3.0,5,3,1,3,1,0,0,0.0,0,4,0,4,2,7,1,0
1190,Andres Iniesta,Barcelona,20.3,28,22,11,8,9,6,31,19.4,25,21,2,19,10,38,12,1
1191,Lorenzo Insigne,Napoli,34.3,29,17,11,13,5,13,33,39.4,20,20,0,20,17,46,4,0
1192,Emiliano Insua,Stuttgart,23.4,46,34,27,16,3,17,32,53.1,15,30,4,26,36,82,48,1
1193,Pablo Insua,Schalke 04,0.3,0,0,0,0,0,0,0,0.0,0,1,1,0,0,0,1,0
1194,Takashi Inui,Eibar,29.2,39,21,12,19,8,13,42,31.0,29,36,0,36,18,57,10,0
1196,Artur Ionita,Cagliari,29.7,63,45,30,24,9,17,38,44.7,21,39,7,32,28,91,29,0
1197,Gorka Iraizoz,Girona,8.5,1,1,1,0,0,1,2,50.0,1,0,0,0,1,2,9,2
1198,Stephen Ireland,Stoke City,1.5,3,1,2,1,0,1,5,20.0,4,4,2,2,1,4,1,0
1199,Carlos Isaac,Atlético Madrid,0.7,1,0,1,0,0,1,3,33.3,2,0,0,0,2,3,1,0
1200,Alexander Isak,Dortmund,1.3,1,0,0,1,0,0,1,0.0,1,1,0,1,0,1,0,0
1201,Isco,Real Madrid,19.7,22,12,5,10,7,5,35,14.3,30,11,0,11,15,37,2,0
1202,Tatsuya Ito,Hamburger SV,11.2,16,13,4,8,4,11,22,50.0,11,28,0,28,6,22,1,0
1203,Gian-Luca Itter,Wolfsburg,4.6,19,12,15,2,2,14,22,63.6,8,6,0,6,5,24,15,0
1204,Manuel Iturra,Málaga,17.6,70,45,36,27,7,22,55,40.0,33,19,2,17,29,99,23,0
1205,Ander Iturraspe,Athletic Club,21.2,42,31,18,22,2,10,32,31.3,22,22,7,15,35,77,57,0
1206,Ivi,Levante,19.6,48,34,19,23,6,21,62,33.9,41,21,1,20,15,63,15,0
1207,Alex Iwobi,Arsenal,20.3,19,15,8,8,3,5,18,27.8,13,19,1,18,7,26,10,1
1208,Jose Izquierdo,Brighton,22.0,23,15,12,9,2,7,19,36.8,12,6,0,6,16,39,34,0
1209,Armando Izzo,Genoa,15.4,30,23,14,10,6,12,18,66.7,6,15,6,9,34,64,70,0
1210,Koo Ja-cheol,Augsburg,22.7,54,41,18,31,5,27,44,61.4,17,22,3,19,27,81,34,2
1211,Paul Jaeckel,Wolfsburg,3.0,3,3,3,0,0,1,2,50.0,1,5,2,3,1,4,8,0
1212,Phil Jagielka,Everton,22.9,33,23,24,9,0,8,21,38.1,13,30,20,10,39,72,179,1
1213,Kilian Jakob,Augsburg,0.6,0,0,0,0,0,0,0,0.0,0,1,0,1,0,0,1,0
1214,Eldin Jakupovic,Leicester City,2.0,0,0,0,0,0,0,0,0.0,0,0,0,0,0,0,4,0
1215,Christophe Jallet,Nice,13.0,29,21,21,8,0,11,26,42.3,15,18,6,12,16,45,47,0
1216,Ablie Jallow,Metz,1.4,1,1,1,0,0,0,5,0.0,5,1,0,1,3,4,1,0
1217,Matty James,Leicester City,11.0,19,10,7,11,1,2,10,20.0,8,14,2,12,17,36,25,0
1218,Vasilije Janjicic,Hamburger SV,3.6,14,11,5,9,0,2,4,50.0,2,6,1,5,3,17,5,0
1219,Christoph Janker,Augsburg,0.9,4,3,3,1,0,2,3,66.7,1,0,0,0,1,5,4,1
1220,Saidy Janko,Saint-Étienne,15.8,43,30,25,14,4,14,24,58.3,10,21,1,20,14,57,50,0
1222,Jakub Jankto,Udinese,29.5,29,18,9,14,6,10,46,21.7,36,46,8,38,20,49,27,0
1223,Daryl Janmaat,Watford,20.2,46,31,29,10,7,22,52,42.3,30,16,5,11,33,79,61,0
1224,Vincent Janssen,Tottenham,0.0,0,0,0,0,0,0,0,0.0,0,0,0,0,0,0,0,0
1225,Tony Jantschke,M'Gladbach,8.1,13,11,9,4,0,8,13,61.5,5,10,1,9,6,19,25,0
1226,Adnan Januzaj,Real Sociedad,17.5,16,11,2,8,6,5,18,27.8,13,12,0,12,11,27,5,0
1227,Nicolas Janvier,Rennes,0.8,4,1,1,1,2,1,2,50.0,1,1,0,1,1,5,0,0
1228,Pawel Jaroszynski,Chievo,9.0,20,12,14,5,1,9,18,50.0,9,11,4,7,21,41,40,1
1229,Rune Jarstein,Hertha BSC,31.0,1,1,1,0,0,1,2,50.0,1,0,0,0,0,1,8,5
1230,Jason,Levante,19.8,32,25,11,14,7,11,38,28.9,27,14,1,13,20,52,8,0
1231,Bakery Jatta,Hamburger SV,3.3,14,12,2,12,0,4,6,66.7,2,6,1,5,3,17,5,0
1232,Corentin Jean,Toulouse,18.8,12,8,4,7,1,5,21,23.8,16,14,1,13,14,26,10,0
1233,Benjamin Jeannot,Dijon,15.6,12,7,5,6,1,1,13,7.7,12,9,3,6,6,18,26,0
1234,Tin Jedvaj,Leverkusen,6.7,10,6,2,6,2,8,15,53.3,7,9,1,8,9,19,18,0
1235,Jemerson,Monaco,31.7,48,32,32,15,1,24,31,77.4,7,46,32,14,56,104,169,1
1236,Jese,Stoke City,6.8,10,7,3,5,2,3,13,23.1,10,5,0,5,0,10,3,0
1237,Gabriel Jesus,Manchester City,18.5,23,15,6,10,7,3,22,13.6,19,16,0,16,8,31,6,0
1238,Juan Jesus,Roma,18.4,42,30,25,15,2,18,34,52.9,16,18,9,9,39,81,63,0
1239,Alvaro Jimenez,Getafe,5.9,15,8,5,6,4,8,21,38.1,13,6,0,6,1,16,6,0
1240,Joaquin,Betis,27.5,22,19,11,10,1,4,16,25.0,12,17,2,15,15,37,38,0
1241,Aron Johannsson,Werder Bremen,3.1,4,3,2,2,0,1,7,14.3,6,3,0,3,1,5,5,0
1242,Fabian Johnson,M'Gladbach,5.2,16,10,7,7,2,6,7,85.7,1,10,2,8,2,18,13,0
1243,Glen Johnson,Stoke City,6.1,7,5,5,2,0,3,12,25.0,9,7,2,5,10,17,23,0
1244,Karl-Johan Johnsson,Guingamp,38.0,0,0,0,0,0,0,1,0.0,1,0,0,0,0,0,14,4
1245,Milos Jojic,Köln,16.2,36,26,18,15,3,16,40,40.0,24,31,4,27,15,51,16,0
1246,Jonathas,Hannover 96,7.0,7,3,2,4,1,1,2,50.0,1,3,1,2,0,7,9,0
1248,Phil Jones,Manchester Utd,21.9,25,18,20,5,0,9,20,45.0,11,25,17,8,41,66,133,2
1249,Nigel de Jong,Mainz 05,8.2,17,12,7,9,1,10,14,71.4,4,5,1,4,12,29,22,1
1250,Jony,Málaga,2.4,3,2,2,0,1,0,4,0.0,4,1,0,1,2,5,1,0
1251,Joan Jordan,Eibar,27.0,31,24,8,19,4,10,68,14.7,58,24,0,24,30,61,12,0
1252,Jorge,Monaco,21.3,69,40,34,25,10,23,38,60.5,15,19,2,17,66,135,86,0
1253,Jorginho,Napoli,29.4,62,46,14,39,9,15,68,22.1,53,32,3,29,50,112,12,2
1254,Willian Jose,Real Sociedad,30.8,10,7,1,5,4,2,9,22.2,7,10,1,9,5,15,31,0
1255,Joselu,Newcastle Utd,19.0,22,17,10,11,1,7,34,20.6,27,25,2,23,11,33,39,0
1256,Yann Jouffre,Metz,3.1,3,2,0,2,1,1,6,16.7,5,5,1,4,3,6,2,0
1257,Vukasin Jovanovic,Bordeaux,16.0,18,14,11,7,0,6,14,42.9,8,18,10,8,27,45,67,0
1258,Stevan Jovetic,Monaco,8.4,4,4,0,3,1,0,9,0.0,9,5,0,5,3,7,3,0
1259,Luka Jovic,Eint Frankfurt,10.4,5,5,0,5,0,1,3,33.3,2,6,2,4,1,6,2,0
1260,Jozabed,Celta Vigo,16.4,18,12,7,9,2,3,18,16.7,15,18,2,16,16,34,19,0
1261,Juanfran,La Coruña,34.0,64,44,38,22,4,35,65,53.8,30,29,11,18,63,127,121,0
1262,Juanfran,Atlético Madrid,14.5,33,24,21,9,3,21,32,65.6,11,14,4,10,26,59,35,0
1263,Juankar,Málaga,8.7,23,17,13,8,2,11,20,55.0,9,8,1,7,19,42,26,0
1264,Juanmi,Real Sociedad,16.5,22,13,7,12,3,4,22,18.2,18,11,0,11,10,32,6,0
1265,Juanpe,Girona,34.1,48,30,28,20,0,30,43,69.8,13,27,19,8,53,101,137,0
1266,Juanpi,Málaga,6.8,11,8,2,7,2,3,8,37.5,5,7,0,7,6,17,1,0
1267,Mariano Julio Izco,Crotone,2.0,6,4,2,4,0,2,4,50.0,2,2,0,2,4,10,1,0
1268,Christopher Jullien,Toulouse,28.9,36,25,27,9,0,15,32,46.9,17,29,19,10,40,76,182,5
1269,David Junca,Eibar,10.0,15,13,9,6,0,7,19,36.8,12,7,1,6,11,26,25,0
1270,Gideon Jung,Hamburger SV,28.6,59,41,32,24,3,22,38,57.9,16,29,12,17,38,97,71,1
1271,Sebastian Jung,Wolfsburg,0.9,2,2,1,1,0,1,1,100.0,0,0,0,0,0,2,5,0
1272,Zlatko Junuzovic,Werder Bremen,18.1,35,23,17,12,6,18,38,47.4,20,23,2,21,18,53,12,0
1274,Mathias Jorgensen,Huddersfield,38.0,55,36,40,13,2,19,45,42.2,26,49,20,29,76,131,249,5
1275,Christian Kabasele,Watford,25.9,42,25,28,14,0,21,36,58.3,15,37,23,14,34,76,185,0
1276,Younes Kaboul,Watford,1.7,3,2,0,3,0,0,0,0.0,0,4,2,2,2,5,15,0
1277,Alexander Kacaniklic,Nantes,3.5,8,5,7,1,0,5,10,50.0,5,5,2,3,6,14,7,0
1278,Gojko Kacar,Augsburg,2.5,7,6,6,1,0,3,7,42.9,4,3,2,1,4,11,7,0
1279,Elias Kachunga,Huddersfield,14.8,30,26,13,12,5,8,19,42.1,11,14,1,13,2,32,9,0
1280,Pavel Kaderabek,Hoffenheim,24.4,44,30,22,18,4,20,44,45.5,24,27,8,19,34,78,45,1
1281,Shinji Kagawa,Dortmund,13.0,32,22,11,14,7,18,27,66.7,9,6,0,6,6,38,2,0
1282,Sullay Kaikai,Crystal Palace,0.2,1,0,0,1,0,0,0,0.0,0,1,0,1,0,1,1,0
1283,Florian Kainz,Werder Bremen,19.0,33,25,9,18,6,9,19,47.4,10,23,0,23,17,50,13,0
1284,Dominik Kaiser,RB Leipzig,3.1,5,5,1,3,1,4,11,36.4,7,6,0,6,1,6,8,0
1285,Gael Kakuta,Amiens,34.3,54,32,14,27,13,9,40,22.5,31,33,3,30,26,80,19,0
1286,Nikola Kalinic,Milan,20.1,6,5,1,4,1,0,8,0.0,8,4,1,3,3,9,12,0
1287,Salomon Kalou,Hertha BSC,24.5,19,11,12,5,2,9,17,52.9,8,37,1,36,10,29,29,0
1288,Daichi Kamada,Eint Frankfurt,1.6,1,1,0,1,0,0,0,0.0,0,0,0,0,1,2,0,0
1289,Francois Kamano,Bordeaux,22.4,32,24,11,14,7,10,35,28.6,25,18,2,16,15,47,8,0
1290,Bingourou Kamara,Strasbourg,18.8,0,0,0,0,0,0,2,0.0,2,0,0,0,1,1,6,3
1291,Boubacar Kamara,Marseille,5.1,14,14,9,5,0,8,12,66.7,4,7,3,4,3,17,18,0
1292,Marcin Kaminski,Stuttgart,12.6,17,14,5,11,1,12,18,66.7,6,12,3,9,30,47,55,0
1293,Kevin Kampl,RB Leipzig,22.4,42,33,16,20,6,16,39,41.0,23,37,2,35,33,75,33,0
1294,Kevin Kampl,Leverkusen,0.3,1,1,1,0,0,1,1,100.0,0,0,0,0,0,1,0,0
1295,Harry Kane,Tottenham,34.2,17,12,2,8,7,4,15,26.7,11,15,4,11,5,22,19,0
1296,Wilfried Kanga,Angers,1.9,2,2,0,2,0,0,2,0.0,2,0,0,0,0,2,1,0
1297,Mamadou Kanoute,Benevento,0.4,0,0,0,0,0,0,0,0.0,0,0,0,0,1,1,1,0
1298,N'Golo Kante,Chelsea,33.3,113,77,55,52,6,33,92,35.9,59,40,4,36,85,198,29,3
1300,Bartosz Kapustka,Freiburg,2.6,9,5,2,6,1,4,6,66.7,2,4,0,4,3,12,0,0
1301,Kenan Karaman,Hannover 96,9.5,16,13,9,6,1,6,7,85.7,1,10,4,6,1,17,17,0
1302,Yann Karamoh,Inter,5.4,3,1,1,1,1,0,3,0.0,3,4,0,4,4,7,1,1
1303,Loris Karius,Liverpool,19.0,0,0,0,0,0,0,0,0.0,0,0,0,0,1,1,4,0
1304,Orestis Karnezis,Watford,14.4,0,0,0,0,0,0,2,0.0,2,0,0,0,1,1,3,3
1305,Rick Karsdorp,Roma,0.9,1,1,1,0,0,0,0,0.0,0,0,0,0,1,2,0,0
1306,Aleksandar Katai,Alavés,0.6,1,1,0,1,0,0,1,0.0,1,0,0,0,0,1,0,0
1307,Florian Kath,Freiburg,7.5,15,10,3,9,3,9,17,52.9,8,9,0,9,8,23,1,0
1308,Ole Kauper,Werder Bremen,0.8,6,5,2,4,0,1,4,25.0,3,1,0,1,2,8,0,0
1309,Eiji Kawashima,Metz,28.5,1,1,1,0,0,1,3,33.3,2,0,0,0,3,4,9,2
1310,Beram Kayal,Brighton,8.3,18,11,10,7,1,6,26,23.1,20,11,4,7,12,30,9,0
1311,Joris Kayembe,Nantes,1.0,1,0,1,0,0,0,4,0.0,4,0,0,0,0,1,4,0
1312,Olarenwaju Kayode,Girona,4.3,3,3,1,2,0,0,4,0.0,4,1,0,1,1,4,0,0
1313,Moise Kean,Hellas Verona,12.6,8,5,1,3,4,1,6,16.7,5,6,0,6,7,15,4,0
1314,Michael Keane,Everton,28.4,33,25,26,5,2,19,43,44.2,24,39,28,11,53,86,214,0
1315,Thilo Kehrer,Schalke 04,26.3,81,64,41,36,4,46,68,67.6,22,42,12,30,35,116,113,2
1316,Cheick Keita,Bologna,1.4,2,2,1,1,0,1,3,33.3,2,5,0,5,2,4,1,0
1317,Naby Keita,RB Leipzig,21.8,65,48,25,33,7,17,43,39.5,26,26,3,23,36,101,18,0
1318,Keko,Málaga,13.4,38,23,17,13,8,15,47,31.9,32,25,3,22,13,51,9,0
1319,Martin Kelly,Crystal Palace,13.3,19,13,15,4,0,14,26,53.8,12,16,11,5,9,28,67,3
1320,Marc-Oliver Kempf,Freiburg,10.0,13,12,9,4,0,5,8,62.5,3,7,7,0,17,30,52,0
1321,Kenedy,Newcastle Utd,11.4,31,17,16,13,2,12,35,34.3,23,12,1,11,14,45,11,0
1322,Jonjoe Kenny,Everton,17.7,41,33,28,10,3,20,32,62.5,12,17,7,10,28,69,95,0
1323,Ryan Kent,Freiburg,2.7,4,3,2,1,1,2,5,40.0,3,6,0,6,1,5,1,0
1324,Christophe Kerbrat,Guingamp,36.9,62,45,47,14,1,35,65,53.8,30,49,40,9,62,124,249,2
1326,Franck Kessie,Milan,36.3,48,34,20,19,9,17,44,38.6,27,47,11,36,26,74,45,3
1327,Billy Ketkeophomphone,Angers,4.9,14,9,4,5,5,5,15,33.3,10,9,0,9,5,19,8,0
1328,Driss Khalid,Toulouse,0.3,1,0,0,0,1,0,0,0.0,0,0,0,0,0,1,2,0
1329,Saif-Eddine Khaoui,Troyes,21.7,57,25,22,27,8,15,50,30.0,35,12,2,10,27,84,9,0
1330,Wahbi Khazri,Rennes,21.3,26,18,7,10,9,7,39,17.9,32,29,0,29,7,33,7,0
1331,Rani Khedira,Augsburg,25.3,62,47,25,28,9,33,47,70.2,14,41,18,23,36,98,96,0
1332,Sami Khedira,Juventus,21.2,14,9,1,9,4,2,23,8.7,21,13,3,10,20,34,20,0
1333,Stefan Kiessling,Leverkusen,0.9,0,0,0,0,0,0,0,0.0,0,2,0,2,0,0,1,0
1334,Kike,Eibar,27.3,14,8,1,7,6,2,11,18.2,9,15,1,14,10,24,14,0
1335,Joshua Kimmich,Bayern Munich,25.9,32,23,14,13,5,20,38,52.6,18,26,5,21,20,52,40,0
1336,Presnel Kimpembe,Paris S-G,26.9,39,28,20,18,1,9,14,64.3,5,17,10,7,24,63,80,1
1337,Andy King,Leicester City,6.0,8,5,0,5,3,0,3,0.0,3,4,2,2,5,13,13,0
1338,Andy King,Swansea City,7.9,18,11,10,8,0,5,14,35.7,9,7,0,7,6,24,14,1
1339,Joshua King,Bournemouth,27.3,36,26,11,17,8,4,27,14.8,23,23,3,20,4,40,14,1
1340,Simon Kjaer,Sevilla,17.5,35,24,25,8,2,13,22,59.1,9,16,10,6,32,67,109,0
1341,Davy Klaassen,Everton,2.8,3,1,1,2,0,2,6,33.3,4,2,1,1,1,4,2,0
1342,Felix Klaus,Hannover 96,22.0,48,38,20,21,7,23,50,46.0,27,29,4,25,8,56,28,0
1343,Ragnar Klavan,Liverpool,16.1,14,10,6,7,1,6,12,50.0,6,11,5,6,15,29,85,1
1344,Tim Kleindienst,Freiburg,12.6,22,15,6,12,4,4,17,23.5,13,17,3,14,6,28,21,0
1345,Lukas Klostermann,RB Leipzig,24.3,56,41,34,18,4,28,37,75.7,9,33,6,27,33,89,79,0
1346,Lukas Klunter,Köln,14.8,25,20,16,8,1,16,24,66.7,8,11,2,9,13,38,28,1
1347,Robin Knoche,Wolfsburg,23.4,34,20,26,8,0,25,35,71.4,10,36,24,12,25,59,89,1
1348,Anthony Knockaert,Brighton,26.9,39,26,25,11,3,16,55,29.1,39,29,3,26,23,62,16,0
1349,Torles Knoll,Hamburger SV,0.2,0,0,0,0,0,0,0,0.0,0,1,0,1,0,0,0,0
1350,Robin Koch,Freiburg,21.3,34,24,21,13,0,10,18,55.6,8,27,11,16,35,69,67,0
1352,Kenan Kodro,Mainz 05,2.6,1,1,0,1,0,0,0,0.0,0,1,0,1,3,4,0,0
1353,Herve Koffi,Lille,4.0,0,0,0,0,0,0,0,0.0,0,0,0,0,1,1,1,1
1354,Dominik Kohr,Leverkusen,18.5,49,26,20,25,4,25,41,61.0,16,39,5,34,30,79,24,0
1355,Seybou Koita,Amiens,2.4,1,1,1,0,0,1,1,100.0,0,0,0,0,0,1,2,0
1356,Koke,Atlético Madrid,30.6,75,45,31,32,12,27,95,28.4,68,40,3,37,24,99,38,0
1357,Aleksandar Kolarov,Roma,34.0,58,47,34,16,8,27,49,55.1,22,24,7,17,53,111,100,2
1358,Sead Kolasinac,Arsenal,23.9,49,37,28,13,8,20,39,51.3,19,15,3,12,26,75,56,0
1359,Vincent Kompany,Manchester City,15.5,20,11,14,5,1,13,19,68.4,6,10,8,2,16,36,73,1
1360,Ibrahima Konate,RB Leipzig,13.6,32,25,20,12,0,18,23,78.3,5,14,3,11,20,52,66,0
1361,Moussa Konate,Amiens,27.5,8,6,1,4,3,3,23,13.0,20,10,2,8,3,11,11,0
1362,Geoffrey Kondogbia,Valencia,29.0,88,57,38,43,7,23,68,33.8,45,46,14,32,62,150,66,0
1363,Bakary Kone,Strasbourg,27.4,26,17,23,3,0,12,31,38.7,19,20,10,10,33,59,122,2
1364,Terence Kongolo,Huddersfield,11.7,33,20,19,13,1,14,22,63.6,8,12,6,6,32,65,71,0
1365,Terence Kongolo,Monaco,2.9,6,4,4,2,0,0,2,0.0,2,5,3,2,5,11,14,0
1366,Yevhen Konoplyanka,Schalke 04,17.4,11,9,3,4,4,3,11,27.3,8,18,1,17,5,16,6,0
1367,Julian Korb,Hannover 96,26.0,52,41,27,19,6,37,68,54.4,31,30,2,28,22,74,77,0
1368,Laurent Koscielny,Arsenal,24.7,43,21,27,12,4,19,33,57.6,14,28,15,13,54,97,138,3
1369,Filip Kostic,Hamburger SV,27.1,48,38,16,21,11,20,41,48.8,21,42,1,41,10,58,12,0
1370,Christian Kouakou,Caen,9.4,24,13,14,8,2,5,19,26.3,14,16,1,15,8,32,6,1
1371,Rominigue Kouame,Lille,2.2,5,2,2,2,1,2,3,66.7,1,1,0,1,5,10,0,0
1372,Tomas Koubek,Rennes,34.0,0,0,0,0,0,0,1,0.0,1,0,0,0,3,3,22,3
1373,Kalidou Koulibaly,Napoli,34.1,54,42,31,19,4,20,40,50.0,20,36,16,20,40,94,119,3
1374,Jules Kounde,Bordeaux,17.7,26,19,19,7,0,13,17,76.5,4,14,11,3,14,40,97,0
1375,Cheikhou Kouyate,West Ham,31.1,71,49,43,26,2,23,62,37.1,39,31,11,20,32,103,56,1
1376,Mateo Kovacic,Real Madrid,11.0,37,27,19,18,0,8,27,29.6,19,9,4,5,5,42,5,0
1378,Maksym Koval,La Coruña,1.3,0,0,0,0,0,0,0,0.0,0,0,0,0,0,0,0,2
1379,Dawid Kownacki,Sampdoria,9.1,8,7,1,4,3,3,11,27.3,8,7,0,7,1,9,5,0
1380,Vincent Koziello,Nice,9.0,16,8,9,5,2,5,16,31.3,11,8,3,5,19,35,7,1
1381,Vincent Koziello,Köln,8.8,28,21,6,21,1,10,21,47.6,11,9,0,9,10,38,5,1
1382,Thomas Kraft,Hertha BSC,3.0,0,0,0,0,0,0,0,0.0,0,0,0,0,0,0,1,0
1383,Emil Krafth,Bologna,10.5,23,16,14,8,1,10,19,52.6,9,12,4,8,16,39,39,1
1384,Oliver Kragl,Crotone,1.1,1,0,0,1,0,0,0,0.0,0,1,0,1,2,3,2,0
1385,Andrej Kramaric,Hoffenheim,24.8,8,6,4,3,1,3,8,37.5,5,15,0,15,6,14,7,0
1386,Christoph Kramer,M'Gladbach,23.9,89,70,43,34,12,39,76,51.3,37,29,4,25,43,132,37,1
1387,Ladislav Krejci,Bologna,4.4,7,5,1,3,3,1,5,20.0,4,3,0,3,2,9,3,0
1388,Rene Krhin,Nantes,14.6,18,12,7,11,0,3,17,17.6,14,11,2,9,16,34,39,0
1389,Bojan Krkic,Stoke City,0.8,0,0,0,0,0,0,1,0.0,1,1,0,1,0,0,0,0
1390,Bojan Krkic,Alavés,4.9,2,1,1,1,0,1,2,50.0,1,5,0,5,3,5,0,0
1391,Michael Krohn-Dehli,La Coruña,8.1,12,9,6,5,1,4,17,23.5,13,2,0,2,13,25,7,0
1392,Michael Krohn-Dehli,Sevilla,6.0,13,7,4,5,4,6,11,54.5,5,5,0,5,4,17,7,0
1393,Toni Kroos,Real Madrid,25.1,55,35,19,29,7,22,59,37.3,37,20,2,18,16,71,10,1
1394,Max Kruse,Werder Bremen,27.3,17,12,3,10,4,5,22,22.7,17,9,0,9,11,28,4,1
1395,Grzegorz Krychowiak,West Brom,18.2,39,24,18,17,4,12,49,24.5,37,23,5,18,45,84,23,0
1396,Lukas Kubler,Freiburg,12.8,31,19,16,15,0,13,23,56.5,10,15,6,9,18,49,41,0
1397,Jasmin Kurtic,SPAL,16.0,28,18,13,11,4,5,21,23.8,16,13,1,12,17,45,25,0
1398,Jasmin Kurtic,Atalanta,7.4,12,7,6,3,3,3,7,42.9,4,7,0,7,5,17,4,0
1399,Layvin Kurzawa,Paris S-G,18.9,44,32,20,15,9,15,39,38.5,24,16,3,13,35,79,41,2
1400,Filip Kusic,Köln,0.2,0,0,0,0,0,0,0,0.0,0,0,0,0,0,0,1,0
1401,Zdravko Kuzmanovic,Málaga,5.3,4,4,1,3,0,0,5,0.0,5,2,2,0,4,8,9,0
1402,Han Kwang-song,Cagliari,3.1,1,1,0,0,1,0,4,0.0,4,4,0,4,0,1,0,0
1404,Enock Kwateng,Nantes,1.0,8,6,6,2,0,7,11,63.6,4,2,0,2,1,9,7,0
1405,Alberto de la Bella,Real Sociedad,17.0,36,22,25,10,1,16,28,57.1,12,19,5,14,21,57,54,0
1406,Rajiv van La Parra,Huddersfield,23.7,41,29,18,15,8,12,41,29.3,29,27,1,26,21,62,8,1
1407,Brighton Labeau,Amiens,0.3,0,0,0,0,0,0,0,0.0,0,0,0,0,0,0,0,0
1408,Gaetan Laborde,Bordeaux,10.6,9,7,1,6,2,2,7,28.6,5,8,2,6,1,10,7,1
1409,Alexandre Lacazette,Arsenal,24.5,24,17,6,11,7,4,27,14.8,23,19,3,16,7,31,5,0
1410,Mehdi Lacen,Málaga,11.7,35,19,18,17,0,14,38,36.8,24,13,1,12,15,50,11,0
1411,Mehdi Lacen,Getafe,0.7,3,1,2,1,0,0,0,0.0,0,1,0,1,0,3,1,0
1412,Leo Lacroix,Saint-Étienne,8.6,13,8,8,5,0,5,9,55.6,4,6,3,3,11,24,54,1
1413,Freddie Ladapo,Crystal Palace,0.2,0,0,0,0,0,0,0,0.0,0,0,0,0,0,0,0,0
1414,Alban Lafont,Toulouse,38.0,1,0,1,0,0,1,4,25.0,3,0,0,0,2,3,20,5
1415,Victor Laguardia,Alavés,17.0,20,15,13,5,2,11,19,57.9,8,23,14,9,29,49,109,0
1416,Konrad Laimer,RB Leipzig,14.9,57,39,31,22,4,28,57,49.1,29,37,2,35,11,68,32,0
1417,Kenny Lala,Strasbourg,30.3,87,47,53,28,6,21,47,44.7,26,18,10,8,42,129,70,2
1418,Adam Lallana,Liverpool,3.4,3,1,3,0,0,2,10,20.0,8,3,0,3,1,4,1,0
1419,Eugenio Lamanna,Genoa,1.0,0,0,0,0,0,0,0,0.0,0,0,0,0,0,0,1,0
1420,Erik Lamela,Tottenham,9.4,23,13,9,7,7,3,20,15.0,17,11,1,10,7,30,5,0
1421,Adam Lang,Dijon,2.6,3,1,3,0,0,3,5,60.0,2,2,1,1,3,6,12,0
1422,Sebastian Langkamp,Hertha BSC,10.6,15,12,9,6,0,11,18,61.1,7,7,4,3,21,36,58,1
1423,Sebastian Langkamp,Werder Bremen,4.6,7,3,4,3,0,4,4,100.0,0,7,5,2,8,15,18,0
1424,Manuel Lanzini,West Ham,22.7,20,11,6,11,3,2,34,5.9,32,7,1,6,30,50,5,2
1425,Gianluca Lapadula,Genoa,16.6,8,5,4,4,0,1,11,9.1,10,7,1,6,3,11,8,0
1426,Aymeric Laporte,Manchester City,9.0,8,7,6,2,0,3,8,37.5,5,2,1,1,11,19,27,0
1427,Aymeric Laporte,Athletic Club,19.0,38,23,27,11,0,14,25,56.0,11,19,13,6,27,65,94,1
1428,Danilo Larangeira,Udinese,30.8,35,21,26,8,1,16,29,55.2,13,50,38,12,50,85,161,2
1430,Kevin Lasagna,Udinese,23.7,10,7,0,8,2,2,7,28.6,5,27,4,23,8,18,18,0
1431,Jamaal Lascelles,Newcastle Utd,32.5,31,19,19,11,1,12,19,63.2,7,33,24,9,28,59,232,1
1432,Paul Lasne,Montpellier,34.0,68,45,27,39,2,12,54,22.2,42,20,1,19,57,125,26,0
1433,Borja Lasso,Sevilla,0.6,4,1,2,2,0,1,2,50.0,1,3,0,3,0,4,0,0
1434,Toni Lato,Valencia,8.9,30,16,22,6,2,16,27,59.3,11,9,3,6,9,39,23,0
1435,Danny Latza,Mainz 05,26.1,67,48,28,33,6,33,73,45.2,40,43,8,35,26,93,47,1
1436,Vincent Laurini,Fiorentina,17.9,34,23,21,9,4,12,22,54.5,10,20,5,15,11,45,72,1
1437,Wesley Lautoa,Dijon,6.9,17,13,11,6,0,6,12,50.0,6,10,4,6,19,36,24,1
1438,Diego Laxalt,Genoa,31.2,54,43,31,17,6,22,59,37.3,37,38,3,35,25,79,55,1
1439,Miguel Layun,Sevilla,13.2,28,19,14,12,2,17,36,47.2,19,18,4,14,15,43,44,1
1440,Achraf Lazaar,Benevento,5.3,12,8,9,2,1,5,11,45.5,6,5,1,4,6,18,10,0
1441,Valentino Lazaro,Hertha BSC,20.7,33,28,11,12,10,15,31,48.4,16,35,2,33,15,48,32,0
1442,Darko Lazovic,Genoa,13.8,19,12,16,2,1,9,18,50.0,9,8,0,8,13,32,12,0
1443,Manuel Lazzari,SPAL,34.6,61,47,33,21,7,27,62,43.5,35,32,7,25,31,92,73,2
1444,Mickael Le Bihan,Nice,1.2,0,0,0,0,0,0,3,0.0,3,0,0,0,1,1,0,0
1445,Maxime Le Marchand,Nice,28.2,48,36,28,18,2,20,41,48.8,21,36,13,23,65,113,105,4
1446,James Lea Siliki,Rennes,20.2,31,21,9,19,3,6,41,14.6,35,21,1,20,18,49,14,1
1447,Mathew Leckie,Hertha BSC,20.6,35,30,16,15,4,20,35,57.1,15,26,3,23,19,54,32,1
1448,Benjamin Lecomte,Montpellier,38.0,1,1,1,0,0,0,0,0.0,0,1,0,1,0,1,14,1
1449,Pierre Lees-Melou,Nice,32.1,78,47,29,39,10,27,76,35.5,49,52,11,41,34,112,38,2
1450,Matthias Lehmann,Köln,16.8,33,23,14,18,1,17,29,58.6,12,15,7,8,26,59,24,1
1451,Lucas Leiva,Lazio,32.0,107,80,43,59,5,29,100,29.0,71,33,7,26,70,177,59,0
1452,Florian Lejeune,Newcastle Utd,23.4,34,20,26,8,0,14,30,46.7,16,21,15,6,46,80,154,0
1453,Inigo Lekue,Athletic Club,23.5,71,42,37,26,8,34,53,64.2,19,29,3,26,16,87,46,1
1454,Thomas Lemar,Monaco,26.4,33,17,9,19,5,10,41,24.4,31,22,1,21,18,51,16,1
1456,Mario Lemina,Southampton,19.1,55,40,21,29,5,12,30,40.0,18,18,6,12,36,91,36,4
1457,Mauricio Lemos,Sassuolo,7.8,11,9,8,3,0,7,14,50.0,7,10,5,5,9,20,33,1
1458,Mauricio Lemos,Las Palmas,14.0,22,10,17,5,0,15,27,55.6,12,16,13,3,25,47,51,1
1459,Dylan Lempereur,Metz,1.6,5,3,3,1,1,2,6,33.3,4,1,0,1,0,5,6,0
1460,Clement Lenglet,Sevilla,33.3,67,50,32,35,0,21,38,55.3,17,44,27,17,35,102,157,1
1461,Aaron Lennon,Burnley,12.4,20,14,5,14,1,2,20,10.0,18,20,5,15,8,28,18,0
1462,Aaron Lennon,Everton,8.8,17,10,10,5,2,5,21,23.8,16,13,1,12,11,28,9,0
1463,Bernd Leno,Leverkusen,33.0,0,0,0,0,0,0,1,0.0,1,0,0,0,1,1,11,2
1464,Pedro Leon,Eibar,10.3,9,4,0,2,7,0,4,0.0,4,18,2,16,9,18,5,0
1465,Sergio Leon,Betis,22.0,13,7,3,6,4,3,11,27.3,8,12,1,11,6,19,5,0
1466,Lukas Lerager,Bordeaux,36.5,107,74,33,61,13,33,107,30.8,74,44,8,36,67,174,66,1
1467,Mehdi Leris,Chievo,0.5,1,1,1,0,0,0,1,0.0,1,0,0,0,1,2,0,0
1468,Jefferson Lerma,Levante,23.7,51,35,26,23,2,17,45,37.8,28,25,10,15,49,100,43,0
1469,Maxime Lestienne,Málaga,7.4,8,5,5,0,3,3,15,20.0,12,7,1,6,6,14,6,0
1470,Alexandre Letellier,Angers,13.0,0,0,0,0,0,0,0,0.0,0,0,0,0,0,0,1,2
1471,Gaetano Letizia,Benevento,23.8,36,26,21,14,1,19,49,38.8,30,24,3,21,33,69,47,3
1472,Timo Letschert,Sassuolo,4.6,13,8,10,3,0,5,8,62.5,3,9,3,6,7,20,23,0
1473,Robert Lewandowski,Bayern Munich,24.1,5,3,1,1,3,0,3,0.0,3,6,0,6,5,10,10,0
1474,Igor Lewczuk,Bordeaux,4.9,9,7,5,3,1,3,6,50.0,3,2,2,0,7,16,11,0
1475,Stephan Lichtsteiner,Juventus,18.9,31,27,16,10,5,9,17,52.9,8,11,2,9,15,46,38,1
1476,Dimitri Lienard,Strasbourg,28.9,77,51,37,32,8,30,84,35.7,54,35,2,33,52,129,41,1
1477,Philipp Lienhart,Freiburg,9.6,16,14,12,4,0,6,17,35.3,11,14,9,5,11,27,60,0
1478,Lucas Lima,Nantes,29.5,73,46,40,27,6,31,68,45.6,37,42,6,36,38,111,85,0
1479,Victor Lindelof,Manchester Utd,14.3,17,11,10,6,1,9,14,64.3,5,15,11,4,13,30,67,1
1480,Karol Linetty,Sampdoria,23.8,66,49,25,31,10,17,77,22.1,60,40,2,38,18,84,13,0
1482,Jesse Lingard,Manchester Utd,20.2,30,21,10,13,7,5,27,18.5,22,18,3,15,9,39,13,0
1483,Pol Lirola,Sassuolo,22.5,34,21,26,6,2,20,35,57.1,15,11,4,7,28,62,88,1
1484,Jake Livermore,West Brom,29.7,72,41,27,35,10,24,64,37.5,40,44,9,35,26,98,36,2
1485,Raul Lizoain,Las Palmas,11.0,1,0,1,0,0,1,3,33.3,2,0,0,0,1,2,2,3
1486,Adem Ljajic,Torino,24.1,12,9,4,6,2,5,13,38.5,8,11,1,10,9,21,13,0
1487,Diego Llorente,Real Sociedad,25.8,30,22,16,13,1,18,29,62.1,11,41,18,23,43,73,96,0
1488,Fernando Llorente,Tottenham,2.6,6,3,1,2,3,1,2,50.0,1,0,0,0,0,6,6,0
1489,Marcos Llorente,Real Madrid,6.1,15,8,7,8,0,6,11,54.5,5,7,0,7,5,20,8,0
1490,Hugo Lloris,Tottenham,36.0,1,1,1,0,0,1,4,25.0,3,0,0,0,2,3,34,8
1491,Giovani Lo Celso,Paris S-G,19.7,77,58,26,36,15,26,74,35.1,48,30,5,25,19,96,12,1
1492,Simone Lo Faso,Fiorentina,0.4,1,1,1,0,0,0,1,0.0,1,0,0,0,1,2,0,0
1493,Stanislav Lobotka,Celta Vigo,34.0,64,45,24,35,5,23,65,35.4,42,25,9,16,39,103,22,0
1494,Jurgen Locadia,Brighton,2.5,1,0,0,1,0,0,1,0.0,1,0,0,0,1,2,1,1
1495,Manuel Locatelli,Milan,7.6,16,13,6,9,1,4,18,22.2,14,10,2,8,9,25,13,0
1496,Ruben Loftus-Cheek,Crystal Palace,20.8,21,15,7,13,1,7,30,23.3,23,19,2,17,22,43,31,0
1497,Enzo Loiodice,Dijon,1.9,9,5,4,5,0,4,7,57.1,3,0,0,0,2,11,0,0
1498,Joe Lolley,Huddersfield,2.5,2,0,1,1,0,0,2,0.0,2,0,0,0,3,5,2,1
1499,David Lomban,Eibar,11.0,16,8,12,3,1,10,15,66.7,5,6,4,2,29,45,66,2
1500,Cristiano Lombardi,Benevento,12.4,25,19,16,7,2,6,27,22.2,21,12,2,10,13,38,22,0
1501,Kevin Long,Burnley,16.0,32,23,28,4,0,16,26,61.5,10,25,14,11,19,51,129,1
1502,Shane Long,Southampton,17.6,25,20,1,19,5,10,30,33.3,20,14,2,12,12,37,29,0
1503,Ademola Lookman,Everton,1.8,1,1,0,1,0,0,2,0.0,2,2,0,2,1,2,3,0
1504,Ademola Lookman,RB Leipzig,6.4,5,4,2,3,0,0,0,0.0,0,3,0,3,2,7,2,0
1505,Anthony Lopes,Lyon,34.0,0,0,0,0,0,0,0,0.0,0,0,0,0,1,1,17,4
1506,Rony Lopes,Monaco,28.1,55,32,15,27,13,21,78,26.9,57,23,2,21,16,71,22,0
1508,Adrian Lopez,La Coruña,26.1,24,14,11,8,5,7,25,28.0,18,22,4,18,10,34,49,0
1509,Alberto Lopez,Málaga,0.5,1,1,0,1,0,1,1,100.0,0,1,0,1,2,3,2,0
1510,Andoni Lopez,Athletic Club,1.0,1,0,1,0,0,1,1,100.0,0,1,0,1,1,2,6,0
1511,David Lopez,Espanyol,37.0,67,49,47,19,1,27,54,50.0,27,43,26,17,67,134,161,0
1512,Diego Lopez,Espanyol,9.5,0,0,0,0,0,0,1,0.0,1,0,0,0,0,0,1,0
1513,Ivan Lopez,Levante,1.9,1,1,1,0,0,0,0,0.0,0,2,2,0,8,9,2,0
1514,Javi Lopez,Espanyol,10.7,47,35,31,12,4,18,35,51.4,17,7,2,5,18,65,48,0
1515,Lisandro Lopez,Inter,0.5,2,2,1,1,0,0,2,0.0,2,0,0,0,1,3,3,0
1516,Maxi Lopez,Udinese,18.7,12,8,2,7,3,0,4,0.0,4,8,2,6,2,14,18,0
1517,Maxime Lopez,Marseille,15.3,30,20,12,12,6,12,56,21.4,44,16,2,14,7,37,6,1
1518,Pedro Lopez Munoz,Levante,17.7,33,23,21,10,2,17,30,56.7,13,22,7,15,26,59,45,0
1519,Pau Lopez,Espanyol,28.5,0,0,0,0,0,0,0,0.0,0,0,0,0,1,1,15,2
1520,Pedro Lopez,Betis,4.6,0,0,0,0,0,0,0,0.0,0,1,0,1,0,0,3,0
1521,Victor Lopez,Alavés,0.7,2,1,0,2,0,0,1,0.0,1,0,0,0,1,3,1,0
1522,Jonas Lossl,Huddersfield,38.0,1,0,1,0,0,1,5,20.0,4,0,0,0,4,5,13,6
1523,Dejan Lovren,Liverpool,23.6,26,17,14,11,1,12,22,54.5,10,26,15,11,38,64,146,2
1524,Chris Lowe,Huddersfield,17.6,43,29,26,15,2,20,44,45.5,24,21,8,13,34,77,65,3
1525,Matthew Lowton,Burnley,25.5,55,34,26,27,2,28,60,46.7,32,35,15,20,39,94,141,2
1526,Anthony Lozano,Girona,5.2,9,5,2,7,0,1,5,20.0,4,3,0,3,3,12,2,0
1527,Fabio Lucioni,Benevento,8.0,11,9,7,4,0,7,11,63.6,4,14,11,3,7,18,61,0
1528,Filipe Luis,Atlético Madrid,18.4,83,52,41,33,9,36,49,73.5,13,27,7,20,35,118,34,0
1529,Jose Luis Gaya,Valencia,32.4,77,60,52,22,3,43,68,63.2,25,43,12,31,56,133,90,1
1530,Jose Luis Morales,Levante,34.0,37,23,15,15,7,13,65,20.0,52,28,0,28,26,63,20,0
1531,Jose Luis Palomino,Atalanta,22.0,60,39,36,19,5,24,51,47.1,27,36,21,15,39,99,111,1
1532,Luisinho,La Coruña,29.1,111,77,64,40,7,65,96,67.7,31,24,4,20,55,166,113,0
1534,David Luiz,Chelsea,9.3,18,11,13,4,1,11,21,52.4,10,9,5,4,24,42,45,2
1535,Douglas Luiz,Girona,3.4,10,9,4,6,0,3,11,27.3,8,1,0,1,4,14,0,0
1536,Everton Luiz,SPAL,7.1,22,16,10,10,2,6,29,20.7,23,8,1,7,10,32,8,1
1537,Jordan Lukaku,Lazio,15.1,28,15,14,11,3,10,16,62.5,6,14,2,12,15,43,23,0
1538,Romelu Lukaku,Manchester Utd,31.9,7,4,1,3,3,0,13,0.0,13,9,2,7,3,10,22,2
1539,Lars Lukas Mai,Bayern Munich,2.0,4,4,4,0,0,3,4,75.0,1,3,2,1,3,7,3,0
1540,Dodi Lukebakio,Watford,0.2,1,0,1,0,0,0,0,0.0,0,0,0,0,0,1,0,0
1541,Sasa Lukic,Levante,11.0,21,16,9,8,4,5,16,31.3,11,14,6,8,17,38,13,0
1542,Senad Lulic,Lazio,27.0,66,40,32,22,12,21,80,26.3,59,32,4,28,36,102,39,0
1543,Levi Lumeka,Crystal Palace,0.3,1,1,1,0,0,0,0,0.0,0,0,0,0,1,2,0,0
1544,Antonio Luna,Levante,22.5,39,26,23,13,3,24,41,58.5,17,26,9,17,36,75,68,0
1545,Arnaud Lusamba,Nice,1.8,12,9,4,6,2,3,7,42.9,4,5,0,5,1,13,1,0
1546,Fabian Lustenberger,Hertha BSC,17.6,47,34,26,20,1,21,31,67.7,10,31,12,19,24,71,74,1
1547,Andreas Luthe,Augsburg,2.0,0,0,0,0,0,0,0,0.0,0,0,0,0,0,0,2,0
1548,Lyanco,Torino,3.5,11,8,8,3,0,5,8,62.5,3,4,3,1,5,16,17,0
1549,Charalambos Lykogiannis,Cagliari,7.6,16,12,9,5,2,11,18,61.1,7,12,3,9,15,31,28,0
1550,Cheikh M'Bengue,Saint-Étienne,5.4,8,4,8,0,0,4,4,100.0,0,6,4,2,8,16,22,1
1551,Rais M'Bolhi,Rennes,1.0,0,0,0,0,0,0,1,0.0,1,0,0,0,0,0,0,0
1552,Yann M'Vila,Saint-Étienne,16.4,26,16,11,12,3,7,24,29.2,17,13,1,12,31,57,56,0
1553,Zinedine Machach,Toulouse,2.1,7,3,5,1,1,4,5,80.0,1,1,0,1,2,9,2,0
1554,Pablo Maffeo,Girona,29.4,74,55,39,23,12,25,49,51.0,24,28,7,21,50,124,82,0
1555,Christian Maggio,Napoli,7.1,17,10,9,6,2,7,19,36.8,12,15,4,11,13,30,21,0
1556,Francesco Magnanelli,Sassuolo,27.7,56,38,30,20,6,20,65,30.8,45,26,7,19,58,114,78,2
1557,Harry Maguire,Leicester City,38.0,63,46,47,15,1,26,43,60.5,17,35,28,7,48,111,181,1
1558,Hicham Mahou,Nice,0.6,1,1,1,0,0,1,3,33.3,2,0,0,0,3,4,0,0
1560,Riyad Mahrez,Leicester City,32.8,39,27,16,17,6,10,63,15.9,53,32,1,31,18,57,15,0
1561,Thiago Maia,Lille,27.4,55,40,26,26,3,15,61,24.6,46,32,10,22,61,116,47,1
1562,Arne Maier,Hertha BSC,13.6,29,23,12,16,1,18,24,75.0,6,19,3,16,24,53,20,0
1563,Sebastian Maier,Hannover 96,2.9,11,6,4,7,0,2,12,16.7,10,6,1,5,4,15,1,1
1564,Domenico Maietta,Bologna,5.2,5,4,4,1,0,3,9,33.3,6,8,6,2,7,12,13,1
1565,Habib Maiga,Saint-Étienne,7.9,29,18,16,10,3,12,30,40.0,18,8,4,4,19,48,10,0
1566,Mike Maignan,Lille,33.7,1,1,1,0,0,1,1,100.0,0,0,0,0,0,1,8,6
1567,Linton Maina,Hannover 96,0.1,1,1,0,0,1,0,0,0.0,0,0,0,0,1,2,0,0
1568,Ainsley Maitland-Niles,Arsenal,10.2,25,17,12,7,6,14,31,45.2,17,15,1,14,12,37,35,2
1569,Jean-Victor Makengo,Nice,2.7,4,2,2,2,0,1,2,50.0,1,1,0,1,3,7,1,1
1570,Nemanja Maksimovic,Valencia,6.2,21,13,10,8,3,8,16,50.0,8,15,6,9,16,37,8,0
1571,Nikola Maksimovic,Napoli,1.1,1,1,0,1,0,1,1,100.0,0,1,0,1,0,1,5,0
1572,Malcom,Bordeaux,31.7,15,10,3,7,5,1,28,3.6,27,13,1,12,14,29,6,0
1573,Kevin Malcuit,Lille,20.2,51,37,31,16,4,17,25,68.0,8,13,5,8,38,89,47,0
1574,Yunus Malli,Wolfsburg,24.9,25,17,8,14,3,12,25,48.0,13,23,0,23,12,37,17,0
1575,Hugo Mallo,Celta Vigo,33.3,84,55,55,26,3,35,53,66.0,18,30,15,15,68,152,111,1
1576,Scott Malone,Huddersfield,12.4,39,29,27,10,2,17,24,70.8,7,12,2,10,26,65,43,2
1577,Vincent Manceau,Angers,33.0,84,49,56,22,6,42,76,55.3,34,34,2,32,34,118,103,0
1578,Gianluca Mancini,Atalanta,7.6,20,14,11,8,1,10,17,58.8,7,8,2,6,15,35,22,0
1579,Steve Mandanda,Marseille,30.0,0,0,0,0,0,0,0,0.0,0,0,0,0,0,0,10,3
1580,Aissa Mandi,Betis,33.6,54,35,27,25,2,19,34,55.9,15,39,24,15,71,125,133,3
1581,Georges Mandjeck,Metz,10.8,25,14,8,16,1,8,18,44.4,10,9,3,6,18,43,21,1
1582,Rolando Mandragora,Crotone,36.0,91,60,48,34,9,26,69,37.7,43,41,13,28,86,177,75,0
1583,Mario Mandzukic,Juventus,25.8,36,23,13,11,12,8,29,27.6,21,20,3,17,25,61,42,2
1584,Sadio Mane,Liverpool,24.3,28,20,8,11,9,3,23,13.0,20,20,0,20,9,37,8,0
1586,Eliaquim Mangala,Everton,1.5,2,1,1,1,0,0,0,0.0,0,0,0,0,1,3,4,1
1587,Eliaquim Mangala,Manchester City,5.4,5,3,5,0,0,1,3,33.3,2,4,3,1,2,7,24,0
1588,Orel Mangala,Stuttgart,8.7,28,18,7,19,2,11,21,52.4,10,8,2,6,18,46,15,0
1589,Kader Mangane,Strasbourg,19.1,37,24,29,8,0,11,21,52.4,10,28,18,10,24,61,120,4
1590,Thomas Mangani,Angers,33.6,92,59,35,46,11,28,120,23.3,92,40,5,35,40,132,45,1
1591,Kostas Manolas,Roma,26.0,23,20,14,7,2,9,15,60.0,6,31,24,7,46,69,133,2
1592,Javier Manquillo,Newcastle Utd,19.5,36,22,25,8,3,15,30,50.0,15,25,6,19,18,54,65,0
1593,Martin Mantovani,Leganés,11.4,12,5,10,2,0,7,10,70.0,3,10,6,4,22,34,67,0
1594,Jose Manuel Jurado,Espanyol,16.7,18,14,8,8,2,5,14,35.7,9,13,1,12,16,34,5,0
1595,Harrison Manzala,Amiens,20.7,32,23,16,9,7,8,25,32.0,17,22,3,19,18,50,15,0
1596,Myziane Maolida,Lyon,3.7,5,5,3,2,0,0,2,0.0,2,1,0,1,0,5,0,0
1597,Faitout Maouassa,Rennes,9.9,6,3,2,3,1,2,10,20.0,8,12,2,10,6,12,5,0
1598,Fernando Marcal,Lyon,14.4,34,20,22,8,4,14,29,48.3,15,14,6,8,26,60,69,0
1599,Vincent Marcel,Nice,0.5,1,1,0,1,0,0,1,0.0,1,1,0,1,0,1,0,0
1600,Marcelo,Real Madrid,25.1,53,37,19,23,11,22,58,37.9,36,26,2,24,30,83,23,2
1601,Marcelo,Lyon,34.5,27,25,16,10,1,9,25,36.0,16,32,18,14,57,84,235,4
1602,Solly March,Brighton,20.6,54,41,34,14,6,22,54,40.7,32,27,3,24,13,67,49,0
1603,Gabriele Marchegiani,SPAL,0.0,0,0,0,0,0,0,0,0.0,0,0,0,0,0,0,0,0
1604,Claudio Marchisio,Juventus,9.1,17,10,9,5,3,6,21,28.6,15,7,2,5,4,21,7,0
1605,Gian Marco Ferrari,Sampdoria,29.4,12,8,8,4,0,5,10,50.0,5,42,38,4,31,43,149,4
1606,Oscar de Marcos,Athletic Club,18.4,28,21,11,15,2,13,29,44.8,16,15,2,13,19,47,36,0
1607,Jose Maria Gimenez,Atlético Madrid,18.8,38,27,29,6,3,23,35,65.7,12,28,15,13,30,68,101,1
1608,Mariano,Lyon,27.9,16,11,0,5,11,2,23,8.7,21,9,1,8,3,19,20,0
1609,Adrian Mariappa,Watford,24.6,45,26,33,12,0,14,34,41.2,20,25,16,9,45,90,133,4
1610,Jordan Marie,Dijon,20.9,63,38,22,36,5,18,66,27.3,48,26,9,17,40,103,25,2
1612,Adrian Marin,Villarreal,2.6,6,4,3,3,0,2,8,25.0,6,2,0,2,3,9,8,0
1613,Joao Mario,West Ham,11.4,14,11,6,5,3,6,19,31.6,13,7,0,7,8,22,4,1
1614,Joao Mario,Inter,6.2,8,4,3,3,2,2,8,25.0,6,6,1,5,4,12,5,0
1615,Guillermo Maripan,Alavés,17.0,28,16,24,4,0,17,32,53.1,15,19,10,9,36,64,108,0
1616,Marlon,Nice,21.4,36,26,22,13,1,15,22,68.2,7,19,15,4,15,51,72,2
1617,Dominic Maroh,Köln,10.2,22,15,18,4,0,15,18,83.3,3,17,9,8,21,43,68,1
1618,Marquinhos,Paris S-G,25.1,28,14,14,14,0,13,21,61.9,8,36,22,14,14,42,114,2
1619,Bruno Martella,Crotone,29.1,30,21,19,7,4,12,30,40.0,18,22,9,13,48,78,151,1
1620,Roger Marti,Levante,10.7,8,4,2,5,1,2,13,15.4,11,11,0,11,1,9,5,0
1621,Anthony Martial,Manchester Utd,17.6,15,13,9,2,4,3,12,25.0,9,5,1,4,3,18,7,0
1622,Aaron Martin,Espanyol,31.3,56,36,41,12,3,31,59,52.5,28,26,5,21,49,105,78,0
1623,Jonas Martin,Strasbourg,33.6,73,50,41,28,4,17,54,31.5,37,30,3,27,33,106,36,0
1624,Cuco Martina,Everton,20.3,61,35,38,15,8,27,46,58.7,19,17,4,13,42,103,130,2
1625,Carlos Martinez,Real Sociedad,0.0,0,0,0,0,0,0,0,0.0,0,0,0,0,0,0,0,0
1626,Emiliano Martinez,Getafe,5.0,0,0,0,0,0,0,0,0.0,0,0,0,0,0,0,3,0
1627,Inigo Martinez,Athletic Club,16.0,28,20,20,8,0,18,29,62.1,11,17,8,9,30,58,82,0
1628,Inigo Martinez,Real Sociedad,11.7,14,9,9,4,1,5,11,45.5,6,9,4,5,23,37,55,0
1629,Javi Martinez,Bayern Munich,17.9,31,22,11,15,5,9,19,47.4,10,16,5,11,33,64,40,1
1630,Pablo Martinez,Strasbourg,23.5,41,34,28,12,1,22,49,44.9,27,25,12,13,51,92,112,3
1631,Roger Martinez,Villarreal,2.6,1,1,0,1,0,0,2,0.0,2,2,0,2,0,1,1,0
1632,Christopher Martins,Lyon,0.8,3,2,0,3,0,1,2,50.0,1,0,0,0,1,4,0,0
1633,Bruno Martins Indi,Stoke City,13.8,21,12,18,3,0,10,19,52.6,9,16,11,5,21,42,77,1
1634,Jonathan Martins Pereira,Guingamp,12.6,34,18,21,10,3,8,23,34.8,15,9,3,6,37,71,39,1
1635,Adam Marusic,Lazio,28.0,28,21,17,8,3,12,28,42.9,16,22,2,20,31,59,33,0
1636,Omar Mascarell,Eint Frankfurt,8.6,20,16,8,12,0,10,18,55.6,8,14,1,13,21,41,10,0
1638,Javier Mascherano,Barcelona,6.0,15,13,9,6,0,8,9,88.9,1,14,8,6,8,23,20,0
1639,Andrea Masiello,Atalanta,30.1,58,38,34,20,4,30,54,55.6,24,24,6,18,72,130,137,0
1640,Adam Masina,Bologna,31.4,82,57,49,26,7,36,84,42.9,48,46,7,39,51,133,127,0
1641,Eden Massouema,Dijon,2.1,2,1,2,0,0,2,2,100.0,0,3,0,3,5,7,2,0
1642,Arthur Masuaku,West Ham,20.8,58,37,36,16,6,25,58,43.1,33,25,2,23,26,84,38,1
1643,Juan Mata,Manchester Utd,21.4,18,13,4,12,2,2,24,8.3,22,10,0,10,15,33,10,1
1644,Christian Mathenia,Hamburger SV,24.0,0,0,0,0,0,0,3,0.0,3,0,0,0,0,0,11,3
1645,Nemanja Matic,Manchester Utd,34.6,70,42,32,34,4,23,71,32.4,48,50,13,37,64,134,62,2
1646,Joel Matip,Liverpool,22.2,35,24,23,11,1,12,24,50.0,12,26,15,11,35,70,101,1
1647,Ryder Matos,Udinese,1.9,3,1,1,1,1,1,1,100.0,0,2,0,2,2,5,3,0
1648,Ryder Matos,Hellas Verona,10.9,18,15,11,5,2,4,9,44.4,5,5,0,5,3,21,9,1
1649,Alessandro Matri,Sassuolo,10.2,2,1,1,1,0,0,3,0.0,3,1,0,1,0,2,5,0
1650,Ville Matti Steinmann,Hamburger SV,6.6,16,10,6,8,2,8,17,47.1,9,6,1,5,18,34,9,1
1651,Federico Mattiello,SPAL,24.5,59,40,31,22,6,21,44,47.7,23,53,15,38,64,123,66,0
1652,Blaise Matuidi,Juventus,26.2,49,35,14,25,10,10,35,28.6,25,28,4,24,32,81,22,1
1653,Blaise Matuidi,Paris S-G,0.3,1,1,1,0,0,0,0,0.0,0,2,1,1,0,1,0,0
1654,Jose Mauri,Milan,0.1,0,0,0,0,0,0,0,0.0,0,0,0,0,0,0,0,0
1655,Mauricio,Lazio,0.1,0,0,0,0,0,0,0,0.0,0,0,0,0,0,0,0,0
1656,Mergim Mavraj,Hamburger SV,16.1,45,32,32,11,2,22,37,59.5,15,28,12,16,21,66,91,3
1657,Konstantinos Mavropanos,Arsenal,2.2,1,1,1,0,0,1,2,50.0,1,4,3,1,6,7,11,1
1658,Alfie Mawson,Swansea City,38.0,32,22,24,8,0,16,27,59.3,11,41,32,9,35,67,229,5
1659,Philipp Max,Augsburg,32.9,65,47,36,19,10,34,59,57.6,25,27,8,19,33,98,65,1
1660,Alexandru Maxim,Mainz 05,10.6,17,12,6,8,3,7,22,31.8,15,20,2,18,6,23,3,0
1661,Eric Maxim Choupo-Moting,Stoke City,25.7,42,30,21,16,5,9,32,28.1,23,31,3,28,23,65,29,1
1662,Florian Mayer,M'Gladbach,0.2,1,1,1,0,0,1,1,100.0,0,0,0,0,0,1,1,0
1664,Borja Mayoral,Real Madrid,3.8,6,3,0,4,2,1,5,20.0,4,3,0,3,0,6,0,0
1665,Robert Mazan,Celta Vigo,0.9,0,0,0,0,0,0,1,0.0,1,1,0,1,2,2,0,0
1666,Luca Mazzitelli,Sassuolo,11.3,37,24,14,15,8,10,36,27.8,26,21,2,19,21,58,19,0
1667,Kylian Mbappe,Monaco,0.8,1,1,0,1,0,0,0,0.0,0,0,0,0,1,2,0,0
1668,Kylian Mbappe,Paris S-G,23.3,11,8,3,3,5,1,13,7.7,12,4,1,3,0,11,1,0
1669,Ibrahima Mbaye,Bologna,19.6,59,34,40,17,2,25,36,69.4,11,25,6,19,28,87,95,0
1670,Chancel Mbemba,Newcastle Utd,7.5,16,12,13,3,0,10,17,58.8,7,7,3,4,15,31,44,1
1671,Adama Mbengue,Caen,17.7,71,48,48,18,5,41,65,63.1,24,21,1,20,28,99,50,0
1672,Isaac Mbenza,Montpellier,23.3,16,11,4,8,4,6,16,37.5,10,8,1,7,4,20,5,0
1673,Bryan Mbeumo,Troyes,0.7,0,0,0,0,0,0,3,0.0,3,2,0,2,0,0,2,0
1674,Jordi Mboula,Monaco,0.3,0,0,0,0,0,0,0,0.0,0,2,0,2,0,0,2,0
1675,James McArthur,Crystal Palace,27.0,58,44,28,27,3,23,61,37.7,38,39,2,37,36,94,44,2
1676,Gareth McAuley,West Brom,5.1,8,7,6,2,0,3,7,42.9,4,7,4,3,11,19,16,0
1677,Oliver McBurnie,Swansea City,3.1,4,3,0,2,2,1,3,33.3,2,2,0,2,0,4,3,0
1678,Alex McCarthy,Southampton,18.0,0,0,0,0,0,0,0,0.0,0,0,0,0,1,1,8,0
1679,James McCarthy,Everton,2.3,9,9,3,4,2,1,5,20.0,4,9,2,7,5,14,3,1
1680,James McClean,West Brom,15.6,40,28,23,14,3,10,55,18.2,45,18,4,14,20,60,22,0
1681,Weston McKennie,Schalke 04,14.0,36,23,11,21,4,13,32,40.6,19,16,2,14,20,56,32,0
1682,Sam McQueen,Southampton,1.6,4,4,4,0,0,2,4,50.0,2,2,1,1,3,7,3,0
1683,Scott McTominay,Manchester Utd,7.0,11,9,4,5,2,5,13,38.5,8,3,0,3,13,24,9,0
1684,Iuri Medeiros,Genoa,7.1,6,4,3,2,1,4,8,50.0,4,3,1,2,2,8,3,0
1685,Slobodan Medojevic,Eint Frankfurt,0.3,0,0,0,0,0,0,0,0.0,0,0,0,0,0,0,1,0
1686,Alvaro Medran,Alavés,10.5,20,14,5,10,5,8,21,38.1,13,7,0,7,13,33,10,0
1687,Alvaro Medran,Valencia,0.8,1,1,1,0,0,1,2,50.0,1,0,0,0,3,4,1,0
1688,Ben Mee,Burnley,29.0,33,20,22,11,0,16,29,55.2,13,51,42,9,33,66,217,1
1690,Riccardo Meggiorini,Chievo,8.7,9,6,3,6,0,1,6,16.7,5,12,3,9,2,11,9,0
1691,Admir Mehmedi,Wolfsburg,3.2,4,2,3,1,0,2,2,100.0,0,1,1,0,1,5,3,0
1692,Admir Mehmedi,Leverkusen,7.8,20,18,6,11,3,4,13,30.8,9,13,0,13,13,33,5,0
1693,Alexander Meier,Eint Frankfurt,0.0,0,0,0,0,0,0,0,0.0,0,0,0,0,0,0,0,0
1694,Soualiho Meite,Bordeaux,14.8,25,13,4,19,2,9,32,28.1,23,22,6,16,23,48,13,1
1695,Soualiho Meite,Monaco,1.1,2,1,1,1,0,2,5,40.0,3,1,0,1,3,5,3,0
1696,Oscar Melendo,Espanyol,7.6,2,2,2,0,0,0,5,0.0,5,2,0,2,3,5,3,0
1697,Memphis,Lyon,28.4,13,9,4,3,6,3,28,10.7,25,15,0,15,9,22,5,0
1698,Ledian Memushaj,Benevento,14.0,28,18,11,13,4,7,30,23.3,23,24,5,19,10,38,10,1
1699,Pedro Mendes,Montpellier,31.7,62,50,37,19,6,23,41,56.1,18,36,25,11,44,106,152,0
1700,Thiago Mendes,Lille,25.5,25,16,10,11,4,5,23,21.7,18,21,3,18,25,50,29,0
1701,Brais Mendez,Celta Vigo,10.5,19,15,9,6,4,7,17,41.2,10,13,0,13,4,23,12,0
1702,Stiven Mendoza,Amiens,11.5,18,10,7,7,4,2,11,18.2,9,11,1,10,15,33,8,0
1703,Alexandre Mendy,Bordeaux,8.8,4,4,1,2,1,1,6,16.7,5,5,1,4,1,5,4,0
1704,Benjamin Mendy,Manchester City,4.0,5,4,2,0,3,5,7,71.4,2,5,0,5,8,13,9,0
1705,Ferland Mendy,Lyon,23.6,45,28,29,13,3,20,31,64.5,11,18,5,13,25,70,43,0
1706,Nampalys Mendy,Nice,10.7,13,6,8,5,0,5,17,29.4,12,9,1,8,13,26,10,1
1707,Hamza Mendyl,Lille,9.5,18,10,12,6,0,11,20,55.0,9,5,0,5,17,35,26,0
1708,Gabriel Mercado,Sevilla,23.5,55,37,35,18,2,36,67,53.7,31,32,20,12,42,97,83,1
1709,Jorge Mere,Köln,21.0,34,23,25,9,0,23,35,65.7,12,25,13,12,34,68,110,1
1710,Alex Meret,SPAL,12.9,0,0,0,0,0,0,1,0.0,1,0,0,0,0,0,5,0
1711,Mikel Merino,Newcastle Utd,15.0,56,40,21,32,3,17,56,30.4,39,36,8,28,34,90,25,0
1712,Sabin Merino,Athletic Club,4.2,7,3,2,3,2,3,8,37.5,5,6,2,4,1,8,10,0
1713,Dries Mertens,Napoli,33.4,28,22,5,13,10,5,36,13.9,31,18,2,16,5,33,8,1
1714,Per Mertesacker,Arsenal,4.1,2,2,0,2,0,0,1,0.0,1,4,3,1,6,8,22,2
1716,Roque Mesa,Swansea City,8.4,20,13,8,8,4,10,37,27.0,27,6,0,6,13,33,8,1
1717,Roque Mesa,Sevilla,3.8,13,10,2,7,4,6,8,75.0,2,3,2,1,0,13,5,0
1718,Lionel Messi,Barcelona,33.3,17,8,0,11,6,2,18,11.1,16,11,1,10,7,24,0,0
1719,Thomas Meunier,Paris S-G,17.5,38,21,22,12,4,18,34,52.9,16,7,2,5,18,56,54,2
1720,Mexer,Rennes,13.3,15,12,9,6,0,9,12,75.0,3,13,7,6,16,31,98,2
1721,Max Meyer,Schalke 04,19.2,48,38,23,21,4,19,47,40.4,28,25,3,22,54,102,11,0
1722,Senna Miangue,Cagliari,8.9,7,5,4,2,1,3,7,42.9,4,8,1,7,7,14,35,0
1723,Michel,Las Palmas,23.7,33,24,21,8,4,14,25,56.0,11,21,11,10,39,72,64,1
1724,Mathieu Michel,Angers,6.6,0,0,0,0,0,0,1,0.0,1,0,0,0,0,0,0,1
1725,Clement Michelin,Toulouse,3.1,11,7,7,4,0,7,11,63.6,4,3,1,2,4,15,12,0
1726,Francesco Migliore,Genoa,3.7,5,5,4,1,0,2,6,33.3,4,1,0,1,3,8,9,1
1727,Simon Mignolet,Liverpool,19.0,2,1,2,0,0,1,3,33.3,2,0,0,0,0,2,5,3
1728,Nikola Milenkovic,Fiorentina,13.9,39,25,20,16,3,16,29,55.2,13,18,8,10,23,62,70,0
1729,Danijel Milicevic,Metz,7.9,8,4,0,4,4,1,9,11.1,8,5,0,5,3,11,2,0
1730,Arkadiusz Milik,Napoli,5.0,2,1,0,1,1,0,1,0.0,1,5,0,5,1,3,4,0
1731,Sergej Milinkovic-Savic,Lazio,31.6,55,39,11,34,10,13,52,25.0,39,29,6,23,33,88,36,1
1732,Vanja Milinkovic-Savic,Torino,1.0,0,0,0,0,0,0,0,0.0,0,0,0,0,0,0,0,0
1733,Luka Milivojevic,Crystal Palace,34.2,85,52,40,37,8,31,86,36.0,55,50,12,38,71,156,81,3
1734,James Milner,Liverpool,19.7,58,45,18,32,8,15,39,38.5,24,33,5,28,21,79,23,0
1735,Santi Mina,Valencia,17.3,17,9,4,9,4,4,22,18.2,18,14,1,13,2,19,19,0
1736,Yerry Mina,Barcelona,4.1,10,8,6,4,0,4,6,66.7,2,6,3,3,6,16,16,0
1737,Tyrone Mings,Bournemouth,2.2,1,1,1,0,0,0,0,0.0,0,2,2,0,6,7,13,1
1738,Ignasi Miquel,Málaga,19.7,19,10,11,7,1,4,15,26.7,11,23,13,10,33,52,113,0
1739,Kevin Mirallas,Everton,1.5,4,3,1,2,1,0,1,0.0,1,0,0,0,0,4,3,0
1740,Miranda,Inter,30.3,48,37,38,10,0,22,25,88.0,3,30,23,7,38,86,131,2
1742,Antonio Mirante,Bologna,33.0,0,0,0,0,0,0,3,0.0,3,1,0,1,0,0,11,5
1743,Simone Missiroli,Sassuolo,32.4,62,37,25,31,6,14,72,19.4,58,46,8,38,67,129,70,0
1744,Kostas Mitroglou,Marseille,9.7,3,2,1,2,0,1,4,25.0,3,1,1,0,0,3,2,0
1745,Aleksandar Mitrovic,Newcastle Utd,1.1,1,1,0,1,0,0,1,0.0,1,1,0,1,0,1,2,0
1746,Maximilian Mittelstadt,Hertha BSC,4.7,19,11,14,4,1,10,19,52.6,9,8,1,7,9,28,11,0
1747,Henrikh Mkhitaryan,Arsenal,8.8,18,13,9,7,2,5,21,23.8,16,16,2,14,8,26,7,0
1748,Henrikh Mkhitaryan,Manchester Utd,10.2,15,11,4,7,4,5,25,20.0,20,8,0,8,7,22,3,0
1749,Luka Modric,Real Madrid,21.9,33,22,14,15,4,15,41,36.6,26,13,4,9,31,64,7,0
1750,Niklas Moisander,Werder Bremen,25.0,36,28,22,13,1,24,36,66.7,12,21,9,12,38,74,98,2
1751,Johan Mojica,Girona,23.7,42,27,31,8,3,21,37,56.8,16,24,3,21,32,74,42,2
1752,Jorge Molina,Getafe,31.0,18,10,3,6,9,4,27,14.8,23,25,4,21,7,25,27,0
1753,Daniel Molina Orta,Celta Vigo,0.1,0,0,0,0,0,0,0,0.0,0,0,0,0,0,0,0,0
1754,Cristian Molinaro,Torino,17.4,37,29,19,14,4,11,18,61.1,7,15,4,11,22,59,70,1
1755,Francisco Molinero,Getafe,6.4,13,10,10,3,0,7,16,43.8,9,6,0,6,14,27,27,0
1756,Florent Mollet,Metz,15.7,25,18,10,12,3,3,25,12.0,22,8,1,7,11,36,8,0
1757,Momo,Las Palmas,7.5,14,8,8,3,3,4,13,30.8,9,5,0,5,5,19,1,0
1758,Thomas Monconduit,Amiens,32.8,81,49,33,43,5,34,87,39.1,53,52,17,35,55,136,81,2
1759,Kevin Monnet-Paquet,Saint-Étienne,19.6,33,25,9,19,5,11,48,22.9,37,15,2,13,13,46,23,1
1760,Nacho Monreal,Arsenal,24.9,54,32,19,29,6,21,48,43.8,27,26,7,19,56,110,83,2
1761,Jefferson Montero,Getafe,0.6,1,1,1,0,0,1,1,100.0,0,0,0,0,0,1,2,0
1762,Riccardo Montolivo,Milan,12.1,29,21,11,15,3,7,24,29.2,17,17,4,13,19,48,15,0
1763,Martin Montoya,Valencia,23.9,66,48,36,22,8,30,55,54.5,25,35,10,25,53,119,89,0
1764,Walter Montoya,Sevilla,0.8,1,1,1,0,0,1,3,33.3,2,1,0,1,0,1,3,0
1765,Shaquell Moore,Levante,4.7,8,6,3,3,2,3,7,42.9,4,4,0,4,13,21,11,0
1766,Aaron Mooy,Huddersfield,34.1,102,60,39,51,12,23,55,41.8,32,39,5,34,38,140,52,0
1768,Emre Mor,Celta Vigo,7.4,14,7,6,7,1,6,11,54.5,5,7,1,6,4,18,7,0
1769,Luca Mora,SPAL,10.4,19,17,6,8,5,5,17,29.4,12,9,3,6,4,23,20,0
1770,Sergio Mora,Getafe,9.0,21,15,8,12,1,14,31,45.2,17,10,2,8,15,36,11,0
1771,Erik Moran,Leganés,2.5,2,2,1,0,1,0,3,0.0,3,1,1,0,4,6,0,0
1772,Alvaro Morata,Chelsea,22.9,13,8,0,7,6,1,21,4.8,20,17,4,13,6,19,20,0
1773,Jan Moravek,Augsburg,7.8,41,37,17,23,1,21,36,58.3,15,19,3,16,11,52,11,0
1774,Jeremy Morel,Lyon,32.4,39,27,23,15,1,18,23,78.3,5,28,23,5,46,85,129,5
1775,Alberto Moreno,Liverpool,14.1,35,26,21,12,2,13,29,44.8,16,19,2,17,12,47,44,0
1776,Gerard Moreno,Espanyol,37.9,41,28,7,22,12,12,53,22.6,41,27,6,21,19,60,46,0
1777,Hector Moreno,Roma,2.6,2,2,1,1,0,0,1,0.0,1,1,1,0,3,5,5,0
1778,Hector Moreno,Real Sociedad,8.0,7,3,7,0,0,5,7,71.4,2,3,3,0,10,17,17,0
1779,Marlos Moreno,Girona,0.3,1,1,0,0,1,0,1,0.0,1,1,0,1,0,1,0,0
1780,Emiliano Moretti,Torino,19.8,31,18,25,6,0,14,16,87.5,2,30,23,7,21,52,77,2
1781,Wes Morgan,Leicester City,31.3,35,25,26,8,1,12,18,66.7,6,41,27,14,31,66,146,1
1782,Loren Moron,Betis,11.8,14,8,4,5,5,4,17,23.5,13,14,1,13,1,15,12,0
1783,James Morrison,West Brom,2.3,2,1,0,2,0,1,4,25.0,3,1,1,0,1,3,1,0
1784,Victor Moses,Chelsea,23.4,37,29,21,13,3,14,24,58.3,10,29,4,25,15,52,39,2
1785,Pedro Mosquera,La Coruña,15.5,48,31,15,29,4,13,38,34.2,25,26,6,20,23,71,38,0
1786,Lebo Mothiba,Lille,13.2,8,5,4,0,4,0,7,0.0,7,6,2,4,2,10,11,0
1787,Thiago Motta,Paris S-G,12.8,28,21,14,11,3,8,24,33.3,16,15,6,9,21,49,26,1
1788,Francois Moubandje,Toulouse,18.9,28,15,20,7,1,10,34,29.4,24,23,7,16,27,55,75,0
1789,Jessy Moulin,Saint-Étienne,3.4,0,0,0,0,0,0,0,0.0,0,0,0,0,0,0,3,2
1790,Steve Mounie,Huddersfield,20.6,11,8,2,4,5,0,19,0.0,19,23,3,20,7,18,30,0
1791,Lucas Moura,Tottenham,2.3,4,2,3,0,1,1,3,33.3,2,2,0,2,2,6,2,0
1792,Lucas Moura,Paris S-G,0.8,1,1,0,1,0,0,1,0.0,1,0,0,0,0,1,0,0
1794,Lys Mousset,Bournemouth,6.6,9,5,6,3,0,0,8,0.0,8,5,2,3,3,12,9,0
1795,Joao Moutinho,Monaco,31.1,65,41,19,37,9,27,80,33.8,53,52,12,40,36,101,54,0
1796,Samuel Moutoussamy,Nantes,4.8,15,7,6,7,2,5,8,62.5,3,7,1,6,3,18,4,0
1797,Toni Moya,Atlético Madrid,0.0,0,0,0,0,0,0,0,0.0,0,0,0,0,0,0,0,0
1798,Ndombe Mubele,Toulouse,4.1,8,4,6,2,0,4,10,40.0,6,11,0,11,9,17,4,0
1799,Ndombe Mubele,Rennes,13.6,14,8,5,6,3,5,13,38.5,8,9,0,9,3,17,3,0
1800,Nordi Mukiele,Montpellier,31.0,70,55,41,25,4,25,44,56.8,19,26,14,12,73,143,104,2
1801,Alex Mula,Málaga,6.2,7,3,3,4,0,2,12,16.7,10,5,0,5,6,13,1,0
1802,Florian Muller,Mainz 05,5.0,0,0,0,0,0,0,0,0.0,0,0,0,0,0,0,1,1
1803,Nicolai Muller,Hamburger SV,1.1,2,0,0,1,1,0,0,0.0,0,1,0,1,0,2,0,0
1804,Thomas Muller,Bayern Munich,22.3,35,30,10,15,10,13,27,48.1,14,17,1,16,7,42,14,1
1805,Iker Muniain,Athletic Club,8.7,10,8,2,6,2,1,7,14.3,6,4,0,4,4,14,3,0
1806,Marc Muniesa,Girona,12.5,33,18,17,15,1,11,23,47.8,12,12,5,7,33,66,40,0
1807,Ezequiel Munoz,Leganés,15.6,36,28,24,12,0,11,20,55.0,9,18,11,7,24,60,84,0
1808,Sulley Muntari,La Coruña,4.5,9,7,2,7,0,1,7,14.3,6,10,4,6,11,20,10,0
1809,Alessandro Murgia,Lazio,8.6,19,12,9,9,1,5,19,26.3,14,14,3,11,17,36,13,0
1810,Luis Muriel,Sevilla,17.9,16,9,2,8,6,2,23,8.7,21,16,2,14,3,19,4,1
1811,Jeison Murillo,Valencia,15.3,31,24,25,6,0,14,21,66.7,7,18,9,9,29,60,85,1
1812,Jacob Murphy,Newcastle Utd,12.8,13,10,5,4,4,7,27,25.9,20,16,0,16,6,19,13,2
1813,Jamie Murphy,Brighton,1.9,2,2,2,0,0,2,4,50.0,2,0,0,0,1,3,3,0
1814,Glenn Murray,Brighton,24.4,18,12,4,11,3,2,18,11.1,16,16,4,12,5,23,27,0
1815,Nicola Murru,Sampdoria,16.1,40,31,18,18,4,24,38,63.2,14,29,4,25,17,57,60,1
1816,Mateo Musacchio,Milan,13.4,22,15,13,7,2,8,16,50.0,8,9,3,6,12,34,58,1
1817,Charly Musonda Jr.,Chelsea,0.4,1,0,0,0,1,1,1,100.0,0,0,0,0,0,1,0,0
1818,Shkodran Mustafi,Arsenal,25.3,64,46,42,18,4,28,54,51.9,26,23,15,8,57,121,175,2
1820,Yoshinori Muto,Mainz 05,21.2,21,15,6,8,7,5,14,35.7,9,16,0,16,6,27,12,0
1821,Fahad Al Muwallad,Levante,0.3,0,0,0,0,0,0,1,0.0,1,0,0,0,1,1,0,0
1822,Yvon Mvogo,RB Leipzig,1.0,0,0,0,0,0,0,0,0.0,0,0,0,0,0,0,1,1
1823,Boaz Myhill,West Brom,1.0,0,0,0,0,0,0,0,0.0,0,0,0,0,0,0,1,0
1824,Alfred N'Diaye,Villarreal,1.1,3,1,1,1,1,1,1,100.0,0,0,0,0,3,6,3,0
1825,Kevin N'Doram,Monaco,8.0,16,10,6,9,1,6,24,25.0,18,6,2,4,16,32,29,0
1826,Abdallah N'dour,Strasbourg,2.8,9,5,6,3,0,5,10,50.0,5,6,1,5,2,11,5,0
1827,Clinton N'Jie,Marseille,9.7,10,6,2,5,3,2,9,22.2,7,5,0,5,3,13,0,0
1828,Georges-Kevin N'Koudou,Tottenham,0.0,0,0,0,0,0,0,0,0.0,0,0,0,0,0,0,1,0
1829,Georges-Kevin N'Koudou,Burnley,2.5,7,6,5,1,1,3,8,37.5,5,4,0,4,1,8,1,0
1830,Stanley N'Soki,Paris S-G,0.3,0,0,0,0,0,0,1,0.0,1,0,0,0,0,0,1,0
1831,Nacho,Real Madrid,23.0,55,40,29,19,7,20,38,52.6,18,21,9,12,46,101,51,0
1832,Yuto Nagatomo,Inter,8.8,10,6,4,5,1,5,14,35.7,9,8,3,5,10,20,28,0
1833,Adam Nagy,Bologna,7.9,16,9,6,8,2,7,13,53.8,6,11,0,11,7,23,5,0
1834,Matias Nahuel,Betis,2.8,4,4,1,1,2,2,5,40.0,3,2,0,2,2,6,1,0
1835,Radja Nainggolan,Roma,29.0,49,36,14,28,7,9,33,27.3,24,18,1,17,18,67,31,1
1836,Prejuce Nakoulma,Nantes,12.8,10,8,3,6,1,2,7,28.6,5,2,0,2,5,15,0,0
1837,Naldo,Espanyol,10.2,14,8,12,1,1,5,10,50.0,5,13,10,3,16,30,57,1
1838,Naldo,Schalke 04,34.0,51,36,38,12,1,31,46,67.4,15,39,21,18,55,106,200,1
1839,Andrea Nalini,Crotone,18.2,43,32,22,16,5,16,25,64.0,9,25,2,23,15,58,19,1
1840,Nani,Lazio,4.3,9,6,2,2,5,3,9,33.3,6,8,0,8,2,11,0,0
1841,Nano,Levante,3.1,7,6,2,4,1,1,1,100.0,0,4,0,4,0,7,0,0
1842,Naranjo,Leganés,6.2,17,10,3,12,2,4,12,33.3,8,11,1,10,3,20,4,0
1843,Luciano Narsingh,Swansea City,6.9,7,5,1,5,1,2,7,28.6,5,7,0,7,3,10,3,0
1844,Nikolas Nartey,Köln,0.1,0,0,0,0,0,0,0,0.0,0,0,0,0,0,0,0,0
1846,Juanjo Narvaez,Betis,3.4,8,6,4,4,0,3,6,50.0,3,3,0,3,8,16,4,0
1847,Matija Nastasic,Schalke 04,22.1,48,38,37,10,1,28,37,75.7,9,40,22,18,36,84,85,0
1848,Nathan,Amiens,0.1,0,0,0,0,0,0,0,0.0,0,0,0,0,0,0,0,0
1849,Kyle Naughton,Swansea City,33.7,92,60,49,35,8,54,100,54.0,46,60,13,47,60,152,144,4
1850,Fernando Navarro,La Coruña,11.6,32,22,24,7,1,16,25,64.0,9,13,3,10,29,61,49,0
1851,Marc Navarro,Espanyol,12.3,20,13,12,8,0,10,20,50.0,10,11,6,5,22,42,17,0
1852,Rafa Navarro,Betis,1.5,3,2,3,0,0,0,4,0.0,4,0,0,0,1,4,6,0
1853,Ximo Navarro,Las Palmas,29.0,63,43,44,19,0,28,50,56.0,22,27,16,11,66,129,131,4
1854,Jesus Navas,Sevilla,19.6,32,25,17,9,6,12,26,46.2,14,14,5,9,19,51,37,0
1855,Keylor Navas,Real Madrid,27.0,2,1,2,0,0,1,1,100.0,0,0,0,0,3,5,10,2
1856,Raul Navas,Real Sociedad,19.9,22,15,18,4,0,14,26,53.8,12,23,13,10,30,52,73,0
1857,Badou Ndiaye,Stoke City,12.6,53,28,22,25,6,16,41,39.0,25,21,9,12,13,66,18,0
1858,Wilfred Ndidi,Leicester City,32.2,138,89,68,65,5,45,119,37.8,74,67,10,57,51,189,103,2
1859,Merveille Ndockyt,Getafe,0.8,1,1,0,1,0,0,1,0.0,1,2,0,2,2,3,0,0
1860,Tanguy Ndombele,Amiens,2.6,6,5,2,4,0,1,4,25.0,3,4,0,4,5,11,3,0
1861,Tanguy Ndombele,Lyon,26.1,62,39,23,31,8,11,40,27.5,29,53,8,45,36,98,9,0
1862,Reiss Nelson,Arsenal,1.6,4,3,1,1,2,0,0,0.0,0,4,0,4,3,7,0,0
1863,Neto,Valencia,33.0,1,1,1,0,0,1,2,50.0,1,1,0,1,1,2,8,3
1864,Manuel Neuer,Bayern Munich,3.0,0,0,0,0,0,0,0,0.0,0,0,0,0,0,0,1,0
1865,Neymar,Paris S-G,19.8,20,14,3,11,6,7,40,17.5,33,4,0,4,5,25,2,0
1866,Yeni Ngbakoto,Guingamp,6.4,11,10,4,6,1,3,10,30.0,7,10,0,10,9,20,6,0
1867,Santy Ngom,Nantes,5.2,10,5,5,5,0,1,8,12.5,7,9,1,8,2,12,2,0
1868,Guy Ngosso,Amiens,6.8,8,5,4,4,0,4,20,20.0,16,5,3,2,9,17,19,0
1869,Julien Ngoy,Stoke City,0.2,1,1,0,1,0,1,2,50.0,1,0,0,0,0,1,0,0
1870,Opa Nguette,Metz,11.4,27,22,11,12,4,5,21,23.8,16,10,0,10,18,45,13,0
1872,Moussa Niakhate,Metz,34.5,57,38,44,12,1,22,37,59.5,15,27,14,13,55,112,139,1
1873,Adama Niane,Troyes,24.0,22,12,5,10,7,6,26,23.1,20,11,2,9,9,31,13,0
1874,Ibrahima Niane,Metz,9.4,6,5,4,1,1,2,8,25.0,6,6,0,6,4,10,8,0
1875,M'Baye Niang,Torino,17.0,29,23,11,9,9,6,18,33.3,12,17,3,14,13,42,15,0
1876,Oumar Niasse,Everton,12.1,10,6,2,5,3,4,19,21.1,15,3,2,1,2,12,6,0
1877,Florian Niederlechner,Freiburg,7.7,8,6,1,5,2,2,5,40.0,3,5,1,4,3,11,6,0
1878,Saul Niguez,Atlético Madrid,35.1,132,90,53,69,10,40,104,38.5,64,61,12,49,55,187,77,0
1879,Casimir Ninga,Montpellier,14.3,12,7,1,6,5,2,10,20.0,8,12,2,10,4,16,13,0
1880,Benjamin Nivet,Troyes,15.2,31,14,12,14,5,11,51,21.6,40,18,1,17,16,47,20,0
1881,Eddie Nketiah,Arsenal,0.2,1,1,0,1,0,0,0,0.0,0,0,0,0,0,1,0,0
1882,Jordan Nkololo,Caen,4.7,9,6,4,5,0,1,4,25.0,3,7,1,6,1,10,0,0
1883,Nicolas Nkoulou,Torino,36.2,56,40,40,15,1,22,33,66.7,11,44,22,22,57,113,163,1
1884,Christopher Nkunku,Paris S-G,7.0,5,2,2,2,1,3,14,21.4,11,8,2,6,5,10,2,1
1885,Lukas Nmecha,Manchester City,0.2,0,0,0,0,0,0,0,0.0,0,0,0,0,0,0,0,0
1886,Mark Noble,West Ham,26.7,61,36,32,22,7,16,76,21.1,60,28,10,18,47,108,32,1
1887,Vincent Nogueira,Strasbourg,0.7,0,0,0,0,0,0,0,0.0,0,0,0,0,0,0,2,0
1888,Nolito,Sevilla,17.8,49,36,21,21,7,14,33,42.4,19,17,2,15,10,59,17,0
1889,Havard Nordtveit,Hoffenheim,10.8,19,16,10,9,0,13,18,72.2,5,19,8,11,10,29,50,0
1890,Paul-Georges Ntep,Saint-Étienne,5.7,14,8,8,5,1,8,17,47.1,9,4,1,3,3,17,4,0
1891,Paul-Georges Ntep,Wolfsburg,1.8,2,2,0,0,2,0,1,0.0,1,3,1,2,1,3,0,0
1892,Alexander Nubel,Schalke 04,0.5,0,0,0,0,0,0,0,0.0,0,0,0,0,0,0,0,0
1893,Unai Nunez,Athletic Club,32.7,73,52,54,19,0,38,56,67.9,18,52,27,25,67,140,155,2
1894,Bram Nuytinck,Udinese,26.2,65,41,40,24,1,25,39,64.1,14,43,24,19,37,102,124,1
1895,Simeon Nwankwo,Crotone,13.5,12,9,1,5,6,1,12,8.3,11,16,3,13,1,13,20,0
1896,Gerzino Nyamsi,Rennes,3.0,4,2,4,0,0,0,3,0.0,3,2,2,0,3,7,18,2
1898,Allan Nyom,West Brom,25.7,64,39,43,17,4,28,43,65.1,15,20,9,11,27,91,93,0
1899,Steven Nzonzi,Sevilla,24.6,39,26,14,19,6,20,30,66.7,10,27,8,19,28,67,36,2
1900,Aiden O'Neill,Burnley,0.0,0.0,0.0,0.0,0.0,0.0,0.0,0.0,0.0,0.0,0.0,0.0,0.0,0.0,0.0,0.0,0.0
1901,Michael Obafemi,Southampton,0.1,0,0,0,0,0,0,0,0.0,0,0,0,0,0,0,0,0
1902,Joel Obi,Torino,13.9,45,25,20,20,5,8,26,30.8,18,17,3,14,24,69,15,0
1903,Johann Obiang,Troyes,5.2,13,9,9,2,2,6,13,46.2,7,9,1,8,7,20,15,0
1904,Pedro Obiang,West Ham,17.4,53,34,20,29,4,17,51,33.3,34,37,16,21,24,77,27,1
1905,Jan Oblak,Atlético Madrid,37.0,0,0,0,0,0,0,0,0.0,0,0,0,0,2,2,7,0
1906,Lucas Ocampos,Marseille,22.6,83,57,30,44,9,30,93,32.3,63,42,3,39,30,113,26,0
1907,Philipp Ochs,Hoffenheim,0.8,5,4,1,3,1,1,2,50.0,1,0,0,0,1,6,0,0
1908,Bastian Oczipka,Schalke 04,25.8,60,48,29,26,5,29,37,78.4,8,41,2,39,40,100,40,1
1909,Alvaro Odriozola,Real Sociedad,32.4,41,27,22,15,4,20,35,57.1,15,25,7,18,26,67,50,0
1910,Ebenezer Ofori,Stuttgart,0.1,0,0,0,0,0,0,1,0.0,1,1,0,1,0,0,0,0
1911,Angelo Ogbonna,West Ham,32.0,30,24,18,10,2,8,18,44.4,10,40,27,13,58,88,197,1
1912,Marios Oikonomou,SPAL,1.9,5,3,4,1,0,0,2,0.0,2,0,0,0,4,9,12,0
1913,Stefano Okaka,Watford,5.0,6,4,0,6,0,3,6,50.0,3,3,0,3,0,6,0,0
1914,Shinji Okazaki,Leicester City,14.7,25,16,3,18,4,4,28,14.3,24,15,1,14,8,33,6,0
1915,Orji Okwonkwo,Bologna,2.9,9,3,6,3,0,1,4,25.0,3,2,0,2,1,10,1,0
1916,Kwasi Okyere Wriedt,Bayern Munich,0.3,2,2,1,1,0,0,0,0.0,0,0,0,0,0,2,0,0
1917,Oier Olazabal,Levante,26.0,0,0,0,0,0,0,2,0.0,2,1,0,1,1,1,12,3
1918,Paulo Oliveira,Eibar,24.6,41,22,28,13,0,16,22,72.7,6,23,9,14,62,103,140,0
1919,Mathias Olivera,Getafe,1.1,3,1,1,0,2,3,5,60.0,2,3,0,3,1,4,2,0
1920,Maximiliano Olivera,Fiorentina,4.6,12,9,5,4,3,3,8,37.5,5,4,1,3,11,23,11,0
1921,Pawel Olkowski,Köln,5.0,17,12,9,8,0,5,9,55.6,4,11,2,9,3,20,17,0
1922,Martin Olsson,Swansea City,35.0,34,26,18,10,6,12,29,41.4,17,21,4,17,31,65,81,0
1924,Michael Olunga,Girona,4.8,6,5,1,3,2,1,3,33.3,2,5,0,5,3,9,5,0
1925,Stephane Omeonga,Genoa,8.9,25,15,16,8,1,7,18,38.9,11,20,1,19,5,30,6,0
1926,Prince Oniangue,Angers,11.7,16,11,5,9,2,8,31,25.8,23,20,4,16,11,27,8,0
1927,Karim Onisiwo,Mainz 05,2.8,7,5,5,1,1,3,7,42.9,4,4,0,4,1,8,8,0
1928,Javier Ontiveros,Málaga,4.3,10,7,8,2,0,2,4,50.0,2,4,2,2,4,14,4,0
1929,Daniel Opare,Augsburg,15.7,31,27,20,10,1,21,27,77.8,6,14,5,9,28,59,56,0
1930,Willi Orban,RB Leipzig,23.6,49,30,35,14,0,29,43,67.4,14,45,18,27,28,77,155,1
1931,Fabian Orellana,Eibar,13.1,14,8,5,8,1,4,23,17.4,19,10,1,9,7,21,3,0
1932,Divock Origi,Liverpool,0.1,0,0,0,0,0,0,0,0.0,0,0,0,0,0,0,0,0
1933,Divock Origi,Wolfsburg,21.9,6,5,2,3,1,1,7,14.3,6,16,2,14,3,9,17,0
1934,Riccardo Orsolini,Bologna,3.8,5,5,4,1,0,1,5,20.0,4,2,1,1,3,8,4,0
1935,Riccardo Orsolini,Atalanta,1.4,3,2,3,0,0,1,1,100.0,0,1,0,1,0,3,0,0
1936,Yuya Osako,Köln,21.1,13,10,4,9,0,4,18,22.2,14,13,2,11,8,21,22,0
1937,Victor Osimhen,Wolfsburg,3.2,4,4,3,1,0,2,5,40.0,3,2,1,1,2,6,7,0
1938,David Ospina,Arsenal,4.2,0,0,0,0,0,0,0,0.0,0,0,0,0,0,0,1,0
1939,Matthias Ostrzolek,Hannover 96,26.4,68,53,43,20,5,38,57,66.7,19,39,10,29,30,98,58,1
1940,Nicolas Otamendi,Manchester City,33.0,58,43,35,22,1,19,44,43.2,25,21,10,11,48,106,129,3
1941,Otavio,Bordeaux,16.5,64,42,25,37,2,20,61,32.8,41,26,4,22,32,96,35,0
1942,Anas Ouahim,Köln,0.2,1,1,0,1,0,1,1,100.0,0,0,0,0,0,1,0,0
1943,Alexandre Oukidja,Strasbourg,16.2,0,0,0,0,0,0,1,0.0,1,0,0,0,3,3,9,1
1944,Adam Ounas,Napoli,1.1,4,3,0,2,2,1,4,25.0,3,2,0,2,0,4,2,0
1945,Reece Oxford,West Ham,0.1,2,1,1,1,0,1,1,100.0,0,0,0,0,0,2,0,0
1946,Reece Oxford,M'Gladbach,5.1,8,6,3,4,1,3,4,75.0,1,4,0,4,9,17,26,1
1947,Alex Oxlade-Chamberlain,Arsenal,2.7,5,3,2,2,1,2,3,66.7,1,5,2,3,6,11,8,0
1948,Alex Oxlade-Chamberlain,Liverpool,16.6,32,21,13,14,5,6,21,28.6,15,24,0,24,20,52,14,0
1950,Mikel Oyarzabal,Real Sociedad,30.8,33,23,10,13,10,7,39,17.9,32,32,2,30,18,51,19,0
1951,Ambroise Oyongo,Montpellier,2.2,2,1,1,1,0,0,1,0.0,1,2,1,1,6,8,6,0
1952,Berkay Ozcan,Stuttgart,11.1,19,10,7,9,3,7,11,63.6,4,14,2,12,3,22,8,0
1953,Ramazan Ozcan,Leverkusen,1.0,0,0,0,0,0,0,1,0.0,1,0,0,0,0,0,0,0
1954,Salih Ozcan,Köln,18.6,56,42,24,29,3,28,54,51.9,26,27,5,22,29,85,22,1
1955,Mesut Ozil,Arsenal,24.0,20,13,6,10,4,5,22,22.7,17,11,1,10,12,32,9,0
1956,Levin Oztunali,Mainz 05,19.3,26,19,8,15,3,10,20,50.0,10,25,0,25,11,37,9,0
1957,Pablo,Bordeaux,14.3,16,15,13,3,0,10,16,62.5,6,13,7,6,16,32,96,1
1958,Daniel Pacheco,Getafe,1.9,4,4,1,2,1,0,1,0.0,1,2,0,2,2,6,1,0
1959,Fernando Pacheco,Alavés,37.3,0,0,0,0,0,0,0,0.0,0,1,0,1,3,3,12,4
1960,Simone Padoin,Cagliari,34.5,22,18,8,10,4,12,28,42.9,16,38,14,24,24,46,74,0
1961,Vincent Pajot,Saint-Étienne,14.3,24,16,9,13,2,3,17,17.6,14,21,9,12,24,48,34,0
1962,Rodrigo Palacio,Bologna,22.9,25,18,6,12,7,10,28,35.7,18,16,2,14,12,37,14,0
1963,Raffaele Palladino,Genoa,2.6,1,1,1,0,0,0,1,0.0,1,0,0,0,1,2,0,0
1964,Nicolas Pallois,Nantes,27.0,39,28,25,9,5,18,36,50.0,18,34,19,15,35,74,182,3
1965,Kasey Palmer,Huddersfield,1.9,6,3,2,3,1,2,8,25.0,6,5,0,5,0,6,2,0
1966,Emerson Palmieri,Chelsea,3.1,6,4,4,2,0,5,5,100.0,0,2,0,2,2,8,10,0
1967,Emerson Palmieri,Roma,0.2,0,0,0,0,0,0,0,0.0,0,0,0,0,0,0,0,0
1968,Julian Palmieri,Metz,12.5,29,15,17,9,3,17,29,58.6,12,16,2,14,22,51,31,0
1969,Simone Palombi,Lazio,0.7,0,0,0,0,0,0,0,0.0,0,0,0,0,0,0,0,0
1970,Alberto Paloschi,SPAL,24.3,10,7,0,9,1,0,10,0.0,10,2,1,1,4,14,11,0
1971,Goran Pandev,Genoa,20.0,10,9,3,6,1,2,13,15.4,11,8,0,8,4,14,5,0
1972,Costel Pantilimon,La Coruña,6.0,0,0,0,0,0,0,1,0.0,1,0,0,0,0,0,0,1
1973,Kyriakos Papadopoulos,Hamburger SV,29.0,60,54,36,24,0,41,69,59.4,28,54,35,19,43,103,181,2
1974,Sokratis Papastathopoulos,Dortmund,26.4,65,47,50,13,2,39,47,83.0,8,36,11,25,30,95,112,0
1976,Ruben Pardo,Real Sociedad,2.5,1,0,0,1,0,1,2,50.0,1,5,0,5,5,6,1,0
1977,Nicolas Pareja,Sevilla,4.5,11,8,7,3,1,3,5,60.0,2,8,1,7,13,24,24,0
1978,Daniel Parejo,Valencia,33.3,88,57,35,43,10,31,87,35.6,56,37,10,27,34,122,27,1
1979,Vittorio Parigini,Benevento,9.5,18,11,11,6,1,6,17,35.3,11,8,1,7,5,23,1,0
1980,Shawn Parker,Augsburg,0.5,0,0,0,0,0,0,0,0.0,0,0,0,0,0,0,0,0
1981,Marco Parolo,Lazio,29.0,70,37,27,36,7,14,58,24.1,44,49,8,41,43,113,64,0
1982,Thomas Partey,Atlético Madrid,26.4,94,64,48,39,7,33,69,47.8,36,32,7,25,53,147,34,1
1983,Felix Passlack,Hoffenheim,0.7,2,2,2,0,0,2,3,66.7,1,0,0,0,0,2,2,0
1984,Felix Passlack,Dortmund,0.1,0,0,0,0,0,0,0,0.0,0,0,0,0,1,1,0,0
1985,Javier Pastore,Paris S-G,15.0,33,21,9,16,8,5,23,21.7,18,13,0,13,10,43,14,1
1986,Patric,Lazio,6.6,11,6,8,2,1,4,6,66.7,2,3,0,3,3,14,32,0
1987,Paulinho,Barcelona,21.6,39,28,17,15,7,11,38,28.9,27,25,3,22,15,54,16,1
1988,Gabriel Paulista,Valencia,28.7,47,27,41,4,2,32,46,69.6,14,30,14,16,51,98,142,2
1989,Benjamin Pavard,Stuttgart,34.0,55,40,40,13,2,36,47,76.6,11,59,34,25,70,125,192,1
1990,Jiri Pavlenka,Werder Bremen,34.0,1,1,1,0,0,0,0,0.0,0,2,0,2,0,1,17,4
1991,Daniel Pavlovic,Crotone,8.4,10,5,9,0,1,5,10,50.0,5,4,3,1,5,15,22,0
1992,Daniel Pavlovic,Sampdoria,1.0,3,1,1,1,1,1,1,100.0,0,0,0,0,0,3,5,0
1993,Mateo Pavlovic,Angers,21.8,13,7,10,3,0,7,20,35.0,13,14,11,3,21,34,120,0
1994,Leonardo Pavoletti,Cagliari,30.2,27,13,5,14,8,2,21,9.5,19,13,5,8,13,40,28,0
1995,Dimitri Payet,Marseille,26.1,22,11,5,13,4,8,37,21.6,29,19,2,17,19,41,7,1
1996,Giampaolo Pazzini,Hellas Verona,11.0,0,0,0,0,0,0,4,0.0,4,2,0,2,1,1,13,0
1997,Giampaolo Pazzini,Levante,4.9,0,0,0,0,0,0,0,0.0,0,1,0,1,1,1,1,0
1998,Alfonso Pedraza,Alavés,27.1,57,40,24,21,12,19,56,33.9,37,39,5,34,32,89,26,0
1999,Pedro,Chelsea,16.9,20,11,6,8,6,5,18,27.8,13,13,1,12,13,33,7,1
2000,Joao Pedro,Cagliari,18.4,15,9,4,9,2,0,12,0.0,12,9,1,8,11,26,24,0
2002,Stef Peeters,Caen,12.3,22,11,6,14,2,6,31,19.4,25,17,3,14,7,29,11,0
2003,Gianluca Pegolo,Sassuolo,1.2,0,0,0,0,0,0,0,0.0,0,0,0,0,0,0,0,0
2004,Peter Pekarik,Hertha BSC,15.3,42,33,17,21,4,21,29,72.4,8,23,3,20,18,60,44,0
2005,Bryan Pele,Troyes,17.9,20,9,9,8,3,4,28,14.3,24,11,0,11,15,35,13,0
2006,Yohann Pele,Marseille,8.2,0,0,0,0,0,0,1,0.0,1,0,0,0,1,1,2,0
2007,Pietro Pellegri,Genoa,3.1,1,0,0,0,1,0,5,0.0,5,3,0,3,2,3,1,0
2008,Pietro Pellegri,Monaco,0.3,0,0,0,0,0,0,2,0.0,2,1,0,1,0,0,0,0
2009,Lorenzo Pellegrini,Roma,20.0,36,20,16,11,9,10,35,28.6,25,21,2,19,41,77,21,1
2010,Theo Pellenard,Bordeaux,15.9,32,20,13,15,4,10,28,35.7,18,15,6,9,32,64,31,0
2011,Sergio Pellissier,Chievo,6.2,6,2,1,3,2,1,3,33.3,2,3,0,3,1,7,2,0
2012,Federico Peluso,Sassuolo,28.8,46,34,29,13,4,14,26,53.8,12,39,13,26,40,86,132,1
2013,Ruben Pena,Eibar,19.2,41,28,20,17,4,20,42,47.6,22,24,6,18,30,71,31,0
2014,Gabriel Penalba,Las Palmas,6.3,6,5,4,2,0,5,11,45.5,6,7,4,3,8,14,15,0
2015,Adalberto Penaranda,Málaga,8.9,10,6,2,6,2,2,3,66.7,1,8,1,7,0,10,1,0
2016,Nicolas Pepe,Lille,31.6,30,18,14,11,5,11,42,26.2,31,23,0,23,10,40,20,0
2017,Andreas Pereira,Valencia,12.0,26,15,12,11,3,10,30,33.3,20,9,1,8,11,37,5,0
2018,Pedro Pereira,Genoa,4.2,5,4,2,1,2,3,5,60.0,2,5,2,3,5,10,15,0
2019,Bruno Peres,Roma,12.8,26,17,16,7,3,10,23,43.5,13,9,2,7,22,48,28,1
2020,Roberto Pereyra,Watford,18.0,10,8,4,5,1,2,13,15.4,11,16,0,16,9,19,6,0
2021,Ayoze Perez,Newcastle Utd,27.7,39,21,11,15,13,12,54,22.2,42,36,1,35,24,63,28,0
2022,Hernan Perez,Alavés,4.2,11,8,6,4,1,2,19,10.5,17,5,0,5,3,14,6,0
2023,Hernan Perez,Espanyol,1.6,4,3,1,1,2,2,3,66.7,1,1,0,1,1,5,1,0
2024,Lucas Perez,La Coruña,31.1,17,12,5,8,4,1,32,3.1,31,19,1,18,9,26,1,0
2025,Ruben Perez,Leganés,28.0,99,61,47,48,4,48,101,47.5,53,30,5,25,77,176,40,0
2026,Stipe Perica,Udinese,10.5,8,5,2,5,1,2,13,15.4,11,7,1,6,3,11,9,0
2028,Mattia Perin,Genoa,37.0,0,0,0,0,0,0,1,0.0,1,0,0,0,1,1,14,2
2029,Ivan Perisic,Inter,36.8,47,31,15,23,9,8,56,14.3,48,47,6,41,45,92,62,0
2030,Diego Perotti,Roma,17.9,25,17,6,14,5,8,20,40.0,12,19,0,19,11,36,13,0
2031,Romain Perraud,Nice,0.0,0,0,0,0,0,0,0,0.0,0,0,0,0,0,0,0,0
2032,Loic Perrin,Saint-Étienne,27.4,39,26,28,10,1,21,31,67.7,10,35,22,13,36,75,142,1
2033,Andrea Petagna,Atalanta,18.0,8,3,2,4,2,1,11,9.1,10,14,3,11,4,12,5,0
2034,Nils Petersen,Freiburg,24.9,27,18,7,18,2,10,27,37.0,17,28,2,26,17,44,33,0
2035,Bruno Petkovic,Hellas Verona,10.2,14,12,3,8,3,6,13,46.2,7,11,1,10,7,21,12,0
2036,Bruno Petkovic,Bologna,3.7,7,6,0,5,2,1,1,100.0,0,3,0,3,4,11,5,0
2037,German Pezzella,Fiorentina,33.1,63,47,42,19,2,19,41,46.3,22,33,16,17,63,126,185,1
2038,Giuseppe Pezzella,Udinese,10.0,19,11,10,4,5,7,19,36.8,12,8,1,7,6,25,32,0
2039,Maximilian Philipp,Dortmund,13.4,24,19,9,12,3,6,19,31.6,13,12,0,12,6,30,7,0
2040,Chris Philipps,Metz,9.4,22,12,10,10,2,5,26,19.2,21,13,5,8,30,52,18,0
2041,Matt Phillips,West Brom,23.3,27,16,17,5,5,10,29,34.5,19,21,1,20,24,51,43,0
2042,Lebogang Phiri,Guingamp,11.5,28,17,14,12,2,11,43,25.6,32,9,2,7,19,47,13,0
2043,Pablo Piatti,Espanyol,19.3,45,32,14,21,10,17,57,29.8,40,28,3,25,22,67,16,0
2044,Jordan Pickford,Everton,38.0,0,0,0,0,0,0,2,0.0,2,0,0,0,2,2,26,5
2045,Jeremy Pied,Southampton,2.0,9,6,8,1,0,6,9,66.7,3,3,2,1,8,17,4,0
2046,Nicholas Pierini,Sassuolo,0.5,1,1,0,0,1,0,0,0.0,0,1,0,1,1,2,0,0
2047,Ronael Pierre-Gabriel,Saint-Étienne,13.0,43,31,33,7,3,17,28,60.7,11,11,2,9,9,52,35,0
2048,Erik Pieters,Stoke City,30.2,71,47,43,26,2,24,51,47.1,27,70,25,45,61,132,127,5
2049,Tomas Pina Isla,Alavés,26.5,71,49,27,38,6,20,40,50.0,20,28,10,18,43,114,37,0
2050,Andrea Pinamonti,Inter,0.2,0,0,0,0,0,0,0,0.0,0,0,0,0,0,0,0,0
2051,Carlo Pinsoglio,Juventus,0.3,0,0,0,0,0,0,0,0.0,0,0,0,0,0,0,0,0
2052,Gerard Pique,Barcelona,29.2,31,22,22,9,0,16,36,44.4,20,40,27,13,30,61,127,0
2054,Facundo Piriz,Montpellier,9.0,25,16,9,12,4,6,35,17.1,29,10,1,9,18,43,14,0
2055,Fabio Pisacane,Cagliari,21.4,52,39,36,13,3,15,41,36.6,26,29,16,13,38,90,105,1
2056,Lukasz Piszczek,Dortmund,23.8,51,37,23,23,5,30,52,57.7,22,39,11,28,42,93,64,1
2057,Claudio Pizarro,Köln,6.4,11,9,3,6,2,6,9,66.7,3,10,2,8,3,14,5,0
2058,Guido Pizarro,Sevilla,19.5,75,47,36,36,3,29,67,43.3,38,20,7,13,26,101,48,0
2059,Marko Pjaca,Schalke 04,2.9,5,3,2,3,0,4,6,66.7,2,3,0,3,1,6,2,0
2060,Miralem Pjanic,Juventus,27.6,36,30,13,18,5,13,51,25.5,38,25,5,20,64,100,27,2
2061,Carles Planas,Girona,2.1,5,2,4,1,0,3,6,50.0,3,1,0,1,5,10,6,0
2062,Jaroslav Plasil,Bordeaux,11.6,24,14,7,17,0,7,31,22.6,24,18,6,12,21,45,15,0
2063,Marvin Plattenhardt,Hertha BSC,33.0,57,43,39,15,3,35,50,70.0,15,24,7,17,27,84,92,0
2064,Alassane Plea,Nice,33.8,15,9,5,7,3,5,32,15.6,27,14,3,11,8,23,21,0
2065,Morgan Poaty,Montpellier,1.9,0,0,0,0,0,0,1,0.0,1,5,3,2,1,1,2,0
2066,Geronimo Poblete,Metz,18.4,58,37,23,29,6,25,66,37.9,41,19,0,19,24,82,22,1
2067,Florentin Pogba,Saint-Étienne,3.6,6,0,4,2,0,3,5,60.0,2,2,2,0,1,7,12,0
2068,Paul Pogba,Manchester Utd,23.9,33,23,13,15,5,5,33,15.2,28,16,0,16,21,54,26,0
2069,Joel Pohjanpalo,Leverkusen,1.3,0,0,0,0,0,0,2,0.0,2,1,1,0,0,0,2,0
2070,Eugen Polanski,Hoffenheim,2.9,8,7,3,4,1,5,6,83.3,1,6,1,5,4,12,4,0
2071,Andrea Poli,Bologna,28.3,66,53,33,27,6,18,64,28.1,46,55,3,52,43,109,27,0
2072,Matteo Politano,Sassuolo,31.2,23,16,8,10,5,3,32,9.4,29,13,2,11,14,37,13,0
2073,Julian Pollersbeck,Hamburger SV,10.0,0,0,0,0,0,0,1,0.0,1,0,0,0,0,0,4,1
2074,Ezequiel Ponce,Lille,12.2,9,8,3,5,1,0,7,0.0,7,2,1,1,3,12,11,0
2075,Pere Pons,Girona,28.4,80,54,28,48,4,23,87,26.4,64,28,3,25,30,110,25,0
2076,Simone Pontisso,Udinese,0.1,1,0,0,1,0,0,0,0.0,0,0,0,0,0,1,0,0
2077,Nick Pope,Burnley,34.6,0,0,0,0,0,0,1,0.0,1,0,0,0,0,0,21,0
2078,Jeremie Porsan-Clemente,Montpellier,1.0,3,2,1,2,0,2,2,100.0,0,1,0,1,1,4,4,1
2080,Francisco Portillo,Getafe,27.3,38,23,15,18,5,11,45,24.4,34,25,1,24,22,60,21,0
2081,Portu,Girona,33.3,30,24,9,11,10,8,33,24.2,25,14,0,14,12,42,1,0
2082,Stefan Posch,Hoffenheim,8.4,28,21,18,7,3,15,27,55.6,12,15,4,11,24,52,30,0
2083,Sergio Postigo,Levante,26.9,36,23,30,5,1,18,32,56.3,14,27,13,14,40,76,140,1
2084,Yussuf Poulsen,RB Leipzig,18.5,23,19,2,13,8,7,12,58.3,5,24,5,19,9,32,8,0
2085,Maxime Poundje,Bordeaux,18.9,53,29,32,16,5,28,51,54.9,23,14,6,8,35,88,63,1
2086,Dario Poveda,Villarreal,0.0,1,0,0,1,0,1,1,100.0,0,0,0,0,0,1,0,0
2087,Dennis Praet,Sampdoria,29.5,85,57,34,36,15,38,73,52.1,35,49,1,48,37,122,22,0
2088,Sanjin Prcic,Rennes,17.4,37,18,9,24,4,8,39,20.5,31,19,5,14,30,67,25,0
2089,Nicolas de Preville,Bordeaux,21.5,34,27,10,15,9,9,33,27.3,24,25,4,21,21,55,12,0
2090,Nicolas de Preville,Lille,3.2,3,3,0,1,2,1,5,20.0,4,3,0,3,0,3,2,0
2091,Andres Prieto,Málaga,4.0,0,0,0,0,0,0,0,0.0,0,0,0,0,0,0,2,0
2092,Xabi Prieto,Real Sociedad,21.4,18,14,5,9,4,2,10,20.0,8,8,2,6,7,25,20,0
2093,Jerome Prior,Bordeaux,2.0,0,0,0,0,0,0,0,0.0,0,0,0,0,0,0,2,2
2094,Alex Pritchard,Huddersfield,11.1,18,8,2,6,10,10,21,47.6,11,6,1,5,5,23,11,0
2095,Sloan Privat,Guingamp,0.0,0,0,0,0,0,0,0,0.0,0,0,0,0,0,0,0,0
2096,Sebastian Prodl,Watford,17.4,22,17,19,3,0,8,15,53.3,7,20,9,11,31,53,92,1
2097,Davy Propper,Brighton,34.7,73,44,35,35,3,18,83,21.7,65,35,11,24,60,133,80,2
2098,Manuel Pucciarelli,Chievo,15.3,23,14,3,11,9,8,21,38.1,13,15,0,15,7,30,4,0
2099,Christian Puggioni,Benevento,13.1,0,0,0,0,0,0,0,0.0,0,0,0,0,0,0,5,1
2100,Christian Puggioni,Sampdoria,9.0,0,0,0,0,0,0,0,0.0,0,0,0,0,0,0,6,1
2101,Marc Pugh,Bournemouth,10.9,7,3,2,4,1,2,10,20.0,8,6,1,5,13,20,13,2
2102,Erick Pulgar,Bologna,30.8,70,48,41,29,0,24,75,32.0,51,49,13,36,46,116,83,1
2103,Christian Pulisic,Dortmund,25.6,46,30,12,20,14,26,44,59.1,18,24,2,22,16,62,11,0
2104,Jason Puncheon,Crystal Palace,7.2,13,4,3,7,3,1,5,20.0,4,3,0,3,5,18,4,0
2106,George Puscas,Benevento,7.8,0,0,0,0,0,0,3,0.0,3,0,0,0,1,1,13,0
2107,Loic Puyo,Angers,1.9,9,5,2,5,2,3,4,75.0,1,7,3,4,4,13,2,0
2108,Fabio Quagliarella,Sampdoria,30.2,11,9,1,3,7,2,25,8.0,23,34,0,34,7,18,23,0
2109,Robin Quaison,Mainz 05,15.7,17,14,1,10,6,7,11,63.6,4,16,2,14,7,24,9,0
2110,Collin Quaner,Huddersfield,14.2,22,15,8,8,6,9,26,34.6,17,24,4,20,11,33,15,0
2111,Dani Raba,Villarreal,12.3,25,21,9,12,4,9,45,20.0,36,21,1,20,17,42,10,0
2112,Adrien Rabiot,Paris S-G,26.2,59,36,27,23,9,15,36,41.7,21,29,10,19,33,92,22,1
2113,Nemanja Radoja,Celta Vigo,12.3,18,16,6,8,4,3,8,37.5,5,8,2,6,10,28,11,0
2114,Ivan Radovanovic,Chievo,34.9,55,35,30,22,3,18,48,37.5,30,39,16,23,47,102,107,1
2115,Stefan Radu,Lazio,28.8,53,38,36,16,1,25,41,61.0,16,30,14,16,55,108,105,1
2116,Rafael,Cagliari,8.8,0,0,0,0,0,0,0,0.0,0,0,0,0,1,1,9,0
2117,Rafael,Lyon,20.1,54,28,30,18,6,22,43,51.2,21,20,3,17,42,96,53,0
2118,Raffael,M'Gladbach,23.0,40,32,12,23,5,17,36,47.2,19,18,0,18,8,48,2,0
2119,Rafinha,Inter,11.6,14,9,1,10,3,3,16,18.8,13,15,0,15,7,21,9,0
2120,Rafinha,Bayern Munich,20.6,39,33,24,11,4,28,47,59.6,19,17,6,11,32,71,30,0
2121,Andrea Raggi,Monaco,17.9,20,10,15,4,1,10,27,37.0,17,12,6,6,31,51,66,0
2122,Antonino Ragusa,Sassuolo,9.2,17,7,11,4,2,8,23,34.8,15,12,1,11,6,23,16,0
2123,Baba Rahman,Schalke 04,0.4,1,0,0,1,0,0,0,0.0,0,2,0,2,2,3,1,0
2124,Ivan Rakitic,Barcelona,31.5,52,31,16,30,6,15,45,33.3,30,42,7,35,44,96,16,0
2125,Andre Ramalho,Leverkusen,0.4,3,1,2,1,0,2,2,100.0,0,1,0,1,1,4,1,0
2126,Jonas Ramalho,Girona,25.5,25,16,20,5,0,15,24,62.5,9,25,11,14,35,60,115,0
2127,Adil Rami,Marseille,32.8,39,29,22,15,2,22,41,53.7,19,25,19,6,45,84,163,3
2128,Benito Ramirez,Las Palmas,1.8,6,3,2,3,1,1,5,20.0,4,0,0,0,2,8,3,0
2129,Gaston Ramirez,Sampdoria,24.6,33,20,4,15,14,9,56,16.1,47,30,3,27,18,51,24,0
2130,Sandro Ramirez,Everton,3.1,2,1,0,1,1,0,3,0.0,3,1,0,1,1,3,0,0
2132,Sandro Ramirez,Sevilla,8.0,8,8,1,5,2,1,7,14.3,6,2,0,2,4,12,2,0
2133,Tono Ramirez,Real Sociedad,3.5,0,0,0,0,0,0,1,0.0,1,0,0,0,0,0,1,3
2134,Ivan Ramis,Eibar,14.5,20,14,8,12,0,8,19,42.1,11,12,5,7,25,45,51,2
2135,Omar Ramos,Leganés,16.1,22,14,6,8,8,9,22,40.9,13,16,1,15,14,36,15,0
2136,Sergio Ramos,Real Madrid,25.4,40,29,22,18,0,19,28,67.9,9,22,12,10,47,87,91,0
2137,Aaron Ramsey,Arsenal,20.5,35,27,18,17,0,8,44,18.2,36,14,3,11,24,59,6,1
2138,Angel Rangel,Swansea City,1.7,4,3,2,2,0,1,3,33.3,2,0,0,0,3,7,4,0
2139,Andrea Ranocchia,Inter,7.0,8,4,6,2,0,3,6,50.0,3,6,5,1,12,20,35,0
2140,Marcus Rashford,Manchester Utd,20.1,14,11,4,5,5,6,18,33.3,12,18,0,18,8,22,19,0
2141,Milot Rashica,Werder Bremen,4.3,2,2,1,1,0,1,8,12.5,7,3,0,3,3,5,4,0
2142,Konstantin Rausch,Köln,10.3,21,16,13,7,1,11,26,42.3,15,9,2,7,17,38,25,0
2143,Yoric Ravet,Freiburg,5.5,9,7,3,6,0,3,7,42.9,4,7,0,7,3,12,6,0
2144,Ante Rebic,Eint Frankfurt,19.5,37,29,7,21,9,7,24,29.2,17,27,2,25,6,43,13,0
2145,Pedro Rebocho,Guingamp,19.1,29,22,18,8,3,12,28,42.9,16,20,6,14,19,48,76,0
2146,Recio,Málaga,20.4,54,42,26,23,5,17,62,27.4,45,15,3,12,30,84,17,0
2147,Nathan Redmond,Southampton,21.6,32,17,16,14,2,12,31,38.7,19,20,0,20,15,47,17,2
2148,Alberto Redondo,Getafe,1.0,4,3,4,0,0,2,4,50.0,2,2,1,1,0,4,1,0
2149,Fabian Reese,Schalke 04,0.8,2,2,1,1,0,1,2,50.0,1,1,0,1,2,4,1,0
2150,Vasco Regini,Sampdoria,12.0,13,7,11,0,2,6,11,54.5,5,14,7,7,11,24,68,0
2151,Xesc Regis,Eibar,0.0,1,1,0,1,0,0,0,0.0,0,0,0,0,0,1,0,0
2152,Winston Reid,West Ham,16.1,11,9,7,4,0,4,15,26.7,11,27,14,13,22,33,104,0
2153,Pepe Reina,Napoli,37.0,1,0,1,0,0,1,2,50.0,1,0,0,0,0,1,13,2
2154,Jeff Reine-Adelaide,Angers,4.9,13,8,7,5,1,6,17,35.3,11,7,2,5,1,14,9,0
2155,Karim Rekik,Hertha BSC,25.6,38,29,32,6,0,24,26,92.3,2,27,11,16,28,66,116,2
2156,Loic Remy,Las Palmas,8.5,4,3,1,3,0,0,1,0.0,1,0,0,0,1,5,2,0
2158,Loic Remy,Getafe,5.1,4,2,1,3,0,1,5,20.0,4,4,0,4,1,5,2,0
2159,Jan Repas,Caen,10.0,14,11,5,5,4,4,18,22.2,14,10,0,10,7,21,3,0
2160,Panagiotis Retsos,Leverkusen,19.1,48,40,32,14,2,33,46,71.7,13,29,8,21,29,77,47,0
2161,Marco Reus,Dortmund,10.3,16,8,2,12,2,5,12,41.7,7,16,3,13,4,20,9,0
2162,Elvis Rexhbecaj,Wolfsburg,1.4,4,2,1,2,1,1,1,100.0,0,3,0,3,2,6,3,0
2163,Baptiste Reynet,Dijon,38.0,6,4,5,1,0,5,7,71.4,2,2,0,2,2,8,35,1
2164,Franck Ribery,Bayern Munich,13.4,19,16,9,5,5,13,17,76.5,4,11,0,11,7,26,3,0
2165,Federico Ricca,Málaga,12.3,43,24,32,9,2,23,33,69.7,10,10,2,8,24,67,46,0
2166,Federico Ricci,Crotone,10.2,25,18,9,10,6,9,28,32.1,19,14,0,14,11,36,5,0
2167,Federico Ricci,Genoa,2.4,2,2,2,0,0,1,3,33.3,2,2,0,2,1,3,1,0
2168,Declan Rice,West Ham,15.9,36,24,25,10,1,15,25,60.0,10,19,13,6,27,63,77,1
2169,Richarlison,Watford,31.4,64,44,26,28,10,10,39,25.6,29,39,5,34,24,88,32,1
2170,Marco Richter,Augsburg,7.2,17,14,8,8,1,8,17,47.1,9,5,1,4,1,18,10,0
2171,Diego Rico,Leganés,24.8,68,43,37,21,10,36,53,67.9,17,30,6,24,76,144,61,0
2172,Mikel Rico,Athletic Club,13.0,24,13,7,16,1,12,34,35.3,22,15,5,10,23,47,12,1
2173,Sergio Rico,Sevilla,24.0,1,1,1,0,0,0,2,0.0,2,0,0,0,1,2,5,3
2174,Jairo Riedewald,Crystal Palace,4.9,11,8,6,4,1,0,2,0.0,2,7,1,6,12,23,13,0
2175,Asier Riesgo,Eibar,1.0,0,0,0,0,0,0,0,0.0,0,0,0,0,0,0,0,0
2176,Luca Rigoni,Genoa,17.5,32,22,11,20,1,7,35,20.0,28,24,2,22,19,51,13,0
2177,Nicola Rigoni,Chievo,10.4,29,20,15,12,2,9,26,34.6,17,8,3,5,11,40,22,1
2178,Kevin Rimane,Paris S-G,0.1,0,0,0,0,0,0,0,0.0,0,0,0,0,0,0,0,0
2179,Tomas Rincon,Torino,33.3,66,40,30,34,2,24,66,36.4,42,33,8,25,57,123,61,1
2180,Birk Risa,Köln,0.9,1,1,0,1,0,0,3,0.0,3,2,1,1,0,1,0,0
2181,Marcel Risse,Köln,13.0,21,14,17,4,0,11,19,57.9,8,21,3,18,6,27,10,2
2182,Matt Ritchie,Newcastle Utd,31.2,46,32,22,18,6,14,53,26.4,39,37,5,32,35,81,63,1
2184,Cristian Rivera,Eibar,2.7,13,10,4,8,1,5,7,71.4,2,2,2,0,3,16,2,0
2185,Emmanuel Riviere,Metz,22.3,10,3,1,6,3,1,12,8.3,11,8,0,8,2,12,5,0
2186,Jonathan Rivierez,Metz,22.9,81,59,50,26,5,41,80,51.3,39,21,7,14,39,120,73,0
2187,Luca Rizzo,SPAL,5.4,18,10,7,10,1,5,17,29.4,12,10,0,10,3,21,5,1
2188,Arjen Robben,Bayern Munich,16.7,14,11,1,7,6,4,12,33.3,8,9,0,9,4,18,4,0
2189,Rober,Levante,21.2,35,22,27,8,0,17,32,53.1,15,29,18,11,41,76,75,1
2190,Roberto,Málaga,34.0,0,0,0,0,0,0,0,0.0,0,0,0,0,2,2,15,0
2191,Sergi Roberto,Barcelona,24.7,63,40,30,25,8,25,49,51.0,24,18,8,10,39,102,30,1
2192,Connor Roberts,Swansea City,3.0,6,4,5,1,0,3,3,100.0,0,2,0,2,3,9,6,0
2193,Andrew Robertson,Liverpool,21.6,31,17,19,9,3,15,29,51.7,14,22,2,20,26,57,56,0
2194,Alex Robles,Málaga,1.0,2,1,1,1,0,0,0,0.0,0,1,0,1,3,5,4,0
2195,Hal Robson-Kanu,West Brom,9.2,5,4,1,2,2,0,13,0.0,13,9,3,6,4,9,9,0
2196,Marc Roca,Espanyol,2.9,8,7,3,5,0,3,4,75.0,1,4,2,2,4,12,10,0
2197,Ruben Rochina,Levante,1.7,8,5,5,2,1,4,6,66.7,2,0,0,0,2,10,0,0
2198,Ronny Rodelin,Caen,35.1,33,22,7,18,8,8,42,19.0,34,21,2,19,28,61,41,1
2199,Rodri,Villarreal,35.9,104,71,50,48,6,30,86,34.9,56,49,21,28,52,156,100,1
2200,Rodrigo,Valencia,29.8,23,13,9,12,2,3,21,14.3,18,14,2,12,17,40,11,1
2201,Kevin Rodrigues,Real Sociedad,18.2,44,32,18,20,6,19,34,55.9,15,22,6,16,27,71,39,0
2202,Angel Rodriguez,Getafe,25.5,28,19,3,19,6,3,26,11.5,23,18,3,15,6,34,14,0
2203,Ivan Rodriguez,Málaga,0.2,1,1,0,1,0,0,0,0.0,0,0,0,0,1,2,1,0
2204,James Rodriguez,Bayern Munich,18.0,35,27,10,15,10,15,30,50.0,15,16,1,15,12,47,4,0
2205,Jay Rodriguez,West Brom,31.2,31,21,12,11,8,9,50,18.0,41,32,2,30,19,50,41,0
2206,Ricardo Rodriguez,Milan,33.4,48,29,24,18,6,18,28,64.3,10,36,6,30,33,81,93,3
2207,Marko Rog,Napoli,3.2,11,7,3,6,2,1,11,9.1,10,4,1,3,2,13,1,0
2208,Rogerio,Sassuolo,10.1,18,14,10,5,3,7,15,46.7,8,11,1,10,9,27,31,0
2210,Marcus Rohden,Crotone,18.1,33,19,21,10,2,14,50,28.0,36,14,1,13,18,51,30,0
2211,Marcos Rojo,Manchester Utd,7.1,7,5,6,0,1,1,8,12.5,7,11,6,5,7,14,56,2
2212,Diego Rolan,Málaga,21.6,33,25,7,13,13,9,44,20.5,35,18,1,17,12,45,9,0
2213,Rolando,Marseille,27.9,44,29,28,15,1,23,40,57.5,17,22,14,8,37,81,126,0
2214,Esteban Rolon,Málaga,4.6,6,4,4,2,0,2,4,50.0,2,7,1,6,9,15,8,1
2215,Filippo Romagna,Cagliari,21.0,33,18,20,12,1,16,26,61.5,10,20,11,9,33,66,96,0
2216,Alessio Romagnoli,Milan,26.1,20,14,17,2,1,9,14,64.3,5,24,14,10,23,43,154,1
2217,Simone Romagnoli,Bologna,6.2,12,9,10,2,0,4,9,44.4,5,12,8,4,7,19,41,2
2218,Aristoteles Romero,Crotone,1.0,11,7,7,4,0,3,5,60.0,2,3,0,3,5,16,0,0
2219,Oscar Romero,Alavés,2.8,5,2,4,1,0,0,3,0.0,3,3,0,3,3,8,2,0
2220,Sergio Romero,Manchester Utd,1.0,0,0,0,0,0,0,0,0.0,0,0,0,0,0,0,0,0
2221,Oriol Romeu,Southampton,32.2,93,64,41,44,8,32,100,32.0,68,59,19,40,69,162,77,2
2222,Romulo,Hellas Verona,35.2,58,44,23,29,6,13,54,24.1,41,29,2,27,43,101,41,0
2223,Cristiano Ronaldo,Real Madrid,25.4,7,4,3,3,1,1,6,16.7,5,10,3,7,6,13,14,0
2224,Facundo Roncaglia,Celta Vigo,16.6,35,25,30,5,0,22,36,61.1,14,18,6,12,31,66,50,1
2225,Salomon Rondon,West Brom,30.7,14,6,0,7,7,5,26,19.2,21,27,0,27,14,28,20,0
2226,Valentin Rongier,Nantes,26.1,73,49,25,39,9,17,64,26.6,47,42,6,36,40,113,13,1
2227,Marten de Roon,Atalanta,28.6,77,50,27,44,6,29,82,35.4,53,40,5,35,46,123,36,0
2228,Wayne Rooney,Everton,25.2,28,19,11,13,4,10,42,23.8,32,25,6,19,16,44,43,2
2229,Roberto Rosales,Málaga,34.7,104,69,52,40,12,50,84,59.5,34,37,13,24,58,162,104,1
2230,Danny Rose,Tottenham,8.9,15,11,6,7,2,8,15,53.3,7,12,6,6,9,24,15,0
2231,Liam Rosenior,Brighton,1.8,4,3,2,1,1,2,5,40.0,3,2,1,1,4,8,7,0
2232,Aleandro Rosi,Genoa,18.9,24,17,7,13,4,5,19,26.3,14,24,5,19,20,44,61,1
2233,Valentin Rosier,Dijon,30.9,73,54,47,23,3,26,68,38.2,42,43,9,34,58,131,124,0
2234,Luca Rossettini,Genoa,22.5,16,8,12,3,1,6,17,35.3,11,31,21,10,29,45,151,1
2236,Francesco Rossi,Atalanta,0.1,0,0,0,0,0,0,0,0.0,0,0,0,0,0,0,0,0
2237,Giuseppe Rossi,Genoa,2.9,1,1,0,1,0,0,3,0.0,3,2,0,2,1,2,1,0
2238,Jerome Roussillon,Montpellier,20.9,40,27,17,19,4,15,26,57.7,11,26,3,23,15,55,52,0
2239,Wayne Routledge,Swansea City,4.8,10,5,2,6,2,2,8,25.0,6,5,0,5,2,12,5,0
2240,Nolan Roux,Metz,31.5,24,17,8,10,6,7,38,18.4,31,32,2,30,25,49,22,0
2241,Ruben,La Coruña,27.5,1,0,1,0,0,1,3,33.3,2,0,0,0,1,2,5,4
2242,Antonio Rudiger,Chelsea,26.0,31,21,20,10,1,15,31,48.4,16,29,15,14,24,55,115,1
2243,Sebastian Rudy,Bayern Munich,16.8,50,40,12,33,5,28,55,50.9,27,11,1,10,18,68,7,1
2244,Stephane Ruffier,Saint-Étienne,34.6,0,0,0,0,0,0,0,0.0,0,0,0,0,0,0,14,1
2245,Vincent Rufli,Dijon,0.3,4,1,3,1,0,3,3,100.0,0,1,0,1,1,5,0,0
2246,Daniele Rugani,Juventus,21.5,18,12,11,5,2,7,13,53.8,6,18,14,4,20,38,87,1
2247,Mario Rui,Napoli,23.2,55,39,18,32,5,30,52,57.7,22,30,5,25,14,69,43,1
2248,Aitor Ruibal,Betis,0.1,0,0,0,0,0,0,0,0.0,0,0,0,0,0,0,0,0
2249,Fabian Ruiz Pena,Betis,29.5,83,53,34,40,9,26,73,35.6,47,35,3,32,42,125,36,1
2250,Victor Ruiz,Villarreal,26.8,33,22,29,4,0,13,25,52.0,12,27,18,9,58,91,134,1
2251,Antonio Rukavina,Villarreal,14.1,25,22,12,9,4,17,25,68.0,8,11,3,8,16,41,68,0
2252,Geronimo Rulli,Real Sociedad,26.0,2,1,2,0,0,2,6,33.3,4,0,0,0,0,2,10,2
2253,Lukas Rupp,Hoffenheim,12.9,36,32,18,14,4,19,36,52.8,17,18,0,18,13,49,13,2
2254,Marco Russ,Eint Frankfurt,12.7,17,11,9,8,0,13,19,68.4,6,23,11,12,24,41,66,0
2255,Mathew Ryan,Brighton,38.0,0,0,0,0,0,0,3,0.0,3,0,0,0,3,3,10,3
2256,Idriss Saadi,Strasbourg,10.5,6,5,2,3,1,2,11,18.2,9,3,2,1,5,11,1,0
2257,Youssouf Sabaly,Bordeaux,34.4,93,61,54,34,5,43,68,63.2,25,26,6,20,54,147,104,0
2258,Abdelhamid Sabiri,Huddersfield,2.4,5,4,2,0,3,1,7,14.3,6,4,0,4,1,6,2,0
2259,Marcel Sabitzer,RB Leipzig,19.9,38,28,12,20,6,23,49,46.9,26,23,2,21,24,62,21,1
2260,Enric Saborit,Athletic Club,15.9,50,27,31,17,2,19,29,65.5,10,17,5,12,24,74,55,0
2262,Ihsan Sacko,Nice,2.9,1,1,0,1,0,0,1,0.0,1,1,0,1,2,3,1,0
2263,Ihsan Sacko,Strasbourg,7.9,10,8,6,0,4,2,10,20.0,8,2,0,2,5,15,6,0
2264,Mujaid Sadick,La Coruña,1.2,4,2,2,2,0,2,3,66.7,1,3,2,1,1,5,4,0
2265,Armando Sadiku,Levante,3.0,1,1,0,1,0,0,1,0.0,1,4,2,2,2,3,2,0
2266,Umar Sadiq,Torino,2.5,0,0,0,0,0,0,3,0.0,3,1,0,1,1,1,2,0
2267,Bacary Sagna,Benevento,10.6,9,7,5,3,1,1,7,14.3,6,9,2,7,20,29,28,0
2268,Adrian Sahibeddine,Dijon,0.4,0,0,0,0,0,0,1,0.0,1,1,0,1,0,0,0,0
2269,Nuri Sahin,Dortmund,13.6,40,34,9,28,3,15,39,38.5,24,12,0,12,20,60,29,1
2270,Wesley Said,Dijon,20.4,33,22,17,11,5,7,26,26.9,19,15,1,14,15,48,4,0
2271,Allan Saint-Maximin,Nice,25.0,18,14,13,2,3,12,28,42.9,16,12,1,11,11,29,10,0
2272,Allan Saint-Maximin,Monaco,0.2,0,0,0,0,0,0,0,0.0,0,0,0,0,0,0,0,0
2273,Henri Saivet,Newcastle Utd,0.9,5,3,4,1,0,2,5,40.0,3,0,0,0,4,9,8,1
2274,Gotoku Sakai,Hamburger SV,25.4,50,40,25,18,7,22,47,46.8,25,40,12,28,44,94,55,0
2275,Hiroki Sakai,Marseille,28.0,66,45,30,30,6,32,49,65.3,17,32,7,25,45,111,90,1
2276,Diafra Sakho,West Ham,3.4,5,2,1,4,0,0,3,0.0,3,3,0,3,1,6,2,0
2277,Diafra Sakho,Rennes,8.6,5,4,1,2,2,0,7,0.0,7,4,0,4,2,7,11,0
2278,Mamadou Sakho,Crystal Palace,17.8,21,14,15,5,1,9,16,56.3,7,19,11,8,30,51,101,3
2279,Bakary Sako,Crystal Palace,5.3,7,6,5,0,2,2,9,22.2,7,2,0,2,1,8,2,0
2280,Emiliano Sala,Nantes,33.7,19,11,3,9,7,5,33,15.2,28,27,3,24,9,28,50,0
2281,Jacopo Sala,Sampdoria,11.0,17,10,12,4,1,4,10,40.0,6,9,1,8,8,25,28,2
2282,Mohamed Salah,Liverpool,32.3,12,6,2,5,5,3,23,13.0,20,10,0,10,5,17,5,0
2283,Bartosz Salamon,SPAL,19.2,28,22,21,7,0,12,21,57.1,9,24,18,6,58,86,148,0
2284,Carlos Salcedo,Eint Frankfurt,17.9,26,22,16,9,1,19,29,65.5,10,28,12,16,21,47,94,1
2285,Eddie Salcedo,Genoa,0.4,0,0,0,0,0,0,0,0.0,0,0,0,0,0,0,0,0
2286,Yannis Salibur,Guingamp,16.9,11,9,4,6,1,4,15,26.7,11,7,1,6,7,18,2,0
2288,Sejad Salihovic,Hamburger SV,4.1,7,5,3,3,1,0,3,0.0,3,5,0,5,5,12,1,0
2289,Yoann Salmier,Strasbourg,12.3,15,13,10,5,0,5,12,41.7,7,11,6,5,26,41,62,1
2290,Mamadou Samassa,Troyes,21.0,0,0,0,0,0,0,2,0.0,2,0,0,0,0,0,12,3
2291,Brice Samba,Caen,3.5,0,0,0,0,0,0,0,0.0,0,0,0,0,0,0,2,0
2292,Junior Sambia,Montpellier,17.1,21,12,6,11,4,6,28,21.4,22,16,0,16,20,41,18,0
2293,Frederic Sammaritano,Dijon,15.9,29,25,17,9,3,10,36,27.8,26,14,0,14,5,34,15,0
2294,Sergi Samper,Las Palmas,1.6,10,4,4,6,0,2,3,66.7,1,0,0,0,0,10,0,0
2295,Jairo Samperio,Las Palmas,6.2,9,6,2,6,1,3,13,23.1,10,5,1,4,1,10,5,0
2296,Jairo Samperio,Mainz 05,0.4,1,1,0,1,0,1,1,100.0,0,0,0,0,0,1,0,0
2297,Mario Sampirisi,Crotone,24.4,44,32,29,12,3,13,22,59.1,9,27,14,13,43,87,116,2
2298,Mikel San Jose,Athletic Club,23.9,52,37,19,23,10,19,73,26.0,54,43,13,30,41,93,30,0
2299,Antonio Sanabria,Betis,9.5,8,8,0,4,4,0,3,0.0,3,5,0,5,4,12,6,0
2300,Renato Sanches,Swansea City,7.8,12,7,6,6,0,6,18,33.3,12,9,1,8,7,19,5,1
2301,Alexis Sanchez,Arsenal,16.7,20,9,9,4,7,7,32,21.9,25,5,2,3,6,26,1,0
2302,Alexis Sanchez,Manchester Utd,11.6,21,17,10,4,7,4,27,14.8,23,8,0,8,17,38,0,0
2303,Carlos Sanchez,Fiorentina,4.1,7,6,2,5,0,4,6,66.7,2,3,1,2,8,15,10,0
2304,Carlos Sanchez,Espanyol,12.5,25,12,6,16,3,9,24,37.5,15,13,5,8,18,43,24,2
2305,Davinson Sanchez,Tottenham,28.2,38,24,28,9,1,18,40,45.0,22,26,10,16,38,76,162,0
2306,Sergio Sanchez,Espanyol,1.1,4,3,4,0,0,3,4,75.0,1,1,0,1,3,7,3,0
2307,Victor Sanchez,Espanyol,27.3,106,72,56,45,5,49,113,43.4,64,38,14,24,79,185,73,1
2308,Jadon Sancho,Dortmund,7.7,5,5,2,2,1,2,7,28.6,5,8,0,8,5,10,2,0
2309,Sandro,Benevento,12.8,29,21,15,13,1,12,18,66.7,6,23,16,7,18,47,43,1
2310,Alex Sandro,Juventus,23.5,57,31,33,17,7,20,39,51.3,19,21,1,20,30,87,45,0
2311,Arona Sane,Atlético Madrid,0.7,1,0,1,0,0,0,0,0.0,0,1,0,1,0,1,0,0
2312,Lamine Sane,Werder Bremen,8.7,19,14,15,4,0,8,10,80.0,2,8,6,2,20,39,49,1
2314,Leroy Sane,Manchester City,26.9,27,21,14,7,6,8,22,36.4,14,22,1,21,13,40,6,0
2315,Salif Sane,Hannover 96,32.0,57,43,46,10,1,40,64,62.5,24,49,29,20,57,114,238,6
2316,Ibrahim Sangare,Toulouse,17.6,72,47,35,34,3,29,69,42.0,40,33,7,26,24,96,19,1
2317,Younousse Sankhare,Bordeaux,20.9,33,23,10,20,3,4,34,11.8,30,15,4,11,21,54,7,0
2318,Baissama Sankoh,Caen,17.1,27,19,8,18,1,8,28,28.6,20,20,8,12,25,52,64,1
2319,Siriki Sanogo,Benevento,0.4,1,1,0,1,0,0,0,0.0,0,0,0,0,1,2,1,0
2320,Yaya Sanogo,Toulouse,16.8,11,6,1,5,5,3,11,27.3,8,6,1,5,6,17,14,1
2321,Morgan Sanson,Marseille,24.1,64,40,13,34,17,21,71,29.6,50,30,0,30,25,89,5,1
2322,Nicola Sansone,Villarreal,7.1,8,4,2,4,2,2,17,11.8,15,1,0,1,1,9,2,0
2323,Baptiste Santamaria,Angers,28.8,59,40,25,29,5,23,83,27.7,60,39,8,31,43,102,48,2
2324,Ivan Santini,Caen,30.9,19,12,5,8,6,4,29,13.8,25,13,5,8,4,23,33,0
2325,Davide Santon,Inter,9.3,19,14,13,6,0,9,17,52.9,8,10,3,7,20,39,32,2
2326,Christian Santos,Alavés,4.8,2,0,1,0,1,0,4,0.0,4,2,1,1,2,4,9,0
2327,Douglas Santos,Hamburger SV,26.4,90,60,53,34,3,50,87,57.5,37,63,2,61,56,146,96,1
2328,Samir Santos,Udinese,28.5,55,38,35,17,3,19,38,50.0,19,33,16,17,75,130,161,1
2329,Antonio Santurro,Bologna,1.0,0,0,0,0,0,0,0,0.0,0,0,0,0,0,0,1,0
2330,Riccardo Saponara,Fiorentina,10.0,12,8,2,8,2,2,11,18.2,9,3,1,2,1,13,5,0
2331,Pablo Sarabia,Sevilla,26.6,27,19,10,13,4,11,49,22.4,38,39,1,38,30,57,34,1
2332,Yusuf Sari,Marseille,0.0,0,0,0,0,0,0,0,0.0,0,0,0,0,0,0,0,0
2333,Bouna Sarr,Marseille,19.9,65,42,42,20,3,22,38,57.9,16,20,4,16,32,97,53,2
2334,Ismaila Sarr,Rennes,20.6,20,10,5,10,5,7,29,24.1,22,17,0,17,9,29,3,1
2335,Malang Sarr,Nice,14.7,24,18,17,7,0,8,18,44.4,10,14,6,8,31,55,44,2
2336,Imanol Sarriegi,Eibar,0.5,2,2,1,0,1,2,3,66.7,1,2,0,2,1,3,0,0
2337,Marco Sau,Cagliari,14.6,9,6,2,4,3,1,17,5.9,16,10,0,10,9,18,1,0
2338,Stefan Savic,Atlético Madrid,25.5,30,20,23,7,0,16,39,41.0,23,38,23,15,45,75,150,1
2340,Gianluca Scamacca,Sassuolo,0.3,0,0,0,0,0,0,0,0.0,0,1,0,1,0,0,0,0
2341,Fabian Schar,La Coruña,24.7,59,45,45,14,0,32,61,52.5,29,36,20,16,45,104,141,1
2342,Ezequiel Schelotto,Brighton,14.6,20,13,14,6,0,12,27,44.4,15,7,3,4,19,39,58,2
2343,Pasquale Schiattarella,SPAL,22.1,40,31,20,15,5,13,43,30.2,30,7,2,5,24,64,26,0
2344,Eros Schiavon,SPAL,4.3,6,5,2,3,1,1,7,14.3,6,6,2,4,2,8,4,0
2345,Patrik Schick,Roma,11.0,9,7,1,5,3,1,9,11.1,8,14,0,14,2,11,11,0
2346,Julian Schieber,Hertha BSC,0.6,1,1,0,0,1,1,1,100.0,0,1,0,1,0,1,2,0
2347,Christopher Schindler,Huddersfield,36.3,83,61,56,27,0,24,41,58.5,17,54,30,24,75,158,275,1
2348,Sven Schipplock,Hamburger SV,3.8,7,6,1,5,1,0,1,0.0,1,4,0,4,1,8,3,0
2349,Jeffrey Schlupp,Crystal Palace,19.4,57,36,35,20,2,23,43,53.5,20,34,8,26,24,81,67,0
2350,Kasper Schmeichel,Leicester City,32.9,1,0,1,0,0,1,3,33.3,2,1,0,1,0,1,18,5
2351,Marcel Schmelzer,Dortmund,16.6,35,27,21,12,2,20,30,66.7,10,27,6,21,30,65,57,1
2352,Jonathan Schmid,Augsburg,16.4,23,16,6,13,4,11,18,61.1,7,16,1,15,10,33,35,1
2353,Manuel Schmiedebach,Hannover 96,1.8,5,5,5,0,0,4,9,44.4,5,2,0,2,5,10,6,0
2354,Benno Schmitz,RB Leipzig,0.9,3,2,2,1,0,2,3,66.7,1,0,0,0,0,3,1,0
2355,Morgan Schneiderlin,Everton,23.7,58,40,34,21,3,15,44,34.1,29,18,7,11,61,119,59,1
2356,Alessandro Schopf,Schalke 04,9.0,22,17,10,9,3,11,23,47.8,12,16,0,16,15,37,13,1
2357,Nico Schulz,Hoffenheim,19.8,40,29,17,14,9,20,27,74.1,7,33,5,28,23,63,24,0
2358,Andre Schurrle,Dortmund,13.7,22,19,8,7,7,9,18,50.0,9,13,1,12,7,29,7,1
2359,Julian Schuster,Freiburg,14.5,14,10,6,7,1,6,11,54.5,5,17,10,7,19,33,56,0
2360,Pirmin Schwegler,Hannover 96,25.8,81,57,25,55,1,42,70,60.0,28,33,9,24,49,130,46,1
2361,Alexander Schwolow,Freiburg,32.3,0,0,0,0,0,0,1,0.0,1,0,0,0,0,0,9,1
2362,Simone Scuffet,Udinese,6.0,0,0,0,0,0,0,0,0.0,0,0,0,0,1,1,1,1
2363,Sergio Segura Garcia,Leganés,0.3,0.0,2,0.0,0.0,0.0,0.0,0.0,0.0,0.0,0.0,0.0,0.0,1,0.0,0.0,0.0
2364,Ernest Seka,Strasbourg,24.2,60,47,41,14,5,40,61,65.6,21,25,8,17,51,111,98,1
2366,Vahid Selimovic,Metz,11.7,20,14,10,9,1,11,14,78.6,3,10,8,2,17,37,58,1
2367,Davie Selke,Hertha BSC,21.0,13,10,1,5,7,4,9,44.4,5,26,5,21,2,15,20,1
2368,Ole Selnaes,Saint-Étienne,22.9,73,45,29,42,2,18,61,29.5,43,37,15,22,34,107,53,1
2369,Nelson Semedo,Barcelona,16.6,34,25,19,11,4,17,29,58.6,12,16,2,14,22,56,26,1
2370,Ruben Semedo,Villarreal,2.6,6,5,6,0,0,4,6,66.7,2,5,1,4,5,11,13,2
2371,Stefano Sensi,Sassuolo,11.6,17,13,11,6,0,9,22,40.9,13,16,3,13,22,39,10,1
2372,Luigi Sepe,Napoli,1.0,0,0,0,0,0,0,0,0.0,0,0,0,0,0,0,1,0
2373,Suat Serdar,Mainz 05,18.9,59,47,21,26,12,27,64,42.2,37,38,3,35,21,80,17,1
2374,Jean Seri,Nice,29.1,25,14,9,12,4,9,56,16.1,47,16,4,12,26,51,15,4
2375,Julien Serrano,Monaco,3.1,2,2,1,0,1,1,2,50.0,1,2,0,2,4,6,14,0
2376,Gregory Sertic,Marseille,3.9,5,3,3,2,0,2,6,33.3,4,8,7,1,6,11,23,0
2377,Stephane Sessegnon,Montpellier,10.9,4,4,2,2,0,1,7,14.3,6,0,0,0,0,4,2,0
2378,Lee Seung-woo,Hellas Verona,4.0,3,2,0,1,2,0,6,0.0,6,1,0,1,2,5,0,0
2379,Stephan El Shaarawy,Roma,23.9,22,16,9,8,5,5,21,23.8,16,16,1,15,24,46,8,0
2380,Meritan Shabani,Bayern Munich,0.6,2,1,1,0,1,1,2,50.0,1,1,0,1,0,2,0,1
2381,Xherdan Shaqiri,Stoke City,33.8,25,17,9,11,5,10,39,25.6,29,9,1,8,16,41,6,2
2382,Luke Shaw,Manchester Utd,8.8,18,15,10,7,1,11,18,61.1,7,16,2,14,4,22,22,1
2383,Ryan Shawcross,Stoke City,26.3,36,20,25,9,2,13,25,52.0,12,33,23,10,40,76,224,1
2384,Jonjo Shelvey,Newcastle Utd,25.2,39,24,17,21,1,8,26,30.8,18,26,5,21,28,67,33,0
2385,Gaku Shibasaki,Getafe,11.1,21,10,8,10,3,6,21,28.6,15,6,1,5,19,40,9,0
2386,Djibril Sidibe,Monaco,23.9,59,39,24,27,8,23,45,51.1,22,20,4,16,46,105,52,1
2387,Sidnei,La Coruña,19.8,41,28,30,11,0,18,25,72.0,7,26,9,17,31,72,101,1
2388,Jaime Sierra Mateos,Leganés,0.3,1,1,1,0,0,0,1,0.0,1,0,0,0,1,2,0,0
2389,Vincent Sierro,Freiburg,2.4,8,6,2,6,0,4,9,44.4,5,2,1,1,4,12,0,0
2390,Gylfi Sigurdsson,Everton,25.1,38,26,15,14,9,16,57,28.1,41,37,7,30,34,72,36,0
2392,Kolbeinn Sigthorsson,Nantes,0.3,0,0,0,0,0,0,0,0.0,0,0,0,0,1,1,0,0
2393,Adrien Silva,Leicester City,8.5,22,13,8,13,1,6,28,21.4,22,12,2,10,14,36,0,0
2394,Andre Silva,Milan,10.4,5,4,1,0,4,2,7,28.6,5,10,1,9,4,9,6,0
2395,Bernardo Silva,Manchester City,17.0,27,18,11,9,7,6,30,20.0,24,17,1,16,10,37,12,1
2396,David Silva,Manchester City,27.0,32,21,11,17,4,9,45,20.0,36,28,5,23,18,50,7,0
2397,Gabriel Silva,Saint-Étienne,23.1,28,20,19,4,5,19,31,61.3,12,21,6,15,37,65,83,1
2398,Jonathan Silva,Roma,1.2,0,0,0,0,0,0,1,0.0,1,1,1,0,3,3,1,0
2399,Thiago Silva,Paris S-G,23.5,31,23,19,12,0,12,21,57.1,9,28,18,10,18,49,114,0
2400,Matias Silvestre,Sampdoria,34.0,12,8,10,1,1,6,12,50.0,6,33,26,7,11,23,154,3
2401,Marco Silvestri,Hellas Verona,2.0,0,0,0,0,0,0,0,0.0,0,0,0,0,1,1,0,0
2402,Giovanni Simeone,Fiorentina,33.3,32,23,9,17,6,8,40,20.0,32,27,1,26,12,44,32,0
2403,Lorenco Simic,SPAL,3.5,5,3,5,0,0,3,4,75.0,1,7,4,3,11,16,15,0
2404,Stefan Simic,Crotone,6.2,13,8,11,2,0,10,11,90.9,1,6,3,3,10,23,44,0
2405,David Simon,Las Palmas,8.0,24,17,11,10,3,9,16,56.3,7,13,4,9,22,46,11,1
2406,Danny Simpson,Leicester City,25.6,38,22,31,6,1,22,45,48.9,23,31,19,12,34,72,132,1
2407,Jack Simpson,Bournemouth,0.8,1,1,1,0,0,0,1,0.0,1,1,0,1,0,1,4,0
2408,Josh Sims,Southampton,1.8,4,3,1,2,1,2,7,28.6,5,5,0,5,1,5,0,0
2409,Jerome Sinclair,Watford,0.3,0,0,0,0,0,0,1,0.0,1,0,0,0,1,1,0,0
2410,Giovanni Sio,Montpellier,24.4,14,8,2,9,3,0,20,0.0,20,11,0,11,6,20,23,1
2411,Dimitris Siovas,Leganés,22.9,48,33,43,5,0,29,46,63.0,17,27,12,15,62,110,89,0
2412,Tobias Sippel,M'Gladbach,4.8,1,1,1,0,0,1,2,50.0,1,0,0,0,0,1,5,1
2413,Salvatore Sirigu,Torino,37.0,0,0,0,0,0,0,0,0.0,0,0,0,0,1,1,35,3
2414,Moussa Sissoko,Tottenham,15.4,23,17,14,5,4,9,12,75.0,3,11,1,10,9,32,23,1
2415,Pione Sisto,Celta Vigo,28.0,18,12,8,6,4,9,33,27.3,24,12,1,11,12,30,7,1
2416,Antonio Sivera,Alavés,0.7,0,0,0,0,0,0,0,0.0,0,0,0,0,0,0,0,0
2418,Ellyes Skhiri,Montpellier,33.9,89,54,34,47,8,37,88,42.0,51,59,10,49,77,166,57,4
2419,Lukasz Skorupski,Roma,1.0,0,0,0,0,0,0,0,0.0,0,0,0,0,0,0,1,0
2420,Milan Skriniar,Inter,38.0,86,55,69,16,1,44,70,62.9,26,38,26,12,35,121,180,0
2421,Islam Slimani,Leicester City,2.8,2,2,1,1,0,1,4,25.0,3,2,0,2,0,2,2,0
2422,Islam Slimani,Newcastle Utd,1.5,0,0,0,0,0,0,2,0.0,2,0,0,0,1,1,1,0
2423,Naim Sliti,Dijon,25.4,47,32,20,17,10,20,52,38.5,32,22,2,20,13,60,7,0
2424,Chris Smalling,Manchester Utd,28.2,40,25,28,12,0,16,28,57.1,12,32,28,4,63,103,162,1
2425,Adam Smith,Bournemouth,23.0,50,36,33,16,1,24,53,45.3,29,46,8,38,31,81,73,0
2426,Tommy Smith,Huddersfield,21.2,38,27,18,14,6,23,36,63.9,13,22,6,16,26,64,80,3
2427,Wesley Sneijder,Nice,4.4,0,0,0,0,0,0,3,0.0,3,1,0,1,2,2,2,1
2428,Cedric Soares,Southampton,31.0,54,34,40,10,4,22,31,71.0,9,32,8,24,24,78,109,2
2429,Ramadan Sobhi,Stoke City,13.8,32,21,17,14,1,11,36,30.6,25,14,0,14,14,46,14,0
2430,Ruben Sobrino,Alavés,16.3,33,24,12,16,5,6,27,22.2,21,19,2,17,18,51,10,0
2431,Dominic Solanke,Liverpool,6.6,7,4,0,6,1,1,4,25.0,3,5,1,4,2,9,9,0
2432,Carlos Soler,Valencia,26.3,51,32,21,21,9,22,53,41.5,31,25,1,24,5,56,19,0
2433,Somalia,Toulouse,22.2,65,45,21,36,8,14,54,25.9,40,34,2,32,34,99,35,0
2434,Yann Sommer,M'Gladbach,29.2,0,0,0,0,0,0,0,0.0,0,0,0,0,3,3,6,3
2435,Kevin Soni,Girona,0.2,1,1,0,1,0,0,0,0.0,0,0,0,0,0,1,0,0
2436,Jeremy Sorbon,Guingamp,29.0,32,19,24,7,1,10,32,31.3,22,37,24,13,53,85,152,4
2437,Oliver Sorg,Hannover 96,18.7,46,28,27,18,1,23,53,43.4,30,24,7,17,42,88,71,0
2438,David Soria,Sevilla,14.0,1,0,1,0,0,1,1,100.0,0,0,0,0,2,3,13,2
2439,Roberto Soriano,Villarreal,12.7,30,20,10,16,4,3,16,18.8,13,14,0,14,4,34,9,0
2440,Stefano Sorrentino,Chievo,38.0,0,0,0,0,0,0,0,0.0,0,0,0,0,0,0,23,3
2441,Pape Souare,Crystal Palace,0.1,0,0,0,0,0,0,0,0.0,0,0,0,0,0,0,0,0
2442,Rayan Souici,Saint-Étienne,0.1,0,0,0,0,0,0,0,0.0,0,1,0,1,0,0,0,0
2444,Adama Soumaoro,Lille,13.2,9,5,7,2,0,2,3,66.7,1,22,16,6,16,25,50,1
2445,Boubakary Soumare,Lille,5.7,13,9,8,5,0,3,14,21.4,11,8,1,7,7,20,6,1
2446,Samuel Souprayen,Hellas Verona,17.6,29,19,25,3,1,12,19,63.2,7,18,9,9,22,51,67,1
2447,Arnaud Souquet,Nice,26.8,89,68,58,26,5,36,56,64.3,20,46,16,30,39,128,72,2
2448,Caglar Soyuncu,Freiburg,23.9,42,26,26,15,1,15,26,57.7,11,30,20,10,54,96,91,2
2449,Luca Sparandeo,Benevento,0.4,0,0,0,0,0,0,1,0.0,1,1,0,1,0,0,0,0
2450,Julian Speroni,Crystal Palace,11.0,0,0,0,0,0,0,0,0.0,0,0,0,0,1,1,4,0
2451,Leonardo Spinazzola,Atalanta,16.7,14,5,9,4,1,7,15,46.7,8,25,6,19,18,32,44,1
2452,Nicolas Spolli,Genoa,20.0,27,21,24,2,1,13,22,59.1,9,26,17,9,36,63,120,2
2453,Marco Sportiello,Fiorentina,35.6,0,0,0,0,0,0,1,0.0,1,0,0,0,1,1,13,4
2454,Bassem Srarfi,Nice,9.7,17,11,6,9,2,4,14,28.6,10,12,0,12,7,24,6,1
2455,Kostas Stafylidis,Stoke City,3.7,12,6,6,4,2,6,9,66.7,3,7,2,5,5,17,19,0
2456,Kostas Stafylidis,Augsburg,0.4,1,1,1,0,0,0,0,0.0,0,1,0,1,0,1,2,0
2457,Benjamin Stambouli,Schalke 04,24.4,95,75,45,48,2,49,74,66.2,25,39,7,32,64,159,76,1
2458,Junior Stanislas,Bournemouth,14.3,16,8,8,4,4,7,15,46.7,8,21,6,15,6,22,15,0
2459,Caleb Stanko,Freiburg,2.1,2,2,1,1,0,1,2,50.0,1,3,0,3,1,3,8,0
2460,Niklas Stark,Hertha BSC,24.6,49,31,32,17,0,22,30,73.3,8,39,14,25,34,83,165,0
2461,Tom Starke,Bayern Munich,2.0,0,0,0,0,0,0,0,0.0,0,0,0,0,0,0,0,0
2462,Timo Stavitski,Caen,4.5,4,3,1,1,2,1,16,6.3,15,7,0,7,3,7,1,0
2463,Renato Steffen,Wolfsburg,7.3,10,9,6,3,1,8,12,66.7,4,6,0,6,5,15,6,0
2464,Marc Stendera,Eint Frankfurt,4.1,23,20,6,15,2,8,20,40.0,12,10,1,9,8,31,2,0
2465,Pascal Stenzel,Freiburg,21.6,62,45,35,25,2,34,57,59.6,23,20,3,17,35,97,51,1
2466,Dale Stephens,Brighton,36.0,104,62,63,39,2,32,114,28.1,82,53,16,37,63,167,69,1
2467,Jack Stephens,Southampton,22.0,29,20,24,5,0,13,25,52.0,12,30,18,12,41,70,108,2
2468,Mariusz Stepinski,Chievo,7.9,9,5,4,4,1,2,10,20.0,8,5,1,4,4,13,5,0
2470,Mariusz Stepinski,Nantes,0.0,0,0,0,0,0,0,0,0.0,0,0,0,0,0,0,0,0
2471,Raheem Sterling,Manchester City,28.7,19,14,7,7,5,3,32,9.4,29,24,0,24,9,28,9,0
2472,Ognjen Stijepovic,Sampdoria,0.1,0,0,0,0,0,0,0,0.0,0,0,0,0,0,0,0,0
2473,Lars Stindl,M'Gladbach,30.3,52,39,11,29,12,14,38,36.8,24,53,4,49,31,83,32,1
2474,Valentin Stocker,Hertha BSC,0.6,1,0,0,1,0,0,0,0.0,0,1,0,1,0,1,0,0
2475,Adrian Stoian,Crotone,23.7,23,19,12,10,1,11,44,25.0,33,29,0,29,25,48,26,0
2476,John Stones,Manchester City,14.5,15,11,11,4,0,4,11,36.4,7,8,5,3,19,34,44,0
2477,Thomas Strakosha,Lazio,38.0,0,0,0,0,0,0,0,0.0,0,0,0,0,2,2,13,4
2478,Ivan Strinic,Sampdoria,13.9,35,24,22,12,1,17,38,44.7,21,21,2,19,22,57,46,2
2479,Tobias Strobl,M'Gladbach,1.3,3,1,0,2,1,0,1,0.0,1,2,0,2,6,9,2,0
2480,Kevin Strootman,Roma,25.1,57,38,19,24,14,15,46,32.6,31,27,3,24,27,84,21,0
2481,Jens Stryger Larsen,Udinese,28.1,36,27,25,10,1,21,39,53.8,18,35,14,21,31,67,82,2
2482,Cristhian Stuani,Girona,30.1,22,14,2,17,3,3,29,10.3,26,10,0,10,5,27,32,0
2483,Stefano Sturaro,Juventus,6.8,17,11,5,9,3,4,11,36.4,7,9,2,7,5,22,18,1
2484,Daniel Sturridge,West Brom,1.3,0,0,0,0,0,0,0,0.0,0,0,0,0,0,0,0,0
2485,Daniel Sturridge,Liverpool,4.8,0,0,0,0,0,0,1,0.0,1,1,0,1,0,0,1,0
2486,Damian Suarez,Getafe,32.0,86,64,54,21,11,44,90,48.9,46,34,8,26,46,132,76,1
2487,Denis Suarez,Barcelona,6.6,11,9,3,8,0,3,8,37.5,5,7,0,7,2,13,3,0
2488,Leonardo Suarez,Villarreal,0.3,0,0,0,0,0,0,0,0.0,0,0,0,0,0,0,1,0
2489,Luis Suarez,Barcelona,32.2,17,10,4,5,8,4,19,21.1,15,4,3,1,8,25,31,0
2490,Danijel Subasic,Monaco,32.7,0,0,0,0,0,0,2,0.0,2,1,0,1,0,0,13,2
2491,Neven Subotic,Saint-Étienne,16.0,23,14,16,7,0,10,27,37.0,17,13,9,4,18,41,96,1
2492,Neven Subotic,Dortmund,3.0,9,9,5,3,1,6,7,85.7,1,6,2,4,5,14,16,0
2493,Isaac Success,Málaga,5.5,9,7,4,4,1,3,8,37.5,5,2,0,2,5,14,0,0
2494,Niklas Sule,Bayern Munich,21.4,34,25,25,7,2,24,31,77.4,7,24,16,8,33,67,58,0
2496,Ki Sung-yueng,Swansea City,20.8,25,18,10,13,2,4,16,25.0,12,16,1,15,32,57,23,0
2497,Gilles Sunu,Angers,7.3,4,4,1,3,0,0,4,0.0,4,7,0,7,3,7,3,0
2498,Andrew Surman,Bournemouth,20.6,16,12,5,8,3,6,23,26.1,17,33,12,21,16,32,52,2
2499,Markel Susaeta,Athletic Club,25.2,42,29,16,15,11,16,65,24.6,49,17,0,17,18,60,13,0
2500,Suso,Milan,31.4,18,14,3,5,10,4,31,12.9,27,25,0,25,16,34,2,1
2501,Markus Suttner,Brighton,13.1,25,15,18,4,3,10,22,45.5,12,16,2,14,12,37,49,1
2502,Seydou Sy,Monaco,2.8,0,0,0,0,0,0,0,0.0,0,0,0,0,0,0,2,0
2503,Issiaga Sylla,Toulouse,17.8,44,32,22,16,6,19,47,40.4,28,31,4,27,34,78,65,1
2504,Moussa Sylla,Monaco,3.4,0,0,0,0,0,0,2,0.0,2,2,0,2,0,0,1,0
2505,Adam Szalai,Hoffenheim,10.0,8,7,1,4,3,2,5,40.0,3,9,2,7,0,8,10,0
2506,Wojciech Szczesny,Juventus,17.0,0,0,0,0,0,0,0,0.0,0,0,0,0,0,0,4,0
2507,Alexander Soderlund,Saint-Étienne,4.0,1,1,1,0,0,0,2,0.0,2,1,0,1,2,3,2,0
2508,Frederik Sorensen,Köln,22.2,56,45,40,14,2,30,41,73.2,11,35,17,18,37,93,130,3
2509,Lasse Sorensen,Stoke City,0.8,2,2,2,0,0,1,5,20.0,4,2,0,2,0,2,3,0
2510,Alexander Sorloth,Crystal Palace,4.0,6,3,1,4,1,4,12,33.3,8,5,0,5,2,8,5,0
2511,Adel Taarabt,Genoa,17.9,18,11,5,11,2,7,16,43.8,9,13,3,10,12,30,7,0
2512,Franck Tabanou,Guingamp,11.6,23,17,17,5,1,10,26,38.5,16,5,3,2,26,49,48,0
2513,Dusan Tadic,Southampton,31.0,46,29,16,22,8,11,35,31.4,24,38,2,36,19,65,29,1
2514,Jonathan Tah,Leverkusen,27.0,47,34,35,12,0,30,38,78.9,8,22,13,9,34,81,112,2
2515,Ervin Taha,Bordeaux,0.4,1,1,0,1,0,0,1,0.0,1,0,0,0,0,1,0,0
2516,Mehdi Tahrat,Angers,4.9,7,6,4,3,0,2,5,40.0,3,3,1,2,9,16,15,1
2517,Saphir Taider,Bologna,4.3,6,2,4,2,0,1,2,50.0,1,3,2,1,1,7,4,0
2518,Flavien Tait,Angers,24.8,50,36,26,18,6,18,78,23.1,60,43,4,39,20,70,17,1
2519,Adrien Tameze,Nice,18.7,58,36,32,21,5,26,47,55.3,21,26,5,21,41,99,22,1
2520,Tana,Las Palmas,17.2,31,24,13,14,4,12,36,33.3,24,8,0,8,23,54,5,0
2522,Oussama Tannane,Las Palmas,6.4,15,13,6,8,1,7,12,58.3,5,5,0,5,5,20,0,0
2523,Oussama Tannane,Saint-Étienne,2.3,12,6,4,5,3,2,5,40.0,3,2,0,2,3,15,2,0
2524,Matt Targett,Southampton,1.8,6,3,5,0,1,1,3,33.3,2,3,2,1,3,9,7,1
2525,James Tarkowski,Burnley,31.0,46,26,36,10,0,17,38,44.7,21,55,43,12,50,96,223,2
2526,Ciprian Tatarusanu,Nantes,37.0,1,0,1,0,0,1,2,50.0,1,0,0,0,1,2,12,3
2527,Julio Tavares,Dijon,22.8,3,1,1,1,1,1,11,9.1,10,11,6,5,3,6,36,0
2528,Taleb Tawatha,Eint Frankfurt,4.9,12,7,7,5,0,5,9,55.6,4,7,1,6,6,18,18,0
2529,Charlie Taylor,Burnley,10.6,16,4,9,6,1,7,12,58.3,5,13,5,8,15,31,52,0
2530,Jordan Tell,Rennes,1.3,4,4,1,3,0,0,1,0.0,1,0,0,0,1,5,0,0
2531,Cristian Tello,Betis,18.8,32,24,12,14,6,7,37,18.9,30,19,0,19,16,48,4,1
2532,Marc-Andre ter Stegen,Barcelona,37.0,1,0,1,0,0,1,3,33.3,2,1,0,1,4,5,12,1
2533,Simon Terodde,Stuttgart,10.6,9,6,1,7,1,2,5,40.0,3,8,2,6,5,14,8,0
2534,Simon Terodde,Köln,12.9,11,9,3,8,0,4,11,36.4,7,3,0,3,4,15,7,0
2535,Marco Terrazzino,Freiburg,16.5,31,24,12,13,6,21,39,53.8,18,16,0,16,9,40,19,0
2536,Martin Terrier,Strasbourg,18.6,42,30,16,23,3,9,28,32.1,19,11,1,10,14,56,6,0
2537,Kenny Tete,Lyon,17.9,37,25,24,10,3,15,26,57.7,11,20,7,13,29,66,52,0
2538,Cedric Teuchert,Schalke 04,0.4,0,0,0,0,0,0,0,0.0,0,1,0,1,0,0,0,0
2539,Florian Thauvin,Marseille,32.8,44,28,16,20,8,15,46,32.6,31,22,1,21,17,61,20,0
2540,Kevin Theophile-Catherine,Saint-Étienne,24.1,36,27,23,13,0,11,24,45.8,13,19,15,4,31,67,113,1
2541,Cyril Thereau,Udinese,2.0,1,1,1,0,0,1,2,50.0,1,0,0,0,0,1,2,0
2542,Cyril Thereau,Fiorentina,12.4,11,6,3,6,2,7,19,36.8,12,13,0,13,8,19,9,0
2543,Vincent Thill,Metz,0.3,0,0,0,0,0,0,0,0.0,0,0,0,0,0,0,0,0
2544,Romain Thomas,Angers,27.4,31,21,16,15,0,14,29,48.3,15,32,19,13,34,65,151,1
2545,Adrien Thomasson,Nantes,28.6,71,52,41,23,7,22,73,30.1,51,58,4,54,18,89,20,0
2546,Erik Thommy,Augsburg,1.9,6,5,1,3,2,3,8,37.5,5,2,0,2,5,11,0,0
2548,Erik Thommy,Stuttgart,10.9,19,11,7,7,5,9,17,52.9,8,17,2,15,9,28,8,1
2549,Marcus Thuram,Guingamp,21.4,20,15,6,10,4,6,25,24.0,19,14,0,14,5,25,12,0
2550,Youri Tielemans,Monaco,17.4,47,24,14,28,5,17,55,30.9,38,24,5,19,34,81,20,1
2551,David Timor,Girona,10.3,17,10,7,7,3,7,18,38.9,11,10,5,5,20,37,30,1
2552,Jonathan Tinhan,Troyes,0.8,1,0,0,1,0,0,1,0.0,1,1,0,1,1,2,0,0
2553,Marcel Tisserand,Wolfsburg,13.9,15,10,10,4,1,7,14,50.0,7,18,13,5,31,46,50,0
2554,Tito,Leganés,6.8,8,5,5,3,0,6,18,33.3,12,12,5,7,12,20,16,0
2555,Ola Toivonen,Toulouse,8.9,4,4,1,0,3,0,7,0.0,7,2,0,2,2,6,12,0
2556,Karl Toko Ekambi,Angers,33.8,17,8,2,5,10,5,29,17.2,24,13,0,13,15,32,2,0
2557,Hernan Toledo,Las Palmas,6.9,5,5,2,2,1,1,11,9.1,10,2,0,2,5,10,5,0
2558,Corentin Tolisso,Bayern Munich,17.5,33,22,8,18,7,14,32,43.8,18,13,3,10,16,49,8,0
2559,Jeremy Toljan,Hoffenheim,2.0,3,1,1,2,0,2,3,66.7,1,3,0,3,0,3,3,0
2560,Jeremy Toljan,Dortmund,13.5,29,20,17,11,1,19,32,59.4,13,17,2,15,12,41,45,0
2561,Rafael Toloi,Atalanta,27.2,72,40,34,38,0,35,68,51.5,33,35,14,21,63,135,119,1
2562,James Tomkins,Crystal Palace,26.5,47,26,36,10,1,16,31,51.6,15,24,12,12,63,110,216,1
2563,Nenad Tomovic,Fiorentina,1.5,2,1,1,1,0,0,2,0.0,2,0,0,0,3,5,5,1
2564,Nenad Tomovic,Chievo,25.6,23,17,17,6,0,10,17,58.8,7,29,21,8,50,73,146,0
2565,Lorenzo Tonelli,Napoli,3.9,7,1,4,3,0,5,9,55.6,4,2,1,1,7,14,10,0
2566,Aleksandar Tonev,Crotone,4.5,5,3,1,2,2,0,1,0.0,1,4,1,3,1,6,6,0
2567,Tono,Levante,12.0,12,11,11,1,0,5,10,50.0,5,4,0,4,6,18,29,0
2568,Omer Toprak,Dortmund,22.4,36,25,29,6,1,26,29,89.7,3,27,16,11,21,57,104,1
2569,Vasilis Torosidis,Bologna,9.1,8,7,5,2,1,4,9,44.4,5,8,3,5,15,23,42,0
2570,Emanuele Torrasi,Milan,0.1,0.0,0.0,0.0,0.0,0.0,0.0,0.0,0.0,0.0,0.0,0.0,0.0,0.0,0.0,0.0,0.0
2571,Lucas Torreira,Sampdoria,35.3,101,73,36,57,8,30,77,39.0,47,52,17,35,72,173,36,1
2572,Daniel Torres,Alavés,13.5,19,11,14,5,0,7,31,22.6,24,15,7,8,19,38,32,2
2574,Fernando Torres,Atlético Madrid,10.9,11,8,3,7,1,2,6,33.3,4,4,1,3,2,13,9,0
2575,Ferran Torres,Valencia,3.5,8,7,3,5,0,2,6,33.3,4,1,0,1,3,11,1,0
2576,Miguel Torres,Málaga,7.5,16,13,13,3,0,6,14,42.9,8,9,7,2,13,29,35,0
2577,Pau Torres,Villarreal,0.6,0,0,0,0,0,0,1,0.0,1,1,1,0,0,0,4,0
2578,Jordan Torunarigha,Hertha BSC,7.4,18,12,16,2,0,7,13,53.8,6,20,13,7,23,41,43,1
2579,Alin Tosca,Benevento,13.0,11,8,7,4,0,6,12,50.0,6,9,4,5,13,24,69,0
2580,Alin Tosca,Betis,4.7,12,9,7,5,0,5,9,55.6,4,7,1,6,5,17,17,1
2581,Cenk Tosun,Everton,11.0,6,3,2,2,2,1,11,9.1,10,9,4,5,1,7,13,0
2582,Jeremy Toulalan,Bordeaux,21.0,43,25,35,7,1,17,39,43.6,22,25,16,9,28,71,121,0
2583,Abdoulaye Toure,Nantes,31.2,74,52,28,38,8,23,67,34.3,44,40,10,30,62,136,49,1
2584,Almamy Toure,Monaco,13.9,51,29,31,13,7,18,30,60.0,12,15,2,13,22,73,61,0
2585,Thomas Toure,Bordeaux,0.1,0,0,0,0,0,0,0,0.0,0,0,0,0,1,1,0,0
2586,Thomas Toure,Angers,1.4,2,1,0,1,1,0,7,0.0,7,5,0,5,1,3,0,0
2587,Yaya Toure,Manchester City,2.6,2,2,1,0,1,1,1,100.0,0,3,1,2,5,7,4,0
2588,Lucas Tousart,Lyon,34.8,98,59,41,55,2,38,98,38.8,60,41,16,25,52,150,79,0
2589,Andros Townsend,Crystal Palace,34.7,60,34,35,12,13,24,75,32.0,51,49,1,48,35,95,28,0
2590,Adama Traore,Monaco,2.1,6,4,0,4,2,1,4,25.0,3,3,0,3,3,9,1,0
2591,Bertrand Traore,Lyon,25.4,32,20,7,20,5,10,35,28.6,25,24,3,21,39,71,31,1
2592,Charles Traore,Troyes,33.3,60,32,46,9,5,26,56,46.4,30,52,16,36,57,117,171,0
2593,Hamari Traore,Rennes,29.3,79,55,43,31,5,41,66,62.1,25,31,12,19,61,140,117,0
2594,Ibrahima Traore,M'Gladbach,2.2,4,2,2,2,0,4,7,57.1,3,2,0,2,0,4,1,0
2595,Ismael Traore,Angers,31.7,54,32,40,13,1,14,29,48.3,15,25,10,15,52,106,132,2
2596,Lacina Traore,Amiens,8.7,9,9,2,3,4,3,7,42.9,4,6,3,3,2,11,21,0
2597,Kevin Trapp,Paris S-G,4.0,0,0,0,0,0,0,0,0.0,0,0,0,0,0,0,1,0
2598,Manu Trigueros,Villarreal,30.0,61,41,23,34,4,21,71,29.6,50,38,13,25,22,83,44,0
2600,Kieran Trippier,Tottenham,21.3,52,30,29,21,2,21,44,47.7,23,31,6,25,20,72,53,1
2601,Marcello Trotta,Crotone,25.1,39,21,12,18,9,10,55,18.2,45,22,2,20,14,53,20,0
2602,Philipp Tschauner,Hannover 96,31.0,1,0,1,0,0,1,2,50.0,1,2,0,2,0,1,8,5
2603,Axel Tuanzebe,Manchester Utd,0.0,0,0,0,0,0,0,0,0.0,0,0,0,0,0,0,0,0
2604,Marco Tumminello,Crotone,2.3,2,2,0,1,1,0,2,0.0,2,2,0,2,0,2,0,0
2605,Marco Tumminello,Roma,0.0,0,0,0,0,0,0,0,0.0,0,0,0,0,0,0,0,0
2606,Lubomir Tupta,Hellas Verona,0.4,0,0,0,0,0,0,3,0.0,3,0,0,0,0,0,0,0
2607,Josh Tymon,Stoke City,1.8,5,1,4,1,0,2,3,66.7,1,1,0,1,1,6,3,0
2608,Przemyslaw Tyton,La Coruña,1.1,0,0,0,0,0,0,0,0.0,0,0,0,0,0,0,0,0
2609,Matthieu Udol,Metz,3.9,14,8,13,1,0,5,14,35.7,9,10,2,8,5,19,17,0
2610,Anthony Ujah,Mainz 05,2.3,4,3,0,2,2,1,1,100.0,0,2,0,2,0,4,6,0
2611,Leonardo Ulloa,Leicester City,0.2,1,0,0,0,1,0,0,0.0,0,0,0,0,0,1,1,0
2612,Leonardo Ulloa,Brighton,3.0,3,1,0,1,2,1,7,14.3,6,1,0,1,0,3,3,0
2613,Sven Ulreich,Bayern Munich,29.0,1,0,1,0,0,1,1,100.0,0,0,0,0,3,4,6,1
2614,Samuel Umtiti,Barcelona,24.3,50,35,35,15,0,20,29,69.0,9,25,17,8,37,87,72,3
2615,Enes Unal,Villarreal,12.5,9,5,0,4,5,0,12,0.0,12,16,3,13,4,13,11,0
2616,Enes Unal,Levante,6.6,6,6,2,2,2,1,10,10.0,9,7,1,6,2,8,5,0
2617,Cengiz Under,Roma,13.9,10,6,4,6,0,3,18,16.7,15,8,1,7,9,19,10,0
2618,Dayot Upamecano,RB Leipzig,25.2,57,43,36,17,4,31,45,68.9,14,32,9,23,55,112,141,1
2619,Mark Uth,Hoffenheim,24.2,32,23,4,21,7,5,22,22.7,17,30,3,27,9,41,19,0
2620,Francis Uzoho,La Coruña,2.0,0,0,0,0,0,0,0,0.0,0,0,0,0,0,0,1,0
2621,Valentin Vada,Bordeaux,9.6,22,11,7,14,1,8,32,25.0,24,8,1,7,6,28,5,1
2622,Josha Vagnoman,Hamburger SV,0.2,1,1,0,1,0,1,1,100.0,0,0,0,0,0,1,0,0
2623,Sauli Vaisanen,SPAL,6.0,12,9,9,3,0,6,8,75.0,2,5,4,1,13,25,26,0
2624,Mirko Valdifiori,Torino,6.9,13,9,5,7,1,2,11,18.2,9,3,1,2,6,19,9,0
2626,Antonio Valencia,Manchester Utd,30.4,57,32,21,28,8,16,36,44.4,20,47,6,41,48,105,80,0
2627,Gerard Valentin,La Coruña,1.8,5,4,4,0,1,1,2,50.0,1,1,0,1,3,8,3,0
2628,Borja Valero,Inter,28.5,46,31,17,25,4,20,58,34.5,38,15,4,11,18,64,41,1
2629,Borja Valle,La Coruña,5.4,6,6,3,3,0,1,4,25.0,3,2,0,2,3,9,4,0
2630,Jesus Vallejo,Real Madrid,7.0,8,7,6,2,0,2,5,40.0,3,6,5,1,16,24,21,1
2631,Mattia Valoti,Hellas Verona,17.5,62,41,21,35,6,11,53,20.8,42,25,3,22,41,103,37,1
2632,Federico Valverde,La Coruña,13.7,25,16,12,10,3,8,15,53.3,7,12,1,11,21,46,17,0
2633,Virgil van Dijk,Southampton,11.0,10,7,6,2,2,2,3,66.7,1,14,13,1,29,39,81,1
2634,Virgil van Dijk,Liverpool,14.0,15,8,7,7,1,4,5,80.0,1,8,2,6,18,33,80,1
2635,Raphael Varane,Real Madrid,25.8,28,19,20,7,1,8,15,53.3,7,27,10,17,33,61,109,2
2636,Jamie Vardy,Leicester City,36.1,15,9,3,7,5,1,8,12.5,7,21,1,20,2,17,17,0
2637,Cedric Varrault,Dijon,9.8,13,7,6,7,0,9,12,75.0,3,14,11,3,16,29,72,0
2638,Franco Vazquez,Sevilla,20.4,39,32,16,15,8,6,34,17.6,28,20,2,18,11,50,11,0
2639,Lucas Vazquez,Real Madrid,18.7,48,33,16,21,11,12,42,28.6,30,28,2,26,7,55,9,0
2640,Matias Vecino,Inter,23.7,54,34,15,30,9,19,49,38.8,30,28,6,22,20,74,31,0
2641,Koke Vegas,Levante,1.0,0,0,0,0,0,0,0,0.0,0,0,0,0,0,0,1,0
2642,Carlos Vela,Real Sociedad,4.2,12,7,5,3,4,6,7,85.7,1,2,0,2,0,12,1,0
2643,Milos Veljkovic,Werder Bremen,29.5,45,32,30,13,2,30,52,57.7,22,34,12,22,34,79,134,1
2644,Miguel Veloso,Genoa,19.3,40,29,18,19,3,11,41,26.8,30,26,3,23,13,53,35,0
2645,Lorenzo Venuti,Benevento,26.6,44,34,26,12,6,16,37,43.2,21,40,16,24,40,84,105,3
2646,Remy Vercoutre,Caen,34.5,2,2,2,0,0,2,2,100.0,0,0,0,0,2,4,14,2
2647,Daniele Verde,Hellas Verona,21.7,10,9,8,1,1,6,20,30.0,14,8,0,8,30,40,19,0
2648,Simone Verdi,Bologna,31.4,33,24,17,13,3,11,43,25.6,32,20,1,19,36,69,12,0
2649,Olivier Verdon,Bordeaux,0.1,0,0,0,0,0,0,0,0.0,0,0,0,0,0,0,3,0
2650,Jordan Veretout,Fiorentina,35.7,65,45,34,23,8,20,69,29.0,49,39,4,35,37,102,59,0
2652,Paul Verhaegh,Wolfsburg,29.0,45,38,21,22,2,24,33,72.7,9,38,10,28,33,78,60,0
2653,Thomas Vermaelen,Barcelona,11.3,13,9,7,5,1,5,11,45.5,6,10,3,7,18,31,28,0
2654,Marco Verratti,Paris S-G,19.1,51,33,20,25,6,12,55,21.8,43,25,6,19,26,77,11,3
2655,Valerio Verre,Sampdoria,4.0,7,3,3,2,2,2,7,28.6,5,12,0,12,8,15,7,0
2656,Jan Vertonghen,Tottenham,35.6,64,41,40,20,4,25,36,69.4,11,29,11,18,60,124,177,0
2657,Mikel Vesga,Athletic Club,9.0,17,8,6,11,0,4,25,16.0,21,14,3,11,8,25,15,0
2658,Jannik Vestergaard,M'Gladbach,32.0,58,41,43,15,0,32,48,66.7,16,55,39,16,40,98,161,3
2659,Ruben Vezo,Valencia,17.3,43,24,30,12,1,16,32,50.0,16,25,9,16,23,66,83,0
2660,Francesco Vicari,SPAL,31.7,38,22,25,13,0,21,39,53.8,18,33,27,6,45,83,210,1
2661,Aleix Vidal,Barcelona,5.1,6,4,2,3,1,1,10,10.0,9,4,0,4,9,15,1,0
2662,Arturo Vidal,Bayern Munich,16.2,69,51,36,28,5,33,69,47.8,36,22,1,21,28,97,20,1
2663,Nacho Vidal,Valencia,5.0,17,14,15,1,1,14,22,63.6,8,5,2,3,10,27,18,0
2664,Luca Vido,Atalanta,0.8,5,5,2,3,0,1,1,100.0,0,1,0,1,0,5,0,0
2665,Jonathan Viera,Las Palmas,22.1,36,25,10,22,4,3,28,10.7,25,21,0,21,11,47,2,0
2666,Luciano Vietto,Atlético Madrid,3.0,5,4,1,2,2,0,3,0.0,3,3,0,3,3,8,3,0
2667,Luciano Vietto,Valencia,5.9,8,6,2,3,3,1,4,25.0,3,3,0,3,2,10,5,0
2668,Carlos Vigaray,Alavés,9.9,27,16,16,9,2,11,16,68.8,5,5,1,4,14,41,13,0
2669,Didac Vila,Espanyol,8.1,29,26,15,9,5,13,18,72.2,5,14,3,11,14,43,27,0
2670,Julio Villalba,M'Gladbach,0.1,0,0,0,0,0,0,0,0.0,0,0,0,0,0,0,0,0
2671,Nicolas Viola,Benevento,20.6,37,27,20,14,3,15,39,38.5,24,29,8,21,24,61,23,2
2672,Mattia Vitale,SPAL,1.1,2,1,2,0,0,0,0,0.0,0,1,0,1,3,5,1,0
2673,Vitolo,Las Palmas,7.7,15,12,9,5,1,4,17,23.5,13,10,3,7,6,21,9,0
2674,Vitolo,Atlético Madrid,6.9,9,6,4,3,2,3,15,20.0,12,10,1,9,6,15,5,0
2675,Federico Viviani,SPAL,27.6,52,36,23,26,3,18,55,32.7,37,39,9,30,58,110,26,2
2676,Emiliano Viviano,Sampdoria,27.0,0,0,0,0,0,0,0,0.0,0,0,0,0,2,2,10,4
2678,Oswaldo Vizcarrondo,Troyes,19.1,21,15,17,3,1,14,37,37.8,23,18,16,2,20,41,129,2
2679,Nikola Vlasic,Everton,6.4,9,5,3,6,0,2,9,22.2,7,14,2,12,9,18,10,0
2680,Kevin Vogt,Hoffenheim,31.0,38,28,30,7,1,23,34,67.6,11,37,23,14,25,63,114,2
2681,Sam Vokes,Burnley,11.1,3,1,1,2,0,0,3,0.0,3,6,2,4,3,6,15,0
2682,Kevin Volland,Leverkusen,28.8,23,20,7,8,8,11,26,42.3,15,16,1,15,3,26,35,0
2683,Giovanni Volpicelli,Benevento,0.0,0,0,0,0,0,0,1,0.0,1,0,0,0,0,0,0,0
2684,Michel Vorm,Tottenham,1.0,0,0,0,0,0,0,0,0.0,0,0,0,0,0,0,1,0
2685,Stefan de Vrij,Lazio,33.7,31,22,14,17,0,14,23,60.9,9,43,24,19,71,102,156,1
2686,Sime Vrsaljko,Atlético Madrid,18.8,48,30,25,17,6,26,40,65.0,14,24,8,16,36,84,63,0
2687,Jagos Vukovic,Hellas Verona,14.8,5,4,3,1,1,3,6,50.0,3,19,14,5,20,25,113,0
2688,Sandro Wagner,Hoffenheim,9.7,8,5,3,5,0,5,6,83.3,1,11,3,8,3,11,13,0
2689,Sandro Wagner,Bayern Munich,8.1,9,6,3,5,1,1,1,100.0,0,4,0,4,2,11,1,0
2690,Molla Wague,Watford,4.9,5,3,3,2,0,2,5,40.0,3,1,0,1,9,14,30,0
2691,Molla Wague,Udinese,0.6,1,0,0,1,0,0,0,0.0,0,0,0,0,2,3,5,0
2692,Wakaso,Alavés,12.2,43,30,25,15,3,13,39,33.3,26,22,1,21,35,78,21,0
2693,Walace,Hamburger SV,14.6,38,25,13,23,2,19,44,43.2,25,25,3,22,21,59,14,1
2694,Theo Walcott,Arsenal,0.8,1,0,1,0,0,0,0,0.0,0,0,0,0,1,2,0,0
2695,Theo Walcott,Everton,12.8,27,19,12,13,2,7,15,46.7,8,9,0,9,8,35,12,0
2696,Luca Waldschmidt,Hamburger SV,8.8,10,6,1,8,1,3,10,30.0,7,11,0,11,3,13,2,0
2697,Kyle Walker,Manchester City,30.9,47,31,20,21,6,18,31,58.1,13,21,2,19,29,76,75,2
2698,Kyle Walker-Peters,Tottenham,2.1,5,4,4,1,0,2,4,50.0,2,2,0,2,3,8,8,0
2699,Wallace,Lazio,11.1,17,7,11,6,0,4,13,30.8,9,13,5,8,29,46,43,3
2700,Anthony Walongwa,Nantes,1.0,2,1,2,0,0,0,0,0.0,0,0,0,0,1,3,8,0
2701,Remi Walter,Nice,5.5,11,7,4,6,1,3,7,42.9,4,2,1,1,5,16,3,0
2702,Remi Walter,Troyes,11.1,23,10,9,13,1,2,23,8.7,21,7,3,4,11,34,14,0
2704,Jonathan Walters,Burnley,0.4,0,0,0,0,0,0,0,0.0,0,0,0,0,0,0,1,0
2705,Aaron Wan-Bissaka,Crystal Palace,7.0,30,19,20,7,3,15,19,78.9,4,18,7,11,15,45,45,0
2706,Victor Wanyama,Tottenham,9.4,30,20,13,16,1,14,31,45.2,17,13,3,10,10,40,20,1
2707,Joel Ward,Crystal Palace,17.9,35,30,23,12,0,16,28,57.1,12,27,11,16,28,63,76,0
2708,Stephen Ward,Burnley,27.3,39,31,27,8,4,20,42,47.6,22,27,12,15,42,81,126,0
2709,James Ward-Prowse,Southampton,19.1,23,16,9,11,3,3,27,11.1,24,29,1,28,8,31,31,0
2710,Daniel Wass,Celta Vigo,32.6,30,21,8,18,4,8,25,32.0,17,23,3,20,30,60,47,0
2711,Ben Watson,Watford,5.1,19,9,9,9,1,10,31,32.3,21,6,1,5,7,26,10,0
2712,Timothy Weah,Paris S-G,1.4,1,1,1,0,0,1,1,100.0,0,0,0,0,0,1,0,0
2713,Roman Weidenfeller,Dortmund,1.0,0,0,0,0,0,0,0,0.0,0,0,0,0,0,0,0,1
2714,Julian Weigl,Dortmund,21.6,69,49,20,42,7,42,66,63.6,24,26,6,20,34,103,29,2
2715,Mitchell Weiser,Hertha BSC,22.0,54,43,20,27,7,17,38,44.7,21,28,1,27,44,98,37,1
2716,Danny Welbeck,Arsenal,13.3,20,13,9,5,6,4,12,33.3,8,22,1,21,11,31,13,0
2717,Nahki Wells,Burnley,0.6,4,3,0,3,1,1,1,100.0,0,2,0,2,0,4,0,0
2718,Wendell,Leverkusen,23.5,54,41,29,20,5,32,58,55.2,26,44,8,36,28,82,58,0
2719,Oscar Wendt,M'Gladbach,27.3,54,40,31,19,4,30,45,66.7,15,46,12,34,27,81,71,0
2720,Axel Werner,Atlético Madrid,1.0,0,0,0,0,0,0,0,0.0,0,0,0,0,0,0,1,0
2721,Timo Werner,RB Leipzig,27.7,16,11,2,8,6,3,19,15.8,16,26,0,26,7,23,11,0
2722,Ashley Westwood,Burnley,12.3,13,10,10,3,0,2,16,12.5,14,17,9,8,19,32,16,0
2723,Dean Whitehead,Huddersfield,0.8,0,0,0,0,0,0,1,0.0,1,1,0,1,2,2,0,0
2724,Silvan Widmer,Udinese,18.1,45,32,30,15,0,22,40,55.0,18,22,5,17,28,73,59,0
2725,Georginio Wijnaldum,Liverpool,26.5,34,23,13,16,5,11,23,47.8,12,20,2,18,25,59,20,0
2726,Jetro Willems,Eint Frankfurt,18.5,55,42,28,23,4,27,42,64.3,15,31,1,30,20,75,53,0
2727,William,Wolfsburg,17.9,76,61,43,26,7,46,86,53.5,40,41,6,35,46,122,65,1
2728,Ashley Williams,Everton,20.4,23,13,17,6,0,9,18,50.0,9,31,23,8,36,59,173,3
2730,Danny Williams,Huddersfield,12.5,23,14,13,9,1,7,22,31.8,15,12,2,10,26,49,27,0
2731,Inaki Williams,Athletic Club,31.7,28,17,11,15,2,8,41,19.5,33,24,2,22,17,45,13,0
2732,Willian,Chelsea,21.0,22,17,7,12,3,0,16,0.0,16,13,1,12,10,32,10,0
2733,Joe Willock,Arsenal,0.9,4,2,4,0,0,1,1,100.0,0,3,0,3,1,5,2,0
2734,Jack Wilshere,Arsenal,13.3,15,10,3,7,5,4,20,20.0,16,10,2,8,8,23,5,0
2735,Callum Wilson,Bournemouth,22.0,9,5,2,6,1,1,14,7.1,13,15,3,12,3,12,15,0
2736,Kevin Wimmer,Stoke City,14.7,24,17,17,7,0,9,20,45.0,11,25,12,13,30,54,88,0
2737,Harry Winks,Tottenham,8.6,15,12,8,5,2,8,16,50.0,8,12,2,10,11,26,10,1
2738,Marius Wolf,Eint Frankfurt,26.3,37,28,15,18,4,18,46,39.1,28,45,1,44,27,64,46,0
2739,Bobby Wood,Hamburger SV,17.9,13,8,2,4,7,3,9,33.3,6,4,0,4,2,15,13,0
2740,Chris Wood,Burnley,18.0,7,3,2,3,2,3,13,23.1,10,12,4,8,0,7,16,0
2741,Ben Woodburn,Liverpool,0.1,0,0,0,0,0,0,0,0.0,0,0,0,0,0,0,0,0
2742,Xeka,Dijon,15.5,25,14,10,11,4,10,38,26.3,28,13,2,11,16,41,21,0
2743,Xeka,Lille,0.2,1,0,1,0,0,0,0,0.0,0,1,0,1,1,2,0,0
2744,Granit Xhaka,Arsenal,36.2,78,57,35,40,3,26,69,37.7,43,30,9,21,37,115,68,4
2745,Claudio Yacob,West Brom,10.0,36,27,23,13,0,13,27,48.1,14,14,6,8,16,52,25,2
2746,Steeve Yago,Toulouse,17.5,49,36,28,17,4,20,37,54.1,17,16,7,9,34,83,64,1
2747,Cedric Yambere,Dijon,31.4,58,42,46,12,0,16,34,47.1,18,24,16,8,54,112,138,5
2748,Jawad El Yamiq,Genoa,4.0,8,5,7,1,0,6,8,75.0,2,11,5,6,5,13,22,1
2749,Mapou Yanga-Mbiwa,Lyon,1.4,3,2,3,0,0,1,1,100.0,0,0,0,0,1,4,2,0
2750,Andriy Yarmolenko,Dortmund,11.5,17,12,6,6,5,7,16,43.8,9,4,0,4,7,24,4,0
2751,DeAndre Yedlin,Newcastle Utd,31.6,57,33,39,14,4,26,54,48.1,28,37,7,30,44,101,114,0
2752,Yoel,Eibar,1.0,0,0,0,0,0,0,0,0.0,0,0,0,0,0,0,2,0
2753,Maya Yoshida,Southampton,22.8,27,20,22,5,0,18,25,72.0,7,32,14,18,41,68,133,2
2754,Ashley Young,Manchester Utd,27.1,53,32,30,17,6,18,47,38.3,29,24,5,19,57,110,86,1
2756,Zaydou Youssouf,Bordeaux,1.5,3,1,2,1,0,1,2,50.0,1,1,0,1,1,4,1,0
2757,Pablo Zabaleta,West Ham,36.5,96,67,54,28,14,48,98,49.0,50,72,13,59,61,157,152,0
2758,Mattia Zaccagni,Hellas Verona,1.7,7,5,4,0,3,2,3,66.7,1,0,0,0,5,12,0,0
2759,Dan-Axel Zagadou,Dortmund,7.3,9,8,5,3,1,6,7,85.7,1,9,0,9,11,20,20,1
2760,Wilfried Zaha,Crystal Palace,28.3,30,23,9,13,8,4,23,17.4,19,24,0,24,7,37,4,0
2761,Denis Zakaria,M'Gladbach,25.5,74,48,38,32,4,40,61,65.6,21,52,9,43,45,119,40,1
2762,Joseba Zaldua,Leganés,28.4,68,52,31,31,6,39,62,62.9,23,28,5,23,61,129,85,0
2763,Andre-Frank Zambo Anguissa,Marseille,27.1,88,65,23,57,8,32,94,34.0,62,50,7,43,67,155,46,3
2764,Francesco Zampano,Udinese,4.6,9,7,5,3,1,5,10,50.0,5,4,0,4,6,15,7,0
2765,Niccolo Zanellato,Crotone,0.8,3,2,0,3,0,1,2,50.0,1,3,0,3,0,3,0,0
2766,Cristian Zapata,Milan,11.0,25,20,21,4,0,15,16,93.8,1,12,6,6,15,40,50,1
2767,Duvan Zapata,Sampdoria,23.4,12,7,1,7,4,1,6,16.7,5,13,0,13,5,17,22,1
2768,Davide Zappacosta,Chelsea,12.2,26,11,14,9,3,11,25,44.0,14,11,2,9,6,32,26,0
2769,Davide Zappacosta,Torino,1.1,1,0,1,0,0,0,0,0.0,0,0,0,0,2,3,1,0
2770,Simone Zaza,Valencia,23.1,21,14,4,10,7,1,20,5.0,19,26,1,25,8,29,34,0
2771,Marvin Zeegelaar,Watford,11.0,23,18,15,3,5,11,24,45.8,13,5,1,4,20,43,30,0
2772,Mehdi Zeffane,Rennes,11.0,17,12,10,5,2,9,25,36.0,16,10,2,8,12,29,44,0
2773,Rafik Zekhnini,Fiorentina,0.1,0,0,0,0,0,0,0,0.0,0,0,0,0,0,0,0,0
2774,Erwin Zelazny,Troyes,17.0,1,1,1,0,0,1,2,50.0,1,0,0,0,2,3,10,1
2775,Robin Zentner,Mainz 05,15.0,0,0,0,0,0,0,1,0.0,1,0,0,0,1,1,10,2
2776,Nabil El Zhar,Leganés,22.0,11,6,4,6,1,3,18,16.7,15,14,1,13,18,29,3,0
2777,Enzo Zidane,Alavés,0.8,2,2,2,0,0,0,0,0.0,0,0,0,0,0,2,1,0
2778,Luca Zidane,Real Madrid,1.0,0,0,0,0,0,0,1,0.0,1,0,0,0,0,0,0,0
2779,Ron-Robert Zieler,Stuttgart,34.0,1,1,1,0,0,1,1,100.0,0,2,0,2,1,2,14,5
2780,Piotr Zielinski,Napoli,18.5,31,19,7,21,3,9,24,37.5,15,32,3,29,13,44,19,1
2782,Matthias Zimmermann,Stuttgart,0.9,3,1,2,1,0,3,4,75.0,1,0,0,0,1,4,5,1
2783,Oleksandr Zinchenko,Manchester City,5.9,23,16,11,9,3,7,13,53.8,6,3,0,3,6,29,7,0
2784,Kevin Zohi,Strasbourg,0.0,0,0,0,0,0,0,0,0.0,0,0,0,0,0,0,0,0
2785,Simon Zoller,Köln,10.7,11,7,3,6,2,7,10,70.0,3,5,2,3,8,19,9,0
2786,Kurt Zouma,Stoke City,32.1,50,38,35,13,2,21,28,75.0,7,42,23,19,61,111,246,2
2787,Igor Zubeldia,Real Sociedad,17.6,39,29,17,16,6,14,42,33.3,28,20,5,15,32,71,31,0
2788,Steven Zuber,Hoffenheim,15.9,40,30,22,13,5,26,41,63.4,15,18,3,15,17,57,27,0
2789,Bruno Zuculini,Hellas Verona,13.5,68,49,37,28,3,20,48,41.7,28,35,8,27,38,106,31,0
2790,Franco Zuculini,Hellas Verona,3.7,11,8,5,5,1,5,14,35.7,9,4,0,4,5,16,6,1
2791,Ervin Zukanovic,Genoa,31.9,50,41,33,16,1,20,51,39.2,31,32,19,13,48,98,175,0
2792,Robert Zulj,Hoffenheim,2.3,3,3,1,2,0,1,1,100.0,0,3,0,3,0,3,2,0
2793,Bongani Zungu,Amiens,23.2,54,37,21,26,7,24,56,42.9,32,30,5,25,38,92,41,2
2794,David Zurutuza,Real Sociedad,24.9,49,36,22,25,2,20,49,40.8,29,32,10,22,41,90,24,1
2795,Filip Duricic,Benevento,10.8,22,14,11,8,3,5,9,55.6,4,7,1,6,9,31,5,0
2796,Filip Duricic,Sampdoria,0.1,0,0,0,0,0,0,1,0.0,1,0,0,0,0,0,0,0
2797,Christian Rutjens,Benevento,0.0,0.0,0.0,0.0,0.0,0.0,0.0,0.0,0.0,0.0,0.0,0.0,0.0,0.0,0.0,0.0,0.0
