,Player,90s,Tackles - Tkl,Tackles - TklW,Tackles - Def 3rd,Tackles - Mid 3rd,Tackles - Att 3rd,Challenges - Tkl,Challenges - Att,Challenges - Tkl%,Challenges - Lost,Blocks - Blocks,Blocks - Sh,Blocks - Pass,Int,Tkl+Int,Clr,Err
0,Ismael Aaneba,2.3,12,6,7,5,0,5,10,50.0,5,5,0,5,8,20,9,0
1,Patrick van Aanholt,35.5,48,24,35,11,2,24,40,60.0,16,33,9,24,40,88,91,2
2,Ignazio Abate,14.5,34,19,16,13,5,14,22,63.6,8,19,6,13,18,52,50,0
4,Yunis Abdelhamid,38.0,60,33,48,11,1,30,40,75.0,10,44,24,20,65,125,196,0
5,Mehdi Abeid,22.5,51,33,27,16,8,15,45,33.3,30,33,7,26,29,80,23,1
6,Charles Abi,0.4,4,4,2,1,1,2,2,100.0,0,1,0,1,0,4,1,0
7,David Abraham,15.8,22,14,13,8,1,11,25,44.0,14,23,12,11,24,46,64,0
8,Amir Abrashi,8.8,20,11,7,10,3,6,19,31.6,13,11,3,8,14,34,15,0
9,Francesco Acerbi,36.8,40,30,22,13,5,12,16,75.0,4,50,32,18,61,101,169,1
10,Afriyie Acquah,16.8,27,9,9,12,6,4,11,36.4,7,11,1,10,12,39,16,0
11,Tyler Adams,8.0,29,17,12,16,1,11,26,42.3,15,17,1,16,16,45,8,0
13,Aday,7.2,9,8,2,5,2,6,7,85.7,1,1,0,1,7,16,17,1
14,Khaled Adenon,22.2,31,22,20,11,0,16,28,57.1,12,26,11,15,31,62,101,0
15,Claud Adjapong,3.0,4,2,1,3,0,1,2,50.0,1,3,1,2,1,5,4,0
16,Yacine Adli,2.4,7,2,2,3,2,3,9,33.3,6,3,0,3,2,9,0,0
17,Ali Adnan Kadhim,1.8,1,1,1,0,0,1,2,50.0,1,1,1,0,3,4,6,0
18,Aritz Aduriz,10.5,4,2,1,1,2,1,7,14.3,6,2,1,1,0,4,4,0
19,Luis Advincula,26.5,52,38,38,12,2,21,31,67.7,10,22,2,20,19,71,60,1
20,Martin Agirregabiria,22.6,45,29,32,10,3,28,46,60.9,18,33,11,22,27,72,65,1
21,Nayef Aguerd,11.7,17,12,8,9,0,8,19,42.1,11,20,11,9,14,31,59,1
22,Sergio Aguero,27.3,17,9,1,10,6,5,9,55.6,4,15,1,14,9,26,3,0
23,Ruben Aguilar,28.1,88,51,40,33,15,39,69,56.5,30,23,3,20,37,125,50,1
24,Juan Aguilera,3.8,2,2,0,1,1,1,4,25.0,3,4,2,2,4,6,2,0
26,Emmanuel Agyemang-Badu,1.8,4,0,1,2,1,1,1,100.0,0,2,0,2,1,5,2,0
27,Jean-Eudes Aholou,11.9,20,11,6,11,3,8,16,50.0,8,7,0,7,17,37,12,0
28,Antonis Aidonis,0.9,3,1,1,1,1,1,4,25.0,3,1,0,1,2,5,2,0
29,Ola Aina,24.0,54,36,32,20,2,23,48,47.9,25,30,3,27,39,93,59,2
30,Youssef Ait Bennasser,10.4,25,13,9,12,4,13,28,46.4,15,15,2,13,19,44,6,2
31,Youssef Ait Bennasser,11.9,33,16,14,18,1,13,29,44.8,16,15,5,10,15,48,19,0
32,Rayan Ait Nouri,0.6,2,2,1,1,0,0,1,0.0,1,0,0,0,0,2,1,0
33,Ludovic Ajorque,17.0,17,13,1,10,6,4,9,44.4,5,5,0,5,5,22,9,0
34,Manuel Akanji,24.5,29,19,14,13,2,14,25,56.0,11,22,13,9,27,56,92,2
35,Carlos Akapo,11.4,28,15,18,8,2,19,33,57.6,14,12,2,10,23,51,36,0
36,Nathan Ake,37.9,66,35,42,21,3,22,35,62.9,13,51,35,16,32,98,241,0
37,Sergio Akieme,2.0,3,3,3,0,0,2,2,100.0,0,0,0,0,1,4,5,0
38,Chadrac Akolo,5.8,9,6,2,7,0,1,3,33.3,2,7,0,7,4,13,1,0
39,Kevin Akpoguma,5.5,23,15,13,10,0,11,21,52.4,10,18,5,13,12,35,20,2
40,Kevin Akpoguma,3.5,10,6,5,5,0,6,7,85.7,1,7,2,5,10,20,7,2
41,David Alaba,28.1,34,21,13,13,8,17,26,65.4,9,24,3,21,31,65,40,0
42,Sofiane Alakouch,21.1,81,44,44,31,6,36,63,57.1,27,15,4,11,46,127,57,0
43,Lucas Alario,14.1,15,8,5,6,4,4,14,28.6,10,9,0,9,1,16,16,0
44,Jordi Alba,33.2,42,22,20,15,7,20,48,41.7,28,24,6,18,60,102,76,1
45,Luis Alberto,22.1,53,22,15,29,9,21,55,38.2,34,23,3,20,10,63,10,0
46,Raul Albiol,19.0,16,8,12,4,0,8,15,53.3,7,19,16,3,20,36,90,1
47,Miiko Albornoz,18.4,46,26,31,10,5,21,45,46.7,24,23,3,20,16,62,37,1
48,Marc Albrighton,18.1,35,22,18,14,3,13,31,41.9,18,26,3,23,23,58,30,0
49,Paco Alcacer,13.5,3,1,2,0,1,0,6,0.0,6,5,0,5,6,9,7,0
50,Pedro Alcala,20.8,32,23,23,9,0,15,23,65.2,8,21,18,3,36,68,120,0
52,Thiago Alcantara,26.8,87,65,31,44,12,25,48,52.1,23,23,4,19,44,131,17,1
53,Ruben Alcaraz,33.1,96,54,50,40,6,32,89,36.0,57,59,10,49,38,134,52,1
54,Toby Alderweireld,32.5,37,23,25,10,2,12,22,54.5,10,41,22,19,24,61,175,0
55,Alex Alegria,1.6,1,1,0,1,0,0,3,0.0,3,1,0,1,0,1,0,0
57,Ivan Alejo,1.6,2,0,0,2,0,0,4,0.0,4,2,0,2,0,2,3,0
58,Carles Alena,7.1,7,4,0,6,1,2,8,25.0,6,4,0,4,2,9,0,0
59,Runar Alex Runarsson,25.0,2,0,2,0,0,2,6,33.3,4,0,0,0,1,3,7,2
60,Alexander,0.1,1,0,1,0,0,1,1,100.0,0,0,0,0,0,1,0,0
61,Trent Alexander-Arnold,27.4,61,39,31,22,8,36,68,52.9,32,19,3,16,35,96,68,0
62,Rachid Alioui,13.9,15,5,3,9,3,4,9,44.4,5,8,1,7,10,25,11,0
63,Alisson,38.0,2,1,2,0,0,2,2,100.0,0,0,0,0,1,3,14,6
64,Bobby Allain,13.0,0,0,0,0,0,0,1,0.0,1,1,0,1,0,0,16,1
65,Allan,29.1,106,70,39,55,12,36,107,33.6,71,55,13,42,36,142,28,0
66,Allan,2.0,4,4,2,2,0,0,4,0.0,4,4,2,2,0,4,1,0
67,Dele Alli,20.3,33,19,6,14,13,5,24,20.8,19,33,5,28,19,52,20,0
68,Miguel Almiron,8.4,20,12,7,10,3,4,10,40.0,6,14,1,13,8,28,5,0
69,Junior Alonso,6.0,13,9,8,4,1,7,12,58.3,5,8,3,5,5,18,24,1
70,Marcos Alonso,30.7,73,46,44,22,7,33,58,56.9,25,25,2,23,39,112,101,0
71,Mickael Alphonse,6.3,10,5,6,1,3,3,4,75.0,1,3,1,2,9,19,30,0
72,Sergio Alvarez,11.9,34,25,12,20,2,13,23,56.5,10,9,4,5,17,51,43,0
74,Yeray Alvarez,29.0,55,30,39,14,2,19,33,57.6,14,35,16,19,63,118,149,1
75,Bruno Alves,32.5,15,8,11,4,0,4,7,57.1,3,36,28,8,29,44,210,0
76,Dani Alves,18.0,42,22,16,23,3,13,38,34.2,25,18,5,13,8,50,11,0
78,Alfons Amade,0.1,1,1,0,1,0,1,2,50.0,1,0,0,0,1,2,0,0
79,Ibrahim Amadou,8.5,27,20,9,15,3,2,9,22.2,7,7,4,3,11,38,24,0
80,Romain Amalfitano,28.0,52,33,20,28,4,25,67,37.3,42,45,13,32,47,99,35,0
81,Daniel Amartey,7.1,18,12,11,6,1,10,15,66.7,5,6,4,2,17,35,28,1
82,Jordi Amat,30.7,54,31,34,19,1,24,42,57.1,18,31,10,21,43,97,133,1
83,Amath,11.1,20,13,7,11,2,6,27,22.2,21,17,0,17,10,30,12,0
84,Jordan Amavi,24.2,74,50,34,26,14,35,56,62.5,21,24,8,16,46,120,93,4
85,Kelvin Amian,32.0,68,45,54,12,2,20,30,66.7,10,36,13,23,36,104,113,1
86,Nadiem Amiri,8.4,14,9,8,4,2,3,13,23.1,10,11,0,11,7,21,4,0
89,Joachim Andersen,32.0,40,27,31,8,1,19,31,61.3,12,30,15,15,35,75,147,1
90,Felipe Anderson,33.8,89,49,33,44,12,31,101,30.7,70,71,0,71,41,130,18,1
91,Florin Andone,9.8,10,2,3,4,3,1,6,16.7,5,9,1,8,3,13,12,0
92,Benjamin Andre,27.7,101,60,39,50,12,33,85,38.8,52,40,6,34,54,155,58,0
93,Marco Andreolli,1.2,1,1,1,0,0,1,1,100.0,0,2,1,1,1,2,5,0
94,Marco Andreolli,7.2,10,6,7,2,1,6,10,60.0,4,4,2,2,6,16,33,0
95,Yoann Andreu,0.0,1,0,1,0,0,0,1,0.0,1,0,0,0,1,2,0,0
96,Jose Angel,33.6,66,46,36,23,7,31,56,55.4,25,24,5,19,41,107,113,1
97,Miguel Angel Moya,11.0,1,1,1,0,0,1,2,50.0,1,0,0,0,1,2,9,2
98,Cristian Ansaldi,20.1,50,26,19,21,10,15,30,50.0,15,21,4,17,15,65,31,0
99,Mirco Antenucci,23.7,11,9,5,1,5,1,10,10.0,9,14,0,14,5,16,5,0
100,Waldemar Anton,34.0,49,32,33,14,2,22,50,44.0,28,56,33,23,69,118,169,3
101,Luca Antonelli,8.4,13,11,4,5,4,7,17,41.2,10,19,4,15,16,29,25,1
102,Mauro Antonio Burruchaga,0.6,2,2,1,1,0,0,2,0.0,2,2,1,1,0,2,3,0
104,Michail Antonio,23.4,23,14,12,6,5,6,12,50.0,6,38,3,35,18,41,26,1
105,Antonito,20.7,35,21,16,15,4,18,42,42.9,24,21,8,13,18,53,31,0
106,Vitorino Antunes,24.2,41,26,22,17,2,27,45,60.0,18,33,7,26,43,84,75,1
107,Anuar,12.0,33,19,15,16,2,6,14,42.9,8,14,1,13,11,44,25,1
108,Dennis Aogo,11.4,15,10,6,7,2,6,15,40.0,9,8,1,7,9,24,19,0
109,Houssem Aouar,34.0,63,38,28,25,10,17,61,27.9,44,33,6,27,32,95,25,3
110,Emmanuel Apeh,0.2,0,0,0,0,0,0,1,0.0,1,0,0,0,0,0,0,0
111,Mauro Arambarri,29.7,59,33,18,37,4,23,76,30.3,53,44,9,35,30,89,36,0
112,Guilherme Arana,7.0,11,6,5,5,1,6,7,85.7,1,6,3,3,9,20,8,0
113,Charles Aranguiz,21.0,48,30,21,22,5,21,66,31.8,45,31,2,29,25,73,27,1
114,Luiz Araujo,8.7,23,17,8,9,6,9,24,37.5,15,6,1,5,3,26,4,0
115,Nestor Araujo,29.8,42,22,32,9,1,18,22,81.8,4,32,21,11,35,77,153,1
116,Anaitz Arbilla,21.7,31,24,25,5,1,17,27,63.0,10,12,5,7,46,77,92,2
118,Alphonse Areola,21.0,1,1,1,0,0,1,1,100.0,0,0,0,0,0,1,4,1
119,Santiago Arias,19.7,48,32,31,16,1,20,31,64.5,11,14,2,12,34,82,43,0
120,Lorenzo Ariaudo,18.7,20,14,15,4,1,6,10,60.0,4,31,20,11,14,34,103,0
121,Nicolo Armini,0.4,1,1,0,1,0,1,2,50.0,1,1,0,1,0,1,0,0
122,Yoel Armougom,20.6,31,21,20,9,2,15,29,51.7,14,9,3,6,21,52,66,0
123,Stuart Armstrong,15.9,28,20,14,6,8,8,42,19.0,34,14,0,14,12,40,12,0
124,Jose Arnaiz,1.3,1,1,1,0,0,0,3,0.0,3,0,0,0,2,3,1,0
125,Marko Arnautovic,22.1,9,5,4,3,2,1,7,14.3,6,4,2,2,3,12,6,0
126,Maximilian Arnold,31.9,52,30,21,27,4,21,61,34.4,40,31,10,21,35,87,48,1
127,Kepa Arrizabalaga,36.0,1,1,1,0,0,1,2,50.0,1,1,0,1,0,1,4,2
128,Harry Arter,22.2,62,37,27,26,9,16,46,34.8,30,33,5,28,21,83,21,2
130,Kwadwo Asamoah,29.7,44,26,22,14,8,29,51,56.9,22,21,4,17,40,84,46,1
131,Takuma Asano,7.8,5,3,1,1,3,1,6,16.7,5,9,0,9,2,7,2,0
132,Santiago Ascacibar,27.0,78,50,43,29,6,34,74,45.9,40,48,10,38,43,121,34,1
133,Sergio Asenjo,32.0,0,0,0,0,0,0,1,0.0,1,0,0,0,3,3,26,2
134,Marco Asensio,19.8,12,8,3,5,4,2,24,8.3,22,16,1,15,14,26,7,0
135,Iago Aspas,25.0,16,11,4,8,4,4,20,20.0,16,14,0,14,16,32,5,0
136,Simon Asta,1.0,6,3,4,2,0,2,2,100.0,0,2,1,1,3,9,1,0
137,Youcef Atal,25.1,68,44,34,25,9,34,67,50.7,33,38,8,30,56,124,42,0
138,Christian Atsu,16.6,24,15,9,11,4,5,16,31.3,11,13,3,10,7,31,16,0
139,Pierre-Emerick Aubameyang,30.3,21,17,6,9,6,8,28,28.6,20,26,0,26,8,29,22,0
140,Emil Audero,36.0,4,3,4,0,0,3,3,100.0,0,0,0,0,1,5,21,4
141,Jean-Kevin Augustin,5.1,2,0,0,0,2,0,1,0.0,1,6,0,6,3,5,0,0
142,Ludwig Augustinsson,33.6,53,31,25,22,6,23,39,59.0,16,37,11,26,38,91,86,1
143,Serge Aurier,6.3,20,12,12,4,4,8,15,53.3,7,8,2,6,7,27,20,0
144,Charlie Austin,10.9,13,7,3,6,4,6,11,54.5,5,12,2,10,2,15,13,0
145,Ezequiel Avila,22.2,18,10,7,7,4,4,26,15.4,22,21,2,19,13,31,22,0
146,Jordan Ayew,13.1,38,23,12,19,7,6,20,30.0,14,16,0,16,7,45,6,0
147,Kaan Ayhan,27.2,53,29,38,15,0,23,47,48.9,24,34,16,18,59,112,118,3
148,Floyd Ayite,5.3,4,4,2,1,1,2,6,33.3,4,8,1,7,7,11,5,0
149,Cesar Azpilicueta,37.8,105,60,52,40,13,38,67,56.7,29,63,16,47,43,148,91,3
150,Abdoulaye Ba,23.4,46,33,37,8,1,29,39,74.4,10,32,18,14,29,75,165,4
153,Khouma Babacar,16.5,7,3,2,5,0,2,10,20.0,8,8,2,6,3,10,25,1
154,Ryan Babel,13.9,8,4,1,5,2,3,9,33.3,6,12,0,12,6,14,13,1
156,Carlos Bacca,14.1,4,2,1,2,1,0,5,0.0,5,4,0,4,8,12,5,0
157,Juninho Bacuna,15.7,46,29,22,19,5,22,54,40.7,32,21,1,20,24,70,12,1
158,Leandro Bacuna,6.2,15,10,5,7,3,8,22,36.4,14,5,2,3,15,30,9,0
159,Milan Badelj,12.7,33,20,10,19,4,16,37,43.2,21,27,9,18,33,66,20,1
160,Benoit Badiashile,19.6,25,18,18,7,0,17,25,68.0,8,12,5,7,21,46,79,2
161,Holger Badstuber,5.8,12,4,8,4,0,7,8,87.5,1,6,2,4,9,21,21,1
162,Stephane Bahoken,27.4,15,7,0,10,5,3,21,14.3,18,35,3,32,8,23,5,0
163,Daniel Baier,31.3,62,39,21,37,4,24,66,36.4,42,27,8,19,60,122,48,2
164,Leon Bailey,21.3,15,11,9,2,4,6,20,30.0,14,20,0,20,14,29,11,0
165,Eric Bailly,7.1,15,9,14,1,0,8,10,80.0,2,9,4,5,13,28,39,1
166,Leighton Baines,4.2,8,6,4,3,1,4,6,66.7,2,2,0,2,2,10,8,0
167,Marvin Bakalorz,16.3,18,11,7,9,2,6,36,16.7,30,29,4,25,28,46,47,0
168,Tiemoue Bakayoko,25.6,69,43,22,40,7,26,62,41.9,36,34,5,29,50,119,42,2
169,Ridle Baku,10.4,18,9,6,9,3,2,7,28.6,5,13,1,12,8,26,9,0
170,Fabian Balbuena,22.4,40,20,34,6,0,16,42,38.1,26,23,15,8,53,93,175,0
171,Keita Balde,9.9,10,6,4,2,4,2,9,22.2,7,8,0,8,3,13,1,0
172,Gareth Bale,19.8,16,8,5,7,4,6,20,30.0,14,19,3,16,11,27,13,0
173,Mikel Balenziaga,5.8,10,6,7,1,2,5,8,62.5,3,6,2,4,2,12,21,0
174,Andrija Balic,0.3,1,0,0,0,1,0,1,0.0,1,0,0,0,0,1,1,0
175,Fode Ballo-Toure,17.7,47,35,26,19,2,21,32,65.6,11,25,7,18,27,74,42,2
176,Fode Ballo-Toure,17.7,46,31,26,16,4,20,40,50.0,20,20,2,18,28,74,38,2
177,Florent Balmont,12.0,29,16,16,10,3,9,36,25.0,27,13,2,11,6,35,8,0
178,Leon Balogun,6.6,12,6,11,1,0,8,9,88.9,1,5,3,2,17,29,32,1
179,Mario Balotelli,8.4,1,0,0,1,0,1,4,25.0,3,9,1,8,1,2,8,0
180,Mario Balotelli,10.4,5,3,1,3,1,2,7,28.6,5,8,2,6,3,8,6,0
182,Abdoulaye Bamba,28.6,51,29,31,14,6,24,44,54.5,20,20,4,16,37,88,86,0
183,Jonathan Bamba,33.4,29,19,7,17,5,13,39,33.3,26,24,1,23,41,70,18,0
184,Sol Bamba,27.5,74,42,44,30,0,31,55,56.4,24,72,32,40,82,156,181,3
185,Yacine Bammou,10.3,14,7,7,4,3,3,8,37.5,5,14,3,11,9,23,17,0
186,Ever Banega,29.6,71,50,32,35,4,20,70,28.6,50,26,5,21,28,99,28,0
187,Mattia Bani,29.0,67,40,46,21,0,27,40,67.5,13,51,35,16,57,124,162,2
188,Leo Baptistao,13.7,22,14,11,5,6,8,27,29.6,19,17,0,17,8,30,14,0
189,Antonin Barak,3.7,9,6,4,5,0,2,11,18.2,9,4,0,4,2,11,2,0
190,Federico Barba,27.6,30,14,21,9,0,8,21,38.1,13,29,15,14,65,95,129,0
191,Danilo Barbosa,17.2,29,20,13,13,3,6,17,35.3,11,17,2,15,15,44,25,1
192,Enis Bardhi,31.5,70,43,30,34,6,28,87,32.2,59,35,3,32,31,101,36,1
194,Phil Bardsley,18.6,32,19,15,14,3,12,21,57.1,9,25,12,13,31,63,68,1
195,Nicolo Barella,34.5,99,65,38,41,20,30,82,36.6,52,61,2,59,38,137,27,0
196,Philipp Bargfrede,12.0,23,15,9,12,2,10,28,35.7,18,35,11,24,34,57,45,1
197,Antonino Barilla,29.1,64,36,40,17,7,19,53,35.8,34,40,13,27,36,100,50,1
198,Ross Barkley,13.8,15,10,5,7,3,4,14,28.6,10,8,1,7,9,24,17,2
199,Aymen Barkok,5.7,13,6,4,9,0,4,19,21.1,15,8,1,7,4,17,3,0
200,Ashley Barnes,26.5,28,17,4,17,7,6,29,20.7,23,29,8,21,2,30,25,0
201,Harvey Barnes,11.2,10,6,5,4,1,4,6,66.7,2,7,1,6,3,13,7,0
202,Antonio Barragan,10.4,14,8,9,4,1,2,12,16.7,10,15,4,11,5,19,30,2
204,Antonio Barreca,6.6,11,8,8,3,0,7,11,63.6,4,3,2,1,7,18,18,0
205,Leandro Barreiro Martins,1.0,4,4,2,0,2,1,2,50.0,1,0,0,0,2,6,1,0
206,Ander Barrenetxea,4.4,7,2,2,0,5,2,8,25.0,6,8,0,8,4,11,1,0
208,Edgar Barreto,8.7,28,19,15,6,7,10,26,38.5,16,11,3,8,17,45,7,0
209,Musa Barrow,6.7,9,5,5,3,1,4,6,66.7,2,4,0,4,0,9,2,0
210,Fin Bartels,0.3,0,0,0,0,0,0,1,0.0,1,0,0,0,1,1,0,0
211,Marc Bartra,32.5,86,55,55,26,5,41,76,53.9,35,46,21,25,60,146,132,2
212,Andrea Barzagli,2.9,1,1,0,1,0,1,2,50.0,1,2,2,0,4,5,10,0
213,Daniele Baselli,26.4,65,45,22,34,9,16,44,36.4,28,30,6,24,34,99,32,0
214,Toma Basic,14.8,32,16,5,21,6,11,31,35.5,20,13,1,12,9,41,22,1
216,Borja Baston,16.0,16,7,4,9,3,2,24,8.3,22,16,5,11,4,20,10,0
217,Alessandro Bastoni,18.8,25,12,20,5,0,6,15,40.0,9,26,18,8,22,47,96,0
218,Bastos,12.7,22,17,16,4,2,17,27,63.0,10,16,8,8,7,29,49,1
219,Michy Batshuayi,8.3,2,1,1,1,0,1,2,50.0,1,8,3,5,3,5,0,0
220,Michy Batshuayi,5.9,1,1,0,1,0,0,3,0.0,3,5,2,3,0,1,3,0
221,Robert Bauer,19.1,48,29,32,13,3,20,39,51.3,19,19,5,14,28,76,80,0
223,Timo Baumgartl,18.0,33,23,21,12,0,11,19,57.9,8,31,22,9,26,59,100,0
224,Julian Baumgartlinger,17.3,52,30,24,20,8,20,45,44.4,25,18,6,12,26,78,21,1
225,Christoph Baumgartner,0.9,1,0,0,0,1,1,3,33.3,2,2,0,2,0,1,0,0
226,Jon Bautista,6.6,5,3,0,3,2,0,3,0.0,3,8,1,7,5,10,4,0
227,Paul Baysse,0.8,1,0,1,0,0,0,1,0.0,1,1,1,0,1,2,6,0
228,Paul Baysse,19.9,25,14,20,5,0,13,18,72.2,5,25,20,5,31,56,113,1
230,Claudio Beauvue,16.7,18,11,7,9,2,1,14,7.1,13,11,2,9,10,28,21,0
231,Bebe,14.5,19,9,10,4,5,9,19,47.4,10,16,1,15,9,28,16,1
234,Ihlas Bebou,11.8,15,9,4,10,1,4,9,44.4,5,18,2,16,9,24,9,0
235,Uffe Bech,0.2,0,0,0,0,0,0,1,0.0,1,0,0,0,0,0,0,0
236,Andreas Beck,19.7,35,19,17,17,1,11,27,40.7,16,32,6,26,22,57,54,0
237,Jan Bednarek,23.9,41,25,25,16,0,21,37,56.8,16,44,27,17,71,112,171,0
238,Andrea Beghetto,24.7,26,14,13,10,3,15,25,60.0,10,20,4,16,17,43,59,0
239,Asmir Begovic,24.0,0,0,0,0,0,0,3,0.0,3,1,0,1,1,1,15,7
240,Valon Behrami,15.1,65,38,25,34,6,18,44,40.9,26,29,12,17,18,83,26,0
241,Hanno Behrens,29.3,46,26,29,17,0,21,47,44.7,26,43,13,30,33,79,49,0
242,Ishak Belfodil,20.7,13,10,5,6,2,4,16,25.0,12,6,0,6,3,16,14,0
243,Stefan Bell,25.0,31,20,18,13,0,15,34,44.1,19,31,11,20,54,85,122,1
244,Karim Bellarabi,11.7,13,6,7,4,2,3,19,15.8,16,13,0,13,10,23,8,0
245,Hector Bellerin,17.0,15,12,8,4,3,6,13,46.2,7,17,5,12,20,35,37,3
246,Andrea Belotti,36.7,33,22,8,15,10,6,30,20.0,24,36,5,31,15,48,23,0
247,Fran Beltran,16.9,23,17,8,12,3,13,31,41.9,18,19,2,17,19,42,15,1
248,Hatem Ben Arfa,22.6,15,7,4,8,3,7,16,43.8,9,9,0,9,4,19,0,0
249,Wissam Ben Yedder,31.2,18,16,3,11,4,2,12,16.7,10,18,0,18,11,29,2,0
250,Diego Benaglio,22.9,1,0,1,0,0,1,1,100.0,0,0,0,0,0,1,16,0
251,Marco Benassi,25.4,30,19,8,15,7,14,41,34.1,27,16,3,13,9,39,27,1
252,Medhi Benatia,5.0,7,6,6,1,0,3,5,60.0,2,10,5,5,16,23,18,0
253,Lars Bender,15.1,43,29,20,20,3,18,35,51.4,17,26,4,22,21,64,26,0
254,Sven Bender,22.1,40,25,25,15,0,18,30,60.0,12,31,14,17,52,92,98,0
255,Laszlo Benes,0.3,3,1,3,0,0,3,3,100.0,0,1,0,1,0,3,0,0
256,Nicolas Benezet,18.5,32,19,14,15,3,5,19,26.3,14,12,0,12,19,51,4,0
257,Walter Benitez,35.0,1,0,1,0,0,1,2,50.0,1,0,0,0,2,3,6,2
258,Ismael Bennacer,32.9,94,57,43,41,10,32,75,42.7,43,38,9,29,57,151,34,0
260,Joe Bennett,29.3,50,29,34,16,0,22,38,57.9,16,30,8,22,60,110,93,0
261,Ryan Bennett,34.0,58,32,41,16,1,25,41,61.0,16,42,21,21,43,101,131,1
262,Yassine Benrahou,2.0,9,6,1,7,1,2,5,40.0,3,4,0,4,2,11,1,0
263,Ramy Bensebaini,23.9,69,48,42,19,8,40,58,69.0,18,24,10,14,41,110,98,0
264,Nabil Bentaleb,19.9,32,17,8,21,3,4,18,22.2,14,28,8,20,35,67,19,0
265,Rodrigo Bentancur,22.3,53,34,22,29,2,18,39,46.2,21,20,8,12,43,96,42,1
266,Christian Benteke,9.0,5,1,0,4,1,1,4,25.0,3,7,2,5,0,5,14,0
267,Karim Benzema,32.8,24,11,2,11,11,2,17,11.8,15,16,1,15,8,32,25,0
268,Yassine Benzia,1.8,1,1,0,1,0,1,1,100.0,0,0,0,0,1,2,1,0
269,Domenico Berardi,31.9,38,21,16,9,13,15,73,20.5,58,31,2,29,27,65,24,0
270,Yuri Berchiche,34.7,46,31,26,11,9,23,46,50.0,23,34,9,25,42,88,82,0
271,Alex Berenguer,16.5,31,20,12,17,2,14,34,41.2,20,20,1,19,8,39,14,0
272,Bartosz Bereszynski,24.4,46,30,27,15,4,24,51,47.1,27,22,7,15,31,77,76,0
273,Johann Berg Gudmundsson,19.5,27,11,14,10,3,16,34,47.1,18,25,4,21,33,60,34,0
274,Markel Bergara,0.6,2,2,0,1,1,2,3,66.7,1,3,0,3,1,3,2,0
275,Robert Beric,13.1,12,5,1,9,2,1,11,9.1,10,8,2,6,4,16,3,0
276,Etrit Berisha,18.0,0,0,0,0,0,0,2,0.0,2,0,0,0,0,0,5,3
277,Valon Berisha,2.2,8,5,1,6,1,4,6,66.7,2,6,0,6,4,12,3,0
278,Bernard,23.5,49,30,19,22,8,15,55,27.3,40,37,2,35,27,76,14,1
279,Federico Bernardeschi,16.4,14,8,5,6,3,7,18,38.9,11,9,0,9,6,20,10,0
280,Bernardo,19.5,62,43,43,13,6,31,45,68.9,14,32,13,19,34,96,82,0
281,Paul Bernardoni,38.0,1,1,1,0,0,1,2,50.0,1,0,0,0,1,2,20,1
282,Juan Bernat,20.4,47,32,22,19,6,22,46,47.8,24,19,5,14,20,67,41,1
283,Antoine Bernede,1.9,13,7,3,8,2,5,9,55.6,4,3,1,2,3,16,1,1
286,Ryan Bertrand,24.0,46,27,22,20,4,16,31,51.6,15,27,5,22,28,74,51,0
287,Daniel Bessa,27.1,60,35,28,23,9,11,39,28.2,28,30,4,26,19,79,16,1
289,Jordan Beyer,8.0,32,18,21,10,1,17,24,70.8,7,12,6,6,11,43,32,0
290,Jonathan Biabiany,11.9,30,22,18,10,2,9,17,52.9,8,8,1,7,11,41,11,1
291,Giulian Biancone,1.0,4,3,4,0,0,1,3,33.3,2,0,0,0,3,7,2,0
292,Ermin Bicakcic,19.9,32,19,18,11,3,13,22,59.1,9,36,15,21,56,88,79,1
293,Pedro Bigas,6.5,4,3,2,0,2,1,5,20.0,4,6,2,4,8,12,22,0
294,Lucas Biglia,12.4,60,33,31,25,4,20,45,44.4,25,19,3,16,22,82,21,1
295,Philip Billing,24.3,73,44,26,39,8,19,42,45.2,23,57,16,41,53,126,43,0
296,Cristiano Biraghi,35.5,52,33,31,17,4,18,38,47.4,20,40,17,23,44,96,113,0
297,Davide Biraschi,31.6,58,38,37,19,2,25,42,59.5,17,32,13,19,64,122,107,1
298,Valter Birsa,3.9,5,3,1,3,1,4,8,50.0,4,5,0,5,4,9,3,0
299,Valter Birsa,12.2,14,9,4,7,3,4,17,23.5,13,9,1,8,6,20,13,0
300,Yves Bissouma,19.7,62,30,33,27,2,20,38,52.6,18,21,5,16,33,95,29,2
301,Leonardo Bittencourt,11.9,37,26,9,22,6,8,32,25.0,24,22,1,21,13,50,7,0
302,Alejandro Blanco,0.2,1,1,1,0,0,1,3,33.3,2,1,0,1,0,1,0,0
303,Ruben Blanco,25.0,1,0,1,0,0,1,2,50.0,1,1,0,1,2,3,13,2
304,Ludovic Blas,26.4,62,38,22,32,8,20,43,46.5,23,44,7,37,26,88,14,0
305,Pablo de Blasis,16.9,32,19,17,8,7,12,32,37.5,20,18,0,18,13,45,20,0
306,Pablo de Blasis,1.0,2,0,0,1,1,2,3,66.7,1,0,0,0,1,3,0,0
307,Alexis Blin,22.1,77,45,33,36,8,35,89,39.3,54,39,14,25,33,110,48,1
309,Emmanuel Boateng,7.8,4,3,0,0,4,0,3,0.0,3,5,0,5,1,5,7,0
310,Jerome Boateng,18.8,21,15,12,9,0,10,22,45.5,12,8,3,5,25,46,49,0
312,Kevin-Prince Boateng,10.4,5,4,0,4,1,1,4,25.0,3,7,3,4,3,8,13,0
313,Kevin-Prince Boateng,2.7,3,2,0,1,2,0,1,0.0,1,1,0,1,1,4,4,0
314,Antonin Bobichon,23.9,34,16,17,12,5,16,58,27.6,42,15,3,12,15,49,13,0
315,Yann Bodiger,0.1,0,0,0,0,0,0,1,0.0,1,0,0,0,0,0,0,0
316,Mathieu Bodmer,11.9,15,11,3,11,1,3,10,30.0,7,3,0,3,2,17,10,0
317,Adam Bodzek,17.7,44,27,27,16,1,17,43,39.5,26,15,6,9,26,70,39,0
318,Jean-Paul Boetius,23.6,51,32,21,25,5,16,44,36.4,28,59,2,57,37,88,13,0
320,Jeremie Boga,16.0,7,4,5,1,1,4,14,28.6,10,19,0,19,2,9,4,0
321,Willy Boly,35.2,85,52,49,34,2,34,56,60.7,22,55,32,23,72,157,177,6
322,Leo Bonatini,1.5,1,1,0,0,1,1,5,20.0,4,1,0,1,0,1,0,0
323,Giacomo Bonaventura,7.2,6,2,2,4,0,2,7,28.6,5,3,0,3,7,13,8,0
324,Daniele Bonera,2.6,2,2,2,0,0,1,1,100.0,0,5,5,0,4,6,10,0
325,Gaetan Bong,20.1,16,10,7,6,3,6,10,60.0,4,16,6,10,25,41,57,2
326,Kevin Bonifazi,25.6,40,24,31,8,1,15,33,45.5,18,38,21,17,36,76,79,0
327,Leonardo Bonucci,27.5,18,9,11,6,1,10,13,76.9,3,32,21,11,38,56,88,3
328,Fabio Borini,11.7,14,10,7,7,0,3,9,33.3,6,17,0,17,12,26,28,0
329,Robin Bormuth,6.8,7,4,7,0,0,5,10,50.0,5,6,4,2,10,17,49,1
330,Artur Boruc,12.0,1,0,1,0,0,1,3,33.3,2,0,0,0,0,1,1,0
331,Olivier Boscagli,9.6,20,12,14,4,2,9,20,45.0,11,12,1,11,17,37,37,0
332,Gabriel Boschilia,14.7,33,23,11,9,13,8,33,24.2,25,14,2,12,8,41,7,0
333,John Bostock,10.9,24,14,14,10,0,9,30,30.0,21,12,2,10,17,41,11,0
334,Denis Bouanga,29.3,52,32,21,22,9,13,61,21.3,48,24,3,21,20,72,16,0
336,Ryad Boudebouz,8.0,14,4,4,6,4,3,8,37.5,5,9,1,8,3,17,9,0
338,Ryad Boudebouz,6.0,8,4,4,1,3,4,10,40.0,6,5,1,4,5,13,2,0
339,Sofiane Boufal,23.2,35,21,18,11,6,15,47,31.9,32,24,0,24,10,45,12,0
340,Nassim Boujellab,4.2,10,4,3,6,1,3,11,27.3,8,6,0,6,2,12,3,0
341,Arnold Bouka Moutou,0.7,3,1,2,1,0,0,4,0.0,4,1,0,1,3,6,1,0
342,Yassine Bounou,31.8,0,0,0,0,0,0,2,0.0,2,0,0,0,1,1,7,2
343,Mehdi Bourabia,22.3,51,28,23,21,7,15,46,32.6,31,28,5,23,33,84,32,0
344,Benjamin Bourigeaud,26.9,55,35,23,21,11,20,67,29.9,47,44,5,39,32,87,34,1
345,Bilal Boutobba,0.4,0,0,0,0,0,0,2,0.0,2,0,0,0,0,0,0,0
346,Umut Bozok,13.7,9,6,0,3,6,2,4,50.0,2,3,0,3,5,14,1,0
347,Filip Bradaric,16.6,26,21,11,12,3,10,20,50.0,10,13,3,10,39,65,50,0
348,Robbie Brady,8.0,15,7,5,5,5,6,17,35.3,11,7,1,6,7,22,18,1
349,Martin Braithwaite,15.6,5,3,0,0,5,0,4,0.0,4,9,0,9,3,8,4,0
350,Julian Brandt,29.6,27,16,13,10,4,7,43,16.3,36,27,1,26,17,44,12,1
351,Darko Brasanac,17.6,32,16,15,13,4,10,26,38.5,16,17,4,13,13,45,19,0
352,Pedro Brazao,0.2,0,0,0,0,0,0,1,0.0,1,0,0,0,0,0,0,0
353,Fabian Bredlow,12.5,1,1,1,0,0,1,1,100.0,0,0,0,0,1,2,3,4
354,Josip Brekalo,15.7,15,7,7,6,2,5,18,27.8,13,15,1,14,12,27,9,1
355,Gleison Bremer,2.0,3,1,1,2,0,1,2,50.0,1,4,1,3,8,11,9,0
356,Joshua Brenet,10.1,20,13,12,5,3,7,13,53.8,6,16,1,15,8,28,19,0
358,Anthony Briancon,32.5,46,27,36,10,0,27,50,54.0,23,51,38,13,70,116,184,1
359,Jimmy Briand,27.7,14,8,2,10,2,4,24,16.7,20,14,6,8,4,18,29,0
360,Nicolo Brighenti,11.0,27,17,9,15,3,6,14,42.9,8,17,8,9,31,58,37,0
361,Matteo Brighi,2.6,11,4,2,9,0,2,9,22.2,7,2,0,2,3,14,4,0
362,Enrico Brignola,1.9,2,2,2,0,0,0,2,0.0,2,0,0,0,1,3,1,0
364,Miguel Britos,2.1,4,2,4,0,0,2,4,50.0,2,1,1,0,3,7,11,1
365,David Brooks,25.1,37,26,12,19,6,19,44,43.2,25,36,7,29,24,61,28,0
366,John Brooks,29.0,29,15,18,9,2,13,27,48.1,14,28,13,15,37,66,135,3
367,Daniel Brosinski,24.5,27,16,16,10,1,18,33,54.5,15,30,9,21,26,53,58,0
368,Marcelo Brozovic,29.4,101,70,47,40,14,31,86,36.0,55,45,8,37,44,145,32,3
369,Bruma,6.1,5,2,3,1,1,1,5,20.0,4,4,0,4,4,9,2,0
370,Jeffrey Bruma,6.9,12,11,8,4,0,6,12,50.0,6,8,2,6,4,16,35,0
371,Bruno,12.6,25,16,20,3,2,14,18,77.8,4,7,2,5,11,36,30,1
372,Jacob Bruun Larsen,14.1,15,9,8,2,5,7,17,41.2,10,15,1,14,13,28,12,0
373,Joe Bryan,26.1,61,41,35,21,5,24,42,57.1,18,34,12,22,31,92,82,1
374,Gianluigi Buffon,17.0,0,0,0,0,0,0,1,0.0,1,0,0,0,0,0,5,0
375,Niko Bungert,3.2,7,5,5,2,0,5,5,100.0,0,7,6,1,4,11,16,0
376,Guido Burgstaller,17.0,11,9,2,5,4,3,8,37.5,5,5,0,5,2,13,10,0
377,Burgui,6.2,6,6,4,2,0,1,3,33.3,2,4,0,4,0,6,2,1
378,Jonathan Burkardt,2.9,4,4,2,1,1,1,2,50.0,1,2,0,2,3,7,5,0
379,Roman Burki,32.0,1,0,1,0,0,1,2,50.0,1,1,0,1,2,3,8,4
380,Patrick Burner,15.0,36,23,22,10,4,16,34,47.1,18,15,5,10,31,67,40,0
381,Sergio Busquets,30.2,90,60,35,45,10,41,89,46.1,48,43,8,35,54,144,22,1
382,Gaetan Bussmann,1.0,2,1,2,0,0,2,5,40.0,3,0,0,0,1,3,2,0
383,Unai Bustinza,22.5,41,31,25,14,2,17,33,51.5,16,31,13,18,53,94,110,2
384,Ludovic Butelle,36.0,1,0,1,0,0,1,1,100.0,0,0,0,0,1,2,31,1
387,Erick Cabaco,18.1,22,13,19,3,0,12,29,41.4,17,29,14,15,29,51,69,0
390,Remy Cabella,33.3,88,51,31,38,19,30,87,34.5,57,39,1,38,19,107,5,3
391,Gustavo Cabral,21.1,37,26,28,7,2,17,27,63.0,10,31,11,20,33,70,102,1
393,Leandro Cabrera,31.0,47,26,28,17,2,24,41,58.5,17,29,16,13,52,99,216,2
394,Fabrizio Cacciatore,6.4,9,7,7,0,2,1,5,20.0,4,6,4,2,7,16,17,0
395,Fabrizio Cacciatore,5.5,8,4,6,2,0,4,9,44.4,5,8,2,6,5,13,20,0
396,Martin Caceres,3.4,4,2,3,1,0,4,6,66.7,2,4,0,4,0,4,12,1
397,Martin Caceres,7.0,7,3,6,0,1,4,4,100.0,0,6,3,3,4,11,14,0
398,Anthony Caci,25.5,56,30,38,14,4,24,46,52.2,22,20,10,10,47,103,63,0
399,Mathieu Cafaro,23.3,59,28,29,24,6,18,63,28.6,45,28,0,28,20,79,14,0
401,Yannick Cahuzac,15.9,33,19,15,15,3,17,32,53.1,15,16,4,12,24,57,55,0
402,Felipe Caicedo,15.2,16,12,4,6,6,1,8,12.5,7,9,2,7,5,21,5,0
403,Marc-Aurele Caillard,21.0,0,0,0,0,0,0,2,0.0,2,0,0,0,2,2,8,3
404,Tom Cairney,24.4,37,21,9,22,6,12,16,75.0,4,21,5,16,10,47,13,1
405,Caiuby,11.2,12,10,5,6,1,3,11,27.3,8,16,1,15,5,17,10,0
406,Arturo Calabresi,15.7,46,27,22,17,7,22,40,55.0,18,18,3,15,34,80,60,0
407,Davide Calabria,21.7,79,51,58,16,5,37,67,55.2,30,33,1,32,32,111,78,1
409,Fernando Calero,34.8,51,31,33,18,0,23,38,60.5,15,55,31,24,55,106,170,0
410,Duje Caleta-Car,17.2,22,16,14,8,0,14,18,77.8,4,15,9,6,20,42,86,2
411,Hakan Calhanoglu,32.0,52,31,27,16,9,23,46,50.0,23,27,5,22,28,80,19,0
412,Daniel Caligiuri,30.6,93,52,55,29,9,44,103,42.7,59,66,10,56,50,143,72,1
413,Jose Callejon,29.4,34,18,12,14,8,18,57,31.6,39,34,5,29,22,56,11,0
414,Jonathan Calleri,31.9,20,13,3,11,6,1,24,4.2,23,34,7,27,7,27,53,0
417,Dominic Calvert-Lewin,19.8,13,7,3,3,7,7,15,46.7,8,16,3,13,7,20,19,0
418,Ignacio Camacho,6.0,15,9,9,6,0,3,7,42.9,4,7,2,5,18,33,12,0
419,Juanjo Camacho,0.4,1,1,1,0,0,1,1,100.0,0,0,0,0,0,1,1,0
420,Rafael Camacho,0.0,1,0,1,0,0,1,1,100.0,0,0,0,0,0,1,0,0
422,Souleymane Camara,1.5,0,0,0,0,0,0,2,0.0,2,0,0,0,0,0,3,0
423,Victor Camarasa,28.5,28,15,8,15,5,6,31,19.4,25,17,2,15,33,61,28,1
424,Eduardo Camavinga,4.0,23,15,8,12,3,8,18,44.4,10,13,2,11,4,27,4,0
425,Sergio Camello,0.5,1,0,1,0,0,1,1,100.0,0,0,0,0,0,1,0,0
426,Jose Campana,35.7,65,45,31,29,5,27,86,31.4,59,51,7,44,48,113,46,1
427,Joel Campbell,9.9,15,10,5,8,2,3,17,17.6,14,2,0,2,3,18,2,1
428,Emre Can,20.1,64,38,28,27,9,24,40,60.0,16,43,13,30,28,92,36,2
429,Sergio Canales,29.5,44,30,19,18,7,11,53,20.8,42,34,3,31,9,53,8,1
430,Joao Cancelo,21.9,43,28,18,18,7,27,49,55.1,22,14,4,10,15,58,48,0
431,Antonio Candreva,5.6,1,1,0,1,0,1,8,12.5,7,0,0,0,4,5,9,0
432,Ander Capa,18.2,43,27,32,8,3,13,27,48.1,14,20,2,18,30,73,47,0
434,Pierrick Capelle,20.5,51,31,23,22,6,19,54,35.2,35,23,2,21,38,89,49,0
435,Leonardo Capezzi,8.6,14,9,6,8,0,7,13,53.8,6,14,4,10,10,24,13,0
436,Etienne Capoue,32.7,91,56,36,48,7,33,87,37.9,54,50,13,37,85,176,96,1
437,Gianluca Caprari,11.5,15,9,4,9,2,5,12,41.7,7,7,0,7,4,19,3,0
438,Marco Capuano,25.6,53,33,37,15,1,26,46,56.5,20,44,31,13,34,87,101,2
439,Francesco Caputo,38.0,13,9,2,4,7,3,10,30.0,7,11,1,10,2,15,11,0
440,Yoan Cardinale,3.0,1,0,1,0,0,1,1,100.0,0,0,0,0,0,1,1,0
442,Marc Cardona,6.7,7,5,2,1,4,2,6,33.3,4,7,0,7,1,8,3,0
443,Diego Carlos,35.0,58,34,43,14,1,26,33,78.8,7,44,31,13,50,108,186,1
444,Jonas Carls,1.0,5,2,4,0,1,5,5,100.0,0,0,0,0,1,6,0,0
446,Lionel Carole,19.2,25,12,16,7,2,11,16,68.8,5,19,5,14,32,57,51,0
447,Daniel Carrico,23.7,35,18,23,11,1,12,20,60.0,8,19,12,7,31,66,104,1
448,Guido Carrillo,22.1,25,14,4,12,9,6,19,31.6,13,12,1,11,8,33,25,0
449,Andy Carroll,5.1,4,2,1,3,0,1,4,25.0,3,3,2,1,1,5,8,0
450,Dani Carvajal,23.4,40,24,17,15,8,18,41,43.9,23,31,7,24,26,66,35,0
451,William Carvalho,26.5,45,27,20,21,4,16,29,55.2,13,8,0,8,12,57,30,0
452,Casemiro,25.7,86,52,44,35,7,38,94,40.4,56,52,12,40,41,127,56,3
453,Santiago Caseres,17.6,67,35,20,38,9,25,57,43.9,32,22,9,13,14,81,24,1
454,Moreto Cassama,0.7,3,3,1,2,0,1,7,14.3,6,1,0,1,1,4,2,0
455,Francesco Cassata,12.5,20,11,12,4,4,9,23,39.1,14,8,1,7,6,26,15,1
456,Timothy Castagne,22.3,61,39,30,22,9,32,57,56.1,25,32,6,26,28,89,50,0
457,Koen Casteels,25.5,1,0,1,0,0,1,2,50.0,1,1,0,1,0,1,11,1
458,Samu Castillejo,11.4,15,10,10,2,3,4,25,16.0,21,16,0,16,8,23,11,0
459,Gonzalo Castro,18.8,50,28,21,25,4,19,43,44.2,24,23,5,18,29,79,22,1
460,Jonny Castro,30.8,79,43,42,33,4,31,60,51.7,29,45,8,37,60,139,64,2
461,Lucas Castro,10.0,18,11,8,8,2,8,23,34.8,15,20,4,16,17,35,6,0
462,Danilo Cataldi,6.4,12,7,4,5,3,2,9,22.2,7,3,0,3,7,19,6,0
463,Catena,2.0,4,4,3,1,0,2,2,100.0,0,4,2,2,8,12,8,0
464,Craig Cathcart,34.4,50,31,36,11,3,21,37,56.8,16,42,30,12,38,88,184,4
465,Ivan Cavaleiro,7.7,5,4,3,1,1,1,14,7.1,13,12,0,12,4,9,5,0
466,Edinson Cavani,18.6,11,8,1,4,6,3,13,23.1,10,11,2,9,6,17,16,0
468,Santi Cazorla,29.4,69,34,32,26,11,24,69,34.8,45,35,6,29,28,97,17,1
469,Dani Ceballos,13.9,32,21,9,16,7,11,31,35.5,20,26,1,25,15,47,6,0
470,Federico Ceccherini,11.0,13,10,8,3,2,5,9,55.6,4,12,8,4,21,34,40,0
471,Petr Cech,6.5,1,1,1,0,0,1,1,100.0,0,0,0,0,0,1,5,2
473,Zeki Celik,33.0,90,59,40,39,11,36,89,40.4,53,34,5,29,34,124,89,1
474,Luca Ceppitelli,22.8,40,24,28,11,1,13,22,59.1,9,34,24,10,20,60,111,2
475,Fabio Ceravolo,13.2,5,1,2,1,2,1,11,9.1,10,9,1,8,2,7,19,0
476,Alberto Cerri,7.4,3,2,2,1,0,0,7,0.0,7,7,1,6,2,5,4,0
477,Bostjan Cesar,12.0,16,10,9,7,0,7,17,41.2,10,14,8,6,14,30,60,2
478,Nacer Chadli,7.7,11,5,4,4,3,3,8,37.5,5,7,1,6,3,14,7,0
479,Fouad Chafik,20.5,44,31,29,12,3,23,36,63.9,13,17,3,14,25,69,71,0
480,Nathaniel Chalobah,3.0,3,2,1,2,0,2,7,28.6,5,2,1,1,5,8,7,0
481,Calum Chambers,28.8,64,36,32,27,5,16,48,33.3,32,37,12,25,69,133,113,4
483,Kwon Chang-hoon,10.4,7,4,3,2,2,0,12,0.0,12,16,0,16,8,15,8,0
484,Charles,19.3,7,5,1,3,3,2,13,15.4,11,14,1,13,4,11,14,0
485,Xavier Chavalerin,36.0,106,61,56,39,11,28,72,38.9,44,44,12,32,72,178,39,1
486,Pablo Chavarria,21.9,20,12,8,6,6,3,15,20.0,12,11,0,11,4,24,19,0
487,Chechu,1.0,0,0,0,0,0,0,2,0.0,2,0,0,0,2,2,5,0
488,Pape Cheikh Diop,5.0,1,0,0,1,0,0,5,0.0,5,6,2,4,2,3,2,1
489,Chema,13.9,27,19,16,9,2,13,19,68.4,6,19,11,8,19,46,83,0
490,Denis Cheryshev,19.0,46,32,15,22,9,17,37,45.9,20,35,3,32,15,61,16,0
491,Raman Chibsah,29.1,46,27,25,19,2,16,54,29.6,38,45,10,35,32,78,28,1
494,Giorgio Chiellini,22.1,24,13,20,2,2,5,8,62.5,3,22,15,7,30,54,96,1
495,Federico Chiesa,33.7,46,27,8,17,21,10,40,25.0,30,24,1,23,10,56,12,0
496,Ben Chilwell,36.0,55,29,34,18,3,24,55,43.6,31,37,7,30,38,93,156,0
497,Vlad Chiriches,1.6,2,1,1,1,0,0,2,0.0,2,2,2,0,1,3,2,0
499,Hamza Choudhury,6.6,24,10,13,10,1,9,15,60.0,6,12,3,9,15,39,13,0
500,Andreas Christensen,6.9,10,4,2,6,2,2,5,40.0,3,4,2,2,4,14,29,0
501,Cyrus Christie,21.6,43,23,26,13,4,18,41,43.9,23,25,11,14,29,72,96,1
502,Samuel Chukwueze,19.0,19,11,7,10,2,9,31,29.0,22,11,2,9,10,29,2,0
503,Camillo Ciano,27.3,33,15,12,10,11,8,50,16.0,42,28,4,24,8,41,16,0
505,Luca Cigarini,18.7,54,33,27,22,5,28,63,44.4,35,28,5,23,26,80,41,0
506,Per Ciljan Skjelbred,11.1,26,18,13,12,1,5,22,22.7,17,10,1,9,20,46,14,0
508,Laurent Ciman,8.0,11,6,9,2,0,7,16,43.8,9,13,9,4,7,18,37,0
509,Daniel Ciofani,18.0,8,6,2,5,1,3,7,42.9,4,4,0,4,3,11,9,0
510,Thiago Cionek,28.2,75,44,46,25,4,29,56,51.8,27,34,22,12,55,130,144,0
511,Ibrahima Cisse,1.0,0,0,0,0,0,0,1,0.0,1,0,0,0,3,3,4,0
513,Ciaran Clark,9.5,20,17,15,5,0,9,12,75.0,3,11,7,4,12,32,58,0
514,Tom Cleverley,5.3,17,9,11,4,2,6,22,27.3,16,4,0,4,5,22,11,0
515,Nathaniel Clyne,12.7,33,18,16,14,3,11,23,47.8,12,13,3,10,16,49,33,1
516,Nathaniel Clyne,1.2,4,3,2,2,0,2,4,50.0,2,1,0,1,2,6,1,0
517,Conor Coady,38.0,31,19,26,5,0,17,32,53.1,15,35,27,8,30,61,133,3
518,Marcus Coco,20.4,39,23,20,10,9,16,33,48.5,17,24,0,24,23,62,14,0
520,Coke,20.2,44,27,24,17,3,26,56,46.4,30,18,8,10,40,84,54,1
522,Seamus Coleman,28.4,44,25,23,18,3,19,30,63.3,11,14,5,9,26,70,86,0
523,Alex Collado,0.9,1,0,0,1,0,0,1,0.0,1,3,0,3,0,1,2,0
524,Omar Colley,19.6,18,11,12,6,0,12,13,92.3,1,24,16,8,22,40,102,0
525,Racine Coly,5.6,7,2,1,5,1,4,11,36.4,7,6,1,5,9,16,11,1
526,Kingsley Coman,15.3,11,6,4,4,3,6,19,31.6,13,20,0,20,5,16,3,0
527,Santi Comesana,22.6,56,35,29,25,2,22,61,36.1,39,30,5,25,30,86,45,2
528,Daniel Congre,36.6,75,45,46,26,3,38,65,58.5,27,35,15,20,67,142,106,1
529,Andrea Consigli,35.7,0,0,0,0,0,0,2,0.0,2,0,0,0,1,1,15,6
530,Andrea Conti,5.6,9,5,3,4,2,2,9,22.2,7,4,0,4,15,24,12,1
531,Lewis Cook,8.0,13,6,6,7,0,8,19,42.1,11,8,2,6,8,21,7,1
532,Steve Cook,31.0,36,19,31,5,0,20,27,74.1,7,36,21,15,50,86,202,1
533,Duje Cop,7.6,5,4,1,2,2,0,8,0.0,8,8,3,5,3,8,3,0
534,Francis Coquelin,19.6,46,31,25,14,7,17,35,48.6,18,21,5,16,49,95,29,1
536,Inigo Cordoba,14.7,37,23,15,17,5,14,47,29.8,33,27,0,27,17,54,13,0
537,Sergio Cordova,5.9,9,5,3,4,2,2,6,33.3,4,0,0,0,3,12,5,0
538,Benjamin Corgnet,7.5,21,12,7,9,5,4,11,36.4,7,1,0,1,6,27,9,0
540,Jack Cork,36.8,51,27,12,34,5,18,46,39.1,28,39,16,23,29,80,82,2
541,Andreas Cornelius,8.8,4,1,1,3,0,1,4,25.0,3,4,1,3,1,5,21,0
542,Maxwel Cornet,14.2,14,11,4,7,3,1,11,9.1,10,10,0,10,5,19,8,0
543,Quentin Cornette,2.3,5,1,2,2,1,3,6,50.0,3,3,0,3,1,6,5,0
544,Angel Correa,21.3,38,19,19,12,7,10,53,18.9,43,28,5,23,17,55,20,0
546,Joaquin Correa,21.4,21,13,6,12,3,5,18,27.8,13,14,3,11,2,23,7,0
547,Danny da Costa,33.7,61,35,29,25,7,18,42,42.9,24,51,9,42,32,93,67,0
548,Diego Costa,12.4,4,1,0,4,0,1,8,12.5,7,5,0,5,2,6,6,0
549,Douglas Costa,6.9,10,8,2,8,0,4,9,44.4,5,8,0,8,4,14,2,0
550,Filippo Costa,6.3,15,13,6,6,3,4,9,44.4,5,10,3,7,8,23,31,1
551,Helder Costa,14.9,18,14,7,7,4,7,23,30.4,16,15,0,15,9,27,6,0
552,Jaume Costa,16.6,33,21,26,5,2,20,33,60.6,13,12,3,9,21,54,61,0
553,Nuno da Costa,22.8,39,27,10,19,10,10,38,26.3,28,24,1,23,14,53,9,0
554,David Costas,13.0,25,13,21,4,0,10,15,66.7,5,12,6,6,18,43,58,1
555,Benoit Costil,37.0,2,0,2,0,0,2,2,100.0,0,0,0,0,0,2,14,3
556,Kalifa Coulibaly,19.5,15,7,1,10,4,4,11,36.4,7,8,1,7,4,19,22,0
557,Senou Coulibaly,4.6,13,7,10,3,0,3,8,37.5,5,8,2,6,11,24,20,0
558,Thibaut Courtois,27.0,0,0,0,0,0,0,2,0.0,2,0,0,0,2,2,5,0
559,Philippe Coutinho,22.4,16,11,1,6,9,7,22,31.8,15,21,2,19,12,28,8,0
560,Nicolas Cozza,10.9,19,15,14,5,0,4,10,40.0,6,13,10,3,23,42,37,1
561,Alessio Cragno,38.0,0,0,0,0,0,0,1,0.0,1,0,0,0,2,2,19,1
562,Aaron Cresswell,17.7,29,16,14,11,4,13,25,52.0,12,28,7,21,23,52,58,0
563,Domenico Criscito,34.1,111,75,64,36,11,57,83,68.7,26,40,11,29,70,181,142,0
564,Lorenzo Crisetig,5.6,14,11,4,8,2,6,15,40.0,9,8,3,5,12,26,12,0
565,Bryan Cristante,26.9,63,34,21,35,7,19,49,38.8,30,37,5,32,29,92,48,0
566,Sebastian Cristoforo,5.0,15,8,4,8,3,5,14,35.7,9,13,0,13,8,23,5,0
567,Enzo Crivelli,25.1,20,14,10,8,2,8,13,61.5,5,5,0,5,4,24,28,1
568,Peter Crouch,1.0,1,1,0,1,0,1,1,100.0,0,0,0,0,0,1,2,0
570,Juan Cuadrado,13.6,20,15,6,9,5,5,23,21.7,18,14,3,11,18,38,11,0
572,Cucho,23.9,22,13,6,10,6,6,18,33.3,12,23,2,21,9,31,21,0
573,Marc Cucurella,26.2,49,37,13,21,15,10,23,43.5,13,36,3,33,20,69,24,0
574,Ivan Cuellar,33.9,0,0,0,0,0,0,1,0.0,1,0,0,0,2,2,10,0
575,Mickael Cuisance,3.1,11,6,6,3,2,3,8,37.5,5,3,0,3,5,16,4,0
576,Matheus Cunha,9.5,10,6,3,5,2,3,13,23.1,10,13,1,12,4,14,8,0
577,Greg Cunningham,7.0,18,7,11,4,3,9,16,56.3,7,9,3,6,17,35,16,1
578,Patrick Cutrone,16.2,9,5,0,3,6,2,16,12.5,14,13,2,11,7,16,13,0
579,Wylan Cyprien,26.2,40,20,16,21,3,15,43,34.9,28,20,5,15,11,51,15,0
580,Marco D'Alessandro,16.6,55,34,34,15,6,29,49,59.2,20,24,2,22,9,64,50,1
581,Danilo D'Ambrosio,28.7,69,40,34,27,8,24,57,42.1,33,25,8,17,27,96,39,0
582,Damien Da Silva,31.9,41,25,31,9,1,18,24,75.0,6,42,36,6,39,80,152,0
583,Kouadio-Yves Dabila,8.7,11,6,10,1,0,5,6,83.3,1,13,9,4,6,17,44,0
585,Bryan Dabo,9.2,10,6,1,8,1,1,6,16.7,5,11,6,5,10,20,21,0
587,Colin Dagba,10.2,24,12,10,12,2,13,19,68.4,6,10,0,10,9,33,10,1
588,Mahmoud Dahoud,7.7,16,10,4,10,2,3,15,20.0,12,10,0,10,17,33,8,0
590,Felipe dal Belo,26.2,36,25,21,13,2,16,32,50.0,16,29,18,11,17,53,88,1
592,Diogo Dalot,11.3,24,12,8,14,2,14,19,73.7,5,15,2,13,10,34,35,1
594,Vitalie Damascan,0.0,1,1,0,1,0,1,1,100.0,0,0,0,0,0,1,0,0
595,Loic Damour,0.3,0,0,0,0,0,0,1,0.0,1,0,0,0,0,0,0,0
596,Charlie Daniels,17.6,25,15,18,6,1,13,22,59.1,9,14,4,10,20,45,56,2
598,Danilo,9.0,20,16,6,12,2,12,17,70.6,5,5,0,5,15,35,22,1
599,Scott Dann,7.4,6,2,5,1,0,3,7,42.9,4,16,12,4,5,11,46,0
600,Kevin Danso,13.9,25,14,21,3,1,11,14,78.6,3,25,17,8,19,44,72,0
601,Dante,35.8,54,40,36,16,2,24,41,58.5,17,56,30,26,38,92,156,2
603,Sergi Darder,30.1,60,35,23,32,5,25,69,36.2,44,18,3,15,22,82,30,0
604,Vladimir Darida,4.2,8,5,3,4,1,2,3,66.7,1,5,0,5,8,16,5,0
605,Matteo Darmian,4.9,14,8,10,4,0,4,11,36.4,7,9,0,9,7,21,20,0
607,Ben Davies,20.5,56,30,39,13,4,38,54,70.4,16,23,10,13,23,79,68,1
608,Tom Davies,10.9,27,17,9,17,1,7,23,30.4,16,15,1,14,16,43,9,1
610,Kevin De Bruyne,10.8,22,15,6,12,4,7,21,33.3,14,13,1,12,3,25,2,1
611,Sebastien De Maio,13.0,11,7,7,4,0,3,12,25.0,9,22,17,5,12,23,93,0
612,Sebastien De Maio,5.5,5,4,3,2,0,1,2,50.0,1,8,5,3,1,6,32,0
613,Rodrigo De Paul,35.4,53,33,21,27,5,13,42,31.0,29,35,2,33,32,85,28,0
614,Daniele De Rossi,14.1,16,10,6,7,3,3,14,21.4,11,18,12,6,26,42,33,0
615,Mattia De Sciglio,19.4,40,28,24,14,2,17,28,60.7,11,18,6,12,26,66,58,1
616,Lorenzo De Silvestri,26.8,15,11,8,5,2,7,24,29.2,17,53,3,50,22,37,69,2
617,Lucas Deaux,13.2,41,28,21,18,2,20,41,48.8,21,10,0,10,11,52,7,0
618,Mathieu Debuchy,21.6,43,26,25,13,5,22,37,59.5,15,17,7,10,47,90,64,0
619,Troy Deeney,28.3,24,14,8,10,6,7,32,21.9,25,22,4,18,7,31,29,0
621,Steven Defour,5.0,8,4,2,4,2,3,14,21.4,11,11,3,8,8,16,7,0
622,Gregoire Defrel,26.0,40,29,10,16,14,9,21,42.9,12,15,0,15,3,43,9,0
624,Alessandro Deiola,5.0,7,3,1,6,0,3,13,23.1,10,14,0,14,6,13,8,0
625,Alessandro Deiola,6.1,12,8,4,7,1,4,10,40.0,6,15,4,11,11,23,10,0
626,Romain Del Castillo,14.9,36,20,15,13,8,13,37,35.1,24,19,0,19,20,56,7,1
627,Thomas Delaney,25.4,69,54,28,39,2,19,30,63.3,11,30,9,21,58,127,43,0
628,Moises Delgado,3.0,7,6,3,3,1,2,3,66.7,1,2,1,1,3,10,9,0
629,Cristian Dell'Orco,11.5,18,11,11,5,2,4,11,36.4,7,13,7,6,17,35,44,0
630,Cristian Dell'Orco,1.2,1,1,1,0,0,1,3,33.3,2,1,0,1,1,2,3,0
631,Andy Delort,34.6,34,20,7,20,7,8,34,23.5,26,28,7,21,4,38,7,0
632,Fabian Delph,8.1,23,14,11,7,5,12,23,52.2,11,3,0,3,13,36,19,1
633,Mousa Dembele,5.7,13,9,6,6,1,4,7,57.1,3,4,1,3,7,20,5,2
634,Moussa Dembele,22.4,12,4,0,8,4,4,14,28.6,10,15,2,13,2,14,13,0
635,Ousmane Dembele,18.5,23,15,4,13,6,6,18,33.3,12,13,0,13,5,28,4,0
636,Jessy Deminguet,14.1,37,25,18,17,2,15,40,37.5,25,19,3,16,18,55,28,1
637,Merih Demiral,14.0,24,16,23,1,0,10,13,76.9,3,16,11,5,19,43,80,0
638,Kerem Demirbay,22.4,57,35,20,27,10,11,51,21.6,40,34,10,24,22,79,25,0
639,Diego Demme,22.8,75,47,24,43,8,33,67,49.3,34,36,3,33,26,101,15,0
640,Jason Denayer,30.6,33,21,22,11,0,16,24,66.7,8,36,32,4,26,59,122,1
641,Leander Dendoncker,16.3,53,26,25,25,3,16,47,34.0,31,35,6,29,23,76,34,1
642,Fabio Depaoli,27.4,74,43,37,32,5,34,67,50.7,33,42,16,26,35,109,99,3
643,Laurent Depoitre,11.9,6,4,2,3,1,0,3,0.0,3,9,0,9,2,8,8,0
644,Clement Depres,4.9,2,2,1,1,0,1,4,25.0,3,3,0,3,0,2,6,0
645,Kiril Despodov,1.2,0,0,0,0,0,0,1,0.0,1,1,0,1,0,0,0,0
646,Daniele Dessena,3.9,2,2,0,2,0,1,3,33.3,2,3,1,2,3,5,5,0
648,Gerard Deulofeu,23.0,11,6,5,3,3,4,26,15.4,22,16,0,16,14,25,3,0
650,Jacopo Dezi,1.0,1,1,1,0,0,0,1,0.0,1,1,0,1,3,4,2,0
651,Federico Di Francesco,11.9,10,6,3,4,3,4,7,57.1,3,12,1,11,5,15,5,0
652,Antonio Di Gaudio,7.8,2,0,0,1,1,1,5,20.0,4,6,1,5,3,5,5,0
653,Giovanni Di Lorenzo,37.0,66,43,38,23,5,24,44,54.5,20,34,13,21,36,102,93,3
654,Angel Di Maria,25.8,29,17,12,10,7,10,42,23.8,32,24,1,23,16,45,4,0
655,Franco Di Santo,1.9,2,2,1,0,1,1,2,50.0,1,0,0,0,0,2,2,0
656,Franco Di Santo,2.7,2,1,0,2,0,1,4,25.0,3,3,1,2,1,3,3,0
657,Boulaye Dia,8.3,12,6,3,8,1,5,11,45.5,6,4,2,2,4,16,9,0
658,Fousseni Diabate,0.6,2,0,2,0,0,0,1,0.0,1,2,0,2,0,2,0,0
659,Moussa Diaby,12.7,14,8,7,2,5,2,11,18.2,9,7,1,6,12,26,6,0
660,Adama Diakhaby,6.1,6,3,4,1,1,3,11,27.3,8,7,0,7,1,7,2,0
661,Mouctar Diakhaby,17.6,14,8,10,4,0,5,10,50.0,5,24,16,8,20,34,94,1
662,Bafode Diakite,7.0,15,7,5,9,1,10,14,71.4,4,15,3,12,11,26,29,0
663,Abdou Diallo,26.4,36,20,20,13,3,11,15,73.3,4,28,15,13,26,62,91,1
664,Abdoulaye Diallo,5.5,1,1,1,0,0,1,1,100.0,0,0,0,0,0,1,1,0
665,Mustapha Diallo,5.1,16,11,6,9,1,5,13,38.5,8,7,1,6,10,26,14,1
666,Mohamed Diame,24.1,76,46,35,36,5,16,54,29.6,38,42,9,33,30,106,39,1
667,Grady Diangana,6.8,20,9,8,8,4,5,14,35.7,9,11,0,11,1,21,4,0
668,Lassana Diarra,1.8,2,1,0,2,0,0,1,0.0,1,0,0,0,2,4,3,0
669,Amadou Diawara,7.3,12,4,1,9,2,4,5,80.0,1,6,0,6,11,23,12,0
670,Brahim Diaz,4.2,9,7,5,4,0,3,8,37.5,5,2,0,2,0,9,0,0
672,Bakaye Dibassy,32.7,38,26,18,16,4,18,27,66.7,9,40,21,19,44,82,102,0
673,Lorenzo Dickmann,1.9,5,4,4,1,0,5,7,71.4,2,0,0,0,1,6,5,0
674,Daniel Didavi,10.6,21,15,8,10,3,7,20,35.0,13,11,1,10,4,25,5,0
676,Etienne Didot,23.4,41,29,12,27,2,17,44,38.6,27,37,10,27,37,78,35,0
677,Adrian Dieguez,8.3,16,10,11,4,1,9,16,56.3,7,9,4,5,12,28,46,1
678,Eric Dier,16.7,26,16,7,15,4,19,47,40.4,28,27,12,15,21,47,46,1
680,Lucas Digne,32.9,71,46,45,18,8,28,45,62.2,17,43,9,34,60,131,116,0
681,Mitchell Dijks,22.5,30,18,19,7,4,13,36,36.1,23,18,1,17,23,53,49,0
682,Javairo Dilrosun,10.0,14,10,7,5,2,3,7,42.9,4,18,2,16,7,21,9,0
683,Federico Dimarco,9.9,22,7,10,8,4,10,20,50.0,10,13,6,7,15,37,27,0
684,Stole Dimitrievski,21.0,0,0,0,0,0,0,1,0.0,1,0,0,0,0,0,8,1
685,Tristan Dingome,14.9,27,15,11,10,6,7,24,29.2,17,16,3,13,11,38,5,0
686,Ismael Diomande,14.4,28,15,15,12,1,11,20,55.0,9,17,7,10,10,38,37,0
687,Federico Dionisi,2.3,3,1,0,2,1,0,2,0.0,2,0,0,0,0,3,0,0
688,Lois Diony,17.7,17,12,3,9,5,4,10,40.0,6,14,0,14,1,18,9,0
689,Issa Diop,33.0,68,38,47,21,0,37,57,64.9,20,58,36,22,64,132,161,4
690,Papakouli Diop,26.1,66,40,14,44,8,14,34,41.2,20,21,1,20,37,103,27,0
691,Sofiane Diop,8.2,12,7,3,6,3,1,15,6.7,14,6,0,6,8,20,6,0
692,Assane Diousse,9.9,24,16,11,8,5,10,23,43.5,13,14,4,10,19,43,13,2
693,Assane Diousse,2.4,6,4,3,3,0,2,4,50.0,2,2,0,2,1,7,7,1
694,Axel Disasi,1.8,2,1,1,1,0,1,2,50.0,1,2,1,1,2,4,16,0
695,Djene,33.1,54,34,43,11,0,26,43,60.5,17,27,11,16,74,128,154,3
696,Koffi Djidji,15.4,37,23,27,9,1,12,20,60.0,8,26,19,7,24,61,72,1
698,Alexander Djiku,30.6,48,37,33,13,2,23,43,53.5,20,56,31,25,83,131,183,3
700,Berat Djimsiti,20.1,32,22,18,12,2,13,29,44.8,16,21,11,10,34,66,96,0
702,Johan Djourou,3.1,3,1,3,0,0,2,2,100.0,0,5,3,2,4,7,20,0
704,Matt Doherty,34.9,67,42,48,15,4,35,58,60.3,23,49,7,42,60,127,107,2
705,Keagan Dolly,1.0,1,1,0,1,0,0,3,0.0,3,0,0,0,0,1,0,0
706,Jaume Domenech,4.0,0,0,0,0,0,0,1,0.0,1,0,0,0,0,0,1,0
707,Giulio Donati,6.9,9,7,6,3,0,8,10,80.0,2,5,3,2,16,25,24,0
708,Ji Dong-won,9.9,10,6,5,3,2,6,16,37.5,10,13,2,11,8,18,10,0
709,Anastasios Donis,10.7,15,13,8,4,3,3,11,27.3,8,7,0,7,4,19,0,0
710,Gianluigi Donnarumma,34.3,1,1,1,0,0,1,2,50.0,1,0,0,0,1,2,13,3
711,Godfred Donsah,1.7,3,1,3,0,0,3,5,60.0,2,4,2,2,0,3,7,0
713,Gabriel Dos Santos,11.8,18,11,13,4,1,4,7,57.1,3,14,6,8,19,37,60,2
714,Mathieu Dossevi,27.4,42,28,20,11,11,13,40,32.5,27,29,1,28,33,75,13,0
715,Abdoulaye Doucoure,34.0,71,38,27,32,12,19,57,33.3,38,31,8,23,34,105,55,5
716,Cheick Doukoure,3.5,13,7,3,7,3,4,15,26.7,11,10,2,8,3,16,3,1
717,Moussa Doumbia,17.8,28,13,13,13,2,11,39,28.2,28,7,2,5,7,35,13,0
718,Seydou Doumbia,6.0,5,1,1,2,2,0,2,0.0,2,2,0,2,3,8,1,0
719,Souleyman Doumbia,6.7,11,7,9,2,0,6,10,60.0,4,6,1,5,4,15,20,0
720,Aleksandar Dragovic,14.8,18,12,14,4,0,9,14,64.3,5,15,8,7,25,43,66,0
722,Bartlomiej Dragowski,14.0,0,0,0,0,0,0,1,0.0,1,0,0,0,0,0,7,1
723,Julian Draxler,22.7,41,22,11,19,11,16,43,37.2,27,20,1,19,15,56,2,1
725,Josip Drmic,2.5,2,0,0,2,0,1,2,50.0,1,1,0,1,1,3,0,0
728,Oscar Duarte,7.3,12,5,7,5,0,4,7,57.1,3,7,7,0,13,25,34,0
729,Ruben Duarte,30.8,72,35,45,20,7,34,64,53.1,30,46,12,34,57,129,130,1
730,Leo Dubois,22.7,51,22,25,21,5,20,35,57.1,15,30,10,20,22,73,61,1
731,Martin Dubravka,38.0,2,0,2,0,0,1,3,33.3,2,0,0,0,0,2,20,5
732,Marvin Ducksch,9.1,3,1,0,2,1,1,5,20.0,4,4,0,4,4,7,11,0
733,Ondrej Duda,28.5,54,33,13,35,6,15,55,27.3,40,36,4,32,15,69,17,1
734,Shane Duffy,34.3,35,20,23,7,5,14,25,56.0,11,57,47,10,36,71,244,3
735,Demeaco Duhaney,0.5,1,0,1,0,0,1,3,33.3,2,2,0,2,1,2,1,0
736,Paul Dummett,22.1,34,22,24,9,1,19,32,59.4,13,25,11,14,37,71,133,0
737,Alfred Duncan,20.5,33,21,15,15,3,19,48,39.6,29,20,6,14,15,48,18,0
738,Lewis Dunk,35.0,42,26,31,10,1,17,39,43.6,22,49,38,11,46,88,196,5
740,Erik Durm,22.8,35,22,24,8,3,14,33,42.4,19,26,6,20,41,76,42,0
741,Jimmy Durmaz,21.1,34,22,8,13,13,15,38,39.5,23,14,2,12,11,45,16,1
742,Riza Durmisi,3.6,4,4,2,0,2,2,3,66.7,1,0,0,0,1,5,9,0
743,Hugo Duro,4.6,6,4,1,2,3,3,6,50.0,3,6,1,5,3,9,4,0
745,Paulo Dybala,23.7,17,8,3,9,5,7,23,30.4,16,20,2,18,14,31,1,0
746,Edin Dzeko,28.7,13,7,3,5,5,4,16,25.0,12,10,1,9,0,13,36,1
747,Blerim Dzemaili,19.4,44,27,22,19,3,19,58,32.8,39,22,1,21,17,61,12,1
748,Felix Eboa Eboa,27.0,47,33,26,20,1,16,22,72.7,6,37,24,13,39,86,136,2
749,Dennis Eckert,2.4,3,2,0,1,2,0,2,0.0,2,1,0,1,2,5,3,0
750,Bruno Ecuele Manga,37.5,69,36,48,16,5,29,58,50.0,29,62,28,34,81,150,179,4
751,Simone Edera,0.9,0,0,0,0,0,0,1,0.0,1,1,0,1,1,1,0,0
752,Simone Edera,2.2,4,4,3,0,1,1,3,33.3,2,5,1,4,0,4,1,0
754,Ederson,38.0,3,3,2,1,0,3,3,100.0,0,0,0,0,1,4,12,2
755,Johannes Eggestein,12.4,13,9,7,4,2,5,19,26.3,14,13,0,13,4,17,7,0
756,Maximilian Eggestein,33.9,68,42,29,34,5,24,54,44.4,30,49,10,39,30,98,69,0
757,Albin Ekdal,29.4,61,39,16,38,7,37,68,54.4,31,42,12,30,53,114,62,1
758,Josip Elez,7.2,8,3,5,3,0,2,11,18.2,9,13,4,9,6,14,27,0
760,Mohamed Elneny,4.2,13,4,9,1,3,1,2,50.0,1,7,4,3,2,15,8,0
761,Aritz Elustondo,25.0,47,29,31,14,2,26,41,63.4,15,23,7,16,39,86,150,0
762,Gorka Elustondo,3.2,7,5,4,3,0,5,8,62.5,3,6,1,5,6,13,10,0
763,Nico Elvedi,29.1,41,19,34,7,0,23,33,69.7,10,30,13,17,47,88,135,6
764,Rodrigo Ely,4.8,8,5,5,3,0,5,7,71.4,2,9,7,2,7,15,30,0
765,Mohamed Elyounoussi,8.8,16,12,7,6,3,6,19,31.6,13,11,1,10,6,22,5,0
766,Adri Embarba,25.4,54,26,20,24,10,22,61,36.1,39,38,2,36,29,83,22,0
767,Breel Embolo,14.9,22,17,4,13,5,1,9,11.1,8,11,0,11,4,26,6,0
768,Emerson,3.5,9,7,6,1,2,3,10,30.0,7,6,0,6,7,16,12,0
769,Youssef En-Nesyri,23.4,16,8,6,5,5,4,24,16.7,20,18,3,15,6,22,23,0
770,Bjorn Engels,33.0,11,8,6,5,0,6,16,37.5,10,30,24,6,44,55,181,3
771,Sergi Enrich,28.7,27,17,3,11,13,7,30,23.3,23,11,1,10,6,33,14,0
772,Javier Eraso,7.0,6,3,3,2,1,0,6,0.0,6,3,1,2,7,13,4,0
773,Christian Eriksen,30.8,41,25,8,20,13,17,59,28.8,42,26,3,23,15,56,13,0
774,Patrick Erras,13.6,15,10,7,7,1,7,19,36.8,12,24,13,11,23,38,45,0
775,Gonzalo Escalante,19.9,49,28,11,35,3,19,46,41.3,27,37,2,35,21,70,21,0
776,Sergio Escudero,17.2,43,29,20,18,5,18,35,51.4,17,22,4,18,24,67,52,0
777,Bernardo Espinosa,30.3,20,14,16,4,0,8,17,47.1,9,46,31,15,40,60,197,5
778,Michael Esser,32.0,3,2,3,0,0,2,5,40.0,3,1,0,1,1,4,15,0
780,Alexander Esswein,13.9,17,11,6,4,7,6,21,28.6,15,17,0,17,12,29,16,0
781,Neil Etheridge,38.0,1,1,1,0,0,1,2,50.0,1,0,0,0,7,8,19,1
782,Benat Etxebarria,22.6,47,24,14,25,8,19,59,32.2,40,18,1,17,24,71,11,0
783,Xabier Etxeita,29.7,47,23,32,12,3,26,47,55.3,21,38,25,13,39,86,163,3
784,Lucas Evangelista,8.0,30,17,11,12,7,14,25,56.0,11,10,0,10,9,39,6,0
785,Jonny Evans,22.2,24,13,20,4,0,13,18,72.2,5,28,10,18,33,57,152,3
786,Ewerton,14.9,24,20,21,3,0,8,14,57.1,6,23,16,7,25,49,108,1
787,Valentin Eysseric,4.0,6,5,3,2,1,2,4,50.0,2,6,1,5,4,10,1,0
788,Valentin Eysseric,2.3,1,1,0,1,0,0,2,0.0,2,2,0,2,0,1,0,0
789,Marco Fabian,0.7,3,2,2,1,0,1,1,100.0,0,0,0,0,3,6,0,0
790,Lukasz Fabianski,38.0,1,0,1,0,0,1,3,33.3,2,0,0,0,1,2,10,1
791,Fabinho,22.4,59,31,17,38,4,24,59,40.7,35,34,6,28,28,87,27,2
792,Fabio,14.2,53,34,25,27,1,26,53,49.1,27,18,4,14,18,71,27,0
793,Cesc Fabregas,2.0,6,4,4,2,0,1,5,20.0,4,2,1,1,1,7,0,0
794,Cesc Fabregas,10.7,14,10,5,5,4,8,28,28.6,20,12,3,9,9,23,5,1
797,Romain Faivre,1.0,1,0,0,1,0,0,1,0.0,1,0,0,0,1,2,1,1
798,Faycal Fajr,36.0,65,32,22,33,10,25,66,37.9,41,27,6,21,29,94,19,2
799,Radamel Falcao,28.4,34,15,6,16,12,8,27,29.6,19,11,6,5,3,37,23,2
800,Diego Falcinelli,7.8,8,5,1,3,4,2,3,66.7,1,4,1,3,1,9,5,0
801,Simon Falette,6.7,9,6,7,1,1,2,6,33.3,4,11,5,6,14,23,32,0
802,Iago Falque,17.9,13,8,3,8,2,3,16,18.8,13,14,0,14,3,16,2,0
803,Paolo Farago,18.9,46,29,20,16,10,13,43,30.2,30,28,2,26,15,61,38,0
804,Mohamed Fares,32.8,63,43,37,18,8,25,54,46.3,29,48,4,44,54,117,83,2
806,Diego Farias,13.3,11,4,2,8,1,3,10,30.0,7,7,1,6,0,11,4,0
807,Diego Farias,7.8,13,9,3,7,3,2,11,18.2,9,7,1,6,1,14,5,0
808,Andrea Favilli,1.9,1,1,0,0,1,0,1,0.0,1,1,0,1,0,1,1,0
809,Federico Fazio,31.2,28,20,14,11,3,12,25,48.0,13,45,33,12,53,81,171,2
810,Zouhair Feddal,18.9,38,23,31,6,1,16,28,57.1,12,19,8,11,31,69,94,2
811,Nabil Fekir,22.1,51,31,16,19,16,13,38,34.2,25,42,0,42,7,58,3,0
812,Yassin Fekir,0.1,0,0,0,0,0,0,1,0.0,1,0,0,0,0,0,0,0
813,Felipe,12.2,23,15,21,2,0,9,17,52.9,8,17,9,8,35,58,71,0
814,Luiz Felipe,14.3,27,18,20,7,0,13,20,65.0,7,27,15,12,26,53,57,1
815,Ohis Felix Uduokhai,2.7,13,7,7,5,1,9,10,90.0,1,6,2,4,6,19,11,1
816,Marouane Fellaini,8.4,21,13,11,9,1,9,17,52.9,8,9,5,4,4,25,34,1
817,Kiko Femenia,22.8,48,30,34,12,2,24,51,47.1,27,24,6,18,36,84,68,0
818,Edimilson Fernandes,21.9,36,24,17,16,3,14,36,38.9,22,31,6,25,26,62,31,0
819,Gelson Fernandes,24.7,74,48,33,38,3,23,65,35.4,42,45,9,36,53,127,16,0
820,Aitor Fernandez,16.0,1,0,1,0,0,1,1,100.0,0,0,0,0,1,2,10,1
821,Andres Fernandez,6.0,1,0,1,0,0,1,1,100.0,0,0,0,0,0,1,4,1
822,Borja Fernandez,9.3,17,12,7,9,1,6,16,37.5,10,14,2,12,14,31,25,0
823,Federico Fernandez,16.5,16,12,12,4,0,10,18,55.6,8,19,12,7,25,41,106,1
824,Joaquin Fernandez,9.3,16,9,14,1,1,8,16,50.0,8,9,7,2,17,33,45,0
825,Valery Fernandez,9.9,20,15,13,6,1,10,17,58.8,7,15,1,14,8,28,10,0
826,Fernandinho,26.4,57,43,19,30,8,26,47,55.3,21,28,4,24,41,98,70,0
827,Juan Ferney Otero,24.2,29,13,11,12,6,13,46,28.3,33,23,3,20,22,51,18,0
828,Alex Ferrari,6.0,10,8,4,6,0,5,7,71.4,2,7,4,3,9,19,26,0
829,David Ferreiro,25.3,36,22,13,19,4,11,64,17.2,53,27,1,26,24,60,14,2
830,Facundo Ferreyra,2.3,5,2,0,4,1,1,3,33.3,2,3,0,3,0,5,5,0
832,Jordan Ferri,20.8,52,31,22,23,7,26,62,41.9,36,27,2,25,15,67,9,1
833,Jordan Ferri,1.3,5,3,3,1,1,1,4,25.0,3,4,2,2,1,6,3,0
834,Oliver Fink,11.7,38,22,17,17,4,12,38,31.6,26,20,3,17,13,51,19,0
835,Alfred Finnbogason,14.8,7,3,2,5,0,1,9,11.1,8,6,1,5,3,10,11,0
836,Roberto Firmino,29.0,30,20,5,16,9,7,34,20.6,27,35,1,34,6,36,16,0
837,Junior Firpo,21.5,38,25,16,14,8,10,24,41.7,14,27,2,25,23,61,48,0
838,Mathieu Flamini,5.0,9,4,4,4,1,4,7,57.1,3,3,1,2,5,14,4,0
840,Sergio Floccari,10.8,13,5,1,5,7,1,7,14.3,6,6,2,4,2,15,6,0
841,Alessandro Florenzi,24.2,38,21,22,11,5,17,37,45.9,20,27,5,22,46,84,58,0
842,Phil Foden,3.7,7,6,1,3,3,2,9,22.2,7,1,0,1,4,11,1,0
843,Guessouma Fofana,2.1,6,4,3,3,0,1,3,33.3,2,2,1,1,3,9,0,0
844,Guessouma Fofana,5.3,14,9,2,10,2,4,10,40.0,6,3,0,3,6,20,8,0
845,Seko Fofana,29.3,25,13,14,10,1,6,36,16.7,30,20,7,13,29,54,18,3
846,Wesley Fofana,1.8,7,6,5,2,0,6,13,46.2,7,1,0,1,4,11,9,0
847,Youssouf Fofana,10.1,28,20,5,20,3,9,27,33.3,18,7,0,7,11,39,8,0
848,Thomas Foket,32.0,91,52,55,23,13,42,69,60.9,27,30,4,26,49,140,80,1
849,Thomas Fontaine,4.7,6,3,5,0,1,2,5,40.0,3,6,2,4,7,13,28,1
850,Jose Fonte,34.6,27,15,15,9,3,17,24,70.8,7,33,26,7,37,64,153,1
851,Rui Fonte,7.0,25,12,4,16,5,6,11,54.5,5,4,0,4,2,27,8,0
852,Pablo Fornals,27.5,49,26,14,26,9,15,54,27.8,39,32,4,28,24,73,19,0
853,Emil Forsberg,13.9,12,7,0,12,0,5,16,31.3,11,16,1,15,3,15,6,0
856,Iver Fossum,5.1,9,5,1,7,1,4,8,50.0,4,8,2,6,7,16,10,0
858,Ben Foster,38.0,2,2,2,0,0,2,6,33.3,4,0,0,0,2,4,34,3
859,Timothy Fosu-Mensah,8.8,18,7,12,6,0,8,13,61.5,5,11,5,6,12,30,30,1
860,Dimitri Foulquier,20.0,29,12,10,14,5,11,22,50.0,11,23,2,21,20,49,38,0
861,Juan Foyth,9.9,31,17,20,11,0,14,19,73.7,5,12,5,7,10,41,50,1
862,Raphael Framberger,6.1,8,6,4,4,0,0,3,0.0,3,10,3,7,11,19,15,1
863,Simon Francis,13.7,25,14,19,5,1,12,24,50.0,12,15,7,8,19,44,73,1
864,Mike Frantz,24.6,34,26,15,15,4,6,20,30.0,14,24,4,20,21,55,32,0
865,Ryan Fraser,35.2,19,11,9,8,2,10,32,31.3,22,23,6,17,22,41,33,0
867,Fred,11.6,29,17,12,16,1,15,33,45.5,18,26,2,24,16,45,14,2
868,Ryan Fredericks,12.1,38,23,33,5,0,21,32,65.6,11,15,5,10,13,51,49,1
869,Remo Freuler,33.6,84,45,34,34,16,30,70,42.9,40,62,12,50,38,122,45,0
870,Nicolas Frey,2.5,3,1,2,1,0,0,3,0.0,3,3,3,0,7,10,18,0
871,Marco Friedl,5.3,8,6,4,3,1,3,11,27.3,8,9,6,3,13,21,21,0
872,Alexander Fuchs,7.3,14,12,5,7,2,5,15,33.3,10,9,1,8,5,19,10,0
873,Christian Fuchs,2.3,4,3,0,4,0,1,2,50.0,1,0,0,0,4,8,8,0
874,Javi Fuego,2.6,6,3,5,1,0,4,8,50.0,4,2,0,2,3,9,9,0
875,Angelo Fulgini,18.2,38,22,18,13,7,12,31,38.7,19,21,3,18,28,66,15,0
876,Niclas Fullkrug,12.4,3,0,0,1,2,1,5,20.0,4,10,4,6,1,4,17,0
877,Ramiro Funes Mori,29.2,41,29,30,9,2,19,44,43.2,25,36,24,12,42,83,149,2
878,Manolo Gabbiadini,5.3,6,2,1,4,1,1,2,50.0,1,5,0,5,3,9,6,0
879,Manolo Gabbiadini,9.0,5,2,1,3,1,3,11,27.3,8,6,1,5,4,9,4,0
880,Mijat Gacinovic,18.1,31,20,7,13,11,11,42,26.2,31,26,1,25,24,55,10,0
882,Roberto Gagliardini,12.1,23,14,13,8,2,10,27,37.0,17,21,3,18,16,39,19,0
884,Riccardo Gagliolo,33.8,69,45,52,15,2,33,68,48.5,35,60,33,27,66,135,213,2
885,Milan Gajic,1.0,2,1,1,0,1,1,1,100.0,0,0,0,0,1,3,7,0
886,Javi Galan,16.0,61,39,36,23,2,34,59,57.6,25,22,1,21,19,80,52,1
888,Alex Gallar,11.2,15,9,6,5,4,8,19,42.1,11,9,1,8,9,24,5,0
889,Enric Gallego,17.1,21,15,3,13,5,3,19,15.8,16,17,2,15,8,29,32,0
890,Alex Galvez,15.7,38,28,25,13,0,14,28,50.0,14,7,2,5,45,83,69,1
891,Kevin Gameiro,17.9,14,9,4,6,4,1,6,16.7,5,12,2,10,5,19,3,0
892,Idrissa Gana Gueye,31.4,142,89,70,63,9,38,76,50.0,38,52,8,44,74,216,48,1
893,Ignatius Ganago,11.5,3,1,0,2,1,0,7,0.0,7,2,0,2,1,4,7,0
894,Cristian Ganea,0.5,0,0,0,0,0,0,3,0.0,3,1,0,1,1,1,2,0
895,Ganso,5.8,12,8,2,8,2,2,15,13.3,13,5,1,4,6,18,0,0
896,Ezequiel Garay,23.7,20,17,15,3,2,9,18,50.0,9,30,23,7,16,36,140,0
898,Alberto Garcia,17.0,1,1,1,0,0,1,3,33.3,2,1,0,1,2,3,1,2
899,Aleix Garcia,18.5,37,19,17,20,0,13,36,36.1,23,21,6,15,21,58,18,0
900,Alvaro Garcia,19.6,22,19,11,7,4,4,25,16.0,21,24,0,24,19,41,30,0
901,Borja Garcia,29.2,39,27,17,15,7,22,44,50.0,22,23,2,21,38,77,17,0
902,Dani Garcia,27.5,56,34,21,32,3,24,63,38.1,39,28,8,20,49,105,46,1
903,Javi Garcia,5.8,3,1,3,0,0,2,3,66.7,1,5,1,4,5,8,27,0
904,Manu Garcia,25.9,83,48,29,40,14,24,77,31.2,53,42,7,35,23,106,67,0
905,Manu Garcia,20.5,37,26,14,17,6,15,49,30.6,34,16,1,15,15,52,5,0
906,Raul Garcia,26.3,61,41,13,37,11,22,68,32.4,46,56,1,55,21,82,39,0
907,Raul Garcia,4.2,8,6,4,4,0,6,8,75.0,2,5,2,3,6,14,28,1
908,Raul Garcia,9.4,21,12,11,7,3,11,16,68.8,5,14,4,10,11,32,35,1
910,Sergio Garcia,16.5,18,10,4,11,3,3,16,18.8,13,6,1,5,10,28,4,0
912,Mario Gaspar,28.9,62,43,39,17,6,29,49,59.2,20,48,11,37,42,104,91,0
914,Marcello Gazzola,10.2,9,4,2,5,2,5,9,55.6,4,6,3,3,4,13,33,0
915,Jean-Philippe Gbamin,29.7,51,31,29,15,7,23,51,45.1,28,39,5,34,30,81,32,1
916,David de Gea,38.0,0,0,0,0,0,0,2,0.0,2,1,0,1,0,0,11,4
917,Theodor Gebre Selassie,31.3,53,38,27,16,10,22,51,43.1,29,33,8,25,69,122,100,0
918,Dennis Geiger,2.7,2,1,1,1,0,1,6,16.7,5,1,0,1,3,5,1,0
919,Jeremy Gelin,14.2,30,16,18,10,2,18,34,52.9,16,14,6,8,19,49,29,0
920,Romain Genevois,4.0,10,6,9,1,0,6,11,54.5,5,3,0,3,8,18,13,0
921,Christian Gentner,22.4,61,38,29,26,6,16,50,32.0,34,30,3,27,31,92,41,1
922,Yannick Gerhardt,27.3,52,34,22,20,10,16,43,37.2,27,35,7,28,30,82,34,0
923,Valere Germain,24.1,38,25,8,22,8,8,33,24.2,25,20,5,15,6,44,30,0
924,Gerson,27.0,42,26,22,15,5,12,38,31.6,26,46,9,37,16,58,32,0
925,Gervinho,25.6,19,12,11,5,3,5,13,38.5,8,7,0,7,10,29,2,0
927,Lamine Ghezali,0.5,1,1,0,1,0,1,2,50.0,1,0,0,0,0,1,2,0
928,Rachid Ghezzal,8.3,14,5,3,7,4,3,18,16.7,15,10,1,9,7,21,4,1
929,Paolo Ghiglione,5.7,8,4,6,1,1,6,14,42.9,8,2,0,2,4,12,22,0
930,Saman Ghoddos,20.3,33,17,14,15,4,13,32,40.6,19,15,2,13,7,40,13,0
931,Faouzi Ghoulam,12.8,9,7,3,5,1,8,9,88.9,1,6,2,4,8,17,17,0
932,Emanuele Giaccherini,22.3,14,8,5,7,2,6,31,19.4,25,21,2,19,16,30,10,2
933,Morgan Gibbs-White,7.4,6,3,2,4,0,1,4,25.0,3,6,0,6,1,7,0,0
936,Fabian Giefer,4.0,0,0,0,0,0,0,2,0.0,2,0,0,0,0,0,1,2
937,Niko Giesselmann,28.8,57,37,38,14,5,26,59,44.1,33,25,6,19,36,93,85,1
938,Bryan Gil,1.9,6,4,4,1,1,1,5,20.0,4,0,0,0,1,7,0,0
939,Daniel Ginczek,14.2,9,7,4,3,2,5,19,26.3,14,12,2,10,3,12,23,1
940,Matthias Ginter,26.4,24,14,16,7,1,9,17,52.9,8,31,19,12,17,41,98,1
941,Andrei Girotto,16.4,57,40,18,36,3,20,44,45.5,24,22,6,16,29,86,43,1
942,Olivier Giroud,9.4,3,2,0,1,2,1,4,25.0,3,6,1,5,3,6,7,0
943,Kamil Glik,33.0,32,23,26,5,1,16,32,50.0,16,25,17,8,61,93,200,1
944,Serge Gnabry,19.6,36,20,12,13,11,5,30,16.7,25,18,0,18,11,47,3,0
945,Joris Gnagnon,5.0,11,8,6,4,1,4,7,57.1,3,2,2,0,10,21,16,0
946,Eddy Gnahore,24.9,39,27,17,17,5,9,39,23.1,30,29,4,25,23,62,23,1
947,Massimo Gobbi,13.1,14,7,5,5,4,8,25,32.0,17,16,8,8,9,23,48,0
948,Kevin Goden,3.0,4,3,3,1,0,2,7,28.6,5,4,1,3,4,8,11,0
949,Diego Godin,27.9,52,30,33,19,0,20,42,47.6,22,22,9,13,45,97,141,2
951,Edoardo Goldaniga,29.0,43,28,34,7,2,19,32,59.4,13,29,16,13,57,100,119,0
952,Pierluigi Gollini,20.0,2,2,2,0,0,1,2,50.0,1,0,0,0,0,2,3,2
953,Aleksandr Golovin,25.4,36,17,3,20,13,10,44,22.7,34,34,3,31,22,58,12,0
954,Andre Gomes,22.0,39,23,12,24,3,13,59,22.0,46,27,4,23,20,59,18,0
956,Ibai Gomez,6.4,6,3,3,2,1,4,9,44.4,5,8,1,7,2,8,8,0
957,Ibai Gomez,16.1,14,8,9,3,2,6,19,31.6,13,10,0,10,8,22,17,0
958,Joe Gomez,11.8,18,11,10,7,1,9,15,60.0,6,10,5,5,14,32,42,0
959,Mario Gomez,24.6,19,11,6,10,3,2,12,16.7,10,17,6,11,5,24,33,0
960,Maxi Gomez,32.9,6,4,1,4,1,1,12,8.3,11,3,0,3,2,8,43,0
962,Moi Gomez,33.9,42,28,15,25,2,11,46,23.9,35,27,3,24,28,70,27,0
963,Papu Gomez,32.2,19,14,5,10,4,6,30,20.0,24,21,0,21,16,35,4,0
964,Sergi Gomez,30.7,49,38,33,12,4,18,28,64.3,10,30,20,10,40,89,135,1
965,Alfred Gomis,19.2,0,0,0,0,0,0,1,0.0,1,0,0,0,1,1,14,1
966,Maxime Gonalons,6.0,8,4,2,5,1,1,15,6.7,14,10,4,6,5,13,12,0
967,Anthony Goncalves,11.8,22,15,12,8,2,7,22,31.8,15,21,2,19,10,32,17,0
968,Jerome Gondorf,14.4,33,18,12,19,2,14,28,50.0,14,29,5,24,19,52,23,1
969,Alvaro Gonzalez,32.9,49,35,33,14,2,25,35,71.4,10,34,24,10,37,86,177,2
970,Bruno Gonzalez,18.9,23,10,14,8,1,9,18,50.0,9,13,6,7,22,45,110,0
972,Giancarlo Gonzalez,8.3,13,7,12,1,0,5,9,55.6,4,15,11,4,12,25,42,0
973,Nicolas Gonzalez,24.0,19,14,3,7,9,9,19,47.4,10,32,2,30,11,30,27,0
974,Jon Gorenc Stankovic,7.9,26,18,18,7,1,14,26,53.8,12,16,9,7,9,35,20,1
975,Leon Goretzka,22.5,41,22,7,27,7,14,38,36.8,24,25,4,21,26,67,14,1
977,Mirko Gori,3.7,16,13,7,9,0,5,16,31.3,11,2,0,2,4,20,9,0
978,Andoni Gorosabel,5.1,16,9,10,5,1,8,13,61.5,5,5,1,4,4,20,20,1
979,Robin Gosens,21.6,63,46,32,26,5,37,54,68.5,17,41,3,38,38,101,60,0
980,Dan Gosling,19.3,57,23,27,21,9,28,53,52.8,25,33,11,22,20,77,46,1
981,Felix Gotze,1.4,4,2,2,2,0,3,3,100.0,0,1,0,1,3,7,7,0
982,Mario Gotze,18.6,26,19,6,11,9,4,25,16.0,21,10,0,10,8,34,4,1
983,Prince-Desir Gouano,29.1,31,18,25,5,1,12,22,54.5,10,36,27,9,46,77,127,6
984,Yoann Gourcuff,1.5,0,0,0,0,0,0,2,0.0,2,1,1,0,0,0,1,0
985,Jeffrey Gouweleeuw,23.2,42,31,23,19,0,24,39,61.5,15,44,21,23,56,98,71,1
988,Max Gradel,36.0,58,35,34,19,5,24,70,34.3,46,53,9,44,18,76,41,0
989,Jonathan Gradit,22.3,52,28,30,21,1,28,52,53.8,24,40,15,25,45,97,82,3
990,Samuel Grandsir,2.6,9,6,5,3,1,3,7,42.9,4,2,0,2,1,10,0,0
991,Samuel Grandsir,5.2,12,7,4,5,3,2,10,20.0,8,11,0,11,1,13,5,1
992,Alex Granell,26.6,64,28,30,31,3,34,83,41.0,49,34,5,29,35,99,36,1
993,Esteban Granero,22.4,50,32,26,18,6,17,50,34.0,33,42,8,34,26,76,34,2
994,Karlan Grant,9.7,5,2,1,2,2,1,3,33.3,2,8,0,8,2,7,1,1
995,Alberto Grassi,5.1,20,12,7,10,3,2,10,20.0,8,8,2,6,8,28,10,0
996,Andre Gray,15.2,3,1,0,2,1,1,6,16.7,5,3,1,2,2,5,6,0
997,Demarai Gray,22.1,25,12,7,14,4,6,16,37.5,10,19,0,19,9,34,15,0
998,Mason Greenwood,1.3,3,3,2,0,1,2,3,66.7,1,2,0,2,0,3,1,0
999,Michael Gregoritsch,27.6,22,13,7,9,6,4,28,14.3,24,29,10,19,15,37,58,0
1000,Clement Grenier,29.6,44,27,7,33,4,21,61,34.4,40,28,4,24,29,73,34,1
1001,Antoine Griezmann,35.5,31,19,8,13,10,8,28,28.6,20,18,1,17,12,43,21,0
1002,Vincenzo Grifo,3.7,6,3,2,3,1,0,5,0.0,5,2,1,1,2,8,5,0
1003,Vincenzo Grifo,15.9,26,14,11,8,7,14,27,51.9,13,10,1,9,2,28,10,0
1004,Florian Grillitsch,26.6,77,49,30,38,9,36,80,45.0,44,34,8,26,72,149,56,1
1005,Jeremy Grimm,1.9,4,2,2,2,0,3,5,60.0,2,1,0,1,4,8,5,0
1006,Pascal Gross,20.7,27,12,12,12,3,11,36,30.6,25,20,8,12,13,40,23,0
1007,Sergej Grubac,1.7,2,1,1,0,1,1,1,100.0,0,1,0,1,0,2,1,0
1008,Marko Grujic,19.8,45,33,17,20,8,13,38,34.2,25,29,6,23,29,74,51,1
1010,Andres Guardado,25.9,24,15,9,12,3,11,47,23.4,36,27,1,26,28,52,28,1
1011,Sergi Guardiola,16.8,19,11,1,10,8,2,13,15.4,11,12,0,12,5,24,17,0
1015,Goncalo Guedes,16.3,31,13,16,12,3,14,43,32.6,29,15,0,15,7,38,1,0
1016,Matteo Guendouzi,23.9,44,26,18,23,3,17,47,36.2,30,28,5,23,30,74,24,3
1017,Javi Guerra,2.6,3,3,1,1,1,0,3,0.0,3,2,0,2,1,4,0,0
1018,Raphael Guerreiro,17.0,25,12,11,7,7,12,23,52.2,11,7,1,6,18,43,12,1
1019,Francis Guerrero,19.8,51,28,25,16,10,23,41,56.1,18,15,1,14,21,72,47,4
1021,Ander Guevara,1.0,3,1,0,3,0,2,6,33.3,4,1,0,1,1,4,0,0
1022,Makhtar Gueye,0.6,2,1,2,0,0,2,2,100.0,0,2,0,2,0,2,0,0
1023,John Guidetti,7.0,4,1,0,3,1,0,4,0.0,4,4,0,4,1,5,6,0
1024,Josuha Guilavogui,17.4,31,16,18,13,0,14,25,56.0,11,17,8,9,43,74,56,2
1025,Frederic Guilbert,32.4,98,67,59,29,10,41,83,49.4,42,49,21,28,78,176,121,2
1026,Baptiste Guillaume,13.1,12,6,1,8,3,2,9,22.2,7,6,0,6,2,14,6,0
1027,Serhou Guirassy,12.3,7,5,1,5,1,0,4,0.0,4,7,0,7,4,11,14,0
1029,Manuel Gulde,19.0,24,16,18,5,1,12,16,75.0,4,25,13,12,26,50,90,0
1030,Gerard Gumbau,13.3,22,16,9,13,0,6,25,24.0,19,15,2,13,13,35,13,0
1031,Ilkay Gundogan,23.7,19,12,4,12,3,6,31,19.4,25,12,3,9,28,47,19,1
1033,Aron Gunnarsson,25.2,51,29,23,25,3,23,84,27.4,61,40,12,28,38,89,55,1
1034,Christian Gunter,32.0,38,26,16,16,6,20,43,46.5,23,31,7,24,14,52,55,0
1035,Koray Gunter,9.3,18,13,13,3,2,9,16,56.3,7,9,7,2,18,36,34,0
1036,Serdar Gurler,5.4,5,5,3,2,0,3,11,27.3,8,8,0,8,1,6,2,0
1038,Regis Gurtner,38.0,1,1,1,0,0,0,1,0.0,1,0,0,0,1,2,7,3
1040,Gorka Guruzeta,0.6,1,1,1,0,0,0,2,0.0,2,1,0,1,2,3,0,0
1041,Luiz Gustavo,27.1,72,43,49,18,5,30,66,45.5,36,26,12,14,34,106,61,0
1042,Jonathan de Guzman,17.4,34,24,11,20,3,13,28,46.4,15,18,2,16,11,45,16,0
1043,Janik Haberer,26.0,71,47,37,24,10,30,75,40.0,45,31,4,27,36,107,49,0
1045,Alexander Hack,11.3,29,13,20,9,0,19,28,67.9,9,26,15,11,41,70,59,2
1046,Munir El Haddadi,11.6,17,10,5,7,5,2,7,28.6,5,15,0,15,6,23,9,0
1047,Munir El Haddadi,1.7,3,3,1,1,1,1,3,33.3,2,1,0,1,0,3,1,0
1048,Oussama Haddadi,29.7,51,25,38,11,2,24,43,55.8,19,33,8,25,45,96,93,2
1049,Florent Hadergjonaj,20.5,30,17,10,18,2,13,37,35.1,24,21,7,14,21,51,37,1
1050,Benjamin Hadzic,0.3,0,0,0,0,0,0,1,0.0,1,0,0,0,0,0,0,0
1051,Andre Hahn,22.8,64,38,22,39,3,22,53,41.5,31,28,2,26,27,91,32,0
1052,Amadou Haidara,4.2,13,11,4,8,1,8,14,57.1,6,9,1,8,4,17,7,0
1053,Oualid El Hajjam,6.0,14,9,10,3,1,5,15,33.3,10,8,2,6,12,26,26,0
1054,Achraf Hakimi,19.3,34,19,25,8,1,17,36,47.2,19,27,4,23,29,63,45,2
1055,Sebastien Haller,24.2,24,11,7,10,7,8,21,38.1,13,21,1,20,15,39,23,0
1056,Emil Hallfredsson,1.5,0,0,0,0,0,0,1,0.0,1,1,1,0,3,3,4,0
1057,Emil Hallfredsson,4.4,10,6,5,4,1,0,9,0.0,9,4,1,3,2,12,3,0
1058,Marcel Halstenberg,26.8,68,44,31,24,13,42,65,64.6,23,27,4,23,38,106,69,0
1059,Ben Hamer,6.1,0,0,0,0,0,0,3,0.0,3,0,0,0,1,1,3,2
1060,Romain Hamouma,17.6,30,19,6,18,6,12,32,37.5,20,12,1,11,9,39,7,0
1061,Marek Hamsik,10.2,7,5,2,4,1,0,11,0.0,11,8,1,7,12,19,14,1
1062,David Hancko,3.1,7,6,4,3,0,6,9,66.7,3,3,1,2,3,10,12,0
1063,Samir Handanovic,38.0,1,0,1,0,0,1,1,100.0,0,0,0,0,0,1,12,1
1064,Genki Haraguchi,23.7,44,26,21,20,3,17,66,25.8,49,34,5,29,21,65,33,0
1066,Fethi Harek,2.0,4,4,2,2,0,3,4,75.0,1,1,0,1,1,5,6,0
1067,Amine Harit,12.0,15,8,4,9,2,8,24,33.3,16,11,1,10,9,24,2,0
1068,Martin Harnik,9.2,12,7,4,3,5,4,15,26.7,11,8,0,8,3,15,10,0
1069,Kadeem Harris,4.2,12,5,6,4,2,7,8,87.5,1,3,0,3,3,15,5,0
1070,Joe Hart,19.0,0,0,0,0,0,0,1,0.0,1,0,0,0,0,0,11,3
1071,Makoto Hasebe,28.0,52,34,35,17,0,25,42,59.5,17,43,22,21,40,92,101,3
1072,Hans Hateboer,33.0,43,31,19,19,5,17,34,50.0,17,29,5,24,23,66,47,1
1073,Kai Havertz,32.2,26,17,10,11,5,8,32,25.0,24,31,4,27,16,42,29,0
1074,Isaac Hayden,20.7,73,43,19,45,9,23,41,56.1,18,32,4,28,40,113,30,0
1075,Eden Hazard,32.5,14,9,2,1,11,5,17,29.4,12,10,0,10,13,27,6,1
1076,Thorgan Hazard,31.9,50,33,22,20,8,17,48,35.4,31,35,2,33,27,77,12,0
1077,Rhys Healey,0.6,1,0,0,1,0,0,1,0.0,1,0,0,0,0,1,0,0
1078,Tom Heaton,19.0,0,0,0,0,0,0,2,0.0,2,0,0,0,0,0,8,2
1079,Dominique Heintz,33.9,41,21,34,6,1,18,32,56.3,14,45,22,23,45,86,214,0
1080,Filip Helander,19.0,42,26,25,13,4,19,23,82.6,4,27,16,11,14,56,84,0
1081,Jordan Henderson,22.1,46,36,20,22,4,16,39,41.0,23,27,3,24,30,76,17,0
1082,Jeff Hendrick,22.9,24,12,13,7,4,9,32,28.1,23,20,5,15,12,36,31,0
1083,Wayne Hennessey,17.5,0,0,0,0,0,0,2,0.0,2,0,0,0,0,0,5,1
1084,Rouwen Hennings,20.4,14,10,1,8,5,2,13,15.4,11,16,1,15,4,18,20,0
1085,Benjamin Henrichs,20.3,58,39,32,22,4,16,38,42.1,22,18,0,18,35,93,45,0
1087,Dalbert Henrique,8.6,33,24,18,14,1,12,21,57.1,9,9,3,6,8,41,20,0
1088,Uche Henry Agbo,4.1,7,4,3,4,0,5,10,50.0,5,3,1,2,6,13,1,0
1089,Christophe Herelle,32.6,72,52,51,19,2,40,50,80.0,10,39,16,23,61,133,158,2
1090,Mario Hermoso,31.2,38,24,29,7,2,21,39,53.8,18,34,25,9,37,75,175,2
1092,Javier Hernandez,14.8,3,0,0,3,0,0,6,0.0,6,8,1,7,1,4,8,0
1093,Lucas Hernandez,12.4,35,25,20,14,1,17,20,85.0,3,17,9,8,14,49,49,0
1094,Theo Hernandez,22.0,54,33,30,15,9,28,44,63.6,16,21,5,16,33,87,42,3
1095,Ander Herrera,15.6,54,28,24,22,8,21,61,34.4,40,38,6,32,37,91,25,1
1096,Yangel Herrera,12.8,48,24,18,25,5,23,43,53.5,20,13,1,12,14,62,32,0
1097,Iago Herrerin,31.0,0,0,0,0,0,0,2,0.0,2,0,0,0,0,0,11,2
1098,Patrick Herrmann,12.0,20,14,8,7,5,6,17,35.3,11,6,3,3,6,26,12,0
1099,Pablo Hervias,1.8,1,0,0,1,0,0,1,0.0,1,0,0,0,2,3,0,0
1100,Pablo Hervias,2.0,1,1,0,1,0,0,4,0.0,4,2,0,2,0,1,0,0
1101,Perparim Hetemaj,24.0,53,27,27,23,3,20,68,29.4,48,25,1,24,30,83,24,2
1102,Son Heung-min,22.7,23,12,7,12,4,10,34,29.4,24,26,2,24,8,31,4,1
1103,Gonzalo Higuain,12.1,10,7,2,4,4,2,11,18.2,9,4,0,4,1,11,5,0
1104,Gonzalo Higuain,14.2,8,6,1,5,2,5,13,38.5,8,3,0,3,0,8,11,1
1105,Oscar Hiljemark,13.3,16,9,8,7,1,5,16,31.3,11,13,3,10,13,29,14,0
1106,Vitorino Hilton,35.9,33,13,28,5,0,12,30,40.0,18,31,15,16,66,99,198,2
1107,Martin Hinteregger,17.5,48,35,31,16,1,24,35,68.6,11,24,13,11,22,70,68,0
1108,Martin Hinteregger,12.7,34,26,19,12,3,13,28,46.4,15,20,7,13,13,47,51,0
1110,Andrew Hjulsager,4.0,16,10,11,2,3,2,18,11.1,16,4,0,4,2,18,1,0
1111,Wesley Hoedt,13.0,28,12,23,5,0,17,26,65.4,9,20,13,7,23,51,79,2
1112,Wesley Hoedt,9.9,17,11,15,2,0,12,17,70.6,5,17,11,6,11,28,58,3
1113,Andre Hoffmann,11.7,22,14,12,10,0,9,25,36.0,16,17,12,5,21,43,44,0
1114,Nicolas Hofler,17.9,45,22,19,22,4,14,36,38.9,22,21,4,17,32,77,41,0
1115,Jonas Hofmann,21.2,37,18,11,19,7,9,37,24.3,28,33,2,31,16,53,14,1
1116,Jonathan Hogg,26.3,78,41,18,51,9,27,69,39.1,42,46,7,39,73,151,19,1
1118,Junior Hoilett,23.8,40,27,26,11,3,15,53,28.3,38,34,0,34,32,72,30,0
1119,Rob Holding,9.0,11,7,9,2,0,2,8,25.0,6,9,7,2,12,23,40,0
1120,Jose Holebas,26.6,68,40,44,20,4,28,53,52.8,25,27,8,19,21,89,97,0
1121,Lucas Holer,11.2,18,13,6,9,3,4,18,22.2,14,10,1,9,3,21,15,2
1122,Mason Holgate,4.5,5,4,4,1,0,1,1,100.0,0,3,2,1,3,8,32,0
1123,Gerrit Holtmann,1.6,2,0,1,0,1,1,2,50.0,1,3,2,1,4,6,1,0
1124,Justin Hoogma,1.2,4,2,2,1,1,2,2,100.0,0,3,1,2,2,6,1,0
1125,Lukas Hradecky,32.0,0,0,0,0,0,0,1,0.0,1,0,0,0,1,1,9,1
1127,Benjamin Hubner,9.0,29,18,18,9,2,14,18,77.8,4,16,7,9,21,50,35,0
1128,Tomas Hubocan,0.8,3,2,3,0,0,3,4,75.0,1,0,0,0,2,5,5,0
1129,Callum Hudson-Odoi,4.4,8,6,8,0,0,2,4,50.0,2,1,0,1,3,11,0,0
1130,Will Hughes,26.9,74,43,27,35,12,25,59,42.4,34,55,6,49,25,99,30,0
1131,Vitor Hugo,27.4,64,42,38,25,1,17,27,63.0,10,28,13,15,74,138,141,2
1132,Mats Hummels,19.7,26,17,19,6,1,9,24,37.5,15,20,8,12,34,60,50,1
1133,Adrien Hunou,13.8,11,7,3,5,3,2,9,22.2,7,14,0,14,5,16,8,0
1134,Emerson Hyndman,0.4,6,2,6,0,0,2,3,66.7,1,0,0,0,1,7,0,0
1135,Elseid Hysaj,23.4,40,28,22,15,3,25,49,51.0,24,11,3,8,24,64,51,0
1136,Suk Hyun-jun,8.8,11,8,1,6,4,0,8,0.0,8,2,1,1,2,13,4,1
1137,Pierre Hojbjerg,30.7,71,49,20,44,7,24,73,32.9,49,51,8,43,60,131,30,1
1138,Simone Iacoponi,37.2,62,43,50,11,1,27,47,57.4,20,40,26,14,37,99,178,3
1139,Robert Ibanez,0.8,2,2,1,1,0,0,1,0.0,1,3,0,3,0,2,0,0
1141,Jordon Ibe,8.9,6,5,0,5,1,2,7,28.6,5,2,0,2,4,10,4,0
1142,Vedad Ibisevic,20.1,12,8,2,5,5,0,10,0.0,10,10,4,6,3,15,20,0
1144,Vicente Iborra,2.5,4,1,1,3,0,0,7,0.0,7,1,0,1,8,12,4,1
1145,Vicente Iborra,18.5,31,18,22,5,4,14,37,37.8,23,25,7,18,22,53,41,1
1146,Didier Ibrahim Ndong,8.3,16,11,3,13,0,5,13,38.5,8,15,3,12,15,31,6,1
1147,Mauro Icardi,25.2,9,8,2,2,5,1,6,16.7,5,4,1,3,3,12,20,1
1149,Edgar Ie,2.7,5,4,3,2,0,3,5,60.0,2,2,1,1,7,12,17,0
1150,Edgar Ie,8.6,20,13,12,6,2,9,16,56.3,7,10,3,7,8,28,23,0
1151,Borja Iglesias,34.2,23,14,7,8,8,5,24,20.8,19,14,6,8,7,30,41,0
1152,Kelechi Iheanacho,10.5,6,5,4,1,1,1,5,20.0,4,5,0,5,2,8,3,0
1153,Jordan Ikoko,19.0,37,24,22,14,1,16,28,57.1,12,18,5,13,24,61,30,0
1154,Jonathan Ikone,31.1,25,14,7,12,6,8,30,26.7,22,24,2,22,6,31,4,0
1155,Ivo Ilicevic,0.4,1,0,0,1,0,1,2,50.0,1,1,0,1,0,1,0,0
1156,Josip Ilicic,23.8,15,7,2,7,6,5,20,25.0,15,20,1,19,5,20,2,0
1157,Asier Illarramendi,20.2,39,24,22,14,3,21,51,41.2,30,36,9,27,31,70,46,1
1158,Stefan Ilsanker,10.4,26,17,15,10,1,14,23,60.9,9,9,2,7,18,44,43,1
1159,Giannelli Imbula,19.2,14,7,6,7,1,5,12,41.7,7,12,3,9,8,22,6,0
1160,Ciro Immobile,31.8,12,6,4,3,5,4,9,44.4,5,18,1,17,1,13,8,0
1161,Emmanuel Imorou,12.4,18,13,10,7,1,11,17,64.7,6,14,4,10,28,46,49,1
1163,Roberto Inglese,21.8,20,14,7,7,6,1,13,7.7,12,26,2,24,6,26,27,0
1164,Danny Ings,18.3,30,14,5,19,6,11,28,39.3,17,30,2,28,5,35,9,0
1165,Lorenzo Insigne,23.0,14,4,5,6,3,6,18,33.3,12,7,0,7,8,22,3,0
1166,Emiliano Insua,23.5,51,33,26,18,7,25,42,59.5,17,29,2,27,31,82,55,1
1167,Pablo Insua,8.6,23,10,14,9,0,8,15,53.3,7,2,0,2,12,35,40,0
1168,Takashi Inui,9.2,9,5,6,2,1,5,18,27.8,13,5,0,5,4,13,3,0
1170,Takashi Inui,4.2,4,3,0,4,0,3,7,42.9,4,3,0,3,1,5,1,0
1171,Artur Ionita,33.0,67,38,23,31,13,16,57,28.1,41,40,5,35,27,94,30,0
1172,Gorka Iraizoz,6.2,1,0,1,0,0,1,1,100.0,0,0,0,0,1,2,7,0
1173,Carlos Isaac,1.0,0,0,0,0,0,0,2,0.0,2,2,0,2,1,1,2,0
1174,Isco,13.2,29,14,14,8,7,14,34,41.2,20,9,1,8,6,35,3,0
1175,Mikael Ishak,21.3,9,6,3,6,0,3,16,18.8,13,8,3,5,3,12,10,0
1177,Gian-Luca Itter,1.0,4,3,3,1,0,1,2,50.0,1,2,0,2,1,5,2,0
1179,Ander Iturraspe,1.1,2,2,1,1,0,1,1,100.0,0,0,0,0,6,8,2,0
1181,Alex Iwobi,21.9,28,14,10,16,2,6,25,24.0,19,21,1,20,12,40,13,1
1182,Jose Izquierdo,8.8,15,9,9,4,2,10,20,50.0,10,7,1,6,5,20,7,0
1183,Armando Izzo,36.3,76,50,35,35,6,33,53,62.3,20,52,24,28,88,164,149,2
1184,Koo Ja-cheol,18.2,36,23,10,20,6,12,30,40.0,18,28,5,23,27,63,21,0
1185,Lukas Jager,0.3,0,0,0,0,0,0,2,0.0,2,0,0,0,0,0,0,0
1186,Phil Jagielka,3.7,7,5,3,4,0,1,4,25.0,3,1,0,1,2,9,14,0
1187,Alireza Jahanbakhsh,11.3,32,18,17,11,4,11,30,36.7,19,16,0,16,11,43,4,0
1188,Christophe Jallet,9.8,29,21,12,13,4,16,27,59.3,11,21,5,16,14,43,32,0
1189,Jandrei,1.0,0,0,0,0,0,0,1,0.0,1,0,0,0,0,0,0,0
1191,Marko Jankovic,0.6,3,1,2,1,0,0,2,0.0,2,0,0,0,0,3,0,0
1192,Jakub Jankto,10.7,7,4,5,2,0,4,15,26.7,11,18,2,16,9,16,16,0
1193,Daryl Janmaat,16.9,36,24,23,11,2,20,29,69.0,9,16,6,10,33,69,71,0
1196,Tony Jantschke,10.4,15,10,9,5,1,6,8,75.0,2,10,7,3,27,42,51,1
1197,Adnan Januzaj,13.9,11,8,5,2,4,3,13,23.1,10,7,0,7,6,17,6,0
1199,Pawel Jaroszynski,15.0,29,18,17,8,4,16,32,50.0,16,15,4,11,24,53,41,1
1201,Jason,25.9,44,25,22,11,11,20,71,28.2,51,25,4,21,46,90,27,0
1202,Dennis Jastrzembski,0.7,0,0,0,0,0,0,3,0.0,3,0,0,0,1,1,0,0
1203,Assil Jaziri,0.4,2,2,0,2,0,1,2,50.0,1,1,0,1,1,3,0,0
1204,Corentin Jean,7.0,9,6,3,6,0,2,8,25.0,6,8,0,8,2,11,5,0
1205,Benjamin Jeannot,16.0,17,12,5,7,5,6,19,31.6,13,15,3,12,12,29,14,0
1206,Tin Jedvaj,12.5,23,15,9,8,6,10,19,52.6,9,28,2,26,22,45,52,0
1207,Jemerson,24.7,54,38,34,19,1,29,46,63.0,17,29,17,12,25,79,121,1
1208,Carl Jenkinson,1.8,3,2,2,0,1,2,3,66.7,1,4,3,1,0,3,2,0
1209,Fredrik Jensen,2.3,5,4,3,1,1,2,4,50.0,2,6,0,6,2,7,3,0
1210,Mathias Jensen,2.6,4,2,2,2,0,2,9,22.2,7,2,0,2,4,8,1,0
1211,Jese,8.7,7,4,3,3,1,2,8,25.0,6,8,0,8,1,8,1,0
1212,Gabriel Jesus,11.5,10,3,5,2,3,0,5,0.0,5,16,2,14,3,13,4,0
1213,Juan Jesus,15.6,37,29,30,5,2,17,30,56.7,13,20,12,8,16,53,41,0
1214,Raul Jimenez,34.6,30,18,5,17,8,6,23,26.1,17,25,3,22,26,56,40,0
1215,Joaquin,18.8,10,4,4,2,4,3,7,42.9,4,13,2,11,14,24,31,1
1216,Joelinton,23.7,35,22,9,20,6,10,30,33.3,20,36,3,33,14,49,8,0
1218,Stefan Johansen,4.6,11,3,4,7,0,5,8,62.5,3,5,0,5,3,14,6,0
1219,Jakob Johansson,7.9,17,9,5,12,0,10,20,50.0,10,7,3,4,3,20,17,1
1220,Ben Johnson,0.7,1,0,1,0,0,0,1,0.0,1,0,0,0,1,2,5,0
1222,Fabian Johnson,11.2,13,5,2,8,3,6,8,75.0,2,8,3,5,10,23,16,0
1224,Karl-Johan Johnsson,17.0,0,0,0,0,0,0,1,0.0,1,0,0,0,0,0,4,1
1225,Jonathas,6.7,7,4,3,4,0,3,10,30.0,7,9,1,8,3,10,4,0
1226,Phil Jones,14.0,19,13,12,7,0,8,13,61.5,5,16,11,5,23,42,67,3
1227,Jony,33.0,20,14,6,7,7,7,37,18.9,30,18,0,18,22,42,12,2
1228,Joan Jordan,31.9,63,40,16,38,9,28,80,35.0,52,38,4,34,32,95,18,1
1229,Bruno Jordao,1.0,4,3,2,1,1,1,3,33.3,2,1,0,1,0,4,2,0
1230,Jorginho,35.1,76,38,27,41,8,45,96,46.9,51,46,7,39,64,140,38,1
1231,Willian Jose,26.3,5,3,1,3,1,2,7,28.6,5,11,5,6,1,6,27,0
1232,Joselu,6.6,14,8,4,5,5,4,9,44.4,5,5,0,5,3,17,15,0
1233,Evens Joseph,3.8,5,2,1,2,2,1,3,33.3,2,3,0,3,2,7,1,0
1234,Diogo Jota,26.2,28,16,11,11,6,10,38,26.3,28,20,1,19,13,41,11,0
1236,Vukasin Jovanovic,15.3,26,21,21,5,0,13,19,68.4,6,23,12,11,36,62,105,0
1237,Stevan Jovetic,4.4,2,1,1,1,0,1,3,33.3,2,1,0,1,1,3,3,0
1238,Luka Jovic,24.9,10,5,1,8,1,1,12,8.3,11,8,0,8,3,13,30,0
1239,Jozabed,12.8,19,10,8,8,3,8,24,33.3,16,8,2,6,9,28,13,2
1240,Miguel Juan Llambrich,6.0,21,14,11,9,1,6,14,42.9,8,9,2,7,12,33,17,0
1241,Juanfran,16.2,20,12,13,5,2,9,16,56.3,7,9,4,5,19,39,37,0
1242,Juanfran,17.9,35,22,27,5,3,24,38,63.2,14,13,5,8,19,54,36,1
1243,Juanmi,16.9,21,12,7,11,3,8,22,36.4,14,12,0,12,16,37,13,0
1244,Juanpe,30.7,48,25,32,15,1,24,45,53.3,21,31,15,16,57,105,138,0
1245,Juanpi,7.4,16,6,9,5,2,4,12,33.3,8,15,0,15,6,22,3,0
1246,Nathael Julan,4.8,1,0,0,0,1,0,3,0.0,3,6,1,5,0,1,2,0
1248,Christopher Jullien,33.5,35,24,23,10,2,12,32,37.5,20,39,27,12,41,76,203,4
1249,David Junca,19.5,55,30,40,13,2,28,46,60.9,18,27,6,21,35,90,63,1
1250,Sebastian Jung,0.6,1,0,0,1,0,1,1,100.0,0,0,0,0,0,1,1,0
1251,Hamed Junior Traore,25.1,67,38,26,32,9,27,72,37.5,45,29,4,25,30,97,17,0
1252,Vinicius Junior,9.7,10,6,3,6,1,3,16,18.8,13,6,1,5,7,17,1,0
1254,Mathias Jorgensen,23.9,49,31,27,21,1,27,46,58.7,19,29,14,15,69,118,83,0
1255,Sory Kaba,2.6,1,1,1,0,0,1,3,33.3,2,2,0,2,0,1,1,0
1256,Ozan Kabak,15.0,33,19,22,9,2,9,19,47.4,10,15,8,7,23,56,58,1
1257,Christian Kabasele,17.6,25,14,20,5,0,10,23,43.5,13,21,16,5,38,63,111,0
1258,Elias Kachunga,13.1,22,9,8,12,2,9,25,36.0,16,16,1,15,4,26,10,0
1259,Pavel Kaderabek,27.9,30,19,12,13,5,11,24,45.8,13,37,10,27,34,64,71,1
1261,Florian Kainz,4.1,6,5,5,1,0,3,6,50.0,3,4,1,3,3,9,5,0
1262,Gael Kakuta,8.0,12,7,5,5,2,2,10,20.0,8,4,1,3,9,21,9,0
1263,Nikola Kalinic,7.1,6,4,2,4,0,1,3,33.3,2,1,0,1,2,8,2,0
1264,Salomon Kalou,25.7,21,12,5,11,5,6,24,25.0,18,23,1,22,6,27,25,0
1265,Samuel Kalu,14.2,27,18,15,7,5,4,11,36.4,7,11,3,8,8,35,4,1
1266,Francois Kamano,28.5,29,18,6,17,6,11,30,36.7,19,27,0,27,17,46,6,1
1267,Aboubakar Kamara,7.7,8,4,1,5,2,3,7,42.9,4,6,0,6,1,9,6,0
1268,Boubacar Kamara,26.8,67,39,38,24,5,32,49,65.3,17,24,13,11,45,112,95,2
1269,Hassane Kamara,10.3,29,21,22,5,2,16,19,84.2,3,6,1,5,14,43,41,0
1270,Marcin Kaminski,27.0,18,13,14,3,1,7,11,63.6,4,21,11,10,39,57,103,2
1272,Kevin Kampl,23.5,41,24,16,21,4,8,28,28.6,20,32,2,30,33,74,22,0
1274,Harry Kane,26.9,10,6,2,8,0,1,14,7.1,13,16,6,10,1,11,14,0
1275,Lee Kang-in,0.3,2,0,1,1,0,1,3,33.3,2,0,0,0,1,3,0,0
1276,Wilfried Kanga,5.5,0,0,0,0,0,0,1,0.0,1,3,0,3,0,0,4,0
1277,N'Golo Kante,34.4,75,41,21,41,13,23,67,34.3,44,63,6,57,44,119,32,1
1279,Wilfrid Kaptoum,8.6,15,6,4,10,1,5,11,45.5,6,9,1,8,10,25,6,2
1280,Kenan Karaman,10.2,13,9,3,10,0,7,12,58.3,5,5,1,4,2,15,8,0
1282,Yann Karamoh,13.6,7,3,1,4,2,1,13,7.7,12,9,0,9,6,13,3,0
1285,Rick Karsdorp,6.6,9,6,3,5,1,5,11,45.5,6,4,2,2,12,21,12,1
1288,Beram Kayal,10.4,28,17,16,11,1,5,21,23.8,16,17,10,7,15,43,25,0
1289,Moise Kean,6.0,0,0,0,0,0,0,1,0.0,1,1,0,1,2,2,1,0
1290,Michael Keane,33.0,41,25,22,16,3,19,32,59.4,13,30,22,8,43,84,185,4
1291,Neeskens Kebano,1.2,3,1,2,1,0,1,1,100.0,0,3,0,3,0,3,3,0
1292,Thilo Kehrer,21.1,64,43,27,31,6,31,55,56.4,24,32,17,15,31,95,69,1
1293,Jules Keita,5.1,10,4,0,3,7,5,12,41.7,7,2,0,2,2,12,1,0
1294,Naby Keita,15.4,37,15,13,19,5,14,42,33.3,28,29,4,25,12,49,16,1
1295,Keko,17.0,42,18,21,15,6,18,50,36.0,32,20,1,19,14,56,17,0
1296,Martin Kelly,12.3,21,13,18,2,1,14,19,73.7,5,18,12,6,11,32,88,1
1297,Marc-Oliver Kempf,22.5,33,18,26,7,0,12,24,50.0,12,35,21,14,46,79,141,1
1298,Kenedy,15.0,30,22,11,16,3,12,29,41.4,17,10,0,10,32,62,24,1
1300,Jonjoe Kenny,8.8,21,16,16,4,1,10,18,55.6,8,13,2,11,17,38,36,1
1301,Christophe Kerbrat,23.3,40,24,28,12,0,24,38,63.2,14,19,10,9,50,90,140,5
1302,Sebastian Kerk,13.1,16,9,8,5,3,7,23,30.4,16,14,5,9,3,19,22,1
1303,Franck Kessie,33.5,42,27,16,20,6,18,38,47.4,20,35,10,25,27,69,53,2
1304,Saif-Eddine Khaoui,15.0,20,14,5,11,4,8,27,29.6,19,9,1,8,20,40,4,0
1305,Wahbi Khazri,31.3,41,26,8,14,19,17,49,34.7,32,27,2,25,11,52,5,0
1306,Rani Khedira,29.2,56,39,22,28,6,18,36,50.0,18,44,22,22,80,136,95,1
1307,Sami Khedira,7.8,10,9,6,2,2,5,9,55.6,4,8,3,5,5,15,6,0
1308,Isaac Kiese Thelin,2.0,2,1,0,2,0,1,2,50.0,1,1,0,1,0,2,4,0
1309,Kike,14.4,7,4,1,2,4,1,5,20.0,4,18,0,18,4,11,6,0
1311,Joshua Kimmich,34.0,46,26,17,22,7,25,54,46.3,29,35,9,26,34,80,41,3
1312,Presnel Kimpembe,22.3,55,34,26,25,4,24,40,60.0,16,17,10,7,30,85,48,5
1313,Joshua King,32.9,30,19,7,19,4,8,29,27.6,21,28,4,24,7,37,14,0
1314,Sofian Kiyine,9.1,28,13,11,14,3,9,18,50.0,9,10,0,10,10,38,4,0
1315,Simon Kjaer,22.3,29,19,25,3,1,9,16,56.3,7,41,34,7,27,56,136,0
1316,Davy Klaassen,31.3,64,47,24,33,7,14,49,28.6,35,44,9,35,47,111,47,0
1317,Felix Klaus,4.9,10,7,4,5,1,2,7,28.6,5,5,0,5,4,14,0,0
1318,Ragnar Klavan,13.7,9,8,5,3,1,5,11,45.5,6,19,13,6,10,19,68,1
1319,Tim Kleindienst,2.2,4,3,1,2,1,1,3,33.3,2,3,0,3,0,4,7,0
1320,Lukas Klostermann,22.3,50,29,33,12,5,29,45,64.4,16,37,5,32,29,79,74,0
1321,Justin Kluivert,14.9,28,27,12,9,7,10,23,43.5,13,17,0,17,7,35,12,0
1322,Lukas Klunter,6.6,11,8,6,5,0,4,5,80.0,1,6,2,4,12,23,20,0
1323,Robin Knoche,31.0,26,20,19,6,1,16,29,55.2,13,46,29,17,44,70,138,2
1324,Anthony Knockaert,20.4,33,21,12,15,6,13,30,43.3,17,13,0,13,29,62,11,0
1326,Torles Knoll,4.1,3,2,1,1,1,0,4,0.0,4,5,1,4,0,3,2,0
1328,Gregor Kobel,15.4,1,1,1,0,0,1,1,100.0,0,0,0,0,2,3,5,3
1329,Robin Koch,21.1,25,14,17,7,1,7,24,29.2,17,31,18,13,32,57,77,4
1330,Kenan Kodro,1.8,3,1,1,1,1,1,3,33.3,2,1,0,1,0,3,0,0
1331,Dominik Kohr,10.8,42,29,21,21,0,14,35,40.0,21,25,12,13,15,57,17,1
1332,Djegui Koita,1.9,8,6,8,0,0,3,4,75.0,1,5,3,2,0,8,9,0
1333,Koke,28.7,84,46,41,32,11,34,86,39.5,52,25,5,20,31,115,37,1
1334,Aleksandar Kolarov,32.3,38,26,22,10,6,21,34,61.8,13,23,15,8,41,79,82,2
1335,Sead Kolasinac,21.0,34,21,21,7,6,20,34,58.8,14,12,3,9,20,54,28,3
1336,Randal Kolo Muani,1.4,2,0,1,1,0,0,1,0.0,1,2,0,2,0,2,2,0
1337,Timothee Kolodziejczak,35.4,34,22,21,10,3,20,45,44.4,25,25,11,14,53,87,118,2
1338,Vincent Kompany,13.6,16,10,11,3,2,8,9,88.9,1,11,8,3,16,32,55,0
1339,Ghislain Konan,20.0,45,28,31,10,4,24,40,60.0,16,18,4,14,40,85,55,1
1340,Ibrahima Konate,27.0,44,32,30,14,0,17,27,63.0,10,29,18,11,58,102,126,0
1341,Moussa Konate,20.8,10,8,3,3,4,2,12,16.7,10,14,3,11,5,15,15,0
1342,Geoffrey Kondogbia,13.8,47,33,18,23,6,12,27,44.4,15,20,7,13,27,74,22,2
1343,Kouadio Kone,0.8,4,2,0,4,0,2,4,50.0,2,0,0,0,0,4,0,0
1344,Lamine Kone,23.9,21,16,9,9,3,6,9,66.7,3,18,13,5,33,54,66,3
1345,Youssouf Kone,19.0,67,38,45,19,3,41,65,63.1,24,31,3,28,39,106,52,1
1346,Terence Kongolo,30.2,74,46,44,26,4,27,47,57.4,20,42,16,26,65,139,106,1
1347,Yevhen Konoplyanka,7.3,2,0,0,0,2,2,4,50.0,2,6,0,6,3,5,3,0
1348,Pascal Kopke,0.8,1,0,1,0,0,1,2,50.0,1,0,0,0,0,1,0,0
1349,Julian Korb,11.2,26,17,16,9,1,10,29,34.5,19,27,4,23,23,49,34,1
1350,Laurent Koscielny,14.8,19,11,9,9,1,10,16,62.5,6,20,15,5,30,49,72,0
1352,Filip Kostic,32.8,64,42,35,22,7,23,65,35.4,42,80,6,74,23,87,50,0
1353,Christian Kouame,34.1,31,22,8,16,7,2,13,15.4,11,23,3,20,25,56,28,0
1354,Tomas Koubek,32.5,0,0,0,0,0,0,1,0.0,1,0,0,0,0,0,26,4
1355,Kalidou Koulibaly,34.8,61,40,37,22,2,19,36,52.8,17,55,33,22,40,101,144,0
1356,Jules Kounde,37.0,48,31,37,11,0,27,41,65.9,14,44,23,21,50,98,193,7
1357,Cheikhou Kouyate,21.1,59,33,23,31,5,9,33,27.3,24,29,11,18,16,75,33,0
1358,Mateo Kovacic,19.3,45,29,23,19,3,20,46,43.5,26,19,2,17,8,53,18,1
1359,Dawid Kownacki,1.9,2,1,0,1,1,1,4,25.0,3,0,0,0,0,2,0,0
1360,Dawid Kownacki,6.4,13,6,9,3,1,7,16,43.8,9,8,0,8,2,15,8,0
1362,Emil Krafth,33.0,55,35,34,14,7,32,65,49.2,33,27,12,15,23,78,94,4
1363,Luka Krajnc,8.8,10,8,6,3,1,5,6,83.3,1,11,3,8,11,21,42,0
1364,Andrej Kramaric,26.6,9,4,1,5,3,4,26,15.4,22,15,3,12,8,17,13,0
1365,Christoph Kramer,12.6,41,22,17,23,1,15,40,37.5,25,19,4,15,21,62,23,0
1366,Vasyl Kravets,5.3,16,11,8,6,2,6,13,46.2,7,5,1,4,4,20,10,1
1367,Ladislav Krejci,11.8,16,12,6,9,1,7,12,58.3,5,8,2,6,6,22,18,0
1368,Rene Krhin,11.7,22,14,7,12,3,11,19,57.9,8,7,4,3,21,43,32,0
1369,Toni Kroos,24.7,51,35,18,24,9,14,57,24.6,43,25,4,21,14,65,13,1
1370,Rade Krunic,30.8,38,23,21,14,3,14,41,34.1,27,35,12,23,24,62,32,0
1371,Max Kruse,31.5,17,5,2,13,2,6,38,15.8,32,16,1,15,8,25,6,2
1372,Lukas Kubler,13.2,35,22,23,12,0,16,26,61.5,10,15,5,10,30,65,50,1
1373,Yuya Kubo,15.1,21,11,6,10,5,12,33,36.4,21,11,0,11,10,31,6,0
1374,Juraj Kucka,17.1,51,32,17,29,5,19,53,35.8,34,27,7,20,17,68,37,1
1375,Dejan Kulusevski,1.2,3,3,0,2,1,1,3,33.3,2,1,0,1,0,3,0,0
1376,Pierre Kunde,21.2,48,29,20,26,2,16,27,59.3,11,34,14,20,24,72,49,1
1378,Jasmin Kurtic,28.4,35,20,19,13,3,13,41,31.7,28,30,3,27,20,55,52,0
1379,Layvin Kurzawa,11.2,19,11,6,5,8,6,16,37.5,10,10,2,8,10,29,16,0
1380,Rafal Kurzawa,2.7,8,3,6,2,0,2,6,33.3,4,1,0,1,3,11,3,0
1381,Ahmed Kutucu,4.7,8,3,3,4,1,1,3,33.3,2,2,1,1,0,8,0,0
1382,Enock Kwateng,22.7,65,41,34,27,4,33,70,47.1,37,28,4,24,78,143,56,0
1383,Grejohn Kyei,0.0,0,0,0,0,0,0,1,0.0,1,0,0,0,0,0,0,0
1384,Antonino La Gumina,12.1,5,4,1,2,2,2,6,33.3,4,8,2,6,6,11,5,0
1385,Rajiv van La Parra,4.5,8,5,1,7,0,1,6,16.7,5,0,0,0,4,12,3,1
1386,Gaetan Laborde,1.0,4,3,0,1,3,2,4,50.0,2,0,0,0,0,4,0,0
1387,Gaetan Laborde,32.2,36,15,6,15,15,11,27,40.7,16,18,2,16,6,42,27,0
1388,Alexandre Lacazette,27.8,35,16,6,19,10,5,28,17.9,23,27,1,26,15,50,31,0
1390,Victor Laguardia,36.0,47,34,37,10,0,24,33,72.7,9,42,19,23,53,100,232,0
1392,Konrad Laimer,20.8,72,38,21,34,17,20,71,28.2,51,67,2,65,32,104,23,0
1393,Diego Lainez,3.9,4,4,0,3,1,1,1,100.0,0,2,0,2,1,5,2,0
1394,Kenny Lala,34.0,78,45,48,23,7,30,53,56.6,23,26,9,17,28,106,62,2
1395,Adam Lallana,5.2,16,9,6,7,3,5,12,41.7,7,10,1,9,5,21,4,0
1396,Erik Lamela,10.8,17,13,6,7,4,5,14,35.7,9,14,0,14,7,24,1,0
1397,Mohamed Lamine Diaby,1.8,1,1,0,1,0,1,1,100.0,0,2,0,2,2,3,0,0
1398,Loick Landre,17.7,31,21,23,8,0,14,22,63.6,8,16,11,5,38,69,83,1
1399,Michael Lang,13.9,14,9,7,6,1,6,16,37.5,10,14,3,11,16,30,42,1
1400,Sebastian Langkamp,15.7,24,15,18,6,0,7,14,50.0,7,17,11,6,20,44,79,1
1401,Manuel Lanzini,7.6,12,7,5,6,1,5,18,27.8,13,3,1,2,9,21,7,1
1402,Gianluca Lapadula,4.5,2,1,2,0,0,1,5,20.0,4,2,0,2,1,3,2,0
1404,Aymeric Laporte,34.0,42,20,27,14,1,22,34,64.7,12,16,9,7,39,81,98,2
1405,Danilo Larangeira,34.2,40,26,29,11,0,20,30,66.7,10,52,39,13,37,77,182,3
1406,Johan Larsson,1.0,1,1,0,1,0,1,2,50.0,1,0,0,0,1,2,1,1
1407,Kevin Lasagna,27.3,6,1,0,3,3,2,12,16.7,10,20,2,18,8,14,35,0
1408,Jamaal Lascelles,30.5,32,21,25,5,2,11,14,78.6,3,43,28,15,39,71,218,3
1409,Paul Lasne,19.9,53,33,32,16,5,24,43,55.8,19,22,2,20,22,75,23,1
1410,Toni Lato,3.0,6,4,4,1,1,1,5,20.0,4,9,3,6,6,12,13,0
1411,Danny Latza,20.7,41,22,16,23,2,20,61,32.8,41,49,10,39,20,61,31,0
1412,Alexandre Lauray,2.9,11,6,9,2,0,6,8,75.0,2,2,0,2,4,15,10,0
1414,Vincent Laurini,10.2,13,5,6,5,2,6,10,60.0,4,11,5,6,13,26,30,0
1415,Wesley Lautoa,33.6,81,55,46,31,4,34,75,45.3,41,37,14,23,87,168,110,1
1416,Diego Laxalt,7.2,26,13,14,7,5,13,22,59.1,9,23,3,20,8,34,12,0
1417,Miguel Layun,5.6,8,2,0,7,1,2,6,33.3,4,8,2,6,1,9,10,0
1418,Valentino Lazaro,30.5,46,31,23,17,6,21,53,39.6,32,52,12,40,44,90,65,0
1419,Darko Lazovic,28.2,28,17,13,8,7,14,31,45.2,17,21,6,15,20,48,33,0
1420,Manuel Lazzari,31.5,29,17,16,10,3,13,24,54.2,11,26,5,21,20,49,51,1
1421,Mickael Le Bihan,2.3,1,1,0,1,0,1,2,50.0,1,1,0,1,1,2,1,0
1422,Maxime Le Marchand,25.0,56,36,45,11,0,23,47,48.9,24,30,16,14,54,110,129,2
1423,Robin Le Normand,3.2,5,2,2,3,0,1,3,33.3,2,3,0,3,4,9,13,1
1424,Damien Le Tallec,31.2,95,58,42,43,10,33,89,37.1,56,35,8,27,59,154,50,0
1425,James Lea Siliki,13.6,26,17,13,10,3,12,35,34.3,23,14,1,13,10,36,7,1
1426,Rafael Leao,14.3,5,2,0,4,1,2,15,13.3,13,13,4,9,4,9,12,0
1427,Mathew Leckie,10.5,20,13,5,10,5,7,16,43.8,9,10,1,9,13,33,16,0
1428,Benjamin Lecomte,37.0,1,0,1,0,0,1,3,33.3,2,0,0,0,5,6,24,3
1430,Pierre Lees-Melou,26.6,74,46,31,36,7,25,62,40.3,37,44,8,36,36,110,37,0
1431,Jordan Lefort,20.0,33,18,23,6,4,16,25,64.0,9,11,8,3,46,79,107,0
1432,Wu Lei,11.8,13,6,5,6,2,5,16,31.3,11,9,0,9,7,20,7,0
1433,Tim Leibold,30.7,62,42,45,16,1,33,71,46.5,38,23,3,20,38,100,57,0
1434,Lucas Leiva,22.1,91,54,40,46,5,38,79,48.1,41,27,11,16,52,143,43,3
1435,Florian Lejeune,11.7,25,15,17,7,1,11,24,45.8,13,16,5,11,21,46,49,0
1436,Inigo Lekue,2.3,5,2,3,2,0,2,7,28.6,5,4,0,4,4,9,11,0
1437,Thomas Lemar,20.2,38,21,23,11,4,19,42,45.2,23,26,1,25,22,60,7,1
1438,Mario Lemina,17.9,49,32,23,23,3,15,34,44.1,19,27,3,24,43,92,31,1
1439,Mauricio Lemos,2.0,2,1,2,0,0,1,2,50.0,1,2,1,1,3,5,10,1
1440,Clement Lenglet,21.5,47,29,26,19,2,22,36,61.1,14,30,20,10,21,68,70,0
1441,Aaron Lennon,13.5,26,16,11,12,3,6,14,42.9,8,24,0,24,10,36,18,0
1442,Bernd Leno,31.5,0,0,0,0,0,0,3,0.0,3,0,0,0,4,4,16,6
1443,Pedro Leon,4.7,7,4,2,2,3,4,7,57.1,3,10,0,10,4,11,2,0
1444,Sergio Leon,7.1,4,2,2,1,1,2,8,25.0,6,4,0,4,2,6,6,0
1445,Lukas Lerager,12.5,34,18,12,20,2,13,42,31.0,29,11,1,10,18,52,12,0
1446,Lukas Lerager,14.4,38,21,14,23,1,18,43,41.9,25,22,10,12,32,70,26,1
1447,Mehdi Leris,17.9,53,33,19,24,10,24,54,44.4,30,34,1,33,28,81,24,1
1448,Jefferson Lerma,27.8,45,31,20,20,5,14,54,25.9,40,35,19,16,54,99,88,1
1449,Robert Lewandowski,32.9,12,9,0,8,4,3,11,27.3,8,11,1,10,7,19,15,0
1450,Igor Lewczuk,5.0,12,7,8,2,2,1,4,25.0,3,2,2,0,4,16,27,0
1451,Aaron Leya Iseka,16.0,6,4,1,4,1,1,4,25.0,3,5,3,2,1,7,10,0
1452,Stephan Lichtsteiner,10.4,15,9,5,4,6,9,16,56.3,7,11,4,7,9,24,25,1
1453,Dimitri Lienard,14.3,33,18,20,9,4,21,45,46.7,24,11,2,9,18,51,22,0
1454,Philipp Lienhart,6.8,6,6,4,2,0,3,6,50.0,3,9,7,2,11,17,42,0
1456,Lucas Lima,27.7,49,28,26,15,8,20,53,37.7,33,39,3,36,29,78,62,1
1457,Anthony Limbombe,13.7,12,10,4,6,2,7,16,43.8,9,5,0,5,8,20,10,0
1458,Victor Lindelof,28.9,40,27,28,12,0,13,23,56.5,10,21,12,9,24,64,121,3
1459,Karol Linetty,27.9,72,48,26,32,14,15,69,21.7,54,39,4,35,25,97,17,0
1460,Jesse Lingard,18.5,29,18,8,11,10,7,28,25.0,21,18,2,16,10,39,9,1
1461,Pol Lirola,33.1,35,22,19,11,5,21,34,61.8,13,25,5,20,32,67,89,0
1462,Adem Ljajic,0.3,0,0,0,0,0,0,1,0.0,1,0,0,0,0,0,0,0
1463,Diego Llorente,19.5,26,15,16,8,2,17,29,58.6,12,27,15,12,26,52,83,2
1464,Fernando Llorente,7.7,4,2,3,0,1,2,3,66.7,1,7,2,5,1,5,10,0
1465,Marcos Llorente,6.0,16,12,7,7,2,8,18,44.4,10,8,0,8,7,23,12,0
1466,Hugo Lloris,33.0,1,0,1,0,0,0,2,0.0,2,0,0,0,0,1,13,5
1467,Giovani Lo Celso,26.6,52,31,16,28,8,9,35,25.7,26,24,1,23,17,69,8,0
1468,Giovani Lo Celso,0.1,1,1,0,0,1,0,1,0.0,1,0,0,0,0,1,0,0
1469,Stanislav Lobotka,27.7,30,19,10,17,3,9,32,28.1,23,15,1,14,26,56,18,1
1470,Jurgen Locadia,13.7,15,10,5,8,2,3,7,42.9,4,8,0,8,9,24,13,0
1471,Manuel Locatelli,20.5,44,28,19,15,10,13,29,44.8,16,21,3,18,27,71,33,1
1472,Ruben Loftus-Cheek,11.1,18,12,7,7,4,3,12,25.0,9,10,4,6,11,29,5,0
1473,Enzo Loiodice,9.4,25,14,8,15,2,10,21,47.6,11,7,0,7,11,36,7,0
1474,Kevin Long,5.7,18,10,13,5,0,7,17,41.2,10,7,5,2,7,25,35,1
1475,Shane Long,14.1,15,8,4,5,6,3,16,18.8,13,10,1,9,7,22,18,0
1476,Samuele Longo,6.2,4,3,2,2,0,0,6,0.0,6,4,0,4,1,5,7,0
1477,Sean Longstaff,7.6,17,13,6,11,0,9,24,37.5,15,19,4,15,10,27,7,0
1478,Ademola Lookman,6.9,15,7,7,5,3,4,6,66.7,2,10,0,10,7,22,2,0
1479,Anthony Lopes,34.0,1,0,1,0,0,1,3,33.3,2,3,0,3,2,3,16,3
1480,Rony Lopes,20.5,33,22,10,17,6,9,22,40.9,13,17,1,16,8,41,10,0
1482,Alex Lopez,1.2,3,1,1,2,0,2,3,66.7,1,0,0,0,3,6,1,0
1483,Cristian Lopez,4.1,6,3,1,2,3,1,8,12.5,7,4,0,4,1,7,2,0
1484,David Lopez,20.2,27,18,15,10,2,10,22,45.5,12,18,12,6,28,55,65,2
1486,Javi Lopez,21.6,63,40,37,22,4,28,60,46.7,32,27,5,22,40,103,90,0
1487,Lluis Lopez,5.8,5,3,4,1,0,3,6,50.0,3,6,2,4,7,12,21,0
1488,Maxime Lopez,24.2,46,24,17,23,6,19,53,35.8,34,10,2,8,20,66,8,0
1489,Pedro Lopez Munoz,5.2,5,3,5,0,0,3,7,42.9,4,8,3,5,8,13,7,0
1490,Pau Lopez,33.0,0,0,0,0,0,0,2,0.0,2,1,0,1,2,2,17,2
1491,Roberto Lopez,0.3,0,0,0,0,0,0,1,0.0,1,1,0,1,1,1,2,0
1492,Unai Lopez,3.6,7,5,3,2,2,2,12,16.7,10,10,3,7,1,8,2,0
1493,Jonas Lossl,30.9,0,0,0,0,0,0,1,0.0,1,1,0,1,2,2,12,2
1494,Albert Lottin,0.2,1,1,0,1,0,0,1,0.0,1,1,0,1,0,1,0,0
1495,Imran Louza,1.0,2,0,1,1,0,1,1,100.0,0,1,0,1,0,2,1,0
1497,Dejan Lovren,11.0,15,9,10,5,0,7,15,46.7,8,11,7,4,11,26,51,2
1498,Chris Lowe,22.9,34,18,17,15,2,12,33,36.4,21,21,3,18,23,57,56,0
1499,Eduard Lowen,18.0,30,22,14,13,3,11,34,32.4,23,15,2,13,8,38,23,0
1500,Matthew Lowton,19.4,56,35,21,31,4,32,60,53.3,28,29,7,22,30,86,80,1
1501,Anthony Lozano,8.1,6,5,3,3,0,0,6,0.0,6,7,1,6,0,6,6,0
1502,Derrick Luckassen,2.8,4,2,4,0,0,1,3,33.3,2,1,0,1,0,4,13,0
1503,Filipe Luis,22.6,66,36,33,25,8,32,58,55.2,26,18,3,15,44,110,47,0
1504,Jose Luis Gaya,34.9,83,59,56,20,7,46,80,57.5,34,48,6,42,43,126,105,1
1505,Jose Luis Morales,35.5,21,15,6,10,5,8,49,16.3,41,22,1,21,12,33,17,0
1506,Jose Luis Palomino,25.1,49,31,31,15,3,23,38,60.5,15,34,17,17,68,117,79,0
1508,Luisinho,5.6,14,10,9,5,0,10,17,58.8,7,6,1,5,16,30,17,0
1509,David Luiz,36.0,41,31,27,13,1,21,28,75.0,7,33,18,15,35,76,149,1
1510,Douglas Luiz,16.6,34,19,13,20,1,9,38,23.7,29,19,7,12,21,55,26,0
1511,Everton Luiz,3.5,11,6,5,5,1,4,7,57.1,3,9,1,8,3,14,7,2
1512,Jordan Lukaku,1.9,4,3,2,1,1,3,5,60.0,2,3,0,3,5,9,2,0
1513,Romelu Lukaku,23.7,8,4,0,6,2,2,10,20.0,8,12,1,11,2,10,19,0
1514,Dodi Lukebakio,21.9,25,17,11,6,8,8,15,53.3,7,13,0,13,9,34,19,0
1515,Sasa Lukic,11.0,21,11,5,11,5,5,16,31.3,11,13,4,9,12,33,11,0
1516,Senad Lulic,32.5,71,43,37,27,7,32,76,42.1,44,27,3,24,49,120,58,1
1517,Antonio Luna,14.0,14,10,6,7,1,6,23,26.1,17,22,7,15,15,29,48,1
1519,Sebastiano Luperto,8.1,8,6,5,2,1,2,5,40.0,3,7,3,4,13,21,30,0
1520,Fabian Lustenberger,24.1,45,30,23,21,1,15,33,45.5,18,39,18,21,39,84,108,2
1523,Lyanco,12.4,29,18,19,10,0,13,18,72.2,5,24,16,8,22,51,64,0
1524,Herve Lybohy,16.4,22,13,13,9,0,11,16,68.8,5,17,11,6,14,36,70,0
1525,Charalambos Lykogiannis,9.2,14,8,8,3,3,6,11,54.5,5,18,3,15,19,33,33,0
1526,Yann M'Vila,36.2,72,40,22,48,2,29,72,40.3,43,42,12,30,74,146,86,5
1527,Darwin Machis,5.1,7,6,4,3,0,0,4,0.0,4,6,0,6,2,9,8,0
1528,James Maddison,31.5,48,32,20,25,3,14,58,24.1,44,20,4,16,12,60,10,1
1530,Pablo Maffeo,6.6,15,13,10,5,0,6,13,46.2,7,8,4,4,13,28,17,0
1531,Francesco Magnanelli,20.7,52,33,29,22,1,22,49,44.9,27,18,5,13,24,76,38,2
1532,Giangiacomo Magnani,16.8,11,9,9,2,0,6,15,40.0,9,17,13,4,16,27,99,1
1534,Harry Maguire,28.8,31,17,21,9,1,11,17,64.7,6,32,18,14,36,67,155,4
1535,Riyad Mahrez,14.9,14,7,3,7,4,6,18,33.3,12,18,1,17,9,23,3,1
1536,Thiago Maia,11.3,32,19,17,13,2,13,33,39.4,20,14,5,9,23,55,23,0
1537,Raffaele Maiello,22.7,42,27,30,8,4,16,27,59.3,11,23,10,13,30,72,41,0
1538,Arne Maier,22.9,31,16,12,19,0,6,25,24.0,19,32,9,23,28,59,35,0
1539,Domenico Maietta,19.0,33,15,22,10,1,16,36,44.4,20,19,14,5,24,57,78,2
1541,Linton Maina,15.7,28,14,13,10,5,12,23,52.2,11,20,0,20,14,42,4,0
1542,Ainsley Maitland-Niles,11.0,33,22,19,12,2,14,28,50.0,14,22,4,18,19,52,15,2
1543,Josh Maja,2.2,2,1,1,1,0,0,1,0.0,1,1,0,1,0,2,0,0
1544,Abdul Majeed Waris,25.0,22,13,6,13,3,7,28,25.0,21,9,0,9,7,29,7,0
1545,Jean-Victor Makengo,11.4,10,8,3,6,1,1,5,20.0,4,5,1,4,9,19,5,0
1546,Nemanja Maksimovic,35.7,77,45,21,51,5,21,61,34.4,40,60,15,45,71,148,33,0
1547,Nikola Maksimovic,15.3,20,13,14,6,0,6,12,50.0,6,16,10,6,28,48,56,1
1548,Malcom,6.8,3,2,0,1,2,2,3,66.7,1,7,0,7,1,4,1,0
1549,Kevin Malcuit,20.1,43,31,23,14,6,23,36,63.9,13,18,4,14,44,87,67,0
1550,Yunus Malli,7.8,15,7,8,6,1,2,11,18.2,9,2,0,2,4,19,1,0
1551,Hugo Mallo,34.4,73,41,41,27,5,27,52,51.9,25,44,13,31,50,123,135,1
1552,Antonio Mance,0.6,1,1,0,0,1,1,2,50.0,1,0,0,0,0,1,0,0
1553,Vincent Manceau,31.0,98,65,64,23,11,33,62,53.2,29,41,10,31,44,142,87,0
1554,Gianluca Mancini,25.0,40,30,22,17,1,16,29,55.2,13,19,4,15,48,88,77,1
1555,Steve Mandanda,30.4,0,0,0,0,0,0,3,0.0,3,0,0,0,1,1,7,4
1556,Reinildo Mandava,1.1,3,2,1,2,0,2,3,66.7,1,1,0,1,1,4,0,0
1557,Aissa Mandi,34.0,52,34,27,20,5,12,29,41.4,17,39,23,16,41,93,71,2
1558,Rolando Mandragora,32.4,66,35,25,34,7,24,69,34.8,45,49,9,40,43,109,59,0
1560,Mario Mandzukic,22.4,34,25,13,15,6,9,18,50.0,9,17,5,12,13,47,22,0
1561,Sadio Mane,34.2,35,29,12,17,6,14,43,32.6,29,28,4,24,15,50,10,1
1562,Thomas Mangani,17.8,42,27,13,26,3,19,62,30.6,43,13,2,11,23,65,24,0
1563,Kostas Manolas,25.8,32,24,23,8,1,17,26,65.4,9,34,25,9,50,82,117,2
1564,Javier Manquillo,12.2,27,19,14,11,2,9,14,64.3,5,9,1,8,17,44,58,0
1565,Martin Mantovani,7.8,15,9,12,3,0,6,11,54.5,5,4,3,1,22,37,48,0
1568,Fran Manzanara,1.7,7,5,3,3,1,4,4,100.0,0,3,2,1,1,8,7,0
1569,Myziane Maolida,10.6,12,8,5,5,2,2,4,50.0,2,5,0,5,1,13,5,0
1570,Faitout Maouassa,23.7,55,30,35,15,5,23,39,59.0,16,24,5,19,23,78,81,1
1571,Fernando Marcal,9.8,25,16,17,7,1,12,15,80.0,3,9,3,6,30,55,42,0
1572,Ivan Marcano,9.0,8,4,4,4,0,5,8,62.5,3,13,6,7,24,32,45,0
1573,Marcelo,20.6,34,19,17,12,5,15,39,38.5,24,19,2,17,17,51,21,0
1574,Marcelo,32.0,48,33,29,17,2,19,24,79.2,5,30,22,8,62,110,152,2
1575,Solly March,27.4,56,24,27,16,13,19,45,42.2,26,34,4,30,27,83,44,0
1577,Gian Marco Ferrari,31.0,41,23,27,12,2,12,16,75.0,4,36,20,16,36,77,97,1
1578,Oscar de Marcos,26.9,60,32,34,17,9,29,62,46.8,33,29,4,25,27,87,62,0
1579,Georg Margreitter,22.9,39,24,28,8,3,31,38,81.6,7,29,26,3,26,65,141,0
1580,Miguel Mari,0.8,0,0,0,0,0,0,2,0.0,2,0,0,0,1,1,2,0
1581,Jose Maria Gimenez,19.7,26,15,20,6,0,13,26,50.0,13,27,14,13,44,70,128,2
1582,Mariano,5.0,2,1,1,1,0,0,3,0.0,3,2,0,2,0,2,2,0
1584,Adrian Mariappa,21.4,35,22,29,6,0,16,32,50.0,16,23,15,8,26,61,120,2
1586,Jordan Marie,20.0,52,28,15,31,6,21,58,36.2,37,28,5,23,40,92,32,0
1587,Adrian Marin,3.2,13,8,8,5,0,4,7,57.1,3,1,0,1,7,20,13,0
1588,Joao Mario,12.0,28,16,9,15,4,9,31,29.0,22,14,0,14,6,34,4,1
1589,Guillermo Maripan,22.3,46,26,34,12,0,26,38,68.4,12,35,19,16,40,86,133,2
1591,Marlon,16.8,29,18,25,3,1,15,21,71.4,6,22,12,10,24,53,39,0
1592,Marquinhos,29.9,65,41,34,28,3,31,52,59.6,21,30,13,17,44,109,84,1
1593,Roger Marti,21.0,8,6,1,4,3,1,19,5.3,18,14,1,13,4,12,9,0
1594,Anthony Martial,18.0,9,7,2,5,2,1,11,9.1,10,12,0,12,3,12,8,0
1595,Aaron Martin,32.0,55,30,29,21,5,20,38,52.6,18,38,11,27,38,93,75,1
1596,Jonas Martin,22.9,46,28,23,18,5,17,33,51.5,16,30,12,18,30,76,42,0
1597,Marvin Martin,6.9,2,1,0,2,0,0,6,0.0,6,2,1,1,2,4,1,0
1598,Inigo Martinez,32.2,53,26,36,16,1,23,37,62.2,14,24,14,10,69,122,144,0
1599,Javi Martinez,14.5,26,15,7,17,2,5,16,31.3,11,17,5,12,31,57,13,0
1600,Lautaro Martinez,14.9,6,5,0,2,4,2,6,33.3,4,16,0,16,3,9,7,0
1601,Pablo Martinez,31.3,51,34,34,17,0,30,49,61.2,19,37,23,14,52,103,132,1
1602,Gelson Martins,2.5,5,3,3,1,1,3,4,75.0,1,1,0,1,1,6,1,0
1603,Gelson Martins,15.4,20,12,8,7,5,13,32,40.6,19,9,1,8,8,28,7,0
1604,Adam Marusic,23.5,32,15,14,14,4,16,25,64.0,9,25,4,21,24,56,36,0
1605,Omar Mascarell,11.0,20,10,9,9,2,10,24,41.7,14,21,7,14,23,43,8,0
1606,Andrea Masiello,20.4,28,14,13,15,0,17,29,58.6,12,21,6,15,44,72,49,0
1607,Adam Masina,11.2,30,17,16,13,1,13,25,52.0,12,19,4,15,17,47,40,0
1609,Han-Noah Massengo,0.7,2,2,2,0,0,2,5,40.0,3,0,0,0,2,4,1,0
1610,Arthur Masuaku,19.5,57,25,38,13,6,31,56,55.4,25,27,6,21,36,93,72,0
1612,Jaime Mata,27.0,30,21,8,14,8,7,26,26.9,19,14,0,14,17,47,27,0
1613,Juan Mata,14.3,9,4,7,1,1,6,21,28.6,15,8,1,7,6,15,6,0
1615,Jean-Philippe Mateta,27.6,13,9,4,4,5,1,10,10.0,9,15,2,13,3,16,22,0
1617,Nemanja Matic,27.1,50,30,27,19,4,30,59,50.8,29,39,18,21,31,81,53,4
1618,Joel Matip,17.1,39,26,23,12,4,13,24,54.2,11,12,7,5,32,71,78,0
1619,Rabbi Matondo,2.1,4,1,4,0,0,1,5,20.0,4,2,0,2,0,4,1,0
1620,Alessandro Matri,6.7,2,1,0,0,2,0,3,0.0,3,4,2,2,4,6,7,0
1621,Federico Mattiello,14.8,33,20,19,9,5,15,23,65.2,8,9,3,6,20,53,43,0
1622,Blaise Matuidi,26.9,59,33,25,21,13,20,36,55.6,16,33,8,25,26,85,21,1
1623,Jose Mauri,2.3,8,4,2,6,0,2,6,33.3,4,0,0,0,5,13,0,0
1625,Konstantinos Mavropanos,1.6,1,0,0,1,0,1,1,100.0,0,1,1,0,7,8,5,0
1626,Alfie Mawson,12.6,11,7,7,4,0,6,10,60.0,4,20,17,3,19,30,64,1
1627,Philipp Max,28.5,35,24,17,15,3,21,39,53.8,18,16,3,13,22,57,46,1
1628,Alexandru Maxim,6.4,16,10,6,9,1,10,19,52.6,9,12,0,12,5,21,7,0
1629,Eric Maxim Choupo-Moting,8.9,9,4,3,2,4,2,9,22.2,7,7,0,7,3,12,4,0
1630,Borja Mayoral,18.0,9,4,1,6,2,5,16,31.3,11,10,1,9,5,14,5,0
1631,Robert Mazan,1.0,3,3,3,0,0,2,2,100.0,0,2,0,2,3,6,0,0
1632,Luca Mazzitelli,3.6,5,2,3,1,1,2,3,66.7,1,4,1,3,6,11,7,0
1633,Kylian Mbappe,26.0,8,4,2,1,5,1,6,16.7,5,2,0,2,5,13,2,0
1634,Ibrahima Mbaye,22.3,48,32,30,16,2,19,32,59.4,13,21,12,9,19,67,66,1
1635,Loic Mbe Soh,2.0,0,0,0,0,0,0,3,0.0,3,2,2,0,3,3,5,0
1636,Nolan Mbemba,4.0,14,8,10,4,0,6,9,66.7,3,4,1,3,10,24,4,2
1638,Adama Mbengue,8.2,48,32,34,12,2,19,26,73.1,7,15,4,11,7,55,22,0
1639,Isaac Mbenza,11.0,10,9,5,5,0,2,4,50.0,2,4,0,4,5,15,4,0
1640,Stephane Mbia,5.0,1,0,1,0,0,1,2,50.0,1,9,4,5,7,8,25,1
1641,Kara Mbodji,5.6,12,10,10,1,1,6,8,75.0,2,4,1,3,6,18,25,0
1642,Jordi Mboula,3.1,3,0,0,1,2,3,6,50.0,3,1,0,1,1,4,5,0
1643,James McArthur,34.0,84,51,38,32,14,30,78,38.5,48,64,22,42,39,123,55,0
1646,Kevin McDonald,9.3,15,11,6,8,1,5,13,38.5,8,8,2,6,9,24,22,0
1647,Levan Mchedlidze,2.3,1,1,0,0,1,0,1,0.0,1,2,0,2,0,1,5,0
1648,Weston McKennie,19.4,28,14,5,17,6,11,35,31.4,24,28,9,19,36,64,46,1
1649,Dwight McNeil,17.7,36,22,16,17,3,13,44,29.5,31,30,3,27,13,49,35,0
1650,Scott McTominay,9.6,10,9,3,6,1,4,10,40.0,6,9,4,5,15,25,16,0
1651,Iuri Medeiros,1.2,2,2,0,1,1,1,2,50.0,1,2,0,2,0,2,1,0
1652,Nicky Medja,0.5,1,0,0,0,1,1,2,50.0,1,0,0,0,0,1,0,0
1653,Alvaro Medran,12.8,15,8,5,6,4,6,21,28.6,15,10,1,9,17,32,9,0
1654,Ben Mee,38.0,55,24,38,17,0,35,44,79.5,9,59,50,9,48,103,235,4
1655,Riccardo Meggiorini,17.2,17,13,5,9,3,1,10,10.0,9,20,2,18,8,25,26,0
1656,Admir Mehmedi,18.8,46,28,19,19,8,18,44,40.9,26,25,0,25,12,58,9,0
1657,Soualiho Meite,29.5,46,21,13,22,11,23,46,50.0,23,46,6,40,29,75,26,0
1658,Farid El Melali,3.6,8,4,3,4,1,3,12,25.0,9,2,0,2,5,13,1,0
1659,Oscar Melendo,22.2,17,8,7,6,4,10,26,38.5,16,17,1,16,13,30,9,0
1660,Gonzalo Melero,14.9,26,23,5,19,2,11,48,22.9,37,14,4,10,2,28,23,0
1661,Arthur Melo,15.9,15,10,5,6,4,6,13,46.2,7,8,0,8,9,24,9,1
1662,Memphis,30.4,12,9,0,7,5,5,21,23.8,16,16,2,14,9,21,1,0
1664,Pedro Mendes,29.6,71,42,56,13,2,31,47,66.0,16,42,22,20,48,119,73,1
1665,Thiago Mendes,34.2,85,47,42,41,2,39,71,54.9,32,44,11,33,68,153,49,0
1666,Brais Mendez,26.1,61,31,23,29,9,14,53,26.4,39,32,3,29,24,85,24,0
1667,Nathaniel Mendez-Laing,10.9,34,25,18,12,4,12,26,46.2,14,17,1,16,13,47,20,0
1668,Stiven Mendoza,20.9,29,18,10,12,7,14,38,36.8,24,18,0,18,17,46,12,0
1669,Alexandre Mendy,8.5,5,3,0,4,1,3,8,37.5,5,3,0,3,1,6,6,0
1670,Benjamin Mendy,10.0,16,10,10,5,1,9,17,52.9,8,13,4,9,10,26,18,0
1671,Edouard Mendy,38.0,0,0,0,0,0,0,1,0.0,1,1,0,1,2,2,16,3
1672,Ferland Mendy,28.1,44,28,25,14,5,14,17,82.4,3,22,5,17,34,78,53,2
1673,Nampalys Mendy,23.2,33,18,16,16,1,6,22,27.3,16,24,8,16,26,59,26,2
1674,Hamza Mendyl,6.0,17,15,6,8,3,8,18,44.4,10,11,2,9,8,25,8,0
1675,Chris Mepham,9.4,9,3,9,0,0,7,11,63.6,4,12,5,7,14,23,57,2
1676,Gabriel Mercado,19.3,35,23,21,12,2,18,36,50.0,18,24,12,12,26,61,75,1
1678,Mehdi Merghem,8.0,25,18,15,7,3,11,21,52.4,10,14,1,13,9,34,6,0
1679,Mikel Merino,22.8,50,28,19,25,6,14,52,26.9,38,37,2,35,29,79,37,1
1680,Sabin Merino,3.3,1,1,0,0,1,1,1,100.0,0,1,0,1,0,1,4,0
1682,Dries Mertens,25.0,19,11,2,7,10,1,21,4.8,20,7,0,7,13,32,3,0
1683,Roque Mesa,19.4,46,27,16,22,8,15,38,39.5,23,16,0,16,14,60,12,4
1684,Lionel Messi,30.1,12,7,5,3,4,1,17,5.9,16,10,0,10,3,15,1,0
1685,Romain Metanire,3.5,12,9,10,1,1,5,7,71.4,2,4,3,1,6,18,13,0
1686,Thomas Meunier,17.9,44,33,25,15,4,21,35,60.0,14,13,2,11,19,63,29,0
1687,Mexer,27.4,23,12,18,5,0,12,18,66.7,6,26,18,8,30,53,125,0
1688,Max Meyer,15.7,33,18,14,18,1,11,20,55.0,9,6,0,6,15,48,19,0
1690,Matt Miazga,8.0,12,11,11,1,0,7,9,77.8,2,11,7,4,12,24,41,1
1691,Michel,28.4,60,38,25,31,4,18,73,24.7,55,40,4,36,43,103,30,1
1692,Clement Michelin,1.0,3,2,2,1,0,2,3,66.7,1,0,0,0,3,6,7,0
1694,Miguel,0.1,0,0,0,0,0,0,1,0.0,1,0,0,0,1,1,0,0
1695,Florian Miguel,12.4,19,16,13,6,0,7,11,63.6,4,15,7,8,21,40,47,0
1696,Nikola Milenkovic,33.4,59,40,36,21,2,17,33,51.5,16,39,21,18,48,107,143,0
1697,Arkadiusz Milik,26.6,19,9,1,8,10,1,20,5.0,19,7,2,5,3,22,15,0
1698,Sergej Milinkovic-Savic,26.6,44,28,17,21,6,23,60,38.3,37,28,4,24,27,71,48,0
1700,Luka Milivojevic,38.0,90,69,36,47,7,39,91,42.9,52,47,15,32,72,162,68,3
1701,Pere Milla,3.8,7,6,1,5,1,0,5,0.0,5,4,1,3,2,9,1,0
1703,James Milner,19.9,43,23,14,24,5,15,41,36.6,26,40,5,35,18,61,30,0
1704,Santi Mina,20.6,17,10,1,15,1,3,25,12.0,22,19,2,17,4,21,20,0
1705,Yerry Mina,9.9,14,7,8,6,0,6,9,66.7,3,11,5,6,8,22,54,3
1706,Tyrone Mings,1.6,4,3,3,1,0,2,3,66.7,1,5,2,3,6,10,8,0
1707,Ignasi Miquel,3.5,1,0,0,1,0,1,2,50.0,1,4,4,0,5,6,25,0
1708,Kevin Mirallas,14.4,17,7,8,4,5,6,15,40.0,9,17,0,17,4,21,10,0
1709,Jorge Miramon,27.7,73,55,49,17,7,34,53,64.2,19,34,11,23,44,117,65,1
1710,Miranda,12.9,11,7,7,4,0,4,8,50.0,4,11,7,4,14,25,48,2
1712,Virgil Misidjan,17.1,21,13,10,5,6,4,25,16.0,21,17,0,17,9,30,5,0
1713,Simone Missiroli,30.5,58,43,31,22,5,25,49,51.0,24,44,11,33,46,104,46,0
1714,Kostas Mitroglou,6.4,0,0,0,0,0,0,3,0.0,3,0,0,0,0,0,5,0
1716,Aleksandar Mitrovic,36.4,19,9,3,13,3,5,15,33.3,10,22,8,14,6,25,53,0
1717,Stefan Mitrovic,33.6,23,16,20,3,0,12,24,50.0,12,41,31,10,46,69,146,2
1718,Maximilian Mittelstadt,20.0,61,37,33,23,5,23,49,46.9,26,32,4,28,46,107,64,0
1719,Henrikh Mkhitaryan,18.2,28,22,8,17,3,6,22,27.3,16,34,2,32,16,44,13,0
1720,Luka Modric,29.0,49,30,11,25,13,14,48,29.2,34,20,3,17,31,80,7,1
1721,Kevin Mohwald,9.7,16,10,3,11,2,3,20,15.0,17,14,0,14,17,33,14,0
1722,Niklas Moisander,29.3,34,23,26,8,0,22,51,43.1,29,42,19,23,39,73,140,2
1724,Hakim El Mokeddem,0.3,1,1,1,0,0,0,1,0.0,1,0,0,0,0,1,1,0
1725,Jorge Molina,29.4,12,9,1,4,7,2,15,13.3,13,22,0,22,7,19,26,1
1726,Cristian Molinaro,12.9,15,10,7,7,1,3,9,33.3,6,11,4,7,15,30,43,0
1727,Victor Mollejo,0.7,0,0,0,0,0,0,2,0.0,2,0,0,0,0,0,0,0
1728,Florent Mollet,28.5,36,20,8,20,8,13,51,25.5,38,32,1,31,23,59,7,0
1730,Thomas Monconduit,31.3,76,47,38,33,5,26,63,41.3,37,46,17,29,36,112,77,1
1731,Kevin Monnet-Paquet,16.5,46,25,23,16,7,20,36,55.6,16,22,4,18,14,60,28,0
1732,Nacho Monreal,20.7,35,17,21,9,5,15,25,60.0,10,28,10,18,31,66,62,0
1733,Francisco Montero,4.5,8,4,5,3,0,5,6,83.3,1,10,4,6,5,13,18,1
1735,Martin Montoya,24.1,58,35,29,21,8,32,55,58.2,23,30,10,20,48,106,76,1
1736,Aaron Mooy,25.9,62,42,19,27,16,21,52,40.4,31,43,7,36,14,76,22,0
1737,Emre Mor,4.1,7,4,1,3,3,2,7,28.6,5,5,0,5,3,10,1,0
1738,Alfredo Morales,17.0,32,18,16,15,1,6,24,25.0,18,18,9,9,24,56,31,0
1739,Alvaro Morata,10.5,8,5,0,5,3,1,7,14.3,6,6,1,5,0,8,6,0
1740,Alvaro Morata,12.0,20,14,2,7,11,3,10,30.0,7,7,0,7,5,25,13,0
1742,Jan Moravek,8.4,38,21,17,16,5,19,42,45.2,23,21,1,20,9,47,13,0
1743,Steven Moreira,9.6,19,8,13,5,1,10,17,58.8,7,14,0,14,10,29,19,1
1744,Jeremy Morel,11.8,16,10,11,5,0,9,13,69.2,4,18,14,4,18,34,45,1
1745,Alberto Moreno,1.7,3,2,1,2,0,1,3,33.3,2,1,0,1,2,5,0,0
1746,Alex Moreno,34.8,63,40,41,18,4,29,53,54.7,24,35,9,26,41,104,97,0
1747,Gerard Moreno,25.7,22,12,2,15,5,8,27,29.6,19,23,9,14,9,31,39,0
1748,Hector Moreno,21.5,16,9,12,4,0,9,17,52.9,8,34,19,15,31,47,73,0
1750,Emiliano Moretti,22.3,30,21,21,9,0,13,20,65.0,7,14,6,8,24,54,65,1
1751,Wes Morgan,21.4,27,15,14,12,1,6,7,85.7,1,24,10,14,32,59,109,1
1752,Manu Morlanes,6.8,21,11,9,9,3,7,19,36.8,12,7,3,4,5,26,9,0
1753,Loren Moron,21.7,18,12,4,11,3,6,27,22.2,21,24,1,23,6,24,18,0
1754,Sean Morrison,33.8,35,17,29,4,2,15,28,53.6,13,47,30,17,52,87,204,5
1756,Lebo Mothiba,19.7,10,9,2,7,1,0,8,0.0,8,5,1,4,0,10,6,0
1758,Francois Moubandje,21.5,38,22,22,10,6,17,22,77.3,5,18,4,14,27,65,74,0
1759,Jessy Moulin,1.0,1,0,1,0,0,1,1,100.0,0,0,0,0,0,1,2,0
1760,Steve Mounie,19.8,9,6,3,4,2,2,12,16.7,10,10,1,9,5,14,15,0
1761,Lucas Moura,23.6,35,18,8,20,7,9,27,33.3,18,15,1,14,24,59,24,0
1762,Herman Moussaki,2.3,3,3,2,1,0,1,4,25.0,3,2,1,1,0,3,3,0
1763,Lys Mousset,4.1,3,1,1,1,1,1,4,25.0,3,3,0,3,1,4,3,0
1764,Joao Moutinho,33.7,113,58,50,56,7,44,126,34.9,82,56,11,45,40,153,50,0
1765,Samuel Moutoussamy,18.3,35,20,16,11,8,12,34,35.3,22,17,2,15,9,44,17,0
1766,Toni Moya,1.0,2,2,2,0,0,0,1,0.0,1,0,0,0,0,2,3,0
1768,Javi Moyano,23.3,25,17,17,6,2,15,30,50.0,15,20,9,11,25,50,88,2
1770,Ndombe Mubele,5.2,9,4,5,2,2,4,9,44.4,5,4,0,4,2,11,2,0
1771,Lukas Muhl,31.0,57,34,49,6,2,32,51,62.7,19,53,18,35,48,105,139,2
1772,Nordi Mukiele,13.6,38,21,23,12,3,19,22,86.4,3,17,3,14,24,62,35,0
1773,Florian Muller,24.0,1,1,1,0,0,1,2,50.0,1,0,0,0,3,4,8,5
1774,Nicolai Muller,10.0,18,9,7,7,4,8,27,29.6,19,9,1,8,1,19,7,0
1775,Nicolai Muller,2.4,4,2,3,1,0,1,2,50.0,1,4,1,3,0,4,0,0
1776,Thomas Muller,26.4,42,23,13,15,14,10,38,26.3,28,46,6,40,9,51,12,0
1778,Iker Muniain,26.5,29,20,10,14,5,6,29,20.7,23,17,3,14,12,41,6,0
1779,Marc Muniesa,15.6,49,34,27,17,5,15,28,53.6,13,18,6,12,37,86,49,1
1780,Aihen Munoz,10.6,13,8,11,2,0,10,19,52.6,9,19,9,10,7,20,26,0
1783,Alessandro Murgia,11.9,22,15,9,12,1,7,32,21.9,25,14,2,12,19,41,12,1
1785,Luis Muriel,16.0,19,11,4,13,2,6,18,33.3,12,10,0,10,3,22,1,0
1786,Luis Muriel,1.4,0,0,0,0,0,0,6,0.0,6,3,0,3,0,0,1,0
1787,Jeison Murillo,1.0,2,1,1,1,0,1,2,50.0,1,1,0,1,2,4,6,0
1788,Jeison Murillo,1.3,2,2,1,1,0,0,3,0.0,3,0,0,0,0,2,5,1
1789,Jacob Murphy,3.4,6,2,4,2,0,2,4,50.0,2,5,2,3,1,7,7,0
1790,Josh Murphy,20.2,26,17,15,7,4,9,29,31.0,20,30,0,30,11,37,17,0
1791,Glenn Murray,27.9,17,7,4,7,6,4,20,20.0,16,20,3,17,2,19,17,1
1792,Nicola Murru,32.6,83,59,42,25,16,41,54,75.9,13,50,22,28,41,124,99,0
1794,Mateo Musacchio,29.0,41,22,30,8,3,19,27,70.4,8,26,19,7,29,70,114,0
1795,Florent Muslija,7.5,16,10,8,6,2,8,12,66.7,4,4,0,4,3,19,4,0
1796,Juan Musso,29.0,0,0,0,0,0,0,1,0.0,1,0,0,0,0,0,10,4
1797,Shkodran Mustafi,29.0,62,45,42,17,3,31,40,77.5,9,34,17,17,58,120,168,1
1798,Damian Musto,18.7,52,34,22,27,3,16,33,48.5,17,30,11,19,34,86,54,1
1799,Yoshinori Muto,5.8,8,4,3,5,0,2,7,28.6,5,9,0,9,5,13,3,1
1801,Phillipp Mwene,3.0,7,2,3,4,0,5,6,83.3,1,6,0,6,6,13,10,0
1802,Obite N'Dicka,25.6,43,28,31,10,2,31,52,59.6,21,29,11,18,29,72,123,0
1803,Kevin N'Doram,2.2,5,4,1,4,0,3,5,60.0,2,1,1,0,5,10,8,1
1804,Abdallah N'dour,3.2,6,4,3,3,0,4,9,44.4,5,4,2,2,5,11,8,0
1805,Cheikh N'Doye,25.9,25,15,14,11,0,10,32,31.3,22,33,8,25,25,50,61,0
1806,Nathan N'Goumou,0.8,1,1,0,1,0,0,1,0.0,1,1,0,1,0,1,3,0
1807,Clinton N'Jie,4.0,7,4,2,3,2,3,3,100.0,0,2,0,2,2,9,0,0
1809,Georges-Kevin N'Koudou,0.3,2,1,0,0,2,1,1,100.0,0,2,0,2,0,2,0,0
1810,Stanley N'Soki,7.8,20,14,8,10,2,6,13,46.2,7,10,1,9,18,38,20,1
1811,Nacho,35.0,110,66,73,30,7,67,100,67.0,33,43,10,33,45,155,113,2
1812,Nacho,18.9,26,19,14,7,5,11,22,50.0,11,19,7,12,32,58,65,1
1813,Adam Nagy,10.8,29,21,15,13,1,11,21,52.4,10,13,5,8,25,54,12,2
1814,Radja Nainggolan,21.9,35,26,7,20,8,10,24,41.7,14,17,2,15,8,43,5,0
1815,Naldo,15.1,18,10,9,5,4,6,10,60.0,4,19,13,6,26,44,112,1
1816,Naldo,3.3,5,3,4,1,0,2,4,50.0,2,5,2,3,5,10,23,0
1817,Naldo,7.0,10,7,8,2,0,5,8,62.5,3,8,3,5,14,24,25,0
1820,Matija Nastasic,27.2,35,23,22,13,0,20,29,69.0,9,32,20,12,38,73,114,1
1821,Marc Navarro,0.9,4,2,3,1,0,3,4,75.0,1,0,0,0,0,4,4,0
1822,Ximo Navarro,28.1,57,35,44,12,1,32,45,71.1,13,25,11,14,47,104,143,1
1823,Jesus Navas,30.1,28,21,15,11,2,16,24,66.7,8,23,5,18,29,57,62,0
1825,Raul Navas,14.6,23,14,20,3,0,13,21,61.9,8,20,9,11,20,43,60,1
1826,Wilfred Ndidi,36.6,142,98,66,67,9,46,95,48.4,49,64,9,55,83,225,85,2
1828,Aly Ndom,4.0,11,9,5,5,1,3,7,42.9,4,6,2,4,3,14,9,1
1829,Tanguy Ndombele,29.9,66,43,21,35,10,22,54,40.7,32,29,9,20,30,96,13,3
1830,Angelo Ndrecka,1.0,1,1,1,0,0,1,2,50.0,1,3,2,1,0,1,1,0
1831,Reiss Nelson,7.1,17,10,8,4,5,2,13,15.4,11,12,1,11,5,22,2,0
1832,Neto,34.0,2,0,2,0,0,2,3,66.7,1,0,0,0,1,3,9,3
1834,Manuel Neuer,25.6,1,1,1,0,0,0,1,0.0,1,1,0,1,0,1,8,3
1835,Florian Neuhaus,22.9,22,15,9,9,4,10,36,27.8,26,20,1,19,10,32,23,0
1836,Ruben Neves,33.4,75,32,33,36,6,27,83,32.5,56,57,18,39,73,148,46,3
1837,Neymar,16.0,14,9,3,10,1,4,21,19.0,17,8,0,8,5,19,1,1
1838,Yeni Ngbakoto,6.3,9,4,4,3,2,4,8,50.0,4,7,0,7,4,13,2,0
1839,Moussa Niakhate,31.0,49,30,35,12,2,20,33,60.6,13,42,24,18,44,93,143,1
1840,M'Baye Niang,19.9,16,10,3,8,5,2,11,18.2,9,19,3,16,8,24,14,0
1841,Oumar Niasse,10.3,12,3,1,5,6,4,8,50.0,4,7,0,7,2,14,7,0
1842,Oumar Niasse,0.7,0,0,0,0,0,0,1,0.0,1,0,0,0,0,0,0,0
1843,Hans Nicolussi Caviglia,0.6,2,1,0,2,0,0,2,0.0,2,2,1,1,0,2,0,0
1844,Florian Niederlechner,10.8,7,5,1,4,2,0,5,0.0,5,12,4,8,6,13,10,0
1846,Saul Niguez,32.5,83,56,35,41,7,32,81,39.5,49,57,10,47,42,125,86,1
1847,Dimitris Nikolaou,3.9,5,3,3,2,0,1,2,50.0,1,2,2,0,2,7,14,0
1848,Casimir Ninga,27.4,53,30,23,21,9,20,49,40.8,29,22,1,21,22,75,12,0
1850,Nicolas Nkoulou,35.7,45,29,34,10,1,15,25,60.0,10,42,28,14,70,115,174,2
1851,Christopher Nkunku,12.8,21,16,8,10,3,7,16,43.8,9,12,2,10,9,30,7,1
1852,Mark Noble,25.5,47,26,19,24,4,17,52,32.7,35,17,2,15,21,68,13,0
1853,Peru Nolaskoain,5.2,11,8,7,4,0,5,9,55.6,4,11,6,5,10,21,18,0
1854,Nolito,0.8,3,2,1,1,1,1,2,50.0,1,2,0,2,0,3,1,0
1855,Arnaud Nordin,11.7,14,12,4,4,6,4,11,36.4,7,13,2,11,5,19,9,0
1856,Havard Nordtveit,4.0,9,4,8,1,0,4,5,80.0,1,3,3,0,8,17,15,1
1857,Havard Nordtveit,5.2,8,5,2,4,2,3,7,42.9,4,8,5,3,4,12,14,0
1859,Alexander Nubel,17.6,0,0,0,0,0,0,1,0.0,1,0,0,0,1,1,4,1
1860,Kasim Nuhu,10.0,19,11,14,3,2,10,23,43.5,13,11,5,6,23,42,44,0
1861,Unai Nunez,11.8,15,11,11,4,0,7,11,63.6,4,20,12,8,28,43,60,2
1863,Bram Nuytinck,23.6,50,35,34,13,3,25,33,75.8,8,44,27,17,29,79,126,0
1864,Gerzino Nyamsi,6.0,6,3,5,1,0,4,9,44.4,5,8,4,4,4,10,17,0
1865,Allan Nyom,19.0,32,24,20,10,2,12,17,70.6,5,7,2,5,20,52,35,0
1866,Steven Nzonzi,29.1,66,45,24,36,6,21,34,61.8,13,40,24,16,27,93,55,2
1867,Christian Norgaard,3.6,4,2,1,2,1,2,5,40.0,3,2,0,2,10,14,16,0
1869,Dimitri Oberlin,1.5,1,1,0,0,1,0,3,0.0,3,1,0,1,0,1,1,0
1870,Joel Obi,7.3,22,15,9,11,2,7,17,41.2,10,12,1,11,14,36,15,0
1872,Pedro Obiang,12.5,41,23,23,16,2,18,43,41.9,25,27,9,18,12,53,18,0
1873,Jan Oblak,37.0,1,0,1,0,0,1,1,100.0,0,0,0,0,1,2,13,1
1874,Lucas Ocampos,30.1,80,54,37,33,10,34,80,42.5,46,40,5,35,29,109,30,0
1875,Bastian Oczipka,20.8,41,27,20,19,2,21,26,80.8,5,23,5,18,24,65,24,2
1877,Denis Odoi,28.8,48,34,29,16,3,21,33,63.6,12,45,24,21,42,90,153,0
1878,Alvaro Odriozola,13.1,28,25,13,11,4,14,18,77.8,4,11,1,10,11,39,17,1
1879,Angelo Ogbonna,20.8,31,13,23,6,2,14,23,60.9,9,29,19,10,35,66,101,0
1880,Dani Ojeda,2.1,3,2,2,0,1,1,3,33.3,2,2,0,2,2,5,2,0
1881,Sheyi Ojo,5.2,8,6,2,4,2,2,8,25.0,6,1,0,1,3,11,2,0
1883,Stefano Okaka,10.8,13,7,4,5,4,2,8,25.0,6,6,1,5,0,13,16,1
1884,Shinji Okazaki,3.2,5,5,2,3,0,0,1,0.0,1,7,1,6,2,7,1,0
1885,Chima Okoroji,1.2,3,0,1,1,1,1,1,100.0,0,0,0,0,1,4,1,0
1886,Orji Okwonkwo,2.9,4,3,1,2,1,2,2,100.0,0,0,0,0,1,5,0,0
1887,Lucas Olaza,10.0,29,18,19,8,2,14,18,77.8,4,13,6,7,8,37,18,0
1888,Oier Olazabal,21.0,1,1,1,0,0,1,2,50.0,1,1,0,1,1,2,15,2
1889,Kiko Olivas,34.4,51,38,35,15,1,22,48,45.8,26,31,18,13,46,97,173,2
1890,Paulo Oliveira,24.9,49,39,33,16,0,28,44,63.6,16,25,10,15,36,85,116,0
1891,Mathias Olivera,11.2,24,17,11,8,5,10,18,55.6,8,25,2,23,10,34,22,0
1893,Robin Olsen,27.0,0,0,0,0,0,0,1,0.0,1,1,0,1,0,0,10,4
1894,Stephane Omeonga,0.6,1,1,1,0,0,0,1,0.0,1,1,0,1,0,1,2,0
1895,Kenneth Omeruo,27.0,49,27,41,8,0,20,29,69.0,9,23,11,12,37,86,159,3
1896,Prince Oniangue,26.0,59,33,22,34,3,24,57,42.1,33,30,10,20,29,88,42,0
1898,Karim Onisiwo,12.9,23,15,6,12,5,4,12,33.3,8,14,3,11,9,32,13,0
1899,Nicholas Opoku,10.1,16,9,15,1,0,10,17,58.8,7,8,5,3,18,34,29,0
1900,Willi Orban,22.8,49,26,31,15,3,24,38,63.2,14,33,15,18,36,85,140,0
1901,Fabian Orellana,30.4,44,21,14,16,14,9,42,21.4,33,17,0,17,19,63,4,0
1902,Divock Origi,4.1,6,1,2,3,1,1,4,25.0,3,2,0,2,0,6,2,0
1903,Riccardo Orsolini,21.8,40,24,16,18,6,9,39,23.1,30,23,2,21,14,54,25,1
1904,Yuya Osako,15.0,23,11,6,12,5,7,22,31.8,15,15,3,12,7,30,8,0
1905,David Ospina,16.2,1,0,1,0,0,1,1,100.0,0,0,0,0,0,1,7,1
1906,Matthias Ostrzolek,16.3,32,18,24,8,0,20,33,60.6,13,20,5,15,26,58,44,2
1907,Nicolas Otamendi,13.7,24,14,17,6,1,5,9,55.6,4,6,4,2,29,53,56,1
1908,Otavio,31.9,127,74,59,64,4,49,109,45.0,60,45,11,34,43,170,54,1
1909,David Otto,0.3,2,1,1,1,0,0,1,0.0,1,0,0,0,0,2,0,0
1910,Remi Oudin,29.0,51,32,25,18,8,20,45,44.4,25,29,5,24,42,93,34,0
1911,Adam Ounas,6.0,5,2,0,3,2,2,11,18.2,9,6,0,6,2,7,0,1
1912,Reece Oxford,5.6,12,9,9,3,0,4,6,66.7,2,10,9,1,11,23,39,0
1913,Alex Oxlade-Chamberlain,0.2,1,1,0,1,0,1,1,100.0,0,0,0,0,1,2,0,0
1914,Mikel Oyarzabal,35.0,36,20,15,15,6,12,49,24.5,37,54,3,51,14,50,26,0
1915,Ambroise Oyongo,23.7,44,21,23,16,5,20,38,52.6,18,26,6,20,38,82,60,0
1918,Mesut Ozil,19.3,12,5,6,3,3,3,21,14.3,18,10,2,8,4,16,5,0
1919,Levin Oztunali,10.2,17,7,5,9,3,4,18,22.2,14,14,2,12,7,24,10,0
1920,Pablo,21.5,26,15,22,3,1,13,23,56.5,10,28,22,6,32,58,173,2
1921,Fernando Pacheco,35.0,0,0,0,0,0,0,1,0.0,1,0,0,0,1,1,23,0
1922,Goncalo Paciencia,4.3,3,2,0,2,1,1,2,50.0,1,8,1,7,0,3,1,0
1924,Simone Padoin,21.3,34,25,12,18,4,14,33,42.4,19,18,5,13,14,48,54,0
1925,Luca Paganini,12.5,25,13,8,13,4,8,23,34.8,15,19,4,15,19,44,17,1
1926,Marko Pajac,8.2,7,7,2,3,2,5,11,45.5,6,3,0,3,7,14,18,0
1928,Vincent Pajot,7.9,18,14,6,8,4,4,14,28.6,10,9,0,9,8,26,6,0
1929,Rodrigo Palacio,25.9,24,13,8,12,4,4,34,11.8,30,35,0,35,5,29,13,0
1930,Federico Palacios Martinez,10.5,21,10,11,8,2,10,20,50.0,10,10,0,10,9,30,4,0
1931,Sergi Palencia,22.1,74,50,46,20,8,27,55,49.1,28,22,3,19,17,91,70,1
1932,Nicolas Pallois,24.0,77,48,60,17,0,40,69,58.0,29,30,14,16,34,111,114,0
1933,Emerson Palmieri,7.4,14,9,6,5,3,6,10,60.0,4,11,1,10,8,22,14,0
1934,Alberto Paloschi,9.6,13,9,3,5,5,1,2,50.0,1,2,0,2,1,14,0,0
1935,Goran Pandev,12.5,14,10,0,10,4,2,8,25.0,6,7,0,7,1,15,3,0
1936,Mickael Panos,0.3,1,0,0,1,0,1,2,50.0,1,2,0,2,1,2,0,0
1937,Sokratis Papastathopoulos,24.4,42,25,30,11,1,15,28,53.6,13,34,17,17,26,68,112,1
1939,Lucas Paqueta,9.4,18,9,9,8,1,7,24,29.2,17,12,0,12,4,22,11,2
1940,Gaetan Paquiez,14.8,43,29,30,10,3,23,48,47.9,25,24,6,18,22,65,50,0
1941,Ruben Pardo,15.2,11,7,2,9,0,4,17,23.5,13,14,6,8,21,32,9,0
1942,Leandro Paredes,13.9,34,19,16,15,3,13,30,43.3,17,17,5,12,14,48,20,2
1943,Daniel Parejo,34.0,73,42,41,24,8,31,90,34.4,59,41,7,34,46,119,26,2
1944,Vittorio Parigini,4.2,11,10,3,6,2,6,9,66.7,3,3,0,3,1,12,5,0
1945,Marco Parolo,28.5,68,45,24,37,7,18,56,32.1,38,48,11,37,28,96,56,0
1946,Thomas Partey,23.0,66,42,32,25,9,21,49,42.9,28,26,5,21,49,115,22,2
1947,Mario Pasalic,18.0,32,19,9,13,10,7,29,24.1,22,19,4,15,12,44,14,1
1948,Manuel Pasqual,14.9,26,19,12,11,3,17,45,37.8,28,7,0,7,11,37,31,0
1950,Javier Pastore,6.6,10,4,4,3,3,4,16,25.0,12,7,0,7,3,13,5,0
1951,Callum Paterson,22.2,21,14,7,7,7,5,26,19.2,21,23,2,21,8,29,29,0
1952,Patric,12.1,19,11,8,8,3,8,15,53.3,7,14,7,7,12,31,29,1
1953,Rui Patricio,37.0,2,0,2,0,0,2,3,66.7,1,0,0,0,1,3,7,4
1954,Paulinho,2.0,4,4,2,2,0,1,2,50.0,1,3,0,3,2,6,0,1
1955,Gabriel Paulista,29.1,29,16,20,6,3,14,28,50.0,14,37,21,16,70,99,162,1
1956,Benjamin Pavard,29.0,28,20,21,6,1,12,19,63.2,7,27,19,8,48,76,189,2
1957,Jiri Pavlenka,33.1,3,0,3,0,0,3,6,50.0,3,1,0,1,3,6,14,1
1958,Mateo Pavlovic,27.7,26,18,24,2,0,12,24,50.0,12,37,29,8,20,46,164,2
1959,Leonardo Pavoletti,30.4,32,21,6,17,9,6,16,37.5,10,12,3,9,7,39,26,0
1960,Dimitri Payet,21.2,11,9,2,8,1,5,22,22.7,17,14,0,14,8,19,8,0
1961,Nehuen Paz,1.3,2,1,2,0,0,1,2,50.0,1,3,1,2,0,2,2,0
1962,Alfonso Pedraza,23.3,59,44,34,19,6,22,62,35.5,40,33,7,26,29,88,55,0
1963,Pedro,19.8,27,14,11,10,6,9,35,25.7,26,13,2,11,18,45,8,1
1964,Joao Pedro,28.4,17,12,4,8,5,4,11,36.4,7,14,5,9,6,23,14,0
1965,Adria Pedrosa,8.5,14,9,11,2,1,7,14,50.0,7,10,4,6,8,22,27,0
1966,Stef Peeters,4.5,15,8,8,4,3,4,11,36.4,7,1,0,1,6,21,1,0
1967,Jordan Pefok,6.8,6,2,0,3,3,2,4,50.0,2,7,2,5,4,10,5,0
1969,Peter Pekarik,2.4,2,1,1,1,0,1,3,33.3,2,2,1,1,1,3,5,0
1970,Pele,5.2,8,7,3,5,0,2,6,33.3,4,2,1,1,3,11,10,0
1971,Yohann Pele,7.6,0,0,0,0,0,0,2,0.0,2,0,0,0,0,0,1,1
1974,Lorenzo Pellegrini,20.2,39,23,16,18,5,10,30,33.3,20,20,2,18,12,51,21,0
1976,Luca Pellegrini,10.4,28,19,16,11,1,14,25,56.0,11,13,3,10,18,46,22,0
1977,Luca Pellegrini,1.8,1,1,1,0,0,1,2,50.0,1,2,1,1,3,4,2,0
1978,Theo Pellenard,5.5,11,6,7,2,2,5,8,62.5,3,6,2,4,5,16,16,0
1979,Sergio Pellissier,10.6,4,3,1,1,2,3,4,75.0,1,8,1,7,2,6,8,0
1980,Andy Pelmard,3.1,5,5,3,2,0,1,4,25.0,3,0,0,0,3,8,3,0
1981,Lee Peltier,17.2,39,25,27,11,1,15,27,55.6,12,18,12,6,18,57,60,0
1982,Federico Peluso,15.1,23,14,15,5,3,13,16,81.3,3,8,3,5,23,46,70,0
1983,Ruben Pena,29.7,63,46,24,27,12,24,53,45.3,29,37,9,28,35,98,57,0
1984,Nicolas Pepe,36.9,27,10,6,15,6,8,35,22.9,27,33,0,33,13,40,11,1
1985,Pepin,0.9,4,2,3,1,0,1,4,25.0,3,0,0,0,3,7,0,0
1986,Andreas Pereira,6.7,8,6,5,2,1,4,15,26.7,11,9,2,7,11,19,8,1
1987,Matheus Pereira,13.7,16,11,4,8,4,2,13,15.4,11,15,2,13,14,30,7,0
1988,Pedro Pereira,15.4,20,14,15,2,3,11,19,57.9,8,10,5,5,14,34,55,1
1989,Ricardo Pereira,34.7,118,66,66,40,12,54,112,48.2,58,60,6,54,60,178,130,1
1990,Roberto Pereyra,31.3,21,12,10,10,1,7,24,29.2,17,26,0,26,24,45,27,2
1991,Ayoze Perez,32.4,59,22,24,28,7,17,63,27.0,46,55,4,51,42,101,33,1
1993,Hernan Perez,8.8,13,10,8,3,2,6,27,22.2,21,14,3,11,5,18,13,0
1994,Lucas Perez,5.3,6,4,3,2,1,1,3,33.3,2,2,1,1,2,8,2,0
1995,Ruben Perez,27.5,71,42,27,40,4,32,80,40.0,48,35,8,27,40,111,34,1
1996,Stipe Perica,5.3,5,3,2,2,1,1,3,33.3,2,3,1,2,0,5,4,0
1998,Ivan Perisic,30.0,34,26,7,20,7,16,51,31.4,35,40,4,36,23,57,55,0
1999,Diego Perotti,7.4,14,12,5,5,4,6,19,31.6,13,4,0,4,4,18,2,0
2000,Loic Perrin,30.0,53,36,34,17,2,20,33,60.6,13,37,24,13,44,97,118,2
2003,Matteo Pessina,2.6,4,2,0,4,0,2,3,66.7,1,2,1,1,0,4,4,0
2004,Andrea Petagna,33.7,15,6,5,5,5,2,9,22.2,7,23,8,15,4,19,15,0
2005,Nils Petersen,21.4,29,21,10,16,3,4,24,16.7,20,28,2,26,13,42,34,0
2006,Ondrej Petrak,18.0,36,24,17,18,1,14,25,56.0,11,18,4,14,40,76,22,0
2007,German Pezzella,31.7,56,36,42,13,1,31,51,60.8,20,42,30,12,60,116,159,1
2008,Giuseppe Pezzella,2.0,5,4,4,1,0,2,8,25.0,6,2,1,1,1,6,9,0
2011,Maximilian Philipp,8.4,7,5,3,4,0,2,9,22.2,7,10,0,10,3,10,6,0
2012,Lebogang Phiri,21.4,60,38,16,41,3,24,43,55.8,19,26,3,23,29,89,19,0
2013,Krzysztof Piatek,17.7,9,4,2,5,2,1,15,6.7,14,18,3,15,3,12,19,0
2014,Krzysztof Piatek,15.3,8,6,2,1,5,3,10,30.0,7,7,2,5,1,9,15,0
2015,Pablo Piatti,8.3,21,15,8,10,3,8,16,50.0,8,15,0,15,2,23,8,0
2016,Lucas Piazon,0.9,2,0,1,1,0,0,2,0.0,2,1,0,1,1,3,0,0
2017,Cristiano Piccini,20.8,32,23,25,7,0,13,26,50.0,13,27,7,20,27,59,64,1
2018,Roberto Piccoli,0.5,2,2,0,1,1,1,1,100.0,0,1,0,1,0,2,0,0
2020,Jeremy Pied,5.2,12,8,5,6,1,3,9,33.3,6,8,1,7,5,17,13,0
2021,Ronael Pierre-Gabriel,3.9,13,8,10,2,1,9,10,90.0,1,3,1,2,3,16,18,0
2022,Erik Pieters,14.0,49,28,28,18,3,25,33,75.8,8,21,13,8,17,66,56,0
2023,Tomas Pina Isla,26.0,64,41,23,36,5,18,46,39.1,28,15,4,11,41,105,43,1
2024,Andrea Pinamonti,18.1,14,6,6,5,3,4,20,20.0,16,16,3,13,5,19,17,0
2029,Gerard Pique,35.0,42,27,25,17,0,24,37,64.9,13,41,27,14,36,78,154,5
2030,Facundo Piriz,1.3,9,6,3,4,2,4,9,44.4,5,2,1,1,0,9,2,0
2031,Fabio Pisacane,25.2,33,17,22,8,3,18,31,58.1,13,36,23,13,23,56,108,0
2032,Lukasz Piszczek,19.5,57,36,34,15,8,18,33,54.5,15,26,3,23,39,96,69,0
2033,Claudio Pizarro,7.7,10,6,4,2,4,4,7,57.1,3,14,1,13,1,11,7,0
2034,Marko Pjaca,8.3,9,4,3,4,2,2,6,33.3,4,2,0,2,7,16,6,0
2035,Miralem Pjanic,25.3,41,20,15,18,8,16,59,27.1,43,34,6,28,36,77,19,2
2036,Carles Planas,4.7,12,6,7,5,0,4,11,36.4,7,2,0,2,4,16,15,0
2037,Oscar Plano,29.9,63,45,23,28,12,14,48,29.2,34,19,3,16,22,85,28,1
2038,Jaroslav Plasil,16.0,34,26,11,20,3,18,44,40.9,26,21,5,16,19,53,28,1
2039,Marvin Plattenhardt,21.4,27,21,12,10,5,14,21,66.7,7,18,3,15,7,34,56,0
2041,Alassane Plea,27.8,14,10,7,4,3,5,22,22.7,17,17,2,15,3,17,15,2
2044,Paul Pogba,33.4,47,30,21,21,5,17,43,39.5,26,30,9,21,18,65,39,0
2045,Denis-Will Poha,0.3,0,0,0,0,0,0,1,0.0,1,0,0,0,1,1,1,0
2046,Andrea Poli,21.5,65,47,30,28,7,24,67,35.8,43,36,5,31,35,100,13,2
2047,Matteo Politano,28.3,18,7,9,4,5,8,30,26.7,22,18,0,18,14,32,10,1
2048,Pierre-Yves Polomat,10.6,18,13,11,6,1,10,18,55.6,8,4,2,2,21,39,27,0
2050,Pere Pons,31.0,83,46,34,38,11,30,82,36.6,52,48,12,36,35,118,39,0
2051,Pedro Porro,24.6,51,31,28,16,7,32,80,40.0,48,36,2,34,39,90,60,1
2052,Manolo Portanova,0.4,1,1,0,1,0,0,1,0.0,1,2,0,2,1,2,2,0
2054,Francisco Portillo,22.2,26,16,6,15,5,9,29,31.0,20,14,0,14,17,43,9,0
2055,Portu,31.3,33,24,8,15,10,12,43,27.9,31,16,1,15,8,41,5,0
2056,Stefan Posch,15.6,45,32,28,15,2,17,28,60.7,11,26,11,15,21,66,58,0
2057,Sergio Postigo,16.1,25,15,22,3,0,15,19,78.9,4,21,12,9,20,45,77,0
2058,Yussuf Poulsen,27.2,20,10,5,10,5,3,25,12.0,22,33,2,31,7,27,28,0
2059,Maxime Poundje,28.2,48,35,34,12,2,31,62,50.0,31,24,5,19,29,77,79,0
2061,Jose Pozo,18.0,13,10,4,5,4,4,25,16.0,21,7,1,6,4,17,6,0
2062,Dennis Praet,32.1,62,44,30,25,7,27,51,52.9,24,33,4,29,36,98,31,0
2063,Sanjin Prcic,5.9,18,13,7,9,2,5,11,45.5,6,11,7,4,11,29,11,1
2064,Sanjin Prcic,11.7,19,14,11,7,1,8,18,44.4,10,22,8,14,18,37,7,1
2065,Nicolas de Preville,14.1,28,19,10,15,3,8,29,27.6,21,23,1,22,10,38,21,1
2066,Edgar Prib,2.2,10,9,3,5,2,2,4,50.0,2,4,0,4,2,12,1,0
2067,Alex Pritchard,23.1,36,24,10,18,8,10,35,28.6,25,26,2,24,17,53,9,0
2069,Quincy Promes,17.6,35,25,23,9,3,15,22,68.2,7,19,3,16,25,60,22,1
2070,Davy Propper,28.3,50,28,23,21,6,16,52,30.8,36,21,6,15,53,103,37,0
2071,Silvio Proto,2.0,0,0,0,0,0,0,1,0.0,1,0,0,0,0,0,1,0
2072,Ivan Provedel,16.0,0,0,0,0,0,0,1,0.0,1,0,0,0,0,0,4,0
2073,Javi Puado,4.0,2,1,0,2,0,0,7,0.0,7,5,1,4,6,8,4,0
2074,Manuel Pucciarelli,3.4,4,2,2,1,1,2,5,40.0,3,5,0,5,3,7,4,0
2075,Riqui Puig,1.7,3,3,0,2,1,2,3,66.7,1,0,0,0,0,3,1,0
2076,Erick Pulgar,26.2,65,36,35,23,7,22,73,30.1,51,35,5,30,50,115,54,1
2077,Jorge Pulido,30.9,63,42,40,19,4,32,51,62.7,19,39,18,21,50,113,158,0
2078,Christian Pulisic,10.4,10,6,2,6,2,2,6,33.3,4,12,2,10,6,16,10,0
2081,Jason Puncheon,4.2,7,4,1,5,1,1,7,14.3,6,3,1,2,3,10,8,0
2082,Ignacio Pussetto,24.2,65,40,25,30,10,15,43,34.9,28,28,3,25,29,94,34,0
2083,Fabio Quagliarella,35.5,14,8,6,4,4,2,15,13.3,13,32,1,31,8,22,17,0
2084,Robin Quaison,24.4,19,12,3,10,6,5,12,41.7,7,9,1,8,7,26,4,0
2085,Collin Quaner,0.4,0,0,0,0,0,0,1,0.0,1,0,0,0,0,0,0,0
2086,Domingos Quina,3.8,9,7,3,5,1,3,11,27.3,8,6,0,6,3,12,1,0
2087,Xavi Quintilla,7.0,10,4,5,4,1,6,12,50.0,6,5,2,3,8,18,17,0
2088,Dani Raba,2.1,6,5,1,2,3,1,5,20.0,4,1,0,1,1,7,0,0
2089,Adrien Rabiot,11.8,35,20,13,17,5,9,12,75.0,3,9,2,7,10,45,20,0
2090,Nemanja Radonjic,7.6,8,5,1,5,2,5,16,31.3,11,3,0,3,5,13,4,0
2091,Ivan Radovanovic,14.2,20,12,11,8,1,8,17,47.1,9,12,4,8,13,33,20,1
2092,Ivan Radovanovic,19.0,27,22,20,7,0,11,31,35.5,20,19,7,12,26,53,36,0
2093,Ionut Radu,33.0,0,0,0,0,0,0,1,0.0,1,0,0,0,1,1,11,4
2094,Stefan Radu,24.9,43,27,24,15,4,25,38,65.8,13,20,14,6,42,85,85,1
2095,Rafael,11.4,31,19,14,12,5,17,24,70.8,7,19,2,17,15,46,30,2
2096,Raffael,6.0,8,4,2,4,2,2,7,28.6,5,5,0,5,1,9,0,0
2097,Rafinha,2.5,8,6,2,3,3,2,2,100.0,0,5,1,4,1,9,2,0
2098,Rafinha,10.0,15,7,6,6,3,6,14,42.9,8,8,3,5,19,34,11,0
2099,Andrea Raggi,5.5,7,5,7,0,0,6,6,100.0,0,1,0,1,7,14,21,0
2100,Baba Rahman,10.7,26,20,17,8,1,18,21,85.7,3,21,3,18,16,42,37,2
2101,Baba Rahman,1.8,3,1,1,1,1,1,1,100.0,0,3,0,3,2,5,2,0
2102,Ivan Rakitic,29.4,30,24,10,14,6,12,37,32.4,25,32,8,24,51,81,33,0
2103,Joe Ralls,21.8,45,23,21,21,3,10,33,30.3,23,21,6,15,29,74,30,0
2104,Jonas Ramalho,18.0,13,6,12,1,0,8,14,57.1,6,24,11,13,16,29,80,1
2106,Benito Raman,18.7,35,20,14,16,5,11,53,20.8,42,30,2,28,15,50,8,0
2107,Adil Rami,15.7,14,9,12,2,0,8,12,66.7,4,14,14,0,18,32,52,3
2108,Gaston Ramirez,17.5,38,22,12,18,8,11,31,35.5,20,28,4,24,8,46,27,0
2109,Sandro Ramirez,11.7,19,10,7,10,2,4,11,36.4,7,12,1,11,9,28,3,0
2110,Ivan Ramis,18.6,23,13,10,11,2,17,23,73.9,6,10,5,5,18,41,65,2
2111,Chris Ramos,0.7,1,1,0,0,1,1,1,100.0,0,0,0,0,0,1,1,0
2112,Sergio Ramos,27.5,41,32,25,12,4,22,39,56.4,17,29,15,14,37,78,90,2
2113,Aaron Ramsey,14.8,34,18,11,15,8,7,25,28.0,18,7,1,6,9,43,3,0
2115,Andrea Ranocchia,0.7,2,2,1,1,0,0,1,0.0,1,1,0,1,0,2,3,0
2116,Marcus Rashford,25.9,24,12,4,12,8,7,29,24.1,22,27,0,27,3,27,24,0
2117,Milot Rashica,17.2,24,16,8,11,5,9,24,37.5,15,16,2,14,6,30,6,1
2118,Jacob Rasmussen,11.3,18,12,10,6,2,5,14,35.7,9,18,13,5,12,30,55,1
2120,Yoric Ravet,0.8,2,1,1,0,1,1,2,50.0,1,2,1,1,0,2,1,0
2121,Tim Ream,22.7,23,14,16,7,0,14,28,50.0,14,19,10,9,25,48,80,2
2122,Ante Rebic,22.0,22,9,5,12,5,5,12,41.7,7,18,1,17,8,30,3,0
2123,Pedro Rebocho,36.0,61,35,31,22,8,29,54,53.7,25,48,13,35,40,101,92,1
2124,Arkadiusz Reca,0.5,2,0,1,0,1,0,1,0.0,1,0,0,0,3,5,0,0
2125,Recio,14.3,30,21,14,13,3,6,24,25.0,18,14,2,12,14,44,14,0
2126,Nathan Redmond,36.3,45,22,14,19,12,14,41,34.1,27,54,2,52,20,65,23,1
2127,Vasco Regini,0.9,1,0,0,1,0,1,3,33.3,2,2,1,1,0,1,4,0
2128,Sergio Reguilon,12.4,25,14,15,9,1,10,21,47.6,11,13,3,10,20,45,41,1
2129,Bobby Reid,15.8,16,9,6,7,3,3,8,37.5,5,13,0,13,3,19,12,0
2132,Jeff Reine-Adelaide,28.4,40,22,18,19,3,16,39,41.0,23,20,0,20,19,59,10,0
2133,Karim Rekik,23.0,36,22,23,12,1,12,18,66.7,6,24,16,8,34,70,88,0
2134,Loic Remy,13.4,2,1,0,2,0,0,3,0.0,3,3,1,2,2,4,17,1
2135,Michael Rensing,32.0,2,1,2,0,0,1,5,20.0,4,1,0,1,2,4,13,2
2136,Marco Reus,25.7,33,22,11,16,6,6,31,19.4,25,28,1,27,8,41,32,0
2137,Elvis Rexhbecaj,12.7,28,18,11,12,5,12,24,50.0,12,18,2,16,14,42,21,0
2138,Diego Reyes,3.6,7,4,4,3,0,3,4,75.0,1,4,4,0,7,14,17,1
2139,Baptiste Reynet,30.0,0,0,0,0,0,0,3,0.0,3,0,0,0,1,1,14,2
2140,Simon Rhein,5.5,7,4,7,0,0,2,7,28.6,5,6,1,5,7,14,6,0
2141,Franck Ribery,13.0,15,7,7,6,2,4,10,40.0,6,9,0,9,7,22,1,0
2142,Declan Rice,33.4,98,60,35,58,5,38,88,43.2,50,51,12,39,52,150,56,0
2143,Jazz Richards,1.5,0,0,0,0,0,0,1,0.0,1,2,1,1,2,2,5,0
2144,Richarlison,29.6,49,34,19,20,10,8,24,33.3,16,30,2,28,16,65,39,0
2145,Marco Richter,15.8,13,8,4,5,4,7,20,35.0,13,16,1,15,13,26,9,1
2146,Diego Rico,6.8,14,9,8,2,4,4,12,33.3,8,13,2,11,14,28,20,0
2147,Mikel Rico,2.7,5,2,1,4,0,2,7,28.6,5,3,2,1,2,7,3,0
2148,Sergio Rico,29.0,1,1,1,0,0,1,1,100.0,0,0,0,0,1,2,13,5
2149,Asier Riesgo,14.0,1,1,1,0,0,1,3,33.3,2,0,0,0,0,1,8,1
2151,Emiliano Rigoni,5.8,6,1,2,2,2,2,6,33.3,4,3,0,3,3,9,3,0
2152,Luca Rigoni,19.6,42,25,25,15,2,9,26,34.6,17,19,2,17,18,60,39,0
2153,Nicola Rigoni,21.7,43,25,22,15,6,22,51,43.1,29,20,5,15,23,66,45,1
2155,Tomas Rincon,31.1,75,44,25,41,9,31,68,45.6,37,35,5,30,42,117,71,1
2156,Renaud Ripart,33.4,76,49,41,22,13,32,76,42.1,44,43,7,36,27,103,79,0
2158,Mihailo Ristic,3.6,14,9,8,5,1,6,10,60.0,4,11,3,8,9,23,6,0
2159,Matt Ritchie,32.5,70,44,35,27,8,19,47,40.4,28,34,11,23,51,121,76,1
2160,Cristian Rivera,18.8,38,25,18,19,1,11,25,44.0,14,21,4,17,31,69,31,0
2161,Arjen Robben,6.3,3,1,0,3,0,0,1,0.0,1,6,1,5,3,6,0,0
2162,Rober,31.7,41,29,33,6,2,24,48,50.0,24,52,36,16,51,92,129,2
2163,Sergi Roberto,23.2,28,20,15,9,4,16,24,66.7,8,18,3,15,43,71,31,0
2164,Patrick Roberts,6.7,7,6,5,2,0,3,15,20.0,12,5,0,5,3,10,2,1
2165,Andrew Robertson,35.7,80,49,41,31,8,39,70,55.7,31,33,6,27,29,109,57,3
2166,Joel Robles,5.0,1,0,1,0,0,1,1,100.0,0,0,0,0,0,1,5,1
2167,Marc Roca,34.6,71,45,36,26,9,28,70,40.0,42,43,21,22,36,107,60,3
2170,Ruben Rochina,20.0,51,33,26,16,9,23,81,28.4,58,29,0,29,21,72,19,1
2171,Sebastian Rode,10.3,31,19,17,9,5,16,35,45.7,19,17,0,17,19,50,14,0
2172,Ronny Rodelin,8.8,13,5,2,7,4,3,8,37.5,5,8,1,7,8,21,13,0
2173,Rodri,30.4,103,70,45,50,8,39,75,52.0,36,35,11,24,41,144,68,0
2174,Rodrigo,28.1,21,10,6,9,6,3,17,17.6,14,17,1,16,3,24,18,0
2175,Kevin Rodrigues,5.4,21,11,14,6,1,9,17,52.9,8,13,3,10,8,29,15,0
2177,Angel Rodriguez,20.2,16,7,1,6,9,6,26,23.1,20,15,1,14,8,24,8,0
2178,Oscar Rodriguez Arnaiz,27.8,46,25,26,15,5,16,58,27.6,42,12,2,10,16,62,16,0
2179,James Rodriguez,12.6,12,8,3,4,5,5,19,26.3,14,9,0,9,4,16,1,0
2180,Ricardo Rodriguez,33.9,57,32,34,21,2,32,39,82.1,7,25,5,20,38,95,98,0
2181,Marko Rog,3.7,12,9,3,7,2,5,11,45.5,6,8,2,6,5,17,1,0
2182,Marko Rog,4.0,12,11,4,8,0,5,9,55.6,4,4,0,4,8,20,1,0
2184,Rogerio,29.7,55,38,35,13,7,30,55,54.5,25,32,7,25,37,92,109,1
2185,Marcos Rojo,2.4,5,3,3,2,0,1,6,16.7,5,3,2,1,6,11,9,1
2186,Diego Rolan,2.4,6,4,3,3,0,2,9,22.2,7,2,0,2,3,9,3,0
2187,Diego Rolan,3.3,7,4,3,1,3,0,2,0.0,2,1,0,1,1,8,4,0
2188,Rolando,8.9,18,7,15,3,0,8,10,80.0,2,8,6,2,11,29,25,0
2189,Esteban Rolon,11.6,46,29,14,20,12,20,44,45.5,24,18,2,16,16,62,12,0
2190,Filippo Romagna,16.4,14,9,10,4,0,4,8,50.0,4,20,12,8,19,33,68,0
2191,Alessio Romagnoli,31.6,34,19,26,6,2,16,19,84.2,3,48,32,16,37,71,173,1
2192,Alaixys Romao,35.1,118,71,61,50,7,43,102,42.2,59,44,16,28,58,176,65,1
2193,Cristian Romero,26.0,61,35,38,18,5,27,40,67.5,13,49,27,22,37,98,128,1
2194,Oriol Romeu,23.7,81,46,39,38,4,32,77,41.6,45,43,17,26,52,133,44,1
2195,Romulo,15.0,26,18,9,10,7,7,17,41.2,10,16,3,13,18,44,20,0
2196,Romulo,8.6,10,5,8,2,0,5,7,71.4,2,10,2,8,5,15,13,0
2197,Cristiano Ronaldo,29.9,10,7,5,4,1,1,11,9.1,10,7,2,5,6,16,32,0
2198,Facundo Roncaglia,6.7,13,10,8,5,0,4,6,66.7,2,4,2,2,10,23,22,0
2199,Facundo Roncaglia,11.9,34,22,26,8,0,17,24,70.8,7,12,5,7,20,54,51,2
2200,Salomon Rondon,28.9,8,3,2,4,2,4,24,16.7,20,14,3,11,5,13,39,0
2201,Valentin Rongier,35.8,86,54,24,46,16,26,65,40.0,39,46,6,40,33,119,19,0
2202,Marten de Roon,33.1,102,57,32,61,9,34,94,36.2,60,48,9,39,53,155,49,1
2203,Roberto Rosales,19.4,48,31,22,16,10,21,44,47.7,23,19,7,12,22,70,68,0
2204,Danny Rose,20.0,49,31,26,16,7,20,32,62.5,12,24,4,20,24,73,28,3
2205,Valentin Rosier,16.2,44,25,22,19,3,16,31,51.6,15,25,4,21,32,76,45,1
2206,Luca Rossettini,20.3,26,17,18,8,0,15,20,75.0,5,23,15,8,35,61,114,0
2208,Jerome Roussillon,27.3,42,29,25,15,2,20,30,66.7,10,50,7,43,31,73,54,0
2210,Nolan Roux,17.1,11,9,0,6,5,4,14,28.6,10,6,2,4,4,15,21,0
2212,Waldo Rubio,5.5,4,2,3,1,0,1,6,16.7,5,2,0,2,1,5,8,1
2214,Antonio Rudiger,31.9,34,16,27,6,1,15,27,55.6,12,15,8,7,32,66,96,1
2215,Sebastian Rudy,15.1,44,24,11,27,6,11,41,26.8,30,23,2,21,15,59,15,0
2216,Stephane Ruffier,37.0,2,2,2,0,0,2,4,50.0,2,0,0,0,0,2,18,3
2217,Daniele Rugani,15.0,8,5,5,3,0,2,5,40.0,3,19,14,5,16,24,51,1
2218,Mario Rui,15.7,24,18,9,12,3,14,25,56.0,11,15,3,12,21,45,38,0
2219,Abel Ruiz,0.2,1,1,1,0,0,1,1,100.0,0,0,0,0,0,1,0,0
2220,Fabian Ruiz Pena,22.1,54,33,22,25,7,20,46,43.5,26,23,4,19,21,75,29,2
2221,Victor Ruiz,21.9,28,19,20,6,2,13,18,72.2,5,28,16,12,38,66,67,1
2222,Geronimo Rulli,27.0,2,1,2,0,0,1,3,33.3,2,1,0,1,1,3,12,6
2224,Marco Russ,4.2,7,2,5,2,0,4,6,66.7,2,2,2,0,7,14,8,0
2225,Mathew Ryan,34.0,1,0,1,0,0,1,2,50.0,1,0,0,0,0,1,13,1
2228,Youssouf Sabaly,21.2,46,32,32,12,2,25,46,54.3,21,19,2,17,26,72,42,0
2230,Marcel Sabitzer,26.1,45,28,17,21,7,18,46,39.1,28,21,2,19,33,78,31,0
2231,Ihsan Sacko,4.9,7,2,2,5,0,2,5,40.0,3,5,0,5,2,9,2,0
2232,Nuri Sahin,16.4,60,33,22,33,5,23,59,39.0,36,30,3,27,37,97,39,1
2234,Wesley Said,25.0,25,18,6,11,8,5,20,25.0,15,9,0,9,9,34,9,0
2236,Allan Saint-Maximin,32.2,12,6,1,7,4,2,14,14.3,12,11,0,11,4,16,3,0
2238,Romain Saiss,12.8,39,26,23,14,2,20,37,54.1,17,25,12,13,26,65,61,0
2239,Samuel Saiz,3.4,4,3,0,3,1,2,5,40.0,3,1,0,1,0,4,2,0
2241,Hiroki Sakai,26.4,59,41,30,23,6,29,54,53.7,25,25,10,15,37,96,77,0
2243,Mamadou Sakho,26.8,25,16,22,3,0,11,18,61.1,7,26,16,10,41,66,136,2
2244,Bakary Sako,0.3,2,1,2,0,0,1,1,100.0,0,0,0,0,0,2,0,0
2245,Emiliano Sala,15.2,7,5,0,2,5,1,8,12.5,7,8,1,7,2,9,20,0
2246,Jacopo Sala,16.9,38,23,20,14,4,23,41,56.1,18,11,3,8,20,58,47,2
2247,Mohamed Salah,36.1,21,9,3,11,7,5,16,31.3,11,9,0,9,5,26,6,0
2248,Bartosz Salamon,19.2,17,10,12,5,0,6,14,42.9,8,27,19,8,27,44,143,1
2249,Carlos Salcedo,5.1,7,3,4,3,0,4,7,57.1,3,7,3,4,9,16,22,0
2250,William Saliba,14.2,32,20,28,4,0,16,24,66.7,8,11,10,1,28,60,44,2
2251,Yannis Salibur,9.8,9,5,1,7,1,1,7,14.3,6,6,0,6,8,17,4,0
2253,Roland Sallai,5.9,12,7,5,5,2,5,13,38.5,8,3,0,3,3,15,8,0
2254,Edgar Salli,1.3,2,1,1,1,0,0,1,0.0,1,0,0,0,1,3,1,0
2255,Brice Samba,38.0,1,0,1,0,0,0,1,0.0,1,0,0,0,1,2,12,4
2256,Junior Sambia,10.3,15,7,7,7,1,6,15,40.0,9,14,2,12,5,20,3,0
2257,Paolo Sammarco,6.1,16,7,7,6,3,6,9,66.7,3,5,0,5,3,19,1,2
2258,Frederic Sammaritano,6.0,11,5,5,5,1,5,13,38.5,8,8,1,7,8,19,2,1
2259,Mikel San Jose,19.3,43,25,19,19,5,15,48,31.3,33,27,6,21,21,64,35,0
2260,Antonio Sanabria,8.5,6,3,1,1,4,0,1,0.0,1,8,0,8,4,10,3,0
2262,Antonio Sanabria,9.0,8,6,0,5,3,1,6,16.7,5,8,2,6,3,11,4,0
2263,Renato Sanches,6.4,5,5,2,1,2,3,10,30.0,7,7,0,7,4,9,2,0
2264,Alexis Sanchez,9.8,17,10,5,9,3,5,13,38.5,8,7,0,7,9,26,2,0
2265,Carlos Sanchez,2.7,4,3,4,0,0,3,8,37.5,5,1,0,1,1,5,5,2
2266,Davinson Sanchez,21.6,37,20,28,9,0,20,37,54.1,17,17,9,8,30,67,103,2
2268,Victor Sanchez,14.1,45,30,21,17,7,14,67,20.9,53,17,2,15,25,70,25,0
2269,Jadon Sancho,27.3,19,10,7,6,6,10,31,32.3,21,21,1,20,14,33,12,1
2270,Sandro,6.6,18,10,10,8,0,7,13,53.8,6,14,5,9,11,29,16,0
2271,Sandro,7.9,27,17,12,11,4,9,17,52.9,8,9,4,5,20,47,25,0
2272,Alex Sandro,26.5,68,45,28,33,7,21,36,58.3,15,32,8,24,38,106,71,0
2273,Leroy Sane,20.7,24,15,8,7,9,2,23,8.7,21,21,2,19,8,32,2,0
2274,Salif Sane,29.0,54,37,34,19,1,27,46,58.7,19,44,29,15,68,122,146,3
2275,Luca Sangalli,11.1,19,13,6,11,2,5,22,22.7,17,9,1,8,5,24,5,0
2276,Ibrahim Sangare,27.4,102,66,50,44,8,32,63,50.8,31,52,20,32,29,131,49,2
2277,Younousse Sankhare,16.4,25,12,2,19,4,6,19,31.6,13,14,0,14,9,34,4,0
2278,Baissama Sankoh,7.2,4,1,4,0,0,1,4,25.0,3,8,1,7,5,9,16,0
2279,Yaya Sanogo,13.8,4,2,0,2,2,2,4,50.0,2,3,0,3,3,7,15,0
2280,Morgan Sanson,26.7,70,47,27,35,8,21,77,27.3,56,40,1,39,42,112,8,1
2281,Nicola Sansone,12.7,29,17,9,14,6,9,27,33.3,18,13,1,12,9,38,4,0
2283,Baptiste Santamaria,36.1,118,60,48,63,7,51,106,48.1,55,41,4,37,57,175,57,2
2285,Federico Santander,22.9,18,10,6,8,4,2,23,8.7,21,20,2,18,9,27,30,0
2286,Davide Santon,11.2,14,6,8,6,0,8,12,66.7,4,11,7,4,15,29,27,0
2288,Michael Santos,6.2,12,5,1,7,4,2,7,28.6,5,7,1,6,1,13,1,0
2289,Samir Santos,20.0,47,33,27,18,2,19,25,76.0,6,18,9,9,34,81,96,0
2290,Riccardo Saponara,10.1,12,6,2,6,4,3,12,25.0,9,5,1,4,4,16,10,0
2291,Pablo Sarabia,30.3,30,15,6,15,9,6,47,12.8,41,30,3,27,22,52,20,0
2292,Marcelo Saracchi,7.3,17,11,12,4,1,8,13,61.5,5,12,1,11,11,28,14,0
2293,Josh Sargent,2.4,2,1,1,0,1,2,2,100.0,0,2,0,2,0,2,3,0
2294,Bouna Sarr,24.9,67,48,27,27,13,26,42,61.9,16,28,3,25,39,106,56,1
2295,Ismaila Sarr,31.0,35,24,16,15,4,17,34,50.0,17,17,2,15,14,49,4,0
2296,Malang Sarr,33.3,59,36,38,17,4,31,57,54.4,26,29,12,17,68,127,107,2
2297,Lluis Sastre,1.3,5,3,0,5,0,0,1,0.0,1,0,0,0,1,6,0,0
2299,Marco Sau,6.2,4,2,0,2,2,0,3,0.0,3,5,0,5,1,5,4,0
2300,Teji Savanier,31.8,95,58,35,52,8,43,116,37.1,73,32,15,17,64,159,53,2
2301,Stefan Savic,15.5,11,10,9,2,0,7,12,58.3,5,13,9,4,22,33,67,0
2302,Fabian Schar,22.2,60,39,37,19,4,24,50,48.0,26,40,16,24,67,127,145,2
2303,Ezequiel Schelotto,1.6,3,0,3,0,0,2,3,66.7,1,1,0,1,2,5,8,0
2305,Pasquale Schiattarella,20.5,43,27,18,21,4,13,38,34.2,25,17,5,12,22,65,25,1
2306,Patrik Schick,14.6,11,5,3,5,3,1,19,5.3,18,19,2,17,3,14,15,1
2307,Julian Schieber,2.9,3,2,1,2,0,0,1,0.0,1,1,0,1,1,4,3,0
2308,Christopher Schindler,36.2,61,36,46,14,1,27,47,57.4,20,69,34,35,70,131,138,4
2309,Keven Schlotterbeck,8.6,22,16,19,2,1,8,12,66.7,4,17,11,6,13,35,26,0
2310,Nico Schlotterbeck,2.5,6,6,6,0,0,2,2,100.0,0,3,1,2,5,11,10,0
2311,Jeffrey Schlupp,18.6,41,20,18,18,5,10,27,37.0,17,30,8,22,19,60,27,1
2312,Kasper Schmeichel,38.0,1,1,1,0,0,1,1,100.0,0,0,0,0,3,4,14,3
2314,Marcel Schmelzer,6.3,10,5,7,2,1,5,9,55.6,4,7,1,6,9,19,14,0
2315,Jonathan Schmid,28.0,44,22,23,19,2,16,28,57.1,12,22,8,14,43,87,70,2
2316,Morgan Schneiderlin,9.3,24,16,11,11,2,6,14,42.9,8,16,3,13,15,39,16,0
2317,Alessandro Schopf,11.2,26,16,12,13,1,12,29,41.4,17,14,0,14,9,35,12,0
2318,Nico Schulz,28.2,34,20,19,12,3,15,36,41.7,21,32,4,28,24,58,36,0
2319,Andre Schurrle,18.2,30,19,14,10,6,12,42,28.6,30,16,1,15,8,38,17,1
2320,Pirmin Schwegler,23.1,63,34,30,29,4,34,60,56.7,26,21,5,16,41,104,54,0
2321,Alexander Schwolow,33.0,0,0,0,0,0,0,1,0.0,1,0,0,0,0,0,13,2
2322,Matteo Scozzarella,16.2,18,13,9,8,1,9,33,27.3,24,22,10,12,23,41,33,0
2323,Simone Scuffet,9.0,0,0,0,0,0,0,1,0.0,1,0,0,0,0,0,4,2
2326,Davie Selke,19.3,5,2,1,4,0,2,9,22.2,7,11,0,11,1,6,7,0
2327,Ole Selnaes,18.5,44,26,12,23,9,13,35,37.1,22,24,7,17,19,63,29,0
2328,Matz Sels,37.0,0,0,0,0,0,0,1,0.0,1,0,0,0,1,1,24,1
2329,Ken Sema,8.4,15,7,7,5,3,9,21,42.9,12,7,0,7,8,23,5,0
2330,Alfa Semedo,0.5,0,0,0,0,0,0,3,0.0,3,1,1,0,2,2,0,0
2331,Nelson Semedo,17.8,38,27,23,12,3,12,18,66.7,6,23,7,16,22,60,26,0
2332,Ruben Semedo,9.4,20,16,14,6,0,12,16,75.0,4,15,9,6,16,36,35,2
2334,Stefano Sensi,21.9,36,20,15,18,3,6,30,20.0,24,36,7,29,33,69,17,0
2335,Luigi Sepe,37.0,1,1,1,0,0,1,2,50.0,1,0,0,0,3,4,21,3
2336,Suat Serdar,19.2,51,32,20,26,5,14,49,28.6,35,37,6,31,23,74,5,1
2337,Jean Seri,24.9,41,28,20,20,1,13,45,28.9,32,40,9,31,32,73,17,4
2340,Julien Serrano,1.3,5,4,3,2,0,3,6,50.0,3,1,0,1,3,8,3,0
2341,Gregory Sertic,1.2,2,0,1,1,0,0,1,0.0,1,2,1,1,1,3,2,0
2342,Ryan Sessegnon,25.6,22,14,8,8,6,6,22,27.3,16,25,2,23,19,41,49,1
2343,Paik Seung-ho,0.7,0,0,0,0,0,0,1,0.0,1,1,0,1,3,3,1,0
2344,Stephan El Shaarawy,23.4,27,14,14,8,5,9,24,37.5,15,11,2,9,20,47,9,0
2346,Xherdan Shaqiri,11.8,14,4,3,9,2,9,19,47.4,10,6,1,5,6,20,6,0
2347,Luke Shaw,28.8,55,29,17,31,7,28,47,59.6,19,42,12,30,21,76,93,2
2348,Jonjo Shelvey,10.5,22,12,10,9,3,8,17,47.1,9,10,3,7,7,29,15,0
2349,Gaku Shibasaki,4.3,7,3,2,4,1,3,6,50.0,3,2,0,2,3,10,4,0
2350,Gen Shoji,18.0,24,13,16,8,0,11,24,45.8,13,22,14,8,21,45,56,0
2351,Djibril Sidibe,23.1,50,34,27,12,11,26,48,54.2,22,25,9,16,30,80,51,0
2352,Kalidou Sidibe,14.0,24,12,11,12,1,7,15,46.7,8,16,3,13,17,41,26,1
2353,Sidnei,19.4,48,29,33,12,3,18,34,52.9,16,21,8,13,41,89,57,0
2354,Francisco Sierralta,3.0,11,8,8,3,0,4,6,66.7,2,1,1,0,4,15,27,0
2355,Gylfi Sigurdsson,34.6,56,36,20,25,11,16,47,34.0,31,38,4,34,28,84,24,0
2356,Luca Siligardi,18.2,30,20,10,13,7,8,23,34.8,15,19,3,16,15,45,11,0
2357,Adrien Silva,1.0,2,2,0,1,1,0,2,0.0,2,1,0,1,1,3,1,0
2358,Adrien Silva,13.2,50,31,19,26,5,30,62,48.4,32,15,2,13,16,66,23,0
2359,Andre Silva,24.0,8,5,1,4,3,1,11,9.1,10,17,1,16,3,11,32,0
2360,Bernardo Silva,31.7,52,39,18,21,13,16,67,23.9,51,47,3,44,25,77,26,1
2361,David Silva,26.7,30,18,12,11,7,1,20,5.0,19,18,1,17,22,52,15,0
2362,Gabriel Silva,15.9,19,10,13,6,0,6,17,35.3,11,15,3,12,14,33,60,1
2363,Jonathan Silva,30.0,51,38,30,17,4,23,52,44.2,29,23,2,21,29,80,86,0
2364,Matheus Pereira da Silva,1.0,3,2,0,2,1,2,4,50.0,2,1,0,1,0,3,1,0
2366,Thiago Silva,23.1,16,13,7,8,1,6,11,54.5,5,28,20,8,32,48,99,1
2368,Matias Silvestre,34.0,31,17,22,5,4,17,26,65.4,9,29,24,5,21,52,165,0
2369,Giovanni Simeone,27.3,43,27,10,23,10,7,29,24.1,22,26,2,24,4,47,14,0
2370,Lorenco Simic,2.6,6,3,5,1,0,2,4,50.0,2,2,1,1,12,18,19,1
2371,Moses Simon,8.7,14,8,10,2,2,5,9,55.6,4,10,1,9,12,26,14,0
2372,Unai Simon,7.0,0,0,0,0,0,0,1,0.0,1,0,0,0,1,1,1,1
2373,Danny Simpson,3.2,11,3,8,3,0,3,5,60.0,2,7,3,4,6,17,20,0
2374,Jack Simpson,4.5,9,5,8,1,0,6,9,66.7,3,5,4,1,9,18,25,2
2375,Josh Sims,2.4,1,0,1,0,0,1,3,33.3,2,2,0,2,1,2,1,0
2377,Dimitris Siovas,32.9,57,32,38,18,1,27,47,57.4,20,32,15,17,65,122,155,1
2378,Salvatore Sirigu,35.2,0,0,0,0,0,0,2,0.0,2,0,0,0,2,2,21,1
2379,Ibrahima Sissoko,29.6,60,41,23,34,3,23,55,41.8,32,37,3,34,34,94,39,1
2380,Moussa Sissoko,25.9,36,25,18,14,4,15,29,51.7,14,31,4,27,16,52,25,2
2381,Pione Sisto,9.4,4,3,4,0,0,0,9,0.0,9,5,0,5,3,7,3,0
2383,Ellyes Skhiri,34.3,105,58,31,64,10,43,91,47.3,48,60,7,53,60,165,41,0
2384,Oliver Skipp,2.4,7,3,4,3,0,4,6,66.7,2,2,1,1,1,8,7,0
2386,Milan Skriniar,35.0,64,37,46,17,1,38,60,63.3,22,48,29,19,27,91,138,0
2387,Steven Skrzybski,7.4,9,3,0,6,3,3,11,27.3,8,8,1,7,3,12,2,0
2388,Petar Skuletic,6.7,9,5,4,2,3,1,15,6.7,14,7,1,6,3,12,14,1
2389,Callum Slattery,1.2,4,3,0,4,0,3,7,42.9,4,1,1,0,2,6,1,0
2390,Naim Sliti,25.4,56,33,24,19,13,15,46,32.6,31,18,0,18,11,67,9,0
2392,Chris Smalling,23.6,30,17,21,9,0,11,17,64.7,6,37,25,12,26,56,109,1
2393,Adam Smith,23.0,46,32,26,14,6,19,41,46.3,22,26,7,19,31,77,68,1
2394,Emile Smith Rowe,0.3,1,0,0,1,0,1,1,100.0,0,0,0,0,1,2,0,0
2395,Tommy Smith,12.7,26,13,14,11,1,10,25,40.0,15,12,4,8,18,44,25,0
2396,Robert Snodgrass,24.7,44,27,18,24,2,13,46,28.3,33,24,4,20,11,55,23,0
2397,Cedric Soares,16.6,22,16,15,6,1,9,15,60.0,6,21,5,16,22,44,60,2
2398,Cedric Soares,2.9,8,6,2,4,2,4,7,57.1,3,4,1,3,2,10,3,0
2400,Marcel Sobottka,10.5,30,20,12,18,0,10,19,52.6,9,13,5,8,24,54,17,0
2401,Ruben Sobrino,10.7,16,11,7,6,3,5,13,38.5,8,16,1,15,2,18,13,0
2402,Ruben Sobrino,2.1,6,3,1,4,1,1,1,100.0,0,1,1,0,1,7,1,0
2403,Danilo Soddimo,2.8,11,9,3,6,2,3,6,50.0,3,2,1,1,7,18,3,0
2404,Alex Sola,1.0,4,3,0,3,1,3,4,75.0,1,0,0,0,1,5,2,0
2405,Dominic Solanke,3.9,8,3,1,4,3,1,8,12.5,7,4,1,3,2,10,9,0
2406,Andres Solano,0.5,4,3,2,2,0,2,2,100.0,0,1,0,1,0,4,1,0
2407,Carlos Soler,27.3,41,28,15,23,3,16,65,24.6,49,46,6,40,19,60,37,0
2408,Oumar Solet,0.7,1,0,1,0,0,1,1,100.0,0,1,0,1,0,1,0,0
2409,Yann Sommer,34.0,2,2,2,0,0,2,2,100.0,0,1,0,1,1,3,12,5
2410,Kevin Soni,0.9,3,2,0,2,1,2,4,50.0,2,3,0,3,1,4,0,0
2411,Jeremy Sorbon,29.4,33,20,23,10,0,14,22,63.6,8,33,23,10,34,67,105,2
2412,Oliver Sorg,17.6,42,28,26,16,0,20,43,46.5,23,16,9,7,46,88,47,0
2413,David Soria,37.0,1,0,1,0,0,1,2,50.0,1,2,0,2,1,2,15,6
2415,Roberto Soriano,5.2,9,5,0,5,4,1,8,12.5,7,9,0,9,6,15,1,0
2416,Roberto Soriano,16.5,27,18,14,10,3,8,24,33.3,16,21,2,19,3,30,11,0
2418,Stefano Sorrentino,31.0,1,1,1,0,0,1,2,50.0,1,0,0,0,3,4,10,1
2419,Borna Sosa,6.8,13,7,8,4,1,4,9,44.4,5,5,1,4,6,19,34,0
2421,Riccardo Sottil,0.2,1,1,0,1,0,1,1,100.0,0,0,0,0,0,1,0,0
2423,Adama Soumaoro,19.1,14,11,12,2,0,4,6,66.7,2,21,18,3,21,35,92,1
2424,Boubakary Soumare,6.3,20,15,9,11,0,10,18,55.6,8,9,3,6,7,27,5,0
2425,Caglar Soyuncu,4.1,5,2,4,1,0,3,6,50.0,3,8,5,3,7,12,22,3
2427,Leonardo Spinazzola,6.7,9,4,4,2,3,4,8,50.0,4,5,0,5,3,12,7,0
2428,Nicolas Spolli,6.0,7,6,3,4,0,0,2,0.0,2,8,6,2,7,14,39,1
2429,Marco Sportiello,35.0,1,0,1,0,0,1,1,100.0,0,1,0,1,0,1,8,2
2430,Mattia Sprocati,7.2,10,4,5,5,0,5,11,45.5,6,6,0,6,7,17,6,0
2431,Bassem Srarfi,9.1,20,11,8,8,4,6,17,35.3,11,8,0,8,5,25,5,0
2432,Darijo Srna,23.2,24,16,6,13,5,9,14,64.3,5,24,5,19,18,42,66,0
2433,Kostas Stafylidis,10.2,22,14,17,4,1,10,19,52.6,9,13,2,11,15,37,31,0
2434,Benjamin Stambouli,19.6,51,31,24,24,3,25,46,54.3,21,41,9,32,32,83,65,2
2436,Junior Stanislas,11.5,12,6,5,4,3,3,7,42.9,4,8,1,7,2,14,15,0
2437,Niklas Stark,20.8,34,19,23,11,0,9,24,37.5,15,45,26,19,37,71,141,1
2438,Timo Stavitski,0.2,0,0,0,0,0,0,1,0.0,1,0,0,0,0,0,0,0
2439,Renato Steffen,16.7,26,17,5,17,4,7,17,41.2,10,13,2,11,16,42,14,0
2440,Marc Stendera,1.2,6,1,2,4,0,2,4,50.0,2,4,1,3,0,6,0,0
2441,Pascal Stenzel,16.1,42,26,26,14,2,24,43,55.8,19,16,3,13,30,72,48,1
2442,Dale Stephens,27.6,83,57,37,41,5,28,74,37.8,46,33,13,20,46,129,47,0
2444,Jack Stephens,18.9,25,13,17,7,1,16,28,57.1,12,25,13,12,37,62,96,2
2445,Mariusz Stepinski,27.5,18,13,1,11,6,1,17,5.9,16,10,2,8,5,23,20,0
2446,Raheem Sterling,30.8,32,16,11,12,9,9,25,36.0,16,28,3,25,17,49,4,0
2447,Lars Stindl,16.8,21,14,8,11,2,3,15,20.0,12,22,2,20,14,35,13,0
2448,Kevin Stoger,23.5,63,35,28,27,8,30,67,44.8,37,32,5,27,31,94,19,1
2449,John Stones,19.6,16,11,9,5,2,4,9,44.4,5,15,9,6,14,30,64,1
2450,Thomas Strakosha,35.0,1,1,1,0,0,1,1,100.0,0,0,0,0,1,2,8,1
2451,Tobias Strobl,25.5,31,17,17,13,1,9,29,31.0,20,36,14,22,29,60,35,1
2452,Kevin Strootman,1.0,2,2,1,0,1,0,1,0.0,1,5,0,5,2,4,2,0
2453,Kevin Strootman,21.6,76,40,21,47,8,20,52,38.5,32,24,6,18,24,100,26,0
2454,Jens Stryger Larsen,35.9,42,20,24,14,4,22,44,50.0,22,27,8,19,26,68,98,1
2455,Cristhian Stuani,30.3,23,13,7,13,3,5,20,25.0,15,13,1,12,4,27,39,0
2456,Leo Stulac,16.1,21,13,10,10,1,4,17,23.5,13,29,13,16,34,55,31,1
2457,Stefano Sturaro,2.4,4,3,0,3,1,2,9,22.2,7,3,1,2,3,7,2,0
2458,Daniel Sturridge,5.7,3,3,1,1,1,2,3,66.7,1,4,0,4,1,4,0,0
2459,Damian Suarez,36.0,96,62,43,41,12,53,120,44.2,67,47,6,41,46,142,57,2
2460,Denis Suarez,0.8,1,1,0,1,0,0,5,0.0,5,0,0,0,1,2,0,0
2462,Leonardo Suarez,5.7,3,3,2,0,1,2,4,50.0,2,7,1,6,1,4,4,0
2463,Luis Suarez,31.4,18,11,1,6,11,4,10,40.0,6,12,4,8,8,26,24,0
2464,Mario Suarez,11.4,37,23,17,17,3,15,28,53.6,13,10,3,7,14,51,17,2
2465,Mathias Suarez,6.1,20,11,7,10,3,10,23,43.5,13,11,0,11,9,29,18,0
2466,Danijel Subasic,12.6,0,0,0,0,0,0,1,0.0,1,0,0,0,0,0,6,2
2467,Neven Subotic,23.9,44,23,36,7,1,20,39,51.3,19,14,6,8,38,82,107,3
2468,Isaac Success,11.7,15,12,4,8,3,2,5,40.0,3,6,0,6,2,17,11,0
2470,Niklas Sule,29.5,28,23,17,10,1,18,25,72.0,7,23,13,10,40,68,83,0
2471,Ki Sung-yueng,14.5,14,10,5,8,1,3,12,25.0,9,11,1,10,19,33,20,0
2472,Andrew Surman,16.0,11,6,6,5,0,3,13,23.1,10,20,7,13,10,21,34,1
2474,Markel Susaeta,15.3,17,10,4,6,7,3,23,13.0,20,10,1,9,12,29,5,0
2475,Suso,33.5,28,18,10,14,4,10,41,24.4,31,26,1,25,16,44,3,0
2476,Markus Suttner,5.4,10,7,5,4,1,4,8,50.0,4,8,3,5,8,18,10,0
2477,Mattias Svanberg,13.1,22,11,14,7,1,11,25,44.0,14,25,6,19,11,33,16,2
2480,Issiaga Sylla,22.2,54,36,30,24,0,28,53,52.8,25,36,10,26,39,93,77,0
2481,Moussa Sylla,8.5,6,4,4,1,1,2,6,33.3,4,5,2,3,2,8,5,0
2482,Eddy Sylvestre,3.0,3,2,0,3,0,3,9,33.3,6,1,0,1,0,3,0,0
2483,Adam Szalai,18.1,19,13,3,12,4,4,11,36.4,7,8,1,7,4,23,8,0
2484,Wojciech Szczesny,28.0,2,1,2,0,0,1,1,100.0,0,0,0,0,1,3,8,2
2485,Alexander Sorloth,2.1,2,1,0,0,2,1,2,50.0,1,0,0,0,0,2,3,0
2486,Franck Tabanou,2.0,4,3,4,0,0,1,2,50.0,1,0,0,0,6,10,15,0
2487,Jonathan Tah,32.6,44,30,30,10,4,17,32,53.1,15,39,26,13,45,89,142,1
2488,Flavien Tait,33.2,58,35,33,16,9,23,59,39.0,36,29,2,27,28,86,15,0
2489,Adrien Tameze,32.7,74,44,32,31,11,39,92,42.4,53,53,12,41,56,130,59,1
2491,Matt Targett,13.2,27,19,15,7,5,12,26,46.2,14,19,3,16,27,54,42,0
2492,Rodrigo Tarin,15.9,22,14,15,5,2,7,10,70.0,3,11,5,6,31,53,79,0
2493,James Tarkowski,34.3,71,36,52,18,1,29,50,58.0,21,72,56,16,42,113,240,2
2496,Julio Tavares,31.2,15,9,1,7,7,3,9,33.3,6,17,3,14,13,28,51,0
2497,Junior Tavares,2.0,2,1,1,1,0,2,4,50.0,2,0,0,0,2,4,1,0
2498,Taleb Tawatha,1.4,1,1,1,0,0,1,2,50.0,1,0,0,0,0,1,1,0
2499,Charlie Taylor,36.0,55,26,37,15,3,24,50,48.0,26,74,35,39,40,95,120,0
2500,Malik Tchokounte,16.4,21,13,6,12,3,5,10,50.0,5,11,0,11,6,27,26,0
2501,Aurelien Tchouameni,7.8,24,12,10,14,0,7,18,38.9,11,11,5,6,21,45,14,0
2502,Georg Teigl,3.3,5,3,4,0,1,2,2,100.0,0,1,0,1,7,12,5,1
2503,Cristian Tello,17.5,32,20,18,9,5,17,35,48.6,18,19,0,19,16,48,17,1
2504,Lukasz Teodorczyk,4.4,4,2,2,2,0,2,8,25.0,6,8,2,6,1,5,4,0
2505,Hidde ter Avest,10.8,26,14,17,6,3,14,20,70.0,6,14,3,11,10,36,39,1
2506,Marc-Andre ter Stegen,35.0,0,0,0,0,0,0,3,0.0,3,0,0,0,2,2,5,2
2509,Marco Terrazzino,5.7,6,3,4,2,0,1,7,14.3,6,5,2,3,3,9,2,0
2510,Martin Terrier,16.5,23,13,5,13,5,9,23,39.1,14,17,2,15,6,29,14,0
2511,Kenny Tete,11.6,30,23,11,16,3,13,19,68.4,6,13,5,8,18,48,29,0
2513,Florian Thauvin,29.0,42,23,10,21,11,16,35,45.7,19,19,1,18,8,50,4,0
2515,Cyril Thereau,1.5,1,1,0,1,0,1,1,100.0,0,0,0,0,0,1,2,0
2516,Sada Thioub,27.5,30,19,13,10,7,20,45,44.4,25,29,1,28,16,46,11,0
2517,Romain Thomas,26.6,35,26,25,10,0,14,19,73.7,5,31,24,7,29,64,133,1
2518,Adrien Thomasson,27.5,54,27,18,23,13,21,66,31.8,45,29,5,24,18,72,12,1
2519,Erik Thommy,8.8,5,3,3,1,1,1,7,14.3,6,16,1,15,14,19,4,0
2520,Marcus Thuram,28.6,45,28,23,15,7,20,43,46.5,23,24,1,23,10,55,14,0
2522,Youri Tielemans,12.1,17,8,5,9,3,5,17,29.4,12,13,2,11,5,22,13,1
2523,Youri Tielemans,18.7,45,24,17,23,5,24,47,51.1,23,20,3,17,18,63,22,0
2524,Timothy Tillman,2.3,0,0,0,0,0,0,4,0.0,4,3,0,3,3,3,0,2
2525,Cheick Timite,16.2,18,13,5,7,6,3,16,18.8,13,14,2,12,12,30,13,0
2526,David Timor,1.8,2,2,1,1,0,0,1,0.0,1,1,1,0,3,5,3,0
2528,Marcel Tisserand,9.8,14,9,9,5,0,10,13,76.9,3,12,5,7,20,34,42,1
2529,Tito,12.2,14,9,12,2,0,7,22,31.8,15,22,2,20,17,31,41,0
2530,Jean-Clair Todibo,1.7,7,2,4,3,0,5,6,83.3,1,1,0,1,3,10,8,0
2531,Jean-Clair Todibo,9.3,21,18,19,2,0,11,13,84.6,2,14,5,9,14,35,62,2
2532,Karl Toko Ekambi,23.8,11,8,1,6,4,2,14,14.3,12,8,0,8,11,22,9,1
2533,Corentin Tolisso,0.6,0,0,0,0,0,0,2,0.0,2,1,1,0,0,0,0,0
2534,Rafael Toloi,19.4,27,17,15,9,3,16,24,66.7,8,28,10,18,33,60,54,1
2535,Raul de Tomas,31.3,8,3,0,7,1,0,12,0.0,12,18,4,14,9,17,45,0
2536,James Tomkins,28.4,34,20,27,7,0,15,28,53.6,13,23,10,13,34,68,184,3
2537,Nenad Tomovic,8.2,9,7,5,4,0,7,10,70.0,3,5,1,4,13,22,34,0
2538,Lorenzo Tonelli,18.4,31,22,19,9,3,15,19,78.9,4,27,21,6,24,55,92,0
2539,Tono,19.6,17,13,12,3,2,10,21,47.6,11,20,5,15,14,31,42,0
2540,Omer Toprak,2.6,1,1,0,1,0,0,1,0.0,1,1,1,0,0,1,7,0
2541,Lucas Torreira,26.5,65,39,24,32,9,25,57,43.9,32,34,7,27,41,106,33,2
2542,Daniel Torres,0.8,2,1,2,0,0,0,3,0.0,3,0,0,0,2,4,0,0
2543,Ferran Torres,9.4,15,8,4,8,3,5,11,45.5,6,10,1,9,10,25,9,0
2544,Lucas Torro,6.2,14,7,5,7,2,5,11,45.5,6,12,1,11,14,28,13,0
2545,Jordan Torunarigha,12.9,34,30,23,10,1,18,28,64.3,10,19,7,12,29,63,55,0
2546,Cenk Tosun,11.8,13,9,3,6,4,4,13,30.8,9,12,0,12,5,18,3,0
2548,Abdoulaye Toure,30.5,48,31,14,28,6,19,56,33.9,37,25,10,15,47,95,29,1
2549,Almamy Toure,3.8,13,6,6,7,0,3,10,30.0,7,3,1,2,11,24,12,0
2550,Almamy Toure,5.8,18,11,7,11,0,5,8,62.5,3,4,1,3,9,27,25,0
2551,Lucas Tousart,19.2,74,38,33,34,7,25,59,42.4,34,30,13,17,26,100,27,0
2552,Andros Townsend,33.4,62,35,38,16,8,35,89,39.3,54,48,5,43,38,100,28,0
2553,Adama Traore,10.0,16,13,11,3,2,4,9,44.4,5,11,0,11,6,22,7,0
2554,Adama Traore,2.7,2,1,1,0,1,1,4,25.0,3,4,0,4,3,5,1,0
2555,Bertrand Traore,23.5,36,22,19,13,4,12,26,46.2,14,23,5,18,15,51,18,0
2556,Charles Traore,12.9,40,20,22,16,2,23,34,67.6,11,16,3,13,19,59,46,0
2557,Cheick Traore,16.8,37,21,23,11,3,15,25,60.0,10,13,3,10,23,60,46,1
2558,Gaoussou Traore,1.2,10,5,6,4,0,4,8,50.0,4,1,0,1,0,10,0,0
2559,Hamari Traore,33.0,61,33,32,27,2,36,71,50.7,35,39,11,28,44,105,82,0
2560,Ibrahima Traore,6.1,12,6,8,2,2,3,11,27.3,8,3,1,2,3,15,1,0
2561,Ismael Traore,29.3,27,11,19,8,0,9,24,37.5,15,27,16,11,42,69,120,2
2562,Kevin Trapp,32.6,0,0,0,0,0,0,2,0.0,2,0,0,0,0,0,17,1
2564,Oscar Trejo,19.6,57,41,21,25,11,8,33,24.2,25,24,2,22,18,75,15,0
2565,Driss Trichard,1.0,2,2,2,0,0,1,1,100.0,0,1,0,1,1,3,4,0
2566,Manu Trigueros,17.2,46,35,18,23,5,20,57,35.1,37,17,6,11,16,62,17,0
2567,Kieran Trippier,25.3,67,37,43,16,8,37,62,59.7,25,38,5,33,23,90,77,2
2568,William Troost-Ekong,34.0,31,15,21,9,1,13,24,54.2,11,53,41,12,40,71,200,2
2569,Marcello Trotta,4.4,7,6,2,4,1,1,3,33.3,2,2,1,1,3,10,3,0
2570,Marcello Trotta,0.1,0,0,0,0,0,0,1,0.0,1,0,0,0,0,0,0,0
2574,Patrick Twumasi,1.9,3,3,2,0,1,0,4,0.0,4,2,0,2,1,4,1,0
2575,Salih Ucan,2.9,10,4,3,5,2,3,10,30.0,7,4,0,4,6,16,2,0
2576,Anthony Ujah,8.2,2,0,0,1,1,1,2,50.0,1,7,2,5,1,3,10,0
2578,Samuel Umtiti,13.2,8,5,3,4,1,4,6,66.7,2,10,8,2,18,26,28,2
2579,Enes Unal,23.9,17,10,3,4,10,4,24,16.7,20,17,4,13,2,19,18,0
2580,Cengiz Under,15.3,6,3,3,3,0,2,11,18.2,9,7,0,7,13,19,5,0
2581,Joel Untersee,1.4,3,2,1,2,0,2,3,66.7,1,2,1,1,1,4,5,1
2582,Dayot Upamecano,14.4,22,16,14,8,0,15,18,83.3,3,19,5,14,33,55,47,0
2583,Takashi Usami,9.8,18,12,7,11,0,9,26,34.6,17,15,2,13,8,26,13,1
2584,Mark Uth,15.6,20,11,8,8,4,4,23,17.4,19,19,2,17,8,28,12,0
2585,Tomas Vaclik,33.0,0,0,0,0,0,0,1,0.0,1,0,0,0,0,0,9,6
2586,Valentin Vada,0.4,2,1,0,2,0,1,1,100.0,0,0,0,0,0,2,0,0
2587,Valentin Vada,4.5,7,4,4,3,0,3,12,25.0,9,4,1,3,7,14,4,0
2588,William Vainqueur,0.9,6,3,4,2,0,1,1,100.0,0,1,0,1,0,6,0,0
2589,Mirko Valdifiori,7.4,20,15,12,7,1,8,14,57.1,6,4,2,2,5,25,9,0
2590,Pierrick Valdivia,0.3,1,1,0,1,0,1,2,50.0,1,1,0,1,1,2,0,0
2591,Antonio Valencia,5.2,8,6,2,4,2,3,4,75.0,1,9,0,9,5,13,10,0
2592,Enrico Valentini,14.4,44,27,31,10,3,22,40,55.0,18,17,3,14,13,57,58,0
2593,Borja Valero,13.7,22,19,9,10,3,8,30,26.7,22,11,1,10,16,38,27,2
2594,Yan Valery,19.0,42,36,26,10,6,16,29,55.2,13,24,3,21,22,64,72,1
2595,Jesus Vallejo,3.5,6,5,4,2,0,5,6,83.3,1,4,4,0,7,13,12,0
2596,Theo Valls,19.7,37,21,16,19,2,15,43,34.9,28,17,4,13,22,59,15,0
2597,Mattia Valoti,13.6,33,19,13,14,6,13,29,44.8,16,23,0,23,19,52,17,1
2598,Federico Valverde,7.3,12,8,3,7,2,5,11,45.5,6,10,2,8,21,33,10,0
2600,Luca Valzania,10.0,21,12,7,10,4,13,33,39.4,20,18,0,18,16,37,8,1
2601,Luca Valzania,0.8,5,4,2,3,0,3,5,60.0,2,0,0,0,1,6,0,0
2602,Virgil van Dijk,37.6,38,28,26,11,1,14,14,100.0,0,29,18,11,40,78,201,1
2603,Raphael Varane,30.6,33,18,25,7,1,15,19,78.9,4,21,9,12,32,65,141,1
2604,Jamie Vardy,30.3,14,8,3,6,5,4,17,23.5,13,16,1,15,6,20,28,0
2605,Franco Vazquez,25.3,51,37,21,21,9,23,66,34.8,43,25,2,23,23,74,27,1
2606,Kevin Vazquez,2.4,6,5,5,0,1,4,7,57.1,3,8,3,5,2,8,9,0
2607,Lucas Vazquez,16.8,43,26,11,21,11,15,41,36.6,26,16,1,15,12,55,11,0
2608,Matias Vecino,22.4,50,39,18,23,9,26,53,49.1,27,38,9,29,17,67,22,0
2610,Emiliano Velazquez,14.2,49,32,38,9,2,20,34,58.8,14,29,7,22,47,96,106,1
2611,Milos Veljkovic,20.9,36,24,29,6,1,22,37,59.5,15,27,13,14,27,63,111,0
2612,Miguel Veloso,14.0,31,20,14,13,4,9,26,34.6,17,12,1,11,13,44,21,0
2613,Daniele Verde,7.3,6,3,2,2,2,1,6,16.7,5,3,0,3,7,13,3,1
2615,Simone Verdi,7.8,16,11,5,9,2,8,16,50.0,8,6,0,6,4,20,3,0
2616,Jordan Veretout,32.7,64,40,22,31,11,21,52,40.4,31,33,7,26,46,110,54,2
2617,Paul Verhaegh,2.0,1,0,0,0,1,1,2,50.0,1,5,0,5,1,2,7,1
2618,Thomas Vermaelen,6.5,6,4,3,3,0,3,7,42.9,4,4,2,2,6,12,21,0
2619,Marco Verratti,20.9,72,42,25,39,8,36,81,44.4,45,26,1,25,18,90,8,2
2620,Jan Vertonghen,21.2,39,24,17,20,2,14,24,58.3,10,18,11,7,32,71,81,0
2621,Freddie Veseli,28.2,34,21,16,15,3,19,27,70.4,8,28,17,11,30,64,99,1
2622,Mikel Vesga,23.0,50,32,27,15,8,20,82,24.4,62,42,4,38,39,89,26,0
2623,Jannik Vestergaard,22.5,53,33,37,13,3,28,45,62.2,17,35,20,15,35,88,174,1
2624,Ruben Vezo,14.9,26,17,17,8,1,14,22,63.6,8,23,20,3,19,45,88,0
2626,Ruben Vezo,2.2,2,1,2,0,0,2,4,50.0,2,2,1,1,2,4,10,0
2627,Francesco Vicari,25.9,28,24,21,7,0,18,28,64.3,10,31,24,7,34,62,139,1
2628,Aleix Vidal,5.9,13,11,5,5,3,5,14,35.7,9,5,0,5,4,17,12,0
2629,Arturo Vidal,21.4,78,44,32,37,9,30,69,43.5,39,46,5,41,29,107,23,1
2630,Ronaldo Vieira,6.7,19,10,3,14,2,5,9,55.6,4,10,2,8,8,27,24,1
2631,Luciano Vietto,11.0,15,11,5,5,5,4,19,21.1,15,9,0,9,6,21,5,0
2632,Carlos Vigaray,7.2,15,8,10,4,1,9,15,60.0,6,6,1,5,6,21,24,1
2633,Emanuel Vignato,7.3,8,4,4,3,1,0,6,0.0,6,4,0,4,10,18,0,0
2634,Didac Vila,26.2,67,31,33,26,8,31,58,53.4,27,41,12,29,53,120,94,1
2635,Toni Villa,19.6,51,32,24,18,9,20,47,42.6,27,15,0,15,12,63,10,0
2636,Ruben Vinagre,7.9,14,9,7,7,0,2,5,40.0,3,10,2,8,14,28,16,1
2637,Carlos Vinicius,5.8,4,1,1,2,1,0,1,0.0,1,7,0,7,1,5,2,0
2638,Vitolo,8.4,17,13,8,6,3,6,19,31.6,13,8,1,7,10,27,6,0
2639,Federico Viviani,3.7,6,5,2,3,1,3,8,37.5,5,6,3,3,8,14,2,0
2643,Rai Vloet,1.4,4,2,1,2,1,0,3,0.0,3,4,0,4,0,4,1,0
2644,Kevin Vogt,26.6,24,15,20,4,0,12,32,37.5,20,28,11,17,33,57,103,3
2646,Kevin Volland,31.3,33,20,7,14,12,13,27,48.1,14,17,1,16,6,39,33,0
2648,Stefan de Vrij,28.0,25,16,14,10,1,8,15,53.3,7,32,23,9,25,50,95,1
2649,Sime Vrsaljko,8.1,20,14,8,6,6,9,14,64.3,5,5,1,4,11,31,27,1
2650,Nikola Vukcevic,7.4,25,18,12,9,4,9,24,37.5,15,15,5,10,10,35,17,0
2652,Matej Vydra,3.5,2,1,0,1,1,0,3,0.0,3,4,1,3,1,3,6,0
2653,Paul Wade,0.1,0,0,0,0,0,0,3,0.0,3,0,0,0,0,0,1,0
2654,Sandro Wagner,1.6,3,2,0,2,1,0,1,0.0,1,0,0,0,0,3,2,0
2655,Molla Wague,1.1,1,1,1,0,0,0,1,0.0,1,1,0,1,4,5,5,0
2656,Moussa Wague,2.5,6,5,1,4,1,3,7,42.9,4,1,0,1,4,10,3,0
2657,Wakaso,18.5,46,30,23,19,4,12,36,33.3,24,37,9,28,16,62,19,2
2658,Walace,22.2,52,22,17,28,7,27,61,44.3,34,30,4,26,45,97,36,1
2659,Theo Walcott,23.5,27,17,11,9,7,10,22,45.5,12,17,1,16,22,49,8,0
2660,Luca Waldschmidt,19.1,20,13,7,10,3,2,20,10.0,18,20,3,17,13,33,8,1
2661,Kyle Walker,30.9,40,26,20,20,0,24,38,63.2,14,19,5,14,36,76,58,2
2662,Kyle Walker-Peters,4.2,7,4,4,2,1,3,4,75.0,1,5,1,4,4,11,6,0
2663,Wallace,13.7,17,13,11,6,0,8,17,47.1,9,13,7,6,30,47,60,2
2665,Remi Walter,9.3,20,12,7,10,3,5,15,33.3,10,9,1,8,6,26,11,0
2666,Aaron Wan-Bissaka,34.8,129,90,90,33,6,55,65,84.6,10,49,16,33,84,213,161,0
2667,Victor Wanyama,5.7,13,13,8,5,0,6,12,50.0,6,9,3,6,7,20,11,0
2668,Danny Ward,4.9,2,1,0,1,1,0,3,0.0,3,3,1,2,0,2,9,0
2669,Joel Ward,6.1,12,7,7,4,1,3,10,30.0,7,2,0,2,10,22,35,0
2670,Stephen Ward,2.5,4,2,1,2,1,1,4,25.0,3,3,1,2,4,8,14,0
2671,James Ward-Prowse,21.6,36,17,19,13,4,14,43,32.6,29,30,6,24,27,63,59,0
2672,Daniel Wass,26.2,35,25,9,19,7,20,42,47.6,22,23,4,19,34,69,49,0
2674,Wout Weghorst,32.5,30,23,10,12,8,7,35,20.0,28,27,3,24,9,39,33,0
2675,Julian Weigl,16.2,32,18,19,12,1,24,41,58.5,17,18,10,8,16,48,56,2
2676,Mitchell Weiser,23.5,63,37,34,22,7,26,50,52.0,24,31,3,28,27,90,48,0
2679,Wendell,25.3,75,48,47,24,4,34,57,59.6,23,49,13,36,29,104,66,0
2680,Oscar Wendt,30.3,45,34,34,8,3,31,53,58.5,22,37,11,26,19,64,90,0
2682,Timo Werner,27.9,18,12,6,8,4,3,16,18.8,13,18,2,16,3,21,7,0
2683,Ashley Westwood,31.4,58,30,24,27,7,14,39,35.9,25,38,9,29,47,105,42,2
2684,Hendrik Weydandt,19.1,18,12,7,8,3,3,24,12.5,21,14,4,10,5,23,44,0
2686,Georginio Wijnaldum,30.3,41,28,14,20,7,14,27,51.9,13,21,7,14,21,62,24,0
2687,Jetro Willems,8.1,20,15,10,8,2,9,15,60.0,6,10,4,6,10,30,14,0
2688,William,29.7,82,57,52,21,9,35,75,46.7,40,41,2,39,85,167,127,3
2690,Inaki Williams,33.6,27,18,9,7,11,5,22,22.7,17,22,1,21,7,34,33,0
2691,Willian,23.3,35,21,11,15,9,9,25,36.0,16,16,1,15,14,49,12,2
2693,Ben Wilmot,0.3,0,0,0,0,0,0,1,0.0,1,2,1,1,0,0,1,0
2694,Ben Wilmot,2.2,0,0,0,0,0,0,2,0.0,2,2,2,0,2,2,11,0
2695,Jack Wilshere,4.4,7,4,1,4,2,2,6,33.3,4,3,1,2,7,14,0,0
2696,Callum Wilson,28.1,9,7,4,3,2,0,8,0.0,8,14,4,10,4,13,16,0
2697,Kevin Wimmer,18.7,25,17,17,6,2,15,27,55.6,12,30,23,7,41,66,63,0
2698,Harry Winks,17.7,22,13,12,9,1,5,30,16.7,25,19,3,16,21,43,19,0
2699,Axel Witsel,31.9,47,33,19,24,4,17,28,60.7,11,33,6,27,47,94,49,0
2700,Maximilian Wober,6.0,12,9,8,2,2,3,6,50.0,3,6,0,6,7,19,16,0
2701,Marius Wolf,9.2,14,10,11,3,0,5,13,38.5,8,6,0,6,13,27,12,0
2702,Jeong Woo-yeong,0.1,0,0,0,0,0,0,1,0.0,1,0,0,0,0,0,0,0
2704,Bobby Wood,13.1,13,10,2,10,1,5,8,62.5,3,2,0,2,4,17,6,0
2705,Chris Wood,28.8,12,8,0,7,5,5,17,29.4,12,17,4,13,3,15,26,0
2706,Haji Wright,2.2,3,2,1,1,1,0,1,0.0,1,1,0,1,0,3,1,0
2707,Xeka,25.1,59,31,25,27,7,18,57,31.6,39,20,2,18,21,80,30,4
2708,Granit Xhaka,27.8,52,29,29,20,3,24,59,40.7,35,35,9,26,36,88,56,3
2709,Cedric Yambere,31.2,47,31,36,11,0,21,39,53.8,18,45,32,13,52,99,136,4
2710,Andriy Yarmolenko,5.1,4,1,2,1,1,4,6,66.7,2,4,1,3,2,6,4,2
2711,John Yeboah,0.6,0,0,0,0,0,0,3,0.0,3,1,0,1,1,1,0,0
2712,DeAndre Yedlin,27.5,54,32,36,14,4,19,41,46.3,22,36,10,26,28,82,88,0
2714,Okay Yokuslu,24.4,61,39,31,28,2,28,45,62.2,17,32,11,21,37,98,53,2
2715,Maya Yoshida,16.9,16,12,5,10,1,4,13,30.8,9,24,20,4,42,58,103,1
2717,Amin Younes,5.5,11,6,3,6,2,3,6,50.0,3,7,0,7,2,13,0,0
2718,Ashley Young,28.5,52,32,34,16,2,20,39,51.3,19,36,10,26,55,107,74,0
2719,Zaydou Youssouf,4.7,7,5,3,4,0,3,7,42.9,4,5,1,4,5,12,0,0
2720,Pablo Zabaleta,23.2,47,24,26,15,6,17,44,38.6,27,39,15,24,48,95,96,3
2721,Dan-Axel Zagadou,14.1,13,10,10,2,1,4,6,66.7,2,17,11,6,25,38,70,2
2722,Wilfried Zaha,33.7,39,20,11,23,5,12,34,35.3,22,19,0,19,10,49,4,0
2723,Younn Zahary,8.2,16,9,7,6,3,8,14,57.1,6,13,8,5,16,32,35,0
2724,Miha Zajc,13.0,6,4,1,1,4,2,11,18.2,9,15,4,11,5,11,8,0
2725,Denis Zakaria,21.8,40,21,15,24,1,12,30,40.0,18,38,9,29,26,66,20,0
2726,Joseba Zaldua,23.8,36,27,23,10,3,15,32,46.9,17,19,3,16,38,74,72,0
2727,Andre-Frank Zambo Anguissa,16.9,48,29,23,20,5,18,52,34.6,34,25,6,19,34,82,32,0
2728,Francesco Zampano,23.4,35,25,23,9,3,15,31,48.4,16,24,4,20,13,48,48,0
2730,Nicolo Zaniolo,19.6,35,21,7,18,10,7,37,18.9,30,14,0,14,13,48,8,0
2731,Cristian Zapata,11.4,23,16,15,7,1,9,10,90.0,1,18,15,3,8,31,59,0
2732,Duvan Zapata,32.2,9,5,3,2,4,1,9,11.1,8,26,6,20,4,13,25,0
2733,Davide Zappacosta,1.4,0,0,0,0,0,0,1,0.0,1,0,0,0,3,3,5,0
2734,Simone Zaza,16.0,20,9,3,12,5,1,8,12.5,7,12,1,11,4,24,9,0
2735,Marvin Zeegelaar,10.6,30,23,21,6,3,16,24,66.7,8,11,2,9,17,47,38,0
2736,Mehdi Zeffane,13.5,19,13,12,7,0,10,26,38.5,16,14,5,9,18,37,35,1
2739,Arber Zeneli,9.0,8,6,3,2,3,0,10,0.0,10,3,0,3,2,10,3,1
2740,Robin Zentner,10.0,0,0,0,0,0,0,1,0.0,1,0,0,0,1,1,3,0
2741,Nabil El Zhar,10.7,8,4,2,4,2,0,5,0.0,5,4,0,4,4,12,1,0
2743,Ron-Robert Zieler,34.0,2,1,2,0,0,1,4,25.0,3,1,0,1,1,3,19,3
2744,Piotr Zielinski,31.9,41,25,11,20,10,13,34,38.2,21,30,4,26,20,61,18,0
2745,Jean Zimmer,15.9,17,11,11,5,1,6,16,37.5,10,13,2,11,11,28,32,1
2746,Matthias Zimmermann,33.9,97,64,69,24,4,45,90,50.0,45,51,18,33,67,164,90,2
2747,Oleksandr Zinchenko,12.8,34,20,13,15,6,14,33,42.4,19,14,3,11,20,54,19,1
2748,Kevin Zohi,7.0,14,10,6,6,2,5,9,55.6,4,8,0,8,7,21,5,0
2749,Kenneth Zohore,8.4,3,2,0,3,0,1,3,33.3,2,4,2,2,2,5,5,0
2750,Kurt Zouma,29.0,32,21,16,14,2,4,11,36.4,7,27,12,15,54,86,126,2
2751,Adam Zrelak,10.5,14,9,2,11,1,5,9,55.6,4,14,2,12,2,16,13,0
2752,Igor Zubeldia,28.3,61,35,32,24,5,22,54,40.7,32,30,6,24,45,106,60,0
2753,Steven Zuber,6.3,12,9,5,6,1,6,13,46.2,7,5,1,4,5,17,4,0
2754,Steven Zuber,11.7,6,3,2,2,2,1,13,7.7,12,14,2,12,6,12,6,0
2756,Martin Zubimendi,0.1,1,0,0,1,0,0,1,0.0,1,0,0,0,0,1,0,0
2757,Ervin Zukanovic,21.8,28,16,20,7,1,17,30,56.7,13,17,9,8,19,47,96,0
2758,Bongani Zungu,2.6,3,2,0,1,2,2,8,25.0,6,0,0,0,2,5,5,0
2759,David Zurutuza,13.6,27,16,9,15,3,8,22,36.4,14,19,4,15,24,51,26,1
2760,Filip Dordevic,7.0,11,6,3,6,2,3,12,25.0,9,7,1,6,2,13,8,1
2761,Filip Duricic,13.9,17,13,2,11,4,5,22,22.7,17,20,1,19,8,25,8,1
