,Player,Squad,90s,Tackles - Tkl,Tackles - TklW,Tackles - Def 3rd,Tackles - Mid 3rd,Tackles - Att 3rd,Challenges - Tkl,Challenges - Att,Challenges - Tkl%,Challenges - Lost,Blocks - Blocks,Blocks - Sh,Blocks - Pass,Int,Tkl+Int,Clr,Err
0,Patrick van Aanholt,Crystal Palace,27.9,43,23,31,10,2,23,50,46.0,27,31,9,22,45,88,52,1
1,Max Aarons,Norwich City,36.0,48,30,33,9,6,18,36,50.0,18,46,29,17,37,85,97,1
2,Yunis Abdelhamid,Reims,28.0,46,33,29,15,2,17,30,56.7,13,26,14,12,47,93,99,1
3,Suleiman Abdullahi,Union Berlin,1.7,0,0,0,0,0,0,3,0.0,3,2,1,1,1,1,1,0
4,Mehdi Abeid,Nantes,20.2,55,29,18,32,5,20,53,37.7,33,16,3,13,23,78,8,1
5,Charles Abi,Saint-Étienne,6.9,9,9,2,5,2,2,7,28.6,5,2,0,2,4,13,4,0
6,David Abraham,Eint Frankfurt,18.8,21,14,16,4,1,15,32,46.9,17,27,11,16,25,46,61,1
7,Tammy Abraham,Chelsea,24.6,8,4,2,5,1,3,14,21.4,11,20,2,18,6,14,27,0
8,Amir Abrashi,Freiburg,7.4,16,8,7,8,1,10,19,52.6,9,18,3,15,7,23,16,2
9,Francesco Acerbi,Lazio,35.1,59,29,42,12,5,14,20,70.0,6,40,27,13,42,101,109,1
10,Che Adams,Southampton,12.3,6,4,1,5,0,1,4,25.0,3,9,1,8,2,8,10,0
11,Tyler Adams,RB Leipzig,10.6,22,15,13,8,1,12,25,48.0,13,16,1,15,14,36,14,0
12,Sargis Adamyan,Hoffenheim,8.3,11,7,3,6,2,3,21,14.3,18,8,1,7,2,13,4,0
13,Antonio Adan,Atlético Madrid,0.3,0,0,0,0,0,0,0,0.0,0,0,0,0,0,0,0,0
14,Bobby Adekanye,Lazio,2.1,3,2,0,3,0,0,5,0.0,5,0,0,0,2,5,1,0
15,Claud Adjapong,Hellas Verona,2.6,5,3,4,1,0,2,3,66.7,1,4,3,1,3,8,7,0
16,Amine Adli,Toulouse,0.5,0,0,0,0,0,0,1,0.0,1,0,0,0,1,1,0,0
17,Yacine Adli,Bordeaux,11.3,22,14,4,15,3,11,34,32.4,23,10,0,10,8,30,3,0
18,Adrian,Liverpool,9.7,1,1,1,0,0,1,1,100.0,0,0,0,0,0,1,8,3
19,Aritz Aduriz,Athletic Club,2.3,3,2,0,3,0,0,0,0.0,0,0,0,0,0,3,2,0
20,Lumor Agbenyenu,Mallorca,20.1,31,21,19,9,3,16,35,45.7,19,13,2,11,21,52,66,1
21,Martin Agirregabiria,Alavés,23.3,55,30,32,18,5,30,54,55.6,24,19,7,12,18,73,48,0
22,Lucien Agoume,Inter,0.8,3,2,0,2,1,0,0,0.0,0,3,1,2,0,3,0,0
23,Kevin Agudelo,Fiorentina,0.7,2,1,0,1,1,0,1,0.0,1,1,0,1,1,3,0,0
24,Kevin Agudelo,Genoa,7.4,23,14,9,12,2,10,20,50.0,10,12,1,11,6,29,2,0
26,Nayef Aguerd,Dijon,10.6,13,9,7,5,1,8,12,66.7,4,11,11,0,18,31,54,0
27,Sergio Aguero,Manchester City,16.1,7,4,0,4,3,1,8,12.5,7,9,1,8,3,10,2,0
28,Ruben Aguilar,Monaco,11.9,36,22,19,15,2,19,28,67.9,9,6,2,4,11,47,21,0
29,Emmanuel Agyemang-Badu,Hellas Verona,2.6,1,1,0,1,0,1,2,50.0,1,2,2,0,1,2,6,0
30,Jean-Eudes Aholou,Saint-Étienne,7.0,16,12,2,11,3,3,9,33.3,6,6,1,5,15,31,10,0
31,Joseph Aidoo,Celta Vigo,27.8,43,27,30,11,2,13,27,48.1,14,31,14,17,45,88,124,3
32,Ola Aina,Torino,23.1,45,24,23,18,4,17,37,45.9,20,24,6,18,41,86,61,0
33,Youssef Ait Bennasser,Bordeaux,6.0,11,8,6,4,1,4,24,16.7,20,6,1,5,4,15,10,1
34,Rayan Ait Nouri,Angers,14.2,29,22,14,8,7,10,21,47.6,11,14,1,13,18,47,33,0
35,Albian Ajeti,West Ham,1.5,1,0,0,0,1,0,0,0.0,0,0,0,0,0,1,0,0
36,Ludovic Ajorque,Strasbourg,22.9,15,10,2,10,3,2,13,15.4,11,11,0,11,2,17,20,0
37,Manuel Akanji,Dortmund,25.7,38,21,23,14,1,12,20,60.0,8,20,11,9,30,68,61,2
38,Marley Ake,Marseille,1.1,2,2,1,1,0,1,3,33.3,2,0,0,0,1,3,1,0
39,Nathan Ake,Bournemouth,27.8,31,21,23,8,0,14,23,60.9,9,40,29,11,36,67,152,0
40,Chadrac Akolo,Amiens,6.0,16,8,8,6,2,5,12,41.7,7,6,1,5,5,21,5,0
41,Kevin Akpoguma,Hoffenheim,12.7,24,16,20,4,0,13,24,54.2,11,21,11,10,13,37,48,0
42,David Alaba,Bayern Munich,27.8,30,17,14,15,1,16,25,64.0,9,19,10,9,29,59,40,0
43,Sofiane Alakouch,Nîmes,15.6,45,26,25,13,7,25,48,52.1,23,13,2,11,23,68,39,3
44,Lucas Alario,Leverkusen,13.0,6,3,0,4,2,1,8,12.5,7,12,2,10,1,7,9,0
45,Jordi Alba,Barcelona,24.3,20,13,9,7,4,6,27,22.2,21,12,3,9,37,57,40,0
46,Luis Alberto,Lazio,34.6,50,30,21,19,10,27,82,32.9,55,32,1,31,21,71,9,1
47,Raul Albiol,Villarreal,36.0,43,23,27,16,0,18,27,66.7,9,29,21,8,42,85,175,2
48,Marc Albrighton,Leicester City,9.6,24,17,10,13,1,9,30,30.0,21,19,2,17,10,34,8,0
49,Paco Alcacer,Villarreal,10.3,3,3,2,1,0,1,7,14.3,6,4,1,3,2,5,10,0
50,Paco Alcacer,Dortmund,5.9,2,2,0,2,0,1,5,20.0,4,4,1,3,2,4,3,0
52,Thiago Alcantara,Bayern Munich,19.7,45,26,17,23,5,12,33,36.4,21,12,3,9,45,90,13,1
53,Ruben Alcaraz,Valladolid,21.4,61,30,37,20,4,30,63,47.6,33,46,15,31,15,76,41,0
54,Toby Alderweireld,Tottenham,32.9,40,29,24,13,3,11,24,45.8,13,48,32,16,31,71,172,2
55,Haitam Aleesami,Amiens,21.3,36,16,25,9,2,18,43,41.9,25,33,10,23,34,70,59,1
56,Alex Alegria,Mallorca,1.2,1,0,1,0,0,0,0,0.0,0,2,0,2,0,1,0,0
57,Carles Alena,Barcelona,1.9,2,1,1,1,0,1,4,25.0,3,1,0,1,0,2,0,0
58,Carles Alena,Betis,8.2,14,9,5,7,2,3,17,17.6,14,4,1,3,1,15,3,0
59,Runar Alex Runarsson,Dijon,10.0,0,0,0,0,0,0,2,0.0,2,0,0,0,0,0,3,3
60,Trent Alexander-Arnold,Liverpool,35.3,55,34,35,17,3,36,78,46.2,42,27,9,18,45,100,84,3
61,Enrico Alfonso,Brescia,3.1,0,0,0,0,0,0,0,0.0,0,0,0,0,0,0,2,0
62,Rachid Alioui,Angers,17.4,8,5,0,7,1,2,13,15.4,11,3,0,3,2,10,9,0
63,Alisson,Liverpool,28.3,0,0,0,0,0,0,2,0.0,2,0,0,0,1,1,13,3
64,Allan,Napoli,14.2,50,27,20,21,9,18,54,33.3,36,19,3,16,16,66,11,1
65,Dele Alli,Tottenham,20.5,34,16,11,20,3,13,37,35.1,24,35,3,32,17,51,17,2
66,Miguel Almiron,Newcastle Utd,33.6,60,39,32,20,8,19,52,36.5,33,25,1,24,31,91,25,0
67,Marcos Alonso,Chelsea,15.9,28,16,20,6,2,14,33,42.4,19,18,2,16,20,48,32,0
68,Mickael Alphonse,Dijon,15.3,39,25,26,12,1,23,37,62.2,14,19,3,16,17,56,64,0
69,Sergio Alvarez,Eibar,12.7,37,22,11,24,2,8,24,33.3,16,16,2,14,17,54,26,1
70,Sergio Alvarez,Celta Vigo,2.0,0,0,0,0,0,0,0,0.0,0,0,0,0,0,0,1,0
71,Yeray Alvarez,Athletic Club,31.2,36,19,28,7,1,17,30,56.7,13,33,22,11,62,98,138,2
72,Bruno Alves,Parma,29.7,17,11,12,5,0,8,13,61.5,5,30,21,9,25,42,150,2
73,Steven Alzate,Brighton,13.2,33,19,20,11,2,17,27,63.0,10,18,3,15,14,47,13,0
74,Ibrahim Amadou,Norwich City,8.4,18,11,9,8,1,3,11,27.3,8,8,5,3,16,34,55,1
75,Ibrahim Amadou,Leganés,8.6,16,9,5,9,2,4,11,36.4,7,5,0,5,12,28,6,0
76,Romain Amalfitano,Dijon,18.8,43,27,18,21,4,21,61,34.4,40,23,9,14,36,79,14,2
78,Amath,Getafe,0.7,2,1,1,1,0,0,5,0.0,5,2,0,2,0,2,0,0
79,Jordan Amavi,Marseille,24.0,55,29,31,19,5,31,64,48.4,33,27,6,21,56,111,97,0
80,Thierry Ambrose,Metz,6.1,7,5,2,2,3,2,7,28.6,5,3,0,3,3,10,3,0
81,Kelvin Amian,Toulouse,18.1,27,21,21,5,1,14,25,56.0,11,14,7,7,18,45,56,0
82,Nadiem Amiri,Leverkusen,20.6,26,16,7,15,4,16,34,47.1,18,12,2,10,14,40,8,1
83,Ethan Ampadu,RB Leipzig,0.9,5,4,3,2,0,1,1,100.0,0,3,1,2,1,6,3,0
84,Opoku Ampomah,Düsseldorf,5.6,9,4,3,4,2,3,12,25.0,9,3,0,3,4,13,5,0
85,Sofyan Amrabat,Hellas Verona,32.4,58,36,26,21,11,26,55,47.3,29,29,10,19,31,89,15,1
86,Joachim Andersen,Lyon,17.0,17,9,15,2,0,7,19,36.8,12,16,12,4,10,27,74,2
87,Djavan Anderson,Lazio,1.9,0,0,0,0,0,0,0,0.0,0,1,0,1,3,3,3,0
88,Felipe Anderson,West Ham,16.6,46,32,20,21,5,11,47,23.4,36,19,1,18,22,68,11,0
89,Sebastian Andersson,Union Berlin,29.8,20,10,0,12,8,4,19,21.1,15,19,3,16,5,25,36,0
90,Florin Andone,Brighton,0.8,1,1,0,1,0,1,1,100.0,0,1,1,0,0,1,1,0
91,Benjamin Andre,Lille,22.8,72,44,31,35,6,29,74,39.2,45,32,9,23,59,131,40,1
92,Lorenzo Andrenacci,Brescia,5.9,1,0,1,0,0,1,3,33.3,2,0,0,0,0,1,0,0
93,Robert Andrich,Union Berlin,28.6,52,27,28,18,6,19,60,31.7,41,27,7,20,47,99,36,0
94,Victorien Angban,Metz,11.4,23,18,11,11,1,11,24,45.8,13,9,2,7,8,31,5,0
95,Miguel Angel Guerrero,Leganés,8.8,1,0,0,1,0,1,10,10.0,9,4,0,4,2,3,4,0
96,Jose Angel,Eibar,26.2,54,31,26,25,3,26,43,60.5,17,23,7,16,33,87,61,1
97,Miguel Angel Moya,Real Sociedad,13.0,0,0,0,0,0,0,1,0.0,1,0,0,0,1,1,6,2
98,Angelino,Manchester City,4.7,5,2,3,1,1,5,7,71.4,2,1,0,1,9,14,15,0
99,Angelino,RB Leipzig,12.2,15,9,7,5,3,5,15,33.3,10,14,1,13,19,34,24,0
100,Faustino Anjorin,Chelsea,0.2,0,0,0,0,0,0,0,0.0,0,1,0,1,0,0,0,0
101,Peter Ankersen,Genoa,11.8,16,4,7,7,2,4,13,30.8,9,19,5,14,9,25,25,1
102,Cristian Ansaldi,Torino,19.6,37,25,24,7,6,19,34,55.9,15,23,3,20,14,51,20,4
104,Janis Antiste,Toulouse,0.1,0,0,0,0,0,0,0,0.0,0,0,0,0,0,0,0,0
105,Michail Antonio,West Ham,19.6,13,9,5,4,4,4,14,28.6,10,17,2,15,9,22,5,0
106,Antonito,Valladolid,11.4,26,18,19,7,0,12,20,60.0,8,9,0,9,15,41,20,1
107,Mirko Antonucci,Roma,0.9,4,3,1,0,3,3,3,100.0,0,2,0,2,2,6,1,0
108,Vitorino Antunes,Getafe,0.1,0,0,0,0,0,0,0,0.0,0,0,0,0,0,0,1,0
109,Christopher Antwi-Adjei,Paderborn 07,27.4,25,16,13,9,3,9,33,27.3,24,29,2,27,15,40,14,0
110,Anuar,Valladolid,2.1,4,2,1,2,1,2,6,33.3,4,7,3,4,5,9,0,0
111,Houssem Aouar,Lyon,21.7,28,12,6,18,4,10,35,28.6,25,15,1,14,13,41,11,0
112,Adil Aouchiche,Paris S-G,0.7,3,2,1,2,0,2,4,50.0,2,3,0,3,0,3,0,0
113,Dennis Appiah,Nantes,17.8,58,35,32,20,6,28,52,53.8,24,9,3,6,23,81,34,0
114,Mauro Arambarri,Getafe,34.1,72,33,24,40,8,31,69,44.9,38,52,5,47,43,115,40,2
115,Guilherme Arana,Atalanta,0.9,4,4,1,3,0,3,5,60.0,2,0,0,0,2,6,0,0
116,Charles Aranguiz,Leverkusen,23.5,56,37,19,29,8,27,74,36.5,47,27,6,21,22,78,21,1
117,Luiz Araujo,Lille,9.2,20,11,3,8,9,5,31,16.1,26,14,0,14,4,24,6,0
118,Nestor Araujo,Celta Vigo,32.1,44,27,35,8,1,22,36,61.1,14,26,18,8,52,96,142,0
119,Ronald Araujo,Barcelona,2.6,3,2,2,1,0,1,1,100.0,0,6,2,4,0,3,9,0
120,Anaitz Arbilla,Eibar,22.3,33,20,23,8,2,16,34,47.1,18,20,4,16,29,62,82,0
121,Alphonse Areola,Real Madrid,4.0,0,0,0,0,0,0,0,0.0,0,0,0,0,0,0,0,0
122,Alphonse Areola,Paris S-G,3.0,0,0,0,0,0,0,0,0.0,0,0,0,0,0,0,1,1
123,Santiago Arias,Atlético Madrid,12.0,36,24,20,12,4,10,18,55.6,8,12,7,5,19,55,20,1
124,Nicolo Armini,Lazio,0.0,1,1,1,0,0,1,1,100.0,0,0,0,0,0,1,1,0
125,Stuart Armstrong,Southampton,19.1,32,19,19,11,2,9,38,23.7,29,22,4,18,11,43,23,1
126,Jose Arnaiz,Osasuna,8.8,3,2,0,2,1,0,12,0.0,12,7,0,7,5,8,5,0
127,Jose Arnaiz,Leganés,3.7,3,0,1,2,0,2,5,40.0,3,4,0,4,2,5,1,0
128,Maximilian Arnold,Wolfsburg,31.3,42,24,15,23,4,16,62,25.8,46,25,6,19,25,67,35,0
130,Kepa Arrizabalaga,Chelsea,33.0,1,1,1,0,0,1,2,50.0,1,0,0,0,1,2,7,2
131,Kwadwo Asamoah,Inter,7.1,10,8,4,5,1,6,14,42.9,8,8,1,7,9,19,13,0
132,Santiago Ascacibar,Hertha BSC,7.0,26,13,15,11,0,11,28,39.3,17,13,2,11,16,42,13,0
133,Sergio Asenjo,Villarreal,34.0,0,0,0,0,0,0,2,0.0,2,0,0,0,1,1,15,1
134,Marco Asensio,Real Madrid,3.7,4,3,3,1,0,1,4,25.0,3,2,0,2,1,5,4,0
135,Kristoffer Askildsen,Sampdoria,0.8,1,1,1,0,0,0,0,0.0,0,1,0,1,1,2,0,0
136,Iago Aspas,Celta Vigo,36.2,29,19,7,9,13,12,45,26.7,33,16,1,15,22,51,7,0
137,Roger Assale,Leganés,5.9,3,2,1,0,2,1,9,11.1,8,8,0,8,0,3,1,0
138,Youcef Atal,Nice,11.1,24,11,15,6,3,13,31,41.9,18,12,1,11,24,48,11,1
139,Miguel Atienza,Eibar,0.3,1,1,0,1,0,1,2,50.0,1,1,1,0,2,3,1,0
140,Christian Atsu,Newcastle Utd,8.3,10,8,5,5,0,5,14,35.7,9,19,0,19,5,15,9,0
141,Pierre-Emerick Aubameyang,Arsenal,34.8,31,19,10,12,9,12,51,23.5,39,39,1,38,14,45,16,0
142,Emil Audero,Sampdoria,36.0,1,1,1,0,0,1,3,33.3,2,0,0,0,0,1,21,1
143,Tommaso Augello,Sampdoria,12.6,14,9,6,3,5,5,7,71.4,2,8,0,8,15,29,21,1
144,Jean-Kevin Augustin,Monaco,3.0,3,0,1,2,0,1,6,16.7,5,2,0,2,3,6,0,0
145,Ludwig Augustinsson,Werder Bremen,10.3,29,12,15,9,5,12,23,52.2,11,19,5,14,10,39,29,0
146,Serge Aurier,Tottenham,30.0,93,69,58,27,8,39,69,56.5,30,38,6,32,47,140,98,2
147,Mathias Autret,Brest,13.6,23,17,5,11,7,8,25,32.0,17,14,1,13,10,33,3,0
148,Ezequiel Avila,Osasuna,17.7,17,12,6,7,4,6,18,33.3,12,12,0,12,3,20,5,0
149,Javier Aviles,Leganés,2.0,9,7,2,7,0,2,4,50.0,2,3,0,3,3,12,1,0
150,Chidozie Awaziem,Leganés,22.2,34,22,29,5,0,16,27,59.3,11,26,15,11,28,62,73,1
151,Taiwo Awoniyi,Mainz 05,5.4,2,0,0,2,0,0,4,0.0,4,4,2,2,2,4,3,0
152,Florian Aye,Brescia,15.3,17,9,9,5,3,6,13,46.2,7,17,2,15,4,21,18,1
153,Jordan Ayew,Crystal Palace,35.0,48,30,10,22,16,17,49,34.7,32,29,4,25,15,63,21,0
154,Kaan Ayhan,Düsseldorf,30.3,38,25,26,11,1,20,37,54.1,17,28,15,13,45,83,72,1
156,Ramon Azeez,Granada,15.1,11,8,2,8,1,7,19,36.8,12,8,2,6,19,30,11,1
157,Cesar Azpilicueta,Chelsea,35.9,86,56,40,32,14,35,69,50.7,34,56,21,35,67,153,94,0
158,Ludovic Baal,Brest,9.2,27,15,13,12,2,10,22,45.5,12,9,3,6,17,44,20,0
159,Iddrisu Baba,Mallorca,32.3,59,37,26,29,4,20,70,28.6,50,31,8,23,39,98,42,0
160,Khouma Babacar,Lecce,15.8,12,8,2,6,4,1,7,14.3,6,12,3,9,3,15,34,0
161,Carlos Bacca,Villarreal,7.6,5,1,1,2,2,2,6,33.3,4,4,0,4,0,5,7,0
162,Milan Badelj,Fiorentina,17.6,29,17,10,16,3,15,50,30.0,35,21,3,18,45,74,34,1
163,Matthias Bader,Köln,0.1,1,1,1,0,0,1,2,50.0,1,0,0,0,0,1,1,0
164,Benoit Badiashile,Monaco,15.7,18,12,12,5,1,6,12,50.0,6,20,11,9,27,45,57,1
165,Bastian Badu,Montpellier,0.1,0,0,0,0,0,0,0,0.0,0,0,0,0,0,0,0,0
166,Alex Baena,Villarreal,0.2,0,0,0,0,0,0,0,0.0,0,1,0,1,0,0,0,0
167,Stephane Bahoken,Angers,10.1,7,4,1,2,4,1,7,14.3,6,4,1,3,2,9,2,0
168,Daniel Baier,Augsburg,21.6,33,17,14,14,5,15,43,34.9,28,19,7,12,58,91,27,0
169,Leon Bailey,Leverkusen,12.1,6,3,1,5,0,6,16,37.5,10,9,0,9,8,14,3,0
170,Eric Bailly,Manchester Utd,1.7,0,0,0,0,0,0,1,0.0,1,3,3,0,4,4,7,1
171,Denys Bain,Brest,14.1,21,14,15,6,0,9,9,100.0,0,13,10,3,28,49,66,0
172,Leighton Baines,Everton,4.5,10,6,6,2,2,8,10,80.0,2,5,2,3,5,15,14,0
173,Stefan Bajic,Saint-Étienne,1.0,0,0,0,0,0,0,0,0.0,0,1,0,1,0,0,2,0
174,Tiemoue Bakayoko,Monaco,19.1,48,24,16,27,5,29,54,53.7,25,12,4,8,29,77,17,0
175,Lewis Baker,Düsseldorf,6.1,8,5,6,2,0,2,10,20.0,8,5,2,3,2,10,5,0
176,Mitchel Bakker,Paris S-G,1.0,2,2,1,1,0,1,1,100.0,0,0,0,0,0,2,2,0
177,Ridle Baku,Mainz 05,26.1,54,31,25,22,7,26,53,49.1,27,45,7,38,42,96,57,0
178,Fabian Balbuena,West Ham,13.1,17,12,13,3,1,9,25,36.0,16,15,5,10,26,43,75,3
179,Keita Balde,Monaco,9.5,6,5,1,1,4,3,9,33.3,6,4,1,3,2,8,7,1
180,George Baldock,Sheffield Utd,38.0,62,43,35,17,10,27,47,57.4,20,26,3,23,34,96,83,3
182,Gareth Bale,Real Madrid,12.1,9,5,5,2,2,3,14,21.4,11,8,2,6,6,15,9,0
183,Mikel Balenziaga,Athletic Club,6.3,15,10,4,10,1,9,11,81.8,2,4,1,3,2,17,20,0
184,Leonardo Balerdi,Dortmund,1.5,2,1,1,1,0,2,2,100.0,0,0,0,0,4,6,3,0
185,Marco Ballarini,Udinese,0.0,0,0,0,0,0,0,0,0.0,0,0,0,0,0,0,0,0
186,Fode Ballo-Toure,Monaco,18.7,36,25,21,11,4,17,32,53.1,15,10,1,9,24,60,45,0
187,Florent Balmont,Dijon,4.5,12,6,5,7,0,7,12,58.3,5,6,0,6,1,13,3,0
188,Mario Balotelli,Brescia,15.6,2,2,0,2,0,0,2,0.0,2,1,1,0,8,10,22,0
189,Abdoulaye Bamba,Angers,6.2,10,7,7,1,2,8,15,53.3,7,4,1,3,4,14,18,0
190,Jonathan Bamba,Lille,21.5,12,6,5,5,2,7,29,24.1,22,19,3,16,16,28,8,2
191,Ever Banega,Sevilla,27.5,43,28,16,18,9,21,70,30.0,49,19,1,18,15,58,5,0
192,Mattia Bani,Bologna,24.5,47,28,27,19,1,25,36,69.4,11,29,15,14,52,99,92,2
193,Antonin Barak,Udinese,2.2,5,4,3,0,2,1,5,20.0,4,6,1,5,0,5,4,0
194,Antonin Barak,Lecce,15.2,19,10,9,10,0,6,24,25.0,18,18,1,17,9,28,20,2
195,Federico Barba,Valladolid,5.0,12,6,10,2,0,7,9,77.8,2,5,2,3,8,20,12,0
196,Danilo Barbosa,Nice,12.5,28,21,17,9,2,13,29,44.8,16,21,6,15,20,48,38,0
197,Melvin Bard,Lyon,0.5,0,0,0,0,0,0,0,0.0,0,0,0,0,1,1,0,0
198,Enis Bardhi,Levante,23.5,24,11,7,15,2,8,35,22.9,27,15,4,11,15,39,19,0
199,Phil Bardsley,Burnley,21.0,49,36,16,24,9,24,37,64.9,13,24,11,13,30,79,73,0
200,Nicolo Barella,Inter,22.4,36,21,14,15,7,8,37,21.6,29,20,5,15,14,50,14,0
201,Philipp Bargfrede,Werder Bremen,6.5,15,12,8,5,2,6,23,26.1,17,8,2,6,16,31,15,0
202,Antonino Barilla,Parma,18.8,43,31,22,19,2,16,45,35.6,29,26,8,18,17,60,32,0
203,Kike Barja,Osasuna,3.5,1,1,1,0,0,1,1,100.0,0,3,1,2,0,1,2,0
204,Ross Barkley,Chelsea,12.3,16,9,6,6,4,5,18,27.8,13,7,2,5,7,23,7,0
205,Aymen Barkok,Düsseldorf,0.9,1,1,0,0,1,0,2,0.0,2,2,0,2,3,4,1,0
206,Ashley Barnes,Burnley,15.0,10,5,3,5,2,3,9,33.3,6,7,2,5,6,16,9,0
208,Harvey Barnes,Leicester City,23.1,16,11,7,7,2,5,23,21.7,18,13,3,10,8,24,6,1
209,Antonio Barragan,Betis,7.1,7,5,4,2,1,3,6,50.0,3,2,2,0,8,15,22,0
210,Antonio Barreca,Genoa,12.2,10,7,5,3,2,4,5,80.0,1,12,7,5,1,11,22,0
211,Leandro Barreiro Martins,Mainz 05,10.4,38,21,16,19,3,14,29,48.3,15,18,3,15,9,47,18,1
212,Ander Barrenetxea,Real Sociedad,4.9,12,9,5,5,2,4,10,40.0,6,3,0,3,3,15,4,0
213,Edgar Barreto,Sampdoria,1.0,4,3,0,1,3,2,3,66.7,1,1,0,1,0,4,0,0
214,Musa Barrow,Bologna,15.0,20,13,11,7,2,6,20,30.0,14,15,0,15,5,25,11,0
215,Musa Barrow,Atalanta,2.1,1,1,0,0,1,1,4,25.0,3,4,0,4,0,1,1,0
216,Fin Bartels,Werder Bremen,3.8,9,5,4,4,1,3,12,25.0,9,3,1,2,1,10,1,0
217,Marc Bartra,Betis,28.0,62,34,39,23,0,27,54,50.0,27,45,24,21,35,97,127,0
218,Daniele Baselli,Torino,14.2,43,23,17,19,7,13,40,32.5,27,20,4,16,25,68,25,0
219,Chris Basham,Sheffield Utd,36.0,85,48,58,20,7,48,81,59.3,33,38,15,23,77,162,173,1
220,Toma Basic,Bordeaux,11.0,26,22,9,16,1,12,27,44.4,15,14,2,12,9,35,12,1
221,Thomas Basila,Nantes,4.6,6,3,2,4,0,4,4,100.0,0,0,0,0,4,10,14,0
222,Gil Bastiao Dias,Granada,4.0,19,14,10,6,3,7,17,41.2,10,4,1,3,3,22,7,0
223,Gil Bastiao Dias,Monaco,11.7,53,33,30,21,2,29,58,50.0,29,15,1,14,13,66,22,1
224,Borja Baston,Aston Villa,0.2,1,0,0,1,0,0,2,0.0,2,1,0,1,0,1,0,1
225,Alessandro Bastoni,Inter,21.3,32,17,14,11,7,15,24,62.5,9,18,9,9,26,58,54,0
226,Bastos,Lazio,8.5,9,5,6,3,0,4,11,36.4,7,13,8,5,13,22,26,0
227,Oliver Batista-Meier,Bayern Munich,0.1,0,0,0,0,0,0,2,0.0,2,0,0,0,0,0,0,0
228,Michy Batshuayi,Chelsea,2.7,4,1,2,2,0,0,5,0.0,5,1,1,0,0,4,1,0
229,Cristian Battocchio,Brest,15.5,31,24,13,13,5,14,36,38.9,22,13,4,9,19,50,21,0
230,Oliver Baumann,Hoffenheim,30.0,0,0,0,0,0,0,0,0.0,0,1,0,1,3,3,15,0
231,Julian Baumgartlinger,Leverkusen,19.9,42,21,15,21,6,18,42,42.9,24,37,4,33,20,62,16,1
232,Christoph Baumgartner,Hoffenheim,16.6,32,17,15,16,1,10,37,27.0,27,25,1,24,8,40,13,0
234,Noah Joel Sarenren Bazee,Augsburg,4.2,4,3,0,4,0,1,4,25.0,3,2,1,1,5,9,4,0
235,Ihlas Bebou,Hoffenheim,23.4,27,15,9,13,5,8,23,34.8,15,25,4,21,11,38,25,0
236,Rodrigo Becao,Udinese,24.6,56,25,34,19,3,26,46,56.5,20,40,20,20,45,101,77,0
237,Sheraldo Becker,Union Berlin,6.0,2,1,2,0,0,1,3,33.3,2,1,0,1,0,2,1,0
238,Timo Becker,Schalke 04,3.7,10,9,3,6,1,5,9,55.6,4,6,1,5,3,13,8,0
239,Jan Bednarek,Southampton,34.0,65,38,41,18,6,31,61,50.8,30,44,23,21,77,142,198,4
240,Asmir Begovic,Milan,1.4,0,0,0,0,0,0,0,0.0,0,0,0,0,0,0,0,0
241,Valon Behrami,Genoa,12.3,34,26,13,17,4,8,32,25.0,24,25,10,15,9,43,16,0
242,Maximilian Beier,Hoffenheim,1.2,5,2,0,1,4,1,2,50.0,1,2,0,2,0,5,0,0
243,Gaetan Belaud,Brest,6.4,13,7,10,2,1,4,8,50.0,4,8,3,5,15,28,15,0
244,Ishak Belfodil,Hoffenheim,3.0,0,0,0,0,0,0,1,0.0,1,0,0,0,0,0,2,0
245,Haris Belkebla,Brest,20.2,44,24,17,17,10,10,28,35.7,18,25,5,20,53,97,21,2
246,Raoul Bellanova,Atalanta,0.2,0,0,0,0,0,0,0,0.0,0,0,0,0,0,0,0,0
247,Raoul Bellanova,Bordeaux,0.7,1,1,1,0,0,0,1,0.0,1,0,0,0,0,1,0,0
248,Karim Bellarabi,Leverkusen,15.8,19,11,9,7,3,9,28,32.1,19,16,0,16,10,29,4,0
249,Jean-Ricner Bellegarde,Strasbourg,16.6,40,27,18,19,3,13,21,61.9,8,16,3,13,22,62,6,0
250,Hector Bellerin,Arsenal,12.9,20,13,7,11,2,11,29,37.9,18,20,4,16,19,39,27,1
251,Andrea Belotti,Torino,33.4,29,16,7,17,5,5,31,16.1,26,23,5,18,5,34,20,1
252,Fran Beltran,Celta Vigo,20.3,31,19,15,12,4,11,35,31.4,24,14,1,13,14,45,17,0
253,Sami Ben Amar,Nîmes,0.2,1,1,0,0,1,1,1,100.0,0,1,0,1,1,2,0,0
254,Hatem Ben Arfa,Valladolid,1.8,0,0,0,0,0,0,4,0.0,4,1,0,1,0,0,0,0
255,Wissam Ben Yedder,Monaco,24.0,22,16,2,12,8,8,19,42.1,11,12,0,12,4,26,1,0
256,Marco Benassi,Fiorentina,10.9,18,12,9,5,4,10,24,41.7,14,11,1,10,4,22,9,0
257,Cristian Benavente,Nantes,3.9,8,5,2,5,1,2,8,25.0,6,1,0,1,3,11,0,0
258,Lars Bender,Leverkusen,15.3,42,26,17,20,5,19,38,50.0,19,32,6,26,24,66,30,0
260,Sven Bender,Leverkusen,30.3,53,34,29,17,7,23,48,47.9,25,42,13,29,67,120,88,2
261,Dario Benedetto,Marseille,23.3,12,9,0,9,3,3,18,16.7,15,15,2,13,3,15,23,1
262,Laszlo Benes,M'Gladbach,10.0,15,8,3,5,7,6,19,31.6,13,6,2,4,8,23,3,1
263,Walter Benitez,Nice,26.0,1,1,1,0,0,1,3,33.3,2,0,0,0,0,1,8,0
264,Loris Benito,Bordeaux,21.1,40,25,23,11,6,16,43,37.2,27,14,5,9,29,69,58,1
265,Bilal Benkhedim,Saint-Étienne,1.5,3,3,1,1,1,1,4,25.0,3,1,0,1,1,4,0,0
266,Ismael Bennacer,Milan,27.6,67,47,21,34,12,29,73,39.7,44,25,7,18,54,121,15,2
267,Ryan Bennett,Wolves,6.7,4,2,4,0,0,2,6,33.3,4,14,8,6,9,13,29,0
268,Ryan Bennett,Leicester City,3.7,5,4,3,2,0,4,6,66.7,2,3,1,2,7,12,8,0
269,Keanan Bennetts,M'Gladbach,0.0,0,0,0,0,0,0,1,0.0,1,0,0,0,0,0,0,0
270,Yassine Benrahou,Bordeaux,1.9,3,0,1,1,1,2,5,40.0,3,1,0,1,2,5,1,0
271,Yassine Benrahou,Nîmes,8.5,13,8,3,3,7,5,16,31.3,11,1,0,1,2,15,0,0
272,Ramy Bensebaini,M'Gladbach,16.1,33,17,17,12,4,18,31,58.1,13,24,4,20,38,71,49,0
273,Nabil Bentaleb,Newcastle Utd,8.3,23,13,14,9,0,7,25,28.0,18,9,2,7,19,42,9,1
274,Rodrigo Bentancur,Juventus,24.4,58,32,27,18,13,31,66,47.0,35,44,9,35,32,90,34,1
275,Christian Benteke,Crystal Palace,14.0,9,5,1,6,2,0,10,0.0,10,11,4,7,4,13,28,1
276,Romario Benzar,Lecce,1.1,2,2,1,1,0,2,3,66.7,1,1,0,1,0,2,2,0
277,Karim Benzema,Real Madrid,34.9,18,8,3,11,4,2,16,12.5,14,16,4,12,7,25,30,1
278,Yassine Benzia,Dijon,1.9,3,2,2,1,0,1,6,16.7,5,4,2,2,3,6,1,0
279,Domenico Berardi,Sassuolo,27.7,32,16,19,8,5,13,59,22.0,46,31,3,28,33,65,27,0
280,Yuri Berchiche,Athletic Club,31.7,48,35,32,15,1,21,40,52.5,19,26,4,22,30,78,73,1
281,Alex Berenguer,Torino,20.3,20,6,6,13,1,8,33,24.2,25,17,1,16,18,38,17,0
282,Bartosz Bereszynski,Sampdoria,26.7,53,35,25,23,5,26,52,50.0,26,38,16,22,35,88,88,1
283,Johann Berg Gudmundsson,Burnley,6.9,4,2,2,2,0,1,8,12.5,7,8,1,7,7,11,9,0
284,Markel Bergara,Getafe,0.8,0,0,0,0,0,0,0,0.0,0,0,0,0,0,0,2,0
286,Sander Berge,Sheffield Utd,10.5,22,15,3,14,5,5,10,50.0,5,15,1,14,10,32,16,0
287,Steven Bergwijn,Tottenham,7.8,10,6,3,6,1,4,12,33.3,8,12,0,12,1,11,5,0
288,Robert Beric,Saint-Étienne,4.6,3,2,0,2,1,0,5,0.0,5,2,0,2,4,7,2,0
289,Etrit Berisha,SPAL,26.0,3,2,3,0,0,2,3,66.7,1,0,0,0,1,4,9,0
290,Valon Berisha,Lazio,0.4,1,1,0,1,0,1,2,50.0,1,0,0,0,0,1,1,0
291,Valon Berisha,Düsseldorf,10.5,14,9,3,8,3,6,21,28.6,15,4,1,3,9,23,8,0
292,Sergio Bermejo,Celta Vigo,0.1,0,0,0,0,0,0,0,0.0,0,0,0,0,0,0,0,0
293,Bernard,Everton,14.2,32,22,12,14,6,13,44,29.5,31,22,2,20,16,48,7,0
294,Federico Bernardeschi,Juventus,17.5,13,5,4,5,4,5,25,20.0,20,11,0,11,13,26,12,1
295,Bernardo,Brighton,7.5,27,16,12,9,6,13,17,76.5,4,7,3,4,6,33,24,0
296,Paul Bernardoni,Nîmes,24.5,0,0,0,0,0,0,1,0.0,1,0,0,0,0,0,11,1
297,Juan Bernat,Paris S-G,15.4,42,27,19,16,7,20,51,39.2,31,13,1,12,10,52,26,0
298,Dimitry Bertaud,Montpellier,2.2,0,0,0,0,0,0,0,0.0,0,0,0,0,0,0,0,0
299,Andrea Bertolacci,Sampdoria,5.9,7,4,2,3,2,1,8,12.5,7,4,1,3,2,9,13,0
300,Ryan Bertrand,Southampton,30.5,47,29,22,15,10,26,58,44.8,32,27,12,15,37,84,31,1
301,Muhamed Besic,Sheffield Utd,2.8,8,6,4,4,0,2,5,40.0,3,4,0,4,1,9,6,0
302,Jordan Beyer,M'Gladbach,1.2,3,1,3,0,0,0,1,0.0,1,4,2,2,1,4,4,0
303,Ermin Bicakcic,Hoffenheim,13.1,7,3,5,2,0,4,11,36.4,7,14,8,6,25,32,64,2
304,Pedro Bigas,Eibar,19.7,18,9,11,7,0,9,19,47.4,10,16,10,6,36,54,82,0
305,Lucas Biglia,Milan,7.6,13,7,7,6,0,4,15,26.7,11,12,4,8,7,20,10,1
306,El Bilal Toure,Reims,5.0,3,3,1,0,2,0,0,0.0,0,6,0,6,1,4,1,0
307,Philip Billing,Bournemouth,28.1,72,46,30,37,5,17,65,26.2,48,59,16,43,66,138,97,1
308,Cristiano Biraghi,Inter,17.5,22,6,10,8,4,10,24,41.7,14,21,7,14,13,35,41,0
309,Davide Biraschi,Genoa,21.9,32,17,17,13,2,15,26,57.7,11,22,12,10,34,66,69,0
310,Valter Birsa,Cagliari,4.8,10,6,3,6,1,7,21,33.3,14,6,1,5,4,14,3,0
312,Dimitri Bisoli,Brescia,23.9,64,35,34,20,10,30,49,61.2,19,41,7,34,25,89,49,0
313,Yves Bissouma,Brighton,14.0,49,38,24,22,3,17,40,42.5,23,18,2,16,21,70,23,0
314,Leonardo Bittencourt,Hoffenheim,0.0,1,1,0,0,1,0,0,0.0,0,0,0,0,0,1,0,0
315,Leonardo Bittencourt,Werder Bremen,21.0,52,28,23,18,11,9,51,17.6,42,20,3,17,12,64,14,0
316,Birkir Bjarnason,Brescia,8.9,5,3,1,3,1,2,13,15.4,11,9,4,5,5,10,4,0
317,Ruben Blanco,Celta Vigo,32.9,1,1,1,0,0,1,1,100.0,0,0,0,0,0,1,14,1
318,Ludovic Blas,Nantes,20.5,26,18,7,15,4,5,26,19.2,21,17,1,16,14,40,11,0
319,Pablo de Blasis,Eibar,17.8,41,32,22,13,6,30,63,47.6,33,13,0,13,24,65,21,0
320,Alejandro Blesa,Levante,0.0,0,0,0,0,0,0,1,0.0,1,0,0,0,0,0,0,0
321,Alexis Blin,Amiens,20.5,39,25,18,15,6,20,61,32.8,41,25,6,19,16,55,49,0
322,Jerome Boateng,Bayern Munich,20.0,21,14,9,12,0,11,22,50.0,11,15,11,4,33,54,58,1
323,Kevin-Prince Boateng,Fiorentina,6.7,3,1,0,2,1,2,8,25.0,6,3,0,3,1,4,7,0
324,Antonin Bobichon,Nîmes,2.0,4,3,1,3,0,3,3,100.0,0,1,0,1,1,5,0,0
325,Antonin Bobichon,Angers,7.2,9,4,4,5,0,2,19,10.5,17,7,0,7,7,16,4,0
326,Salvatore Bocchetti,Hellas Verona,3.4,5,3,3,2,0,2,3,66.7,1,2,2,0,17,22,23,0
327,Mathieu Bodmer,Amiens,1.0,0,0,0,0,0,0,1,0.0,1,1,1,0,1,1,1,0
328,Adam Bodzek,Düsseldorf,22.4,42,26,21,20,1,14,46,30.4,32,34,11,23,25,67,39,0
329,Jean-Paul Boetius,Mainz 05,25.2,63,33,21,31,11,20,57,35.1,37,38,1,37,26,89,6,0
330,Sacha Boey,Rennes,1.9,6,4,3,1,2,4,8,50.0,4,0,0,0,2,8,5,0
331,Jeremie Boga,Sassuolo,27.9,12,7,3,8,1,6,20,30.0,14,24,0,24,3,15,4,0
332,Melayro Bogarde,Hoffenheim,0.6,2,1,2,0,0,2,2,100.0,0,0,0,0,0,2,3,0
333,Quentin Boisgard,Toulouse,12.7,31,19,10,14,7,14,35,40.0,21,11,0,11,12,43,4,1
334,Willy Boly,Wolves,22.0,57,33,36,21,0,25,43,58.1,18,28,11,17,39,96,108,3
335,Giacomo Bonaventura,Milan,14.9,16,9,5,6,5,5,17,29.4,12,8,3,5,7,23,10,0
336,Federico Bonazzoli,Sampdoria,8.3,7,5,1,4,2,0,7,0.0,7,3,0,3,5,12,2,0
338,Gaetan Bong,Brighton,0.7,1,0,0,0,1,0,0,0.0,0,1,1,0,0,1,0,0
339,Kevin Bonifazi,Torino,2.7,9,8,6,3,0,5,6,83.3,1,3,2,1,5,14,10,0
340,Kevin Bonifazi,SPAL,13.2,16,9,15,1,0,9,18,50.0,9,20,12,8,35,51,50,2
341,Federico Bonini,Bologna,0.1,0,0,0,0,0,0,0,0.0,0,0,0,0,0,0,0,0
342,Leonardo Bonucci,Juventus,34.2,28,17,18,8,2,12,17,70.6,5,32,29,3,31,59,94,2
343,Fabio Borini,Hellas Verona,9.0,2,1,2,0,0,0,4,0.0,4,3,0,3,13,15,6,0
344,Fabio Borini,Milan,0.8,2,2,0,0,2,0,2,0.0,2,1,0,1,0,2,3,0
345,Dennis Borkowski,RB Leipzig,0.1,0,0,0,0,0,0,0,0.0,0,0,0,0,0,0,0,0
346,Robin Bormuth,Düsseldorf,2.0,2,1,2,0,0,2,3,66.7,1,6,5,1,0,2,12,0
347,Sebastiaan Bornauw,Köln,27.2,37,24,24,12,1,20,39,51.3,19,32,12,20,42,79,99,0
348,Brandon Borrello,Freiburg,3.3,10,4,6,4,0,4,10,40.0,6,7,1,6,1,11,1,0
349,Gabriel Boschilia,Monaco,1.4,3,1,0,3,0,1,5,20.0,4,1,1,0,2,5,2,0
350,Denis Bouanga,Saint-Étienne,22.7,45,34,10,25,10,20,55,36.4,35,30,0,30,10,55,15,0
351,Hicham Boudaoui,Nice,5.4,20,10,6,11,3,9,23,39.1,14,10,3,7,13,33,7,0
352,Ryad Boudebouz,Saint-Étienne,17.7,25,16,9,14,2,8,25,32.0,17,14,1,13,7,32,5,0
353,Sofiane Boufal,Southampton,8.5,16,8,6,5,5,6,15,40.0,9,17,0,17,4,20,1,0
354,Nassim Boujellab,Schalke 04,4.7,12,10,5,4,3,5,14,35.7,9,8,1,7,7,19,5,0
355,Farid Boulaya,Metz,9.1,14,10,7,4,3,7,19,36.8,12,5,0,5,6,20,3,0
356,Yassine Bounou,Sevilla,5.5,0,0,0,0,0,0,0,0.0,0,0,0,0,0,0,0,0
357,Mehdi Bourabia,Sassuolo,10.3,19,9,8,10,1,9,22,40.9,13,12,2,10,22,41,23,0
358,Benjamin Bourigeaud,Rennes,21.1,40,12,18,20,2,17,68,25.0,51,38,7,31,20,60,25,0
359,Bilal Boutobba,Montpellier,0.1,0,0,0,0,0,0,1,0.0,1,0,0,0,0,0,0,0
360,Jarrod Bowen,West Ham,10.2,19,15,7,9,3,4,17,23.5,13,6,0,6,16,35,8,0
361,Dedryck Boyata,Hertha BSC,27.1,24,18,17,5,2,4,12,33.3,8,39,32,7,62,86,158,1
362,John Boye,Metz,23.5,30,19,25,5,0,19,32,59.4,13,31,18,13,31,61,116,0
364,Can Bozdogan,Schalke 04,2.6,8,6,5,3,0,3,12,25.0,9,2,0,2,2,10,2,0
365,Domagoj Bradaric,Lille,15.8,28,11,9,17,2,12,27,44.4,15,16,3,13,22,50,28,0
366,Filip Bradaric,Celta Vigo,7.8,12,9,5,5,2,3,8,37.5,5,12,3,9,17,29,19,0
367,Robbie Brady,Burnley,5.0,11,9,5,4,2,3,10,30.0,7,10,2,8,5,16,8,0
368,Martin Braithwaite,Barcelona,4.5,2,2,2,0,0,0,8,0.0,8,3,0,3,1,3,1,0
369,Martin Braithwaite,Leganés,21.5,13,7,4,5,4,4,12,33.3,8,10,2,8,4,17,9,0
370,Federico Brancolini,Fiorentina,0.1,0,0,0,0,0,0,0,0.0,0,0,0,0,0,0,0,0
371,Brandon,Osasuna,4.5,5,3,1,3,1,0,5,0.0,5,4,0,4,0,5,1,0
372,Julian Brandt,Dortmund,24.5,48,33,15,21,12,25,55,45.5,30,35,2,33,16,64,10,1
373,Jarrad Branthwaite,Everton,3.3,8,7,5,3,0,3,5,60.0,2,6,3,3,2,10,12,0
374,Darko Brasanac,Osasuna,24.9,45,25,14,26,5,15,41,36.6,26,19,4,15,20,65,21,0
375,Claudio Bravo,Manchester City,3.9,0,0,0,0,0,0,0,0.0,0,0,0,0,0,0,1,1
376,Josip Brekalo,Wolfsburg,18.6,18,8,5,6,7,5,23,21.7,18,26,0,26,16,34,4,0
377,Gleison Bremer,Torino,25.2,63,36,37,20,6,20,34,58.8,14,48,22,26,74,137,118,1
378,Marco Brescianini,Milan,0.3,1,1,1,0,0,0,0,0.0,0,0,0,0,2,3,0,0
379,Anthony Briancon,Nîmes,19.3,29,19,20,9,0,17,34,50.0,17,22,16,6,39,68,80,0
380,Jimmy Briand,Bordeaux,16.9,12,8,5,4,3,3,13,23.1,10,8,4,4,6,18,12,0
381,Yan Brice Eteki,Granada,16.7,37,21,14,18,5,15,31,48.4,16,17,4,13,24,61,20,1
382,Armando Broja,Chelsea,0.1,0,0,0,0,0,0,0,0.0,0,0,0,0,0,0,0,0
383,Dylan Bronn,Metz,9.0,7,5,6,1,0,4,7,57.1,3,11,9,2,6,13,42,0
384,David Brooks,Bournemouth,5.6,5,5,1,2,2,2,14,14.3,12,5,1,4,2,7,1,0
385,John Brooks,Wolfsburg,24.7,38,27,27,9,2,24,49,49.0,25,31,12,19,41,79,93,0
386,Daniel Brosinski,Mainz 05,19.0,40,27,13,23,4,15,34,44.1,19,16,2,14,14,54,58,0
387,Josh Brownhill,Burnley,8.9,14,8,5,7,2,5,13,38.5,8,9,4,5,14,28,18,0
388,Marcelo Brozovic,Inter,30.0,67,35,26,31,10,19,71,26.8,52,26,9,17,46,113,46,2
390,Gaston Brugman,Parma,16.2,47,24,25,15,7,19,46,41.3,27,33,15,18,27,74,19,2
391,Jeffrey Bruma,Wolfsburg,9.0,9,5,4,5,0,7,13,53.8,6,6,3,3,13,22,51,1
392,Jeffrey Bruma,Mainz 05,7.5,12,8,8,4,0,4,6,66.7,2,11,5,6,6,18,34,1
393,Jacob Bruun Larsen,Hoffenheim,4.3,3,2,3,0,0,3,8,37.5,5,3,0,3,3,6,1,0
394,Jacob Bruun Larsen,Dortmund,0.8,0,0,0,0,0,0,0,0.0,0,0,0,0,0,0,0,0
395,Lucas Buades,Nîmes,1.3,4,4,3,1,0,1,5,20.0,4,0,0,0,1,5,3,0
396,Ante Budimir,Mallorca,30.7,31,15,4,22,5,7,29,24.1,22,21,4,17,8,39,29,0
397,Emi Buendia,Norwich City,27.4,82,39,57,21,4,38,118,32.2,80,58,5,53,23,105,32,2
398,Gianluigi Buffon,Juventus,9.0,0,0,0,0,0,0,0,0.0,0,0,0,0,0,0,3,1
399,Marius Bulter,Union Berlin,25.8,38,22,19,13,6,17,54,31.5,37,37,3,34,11,49,20,1
400,Esteban Burgos,Eibar,12.4,11,9,9,2,0,5,9,55.6,4,11,6,5,17,28,66,2
401,Guido Burgstaller,Schalke 04,13.7,7,3,0,5,2,4,15,26.7,11,12,3,9,4,11,10,0
402,Burgui,Alavés,0.2,0,0,0,0,0,0,0,0.0,0,0,0,0,0,0,0,0
403,Jonathan Burkardt,Mainz 05,2.8,9,4,2,5,2,3,8,37.5,5,6,1,5,0,9,1,0
404,Oliver Burke,Alavés,15.9,19,14,8,9,2,10,23,43.5,13,24,0,24,8,27,16,0
405,Roman Burki,Dortmund,30.8,2,2,2,0,0,2,3,66.7,1,1,0,1,2,4,13,1
406,Dan Burn,Brighton,32.0,67,42,35,27,5,25,53,47.2,28,44,20,24,42,109,130,0
407,Patrick Burner,Nice,15.9,35,25,15,17,3,14,25,56.0,11,11,2,9,30,65,37,0
408,Sergio Busquets,Barcelona,27.6,80,44,23,43,14,41,71,57.7,30,36,5,31,44,124,24,2
409,Unai Bustinza,Leganés,29.8,66,40,40,19,7,32,53,60.4,21,30,9,21,65,131,77,0
410,Ludovic Butelle,Angers,26.0,1,1,1,0,0,1,2,50.0,1,1,0,1,0,1,10,4
411,Marcin Bulka,Paris S-G,1.0,0,0,0,0,0,0,0,0.0,0,0,0,0,0,0,0,0
412,Sam Byram,Norwich City,14.4,40,22,24,11,5,18,37,48.6,19,16,8,8,26,66,73,0
413,Erick Cabaco,Getafe,3.0,3,2,1,2,0,0,3,0.0,3,1,1,0,3,6,11,0
414,Erick Cabaco,Levante,9.0,12,9,9,3,0,4,6,66.7,2,12,7,5,12,24,50,1
416,Willy Caballero,Chelsea,5.0,0,0,0,0,0,0,0,0.0,0,0,0,0,0,0,3,0
417,Yohan Cabaye,Saint-Étienne,9.5,29,18,11,14,4,14,25,56.0,11,10,0,10,22,51,7,1
418,Manuel Cabit,Metz,3.0,3,1,1,2,0,2,10,20.0,8,5,0,5,4,7,5,0
419,Ariday Cabrera,Mallorca,0.4,1,1,1,0,0,0,1,0.0,1,2,0,2,0,1,0,0
420,Leandro Cabrera,Getafe,17.0,10,6,5,5,0,5,12,41.7,7,10,4,6,21,31,66,0
421,Leandro Cabrera,Espanyol,17.0,27,11,17,9,1,17,28,60.7,11,19,12,7,21,48,78,1
422,Fabrizio Cacciatore,Cagliari,12.8,14,4,9,4,1,6,9,66.7,3,10,6,4,16,30,44,0
423,Martin Caceres,Fiorentina,26.2,47,31,34,11,2,16,34,47.1,18,29,13,16,31,78,74,2
424,Anthony Caci,Strasbourg,7.7,29,17,19,9,1,8,17,47.1,9,15,5,10,19,48,15,1
425,Jhonder Cadiz,Dijon,8.9,16,8,6,7,3,3,7,42.9,4,4,2,2,1,17,9,0
426,Mathieu Cafaro,Reims,10.3,12,6,5,5,2,6,17,35.3,11,13,0,13,2,14,0,0
427,Jonathan Cafu,Bordeaux,2.2,7,3,4,3,0,4,7,57.1,3,1,0,1,1,8,3,0
428,Gary Cahill,Crystal Palace,24.1,15,8,11,4,0,7,15,46.7,8,34,25,9,18,33,114,1
429,Felipe Caicedo,Lazio,15.6,17,10,4,7,6,2,11,18.2,9,9,1,8,4,21,2,0
430,Arturo Calabresi,Amiens,20.9,53,33,29,20,4,33,75,44.0,42,24,11,13,29,82,60,0
431,Davide Calabria,Milan,18.0,52,33,28,22,2,17,41,41.5,24,23,5,18,21,73,47,1
432,Riccardo Calafiori,Roma,0.7,0,0,0,0,0,0,1,0.0,1,0,0,0,2,2,0,0
433,Mattia Caldara,Atalanta,10.7,21,11,12,8,1,5,11,45.5,6,9,5,4,30,51,22,1
434,Marco Calderoni,Lecce,22.9,38,25,22,13,3,20,39,51.3,19,27,10,17,37,75,54,1
435,Fernando Calero,Espanyol,11.6,14,9,10,4,0,7,15,46.7,8,13,5,8,8,22,42,1
436,Duje Caleta-Car,Marseille,21.0,29,15,17,11,1,18,26,69.2,8,17,6,11,26,55,98,0
437,Hakan Calhanoglu,Milan,30.0,42,21,15,21,6,12,35,34.3,23,26,2,24,26,68,26,1
438,Daniel Caligiuri,Schalke 04,25.5,58,37,18,25,15,27,74,36.5,47,67,6,61,25,83,39,0
439,Jose Callejon,Napoli,24.1,13,9,3,7,3,9,25,36.0,16,15,3,12,10,23,14,1
440,Jonathan Calleri,Espanyol,20.1,12,8,6,4,2,3,24,12.5,21,11,3,8,7,19,22,0
442,Dominic Calvert-Lewin,Everton,29.2,7,5,1,4,2,1,10,10.0,9,15,2,13,6,13,36,0
443,Mahdi Camara,Saint-Étienne,10.0,33,20,12,16,5,18,32,56.3,14,20,2,18,18,51,5,0
444,Souleymane Camara,Montpellier,1.8,0,0,0,0,0,0,2,0.0,2,0,0,0,0,0,1,0
445,Victor Camarasa,Crystal Palace,0.1,0,0,0,0,0,0,0,0.0,0,0,0,0,0,0,0,0
446,Victor Camarasa,Alavés,14.4,18,10,5,10,3,7,18,38.9,11,8,3,5,15,33,12,0
447,Eduardo Camavinga,Rennes,23.4,105,64,45,56,4,48,96,50.0,48,26,8,18,34,139,35,0
448,Sergio Camello,Atlético Madrid,0.3,0,0,0,0,0,0,0,0.0,0,0,0,0,0,0,0,0
449,Jose Campana,Levante,35.1,38,25,15,13,10,13,53,24.5,40,30,5,25,44,82,42,2
450,Xisco Campos,Mallorca,5.3,7,4,5,2,0,5,9,55.6,4,8,5,3,11,18,23,0
451,Victor Campuzano,Espanyol,9.7,12,9,1,6,5,3,19,15.8,16,8,0,8,2,14,4,0
452,Emre Can,Juventus,3.2,10,7,5,3,2,3,10,30.0,7,4,0,4,2,12,3,0
453,Emre Can,Dortmund,10.6,19,12,11,7,1,5,12,41.7,7,14,6,8,19,38,15,0
454,Sergio Canales,Betis,35.1,25,16,14,6,5,7,28,25.0,21,30,1,29,13,38,16,0
455,Joao Cancelo,Manchester City,13.4,40,24,21,12,7,24,40,60.0,16,9,2,7,21,61,18,0
456,Antonio Candreva,Inter,22.1,11,6,9,1,1,7,29,24.1,22,26,10,16,14,25,33,1
457,Gianmarco Cangiano,Bologna,0.2,1,1,0,1,0,0,0,0.0,0,0,0,0,1,2,0,0
458,Todd Cantwell,Norwich City,27.7,51,31,19,27,5,26,73,35.6,47,38,2,36,18,69,35,1
459,Ander Capa,Athletic Club,31.9,64,36,37,21,6,24,59,40.7,35,26,7,19,28,92,63,0
460,Pierrick Capelle,Angers,19.4,42,32,18,16,8,16,48,33.3,32,17,3,14,21,63,28,0
461,Etienne Capoue,Watford,29.2,75,40,38,30,7,37,85,43.5,48,30,11,19,68,143,61,0
462,Gianluca Caprari,Sampdoria,7.4,9,7,1,6,2,4,13,30.8,9,5,0,5,7,16,1,0
463,Gianluca Caprari,Parma,6.5,1,1,0,1,0,0,5,0.0,5,7,2,5,4,5,2,0
464,Francesco Caputo,Sassuolo,32.6,7,4,3,2,2,3,11,27.3,8,15,0,15,1,8,8,0
465,Maxence Caqueret,Lyon,6.3,24,15,10,13,1,11,25,44.0,14,14,2,12,9,33,6,1
466,Andrea Carboni,Cagliari,4.1,8,4,3,5,0,3,4,75.0,1,6,6,0,7,15,20,0
468,Irvin Cardona,Brest,16.1,13,8,5,6,2,9,32,28.1,23,8,0,8,1,14,7,0
469,Marc Cardona,Osasuna,7.8,1,0,0,1,0,0,8,0.0,8,3,1,2,2,3,2,0
470,Diego Carlos,Sevilla,34.8,35,23,25,9,1,15,25,60.0,10,33,24,9,37,72,176,1
471,Lionel Carole,Strasbourg,14.1,23,8,15,6,2,13,17,76.5,4,2,1,1,19,42,22,0
472,Yannick Carrasco,Atlético Madrid,7.0,11,7,4,4,3,7,21,33.3,14,9,0,9,5,16,2,0
473,Daniel Carrico,Sevilla,9.4,8,2,4,3,1,1,6,16.7,5,4,3,1,8,16,23,0
474,Guido Carrillo,Leganés,13.5,13,10,3,6,4,2,14,14.3,12,9,1,8,3,16,22,0
475,Andy Carroll,Newcastle Utd,7.0,5,3,3,2,0,2,8,25.0,6,2,1,1,2,7,24,1
476,Dani Carvajal,Real Madrid,30.4,65,46,33,25,7,23,42,54.8,19,43,14,29,36,101,53,0
477,Matis Carvalho,Montpellier,0.8,0,0,0,0,0,0,1,0.0,1,0,0,0,0,0,1,0
478,William Carvalho,Betis,9.9,7,4,4,2,1,4,14,28.6,10,7,5,2,4,11,8,1
479,Casemiro,Real Madrid,34.3,96,60,43,45,8,39,99,39.4,60,53,10,43,68,164,72,0
480,Moreto Cassama,Reims,6.6,17,11,2,13,2,5,7,71.4,2,7,2,5,5,22,6,0
481,Francesco Cassata,Genoa,16.2,20,10,12,5,3,9,30,30.0,21,12,2,10,11,31,11,0
482,Timothy Castagne,Atalanta,19.7,31,20,9,16,6,13,25,52.0,12,34,5,29,17,48,23,0
483,Koen Casteels,Wolfsburg,26.0,0,0,0,0,0,0,0,0.0,0,0,0,0,0,0,9,1
484,Jean-Charles Castelletto,Brest,20.4,18,9,13,5,0,9,18,50.0,9,20,16,4,33,51,87,1
485,Samu Castillejo,Milan,13.4,24,15,10,11,3,9,42,21.4,33,17,2,15,24,48,5,0
486,Jonny Castro,Wolves,32.1,91,55,54,26,11,29,82,35.4,53,45,10,35,53,144,45,2
487,Lucas Castro,SPAL,4.7,13,5,5,5,3,2,4,50.0,2,4,0,4,2,15,3,0
488,Lucas Castro,Cagliari,6.7,7,3,3,4,0,1,12,8.3,11,6,1,5,8,15,14,0
489,Gaetano Castrovilli,Fiorentina,29.7,59,31,25,23,11,18,53,34.0,35,29,2,27,15,74,31,1
490,Danilo Cataldi,Lazio,6.6,17,11,10,5,2,10,20,50.0,10,7,1,6,13,30,10,0
491,Craig Cathcart,Watford,27.6,41,26,25,15,1,10,24,41.7,14,19,16,3,25,66,136,1
492,Edinson Cavani,Paris S-G,6.7,5,1,0,2,3,0,3,0.0,3,7,0,7,1,6,2,0
494,Santi Cazorla,Villarreal,27.2,48,25,14,21,13,20,57,35.1,37,23,1,22,19,67,16,2
495,Dani Ceballos,Arsenal,18.8,45,23,26,14,5,18,61,29.5,43,14,3,11,32,77,16,1
496,Federico Ceccherini,Fiorentina,9.3,14,8,11,3,0,10,10,100.0,0,9,5,4,13,27,37,1
497,Christian Celesia,Torino,0.0,0,0,0,0,0,0,0,0.0,0,0,0,0,0,0,0,0
498,Zeki Celik,Lille,23.0,53,28,18,28,7,27,60,45.0,33,24,4,20,26,79,39,0
499,Fabien Centonze,Metz,28.0,76,49,53,22,1,34,57,59.6,23,30,11,19,59,135,98,0
500,Luca Ceppitelli,Cagliari,13.8,22,15,16,6,0,6,11,54.5,5,23,17,6,23,45,66,2
501,Alberto Cerri,SPAL,4.7,2,1,0,2,0,1,3,33.3,2,1,0,1,0,2,3,0
502,Alberto Cerri,Cagliari,2.7,3,1,1,0,2,2,6,33.3,4,1,0,1,2,5,4,0
503,Julian Chabot,Sampdoria,6.3,11,7,6,5,0,6,11,54.5,5,3,2,1,15,26,26,0
504,Florian Chabrolle,Marseille,0.2,0,0,0,0,0,0,0,0.0,0,0,0,0,0,0,0,0
505,Fouad Chafik,Dijon,17.0,32,21,22,7,3,17,36,47.2,19,12,5,7,26,58,36,0
506,Sofian Chakla,Villarreal,2.0,0,0,0,0,0,0,1,0.0,1,2,1,1,3,3,7,1
507,Nathaniel Chalobah,Watford,10.3,30,11,13,13,4,12,27,44.4,15,10,4,6,18,48,20,0
508,Calum Chambers,Arsenal,12.2,26,10,12,8,6,11,16,68.8,5,13,7,6,16,42,43,1
509,Jhon Chancellor,Brescia,24.9,30,14,22,8,0,11,22,50.0,11,34,29,5,34,64,145,3
510,Timothy Chandler,Eint Frankfurt,13.6,22,10,9,8,5,9,16,56.3,7,9,4,5,13,35,21,0
511,Kwon Chang-hoon,Freiburg,7.5,7,4,2,3,2,1,10,10.0,9,5,1,4,7,14,14,0
512,Gaetan Charbonnier,Brest,22.9,36,16,11,11,14,10,35,28.6,25,19,6,13,7,43,33,1
513,Brendan Chardonnet,Brest,9.1,12,6,10,2,0,7,12,58.3,5,8,5,3,15,27,50,0
514,Charles,Eibar,14.5,10,5,0,6,4,4,22,18.2,18,7,2,5,7,17,6,0
515,Xavier Chavalerin,Reims,23.9,71,52,29,33,9,19,49,38.8,30,23,8,15,36,107,36,0
516,Pablo Chavarria,Mallorca,2.3,1,1,0,1,0,0,4,0.0,4,1,1,0,1,2,2,0
517,Aurelien Chedjou,Amiens,21.9,27,19,18,9,0,10,22,45.5,12,15,11,4,40,67,120,3
518,Pape Cheikh Diop,Celta Vigo,6.7,10,4,6,3,1,2,12,16.7,10,4,2,2,5,15,3,0
520,Chema,Getafe,3.4,4,3,1,3,0,1,2,50.0,1,1,0,1,5,9,12,0
521,Rayan Cherki,Lyon,1.6,3,2,0,1,2,3,4,75.0,1,3,0,3,0,3,0,0
522,Denis Cheryshev,Valencia,10.3,16,9,5,4,7,3,17,17.6,14,15,1,14,7,23,10,0
523,Giorgio Chiellini,Juventus,2.2,3,0,3,0,0,1,1,100.0,0,2,2,0,1,4,9,0
524,Federico Chiesa,Fiorentina,29.3,38,22,13,15,10,10,52,19.2,42,19,0,19,6,44,6,0
525,Ben Chilwell,Leicester City,26.4,43,26,28,13,2,23,52,44.2,29,30,6,24,28,71,68,2
526,Vlad Chiriches,Sassuolo,7.9,14,9,12,2,0,7,10,70.0,3,13,8,5,11,25,28,2
527,Tahith Chong,Manchester Utd,0.4,0,0,0,0,0,0,0,0.0,0,0,0,0,0,0,0,0
528,Joris Chotard,Montpellier,13.9,30,18,13,17,0,15,35,42.9,20,12,5,7,20,50,12,1
529,Hamza Choudhury,Leicester City,9.9,17,8,7,8,2,3,25,12.0,22,15,6,9,24,41,13,0
530,Mounir Chouiar,Dijon,16.7,36,23,13,18,5,12,42,28.6,30,8,0,8,13,49,13,0
531,Andreas Christensen,Chelsea,19.5,38,21,25,12,1,15,21,71.4,6,12,8,4,29,67,56,0
532,Samuel Chukwueze,Villarreal,22.8,23,14,12,6,5,13,30,43.3,17,15,1,14,10,33,14,1
533,Darko Churlinov,Köln,0.2,1,1,1,0,0,1,2,50.0,1,0,0,0,1,2,0,0
534,Churripi,Valladolid,2.7,1,1,1,0,0,1,1,100.0,0,0,0,0,0,1,2,0
535,Luca Cigarini,Cagliari,17.8,37,20,23,13,1,16,40,40.0,24,28,10,18,20,57,29,0
536,Per Ciljan Skjelbred,Hertha BSC,18.1,50,30,18,29,3,17,41,41.5,24,14,3,11,23,73,17,0
537,Jasper Cillessen,Valencia,23.3,0,0,0,0,0,0,1,0.0,1,0,0,0,3,3,3,1
538,Thiago Cionek,SPAL,24.1,53,32,36,12,5,22,53,41.5,31,30,11,19,46,99,91,2
539,Ibrahim Cisse,Nice,0.6,1,1,1,0,0,0,0,0.0,0,0,0,0,0,1,6,0
540,Ibrahim Cisse,Angers,0.7,2,1,0,2,0,0,0,0.0,0,0,0,0,0,2,2,0
541,Andrea Cistana,Brescia,20.4,20,8,13,7,0,6,17,35.3,11,38,34,4,33,53,96,1
542,Ciaran Clark,Newcastle Utd,13.2,20,12,18,2,0,9,15,60.0,6,18,14,4,11,31,82,0
543,Leon Clarke,Sheffield Utd,0.4,0,0,0,0,0,0,0,0.0,0,0,0,0,0,0,2,0
544,Alexis Claude-Maurice,Nice,18.1,26,16,8,11,7,13,35,37.1,22,20,4,16,11,37,4,0
546,Christian Clemens,Köln,0.2,0,0,0,0,0,0,0,0.0,0,1,1,0,0,0,0,0
547,Oscar Clemente,Atlético Madrid,0.0,0,0,0,0,0,0,0,0.0,0,1,0,1,0,0,0,0
548,Yannis Clementia,Nice,2.0,0,0,0,0,0,0,0,0.0,0,0,0,0,0,0,0,0
549,Denilho Cleonise,Genoa,0.5,1,0,1,0,0,0,0,0.0,0,0,0,0,1,2,0,0
550,Carlos Clerc,Levante,20.5,28,16,14,13,1,12,20,60.0,8,22,9,13,22,50,61,0
551,Tom Cleverley,Watford,10.8,28,15,8,14,6,9,36,25.0,27,13,1,12,10,38,15,0
552,Conor Coady,Wolves,38.0,36,23,30,6,0,15,30,50.0,15,22,15,7,28,64,119,2
553,Marcus Coco,Nantes,0.2,1,0,1,0,0,1,1,100.0,0,0,0,0,0,1,0,0
554,Renaud Cohade,Metz,8.5,28,20,11,12,5,12,28,42.9,16,14,3,11,8,36,6,0
555,Coke,Levante,11.0,25,18,14,8,3,14,30,46.7,16,9,2,7,13,38,19,0
556,Seamus Coleman,Everton,20.4,42,31,24,14,4,19,25,76.0,6,21,9,12,24,66,43,1
557,Alex Collado,Barcelona,0.1,0,0,0,0,0,0,0,0.0,0,0,0,0,0,0,0,0
558,Ebrima Colley,Atalanta,0.9,2,1,1,0,1,1,2,50.0,1,1,0,1,1,3,0,0
559,Omar Colley,Sampdoria,30.8,42,26,27,14,1,12,24,50.0,12,33,22,11,59,101,155,1
560,Jamilu Collins,Paderborn 07,29.6,69,43,44,21,4,37,62,59.7,25,53,19,34,70,139,91,1
561,Simone Colombi,Parma,4.0,0,0,0,0,0,0,0,0.0,0,0,0,0,0,0,1,0
562,Lorenzo Colombo,Milan,0.1,0,0,0,0,0,0,0,0.0,0,0,0,0,0,0,0,0
563,Racine Coly,Nice,7.2,21,13,15,5,1,9,17,52.9,8,5,0,5,12,33,23,0
564,Kingsley Coman,Bayern Munich,16.7,19,11,6,7,6,12,27,44.4,15,9,0,9,4,23,3,0
565,Daniel Congre,Montpellier,21.6,37,27,20,16,1,18,38,47.4,20,8,7,1,47,84,66,1
566,Aaron Connolly,Brighton,14.0,7,6,1,4,2,3,10,30.0,7,11,0,11,0,7,3,0
567,Andrea Consigli,Sassuolo,31.0,0,0,0,0,0,0,1,0.0,1,0,0,0,4,4,19,2
568,Andrea Conti,Milan,19.2,41,25,23,15,3,21,49,42.9,28,21,8,13,43,84,42,1
569,Lewis Cook,Bournemouth,15.0,27,14,15,9,3,10,47,21.3,37,17,5,12,17,44,17,1
570,Steve Cook,Bournemouth,27.0,22,11,18,4,0,8,20,40.0,12,32,23,9,44,66,153,1
572,Francis Coquelin,Valencia,21.2,37,21,25,11,1,16,38,42.1,22,19,9,10,38,75,25,0
573,Gabriele Corbo,Bologna,1.4,1,1,1,0,0,0,3,0.0,3,2,2,0,4,5,5,0
574,Sebastien Corchia,Espanyol,3.0,2,1,2,0,0,2,4,50.0,2,5,2,3,5,7,8,0
575,Inigo Cordoba,Athletic Club,16.0,33,20,16,12,5,14,52,26.9,38,30,2,28,16,49,13,0
576,Jhon Cordoba,Köln,22.2,9,6,1,5,3,3,13,23.1,10,19,1,18,5,14,17,0
577,Sergio Cordova,Augsburg,4.1,3,0,0,2,1,1,10,10.0,9,0,0,0,0,3,3,0
578,Benjamin Corgnet,Strasbourg,2.9,1,1,1,0,0,1,3,33.3,2,2,0,2,2,3,3,0
579,Jack Cork,Burnley,29.0,35,24,10,20,5,12,62,19.4,50,34,12,22,28,63,49,0
580,Andreas Cornelius,Parma,16.6,9,4,2,5,2,4,11,36.4,7,7,0,7,2,11,26,0
581,Maxwel Cornet,Lyon,14.8,30,19,18,8,4,13,23,56.5,10,16,1,15,21,51,19,1
582,Quentin Cornette,Amiens,3.9,8,3,3,2,3,3,9,33.3,6,7,1,6,6,14,5,0
583,Angel Correa,Atlético Madrid,22.9,25,9,7,9,9,9,36,25.0,27,23,5,18,14,39,21,0
584,Joaquin Correa,Lazio,22.2,13,7,3,7,3,5,24,20.8,19,5,1,4,7,20,10,0
585,Rober Correa,Eibar,10.3,13,6,8,3,2,6,10,60.0,4,6,4,2,16,29,31,0
586,Edmilson Correia,Saint-Étienne,0.5,0,0,0,0,0,0,1,0.0,1,1,0,1,1,1,0,0
587,Thierry Correia,Valencia,2.9,8,3,5,3,0,1,2,50.0,1,5,0,5,2,10,10,0
588,Antonio Cortes,Granada,2.0,1,1,0,1,0,0,1,0.0,1,0,0,0,0,1,2,0
589,Danny da Costa,Eint Frankfurt,15.4,26,17,14,8,4,6,16,37.5,10,16,1,15,15,41,26,0
590,Diego Costa,Atlético Madrid,15.0,9,5,1,4,4,1,10,10.0,9,4,2,2,3,12,10,0
591,Douglas Costa,Juventus,8.9,2,1,1,1,0,1,12,8.3,11,7,0,7,5,7,5,0
592,Jaume Costa,Valencia,15.4,27,23,17,8,2,14,28,50.0,14,11,6,5,24,51,52,1
593,Angelo da Costa Junior,Bologna,1.0,0,0,0,0,0,0,0,0.0,0,0,0,0,0,0,0,0
594,Nuno da Costa,Strasbourg,5.9,15,10,3,8,4,4,10,40.0,6,7,0,7,4,19,3,0
595,David Costas,Celta Vigo,3.8,4,3,3,1,0,2,4,50.0,2,3,3,0,8,12,12,0
596,Benoit Costil,Bordeaux,28.0,0,0,0,0,0,0,3,0.0,3,0,0,0,2,2,9,0
598,Kalifa Coulibaly,Nantes,18.0,11,7,0,5,6,3,5,60.0,2,3,1,2,6,17,32,0
599,Senou Coulibaly,Dijon,7.4,14,7,11,3,0,2,4,50.0,2,11,10,1,10,24,44,1
600,Yoann Court,Brest,16.3,48,26,28,17,3,20,64,31.3,44,21,0,21,15,63,14,0
601,Thibaut Courtois,Real Madrid,34.0,0,0,0,0,0,0,2,0.0,2,0,0,0,2,2,18,2
602,Philippe Coutinho,Bayern Munich,15.7,21,15,1,13,7,2,13,15.4,11,9,2,7,6,27,0,0
603,Nicolas Cozza,Montpellier,6.2,5,5,3,2,0,2,3,66.7,1,8,6,2,9,14,18,0
604,Alessio Cragno,Cagliari,16.0,0,0,0,0,0,0,0,0.0,0,0,0,0,0,0,10,0
605,Aaron Cresswell,West Ham,30.3,43,26,21,18,4,23,46,50.0,23,33,10,23,35,78,75,2
606,Domenico Criscito,Genoa,22.8,53,33,34,12,7,24,56,42.9,32,25,13,12,53,106,81,1
607,Bryan Cristante,Roma,18.0,25,15,6,14,5,8,27,29.6,19,13,4,9,22,47,23,0
608,Sebastian Cristoforo,Fiorentina,1.0,5,5,2,2,1,1,5,20.0,4,2,1,1,1,6,0,0
609,Sebastian Cristoforo,Eibar,9.7,35,19,11,14,10,13,32,40.6,19,25,3,22,8,43,2,0
610,Juan Cuadrado,Juventus,29.5,67,43,32,28,7,35,62,56.5,27,22,8,14,35,102,47,0
611,Cucho,Mallorca,16.5,15,8,6,8,1,6,21,28.6,15,14,1,13,10,25,15,0
612,Marc Cucurella,Getafe,36.0,74,51,23,38,13,24,76,31.6,52,58,8,50,36,110,28,1
613,Ivan Cuellar,Leganés,27.0,0,0,0,0,0,0,2,0.0,2,0,0,0,0,0,28,2
614,Jaume Cuellar,SPAL,0.8,1,0,0,0,1,0,1,0.0,1,0,0,0,0,1,0,0
615,Mickael Cuisance,Bayern Munich,3.4,2,1,0,2,0,1,9,11.1,8,1,1,0,3,5,0,0
616,Matheus Cunha,Hertha BSC,8.3,10,5,6,4,0,4,11,36.4,7,11,1,10,10,20,1,0
617,Matheus Cunha,RB Leipzig,3.1,6,2,0,1,5,0,2,0.0,2,5,1,4,1,7,0,0
618,Felipe Curcio,Brescia,0.1,0,0,0,0,0,0,0,0.0,0,0,0,0,0,0,0,0
619,Patrick Cutrone,Wolves,3.3,4,2,2,1,1,1,5,20.0,4,1,1,0,2,6,1,0
620,Patrick Cutrone,Fiorentina,9.3,4,2,2,1,1,1,15,6.7,14,6,1,5,2,6,6,0
621,Wylan Cyprien,Nice,19.7,17,11,5,12,0,7,27,25.9,20,8,2,6,19,36,16,3
622,Rafael Czichos,Köln,24.5,43,34,26,16,1,22,45,48.9,23,24,13,11,35,78,110,1
624,Lennart-Marten Czyborra,Atalanta,0.2,0,0,0,0,0,0,0,0.0,0,2,0,2,0,0,0,0
625,Marco D'Alessandro,SPAL,8.7,11,8,5,3,3,5,8,62.5,3,11,0,11,5,16,6,0
626,Danilo D'Ambrosio,Inter,15.6,30,16,16,12,2,16,33,48.5,17,15,4,11,14,44,25,0
627,Felice D'Amico,Sampdoria,0.0,1,1,0,0,1,0,0,0.0,0,0,0,0,0,1,0,0
628,Lucas Da Cunha,Rennes,0.8,1,0,1,0,0,1,1,100.0,0,0,0,0,0,1,0,0
629,Jacopo Da Riva,Atalanta,0.0,0,0,0,0,0,0,0,0.0,0,0,0,0,0,0,0,0
630,Damien Da Silva,Rennes,24.9,27,14,20,5,2,10,19,52.6,9,21,13,8,26,53,143,1
631,Moanes Dabbur,Sevilla,0.3,1,1,0,0,1,0,0,0.0,0,1,0,1,0,1,0,0
632,Moanes Dabbur,Hoffenheim,8.5,8,5,1,3,4,3,10,30.0,7,6,2,4,4,12,1,0
633,Bryan Dabo,SPAL,12.5,18,10,13,4,1,5,15,33.3,10,13,2,11,9,27,14,0
634,Colin Dagba,Paris S-G,7.4,10,4,2,4,4,5,9,55.6,4,6,1,5,6,16,9,0
635,Mahmoud Dahoud,Dortmund,6.2,10,6,4,4,2,6,18,33.3,12,8,2,6,8,18,4,0
636,Leon Dajaku,Bayern Munich,0.1,0,0,0,0,0,0,1,0.0,1,0,0,0,0,0,0,0
637,Felipe dal Belo,SPAL,11.1,13,6,9,4,0,9,15,60.0,6,14,12,2,9,22,30,0
638,Christian Dalle Mura,Fiorentina,0.0,0,0,0,0,0,0,0,0.0,0,0,0,0,0,0,0,0
639,Diogo Dalot,Manchester Utd,0.7,3,2,3,0,0,3,4,75.0,1,1,0,1,2,5,1,0
640,Charlie Daniels,Bournemouth,1.4,1,1,0,1,0,0,1,0.0,1,2,0,2,1,2,5,1
641,Danilo,Juventus,16.0,30,20,16,12,2,18,30,60.0,12,12,3,9,26,56,44,0
642,Arnaut Danjuma,Bournemouth,7.0,4,2,3,1,0,1,4,25.0,3,2,0,2,8,12,4,1
643,Scott Dann,Crystal Palace,14.1,8,4,7,1,0,8,14,57.1,6,9,7,2,14,22,67,0
644,Kevin Danso,Southampton,3.1,6,4,3,3,0,4,7,57.1,3,7,3,4,2,8,7,0
645,Dante,Nice,21.0,34,21,24,10,0,17,25,68.0,8,27,16,11,26,60,79,0
646,Andrea Danzi,Hellas Verona,0.0,0,0,0,0,0,0,0,0.0,0,0,0,0,0,0,0,0
647,Sergi Darder,Espanyol,29.5,47,23,11,26,10,17,58,29.3,41,30,1,29,24,71,23,1
648,Vladimir Darida,Hertha BSC,25.1,50,27,14,31,5,11,48,22.9,37,44,7,37,27,77,19,2
650,Matteo Darmian,Parma,29.8,81,42,48,30,3,40,83,48.2,43,38,16,22,25,106,78,1
651,Alphonso Davies,Bayern Munich,24.8,70,43,35,24,11,38,58,65.5,20,35,6,29,31,101,51,0
652,Ben Davies,Tottenham,15.9,28,15,13,11,4,7,21,33.3,14,28,12,16,22,50,47,0
653,Tom Davies,Everton,22.5,38,17,12,22,4,17,55,30.9,38,12,4,8,35,73,28,0
654,Keinan Davis,Aston Villa,6.1,1,1,0,1,0,0,3,0.0,3,4,0,4,0,1,3,0
655,Pawel Dawidowicz,Hellas Verona,7.7,15,12,11,4,0,5,11,45.5,6,6,5,1,12,27,26,0
656,Craig Dawson,Watford,26.2,29,18,16,13,0,17,31,54.8,14,41,32,9,34,63,116,0
657,Kevin De Bruyne,Manchester City,31.0,45,24,8,20,17,18,66,27.3,48,26,4,22,18,63,24,2
658,Sebastien De Maio,Udinese,16.7,18,11,11,7,0,7,11,63.6,4,28,20,8,32,50,86,2
659,Rodrigo De Paul,Udinese,31.4,61,31,31,26,4,27,65,41.5,38,38,3,35,29,90,8,1
660,Mattia De Sciglio,Juventus,5.2,10,8,6,4,0,6,14,42.9,8,5,2,3,8,18,18,1
661,Lorenzo De Silvestri,Torino,24.9,15,8,4,7,4,11,27,40.7,16,20,7,13,19,34,72,0
662,Lucas Deaux,Nîmes,14.8,49,26,16,29,4,16,45,35.6,29,20,4,16,15,64,19,0
663,Mathieu Debuchy,Saint-Étienne,19.7,44,26,22,15,7,24,47,51.1,23,21,11,10,43,87,59,0
664,Troy Deeney,Watford,24.7,19,12,6,10,3,6,29,20.7,23,13,1,12,11,30,27,0
665,Gregoire Defrel,Sassuolo,10.9,12,8,4,6,2,4,15,26.7,11,9,0,9,3,15,5,0
666,Alessandro Deiola,Cagliari,0.0,0,0,0,0,0,0,0,0.0,0,0,0,0,1,1,0,0
667,Alessandro Deiola,Lecce,8.0,16,9,9,7,0,9,24,37.5,15,12,4,8,8,24,14,1
668,Romain Del Castillo,Rennes,13.8,20,14,5,11,4,6,27,22.2,21,12,2,10,7,27,7,0
669,Thomas Delaine,Metz,13.9,25,16,18,6,1,12,21,57.1,9,17,1,16,15,40,28,0
670,Thomas Delaney,Dortmund,9.2,22,10,10,11,1,9,15,60.0,6,16,7,9,26,48,26,0
671,Paul Delecroix,Metz,1.5,0,0,0,0,0,0,0,0.0,0,0,0,0,0,0,0,0
672,Cristian Dell'Orco,Lecce,11.2,22,12,14,7,1,8,14,57.1,6,11,7,4,16,38,33,0
673,Andy Delort,Montpellier,25.3,28,18,11,9,8,7,27,25.9,20,21,6,15,3,31,10,0
674,Fabian Delph,Everton,13.2,26,12,10,13,3,9,22,40.9,13,12,3,9,15,41,19,1
676,Moussa Dembele,Lyon,24.3,12,7,2,5,5,4,14,28.6,10,14,3,11,5,17,31,0
677,Ousmane Dembele,Barcelona,4.0,2,2,1,1,0,2,5,40.0,3,4,0,4,0,2,0,1
678,Merih Demiral,Juventus,4.6,8,7,5,3,0,1,3,33.3,2,4,3,1,4,12,16,1
679,Kerem Demirbay,Leverkusen,17.5,35,19,10,21,4,12,31,38.7,19,19,5,14,22,57,7,1
680,Diego Demme,Napoli,10.0,18,8,14,3,1,8,23,34.8,15,9,1,8,8,26,9,0
681,Diego Demme,RB Leipzig,13.5,41,18,17,19,5,17,42,40.5,25,14,2,12,15,56,14,0
682,Jason Denayer,Lyon,23.7,17,13,12,5,0,10,14,71.4,4,32,29,3,20,37,83,0
683,Leander Dendoncker,Wolves,31.1,68,31,41,19,8,28,67,41.8,39,39,12,27,38,106,64,2
684,Kevin Denkey,Nîmes,6.7,10,5,1,8,1,6,10,60.0,4,7,0,7,2,12,1,1
685,Stefano Denswil,Bologna,24.9,49,28,29,19,1,26,44,59.1,18,23,8,15,31,80,68,0
686,Fabio Depaoli,Sampdoria,20.6,41,28,26,10,5,17,31,54.8,14,29,3,26,16,57,39,0
687,Kastriot Dermaku,Parma,11.4,13,5,10,3,0,3,5,60.0,2,20,16,4,12,25,61,1
688,Daniele Dessena,Brescia,20.8,21,11,5,14,2,6,25,24.0,19,11,1,10,11,32,21,0
689,Mattia Destro,Bologna,2.1,3,2,1,2,0,1,3,33.3,2,1,0,1,0,3,0,0
690,Mattia Destro,Genoa,1.7,0,0,0,0,0,0,0,0.0,0,0,0,0,0,0,1,0
691,Gerard Deulofeu,Watford,23.3,33,16,18,9,6,12,59,20.3,47,10,0,10,25,58,6,0
692,Deyverson,Getafe,2.3,0,0,0,0,0,0,1,0.0,1,2,1,1,0,0,5,0
693,Samuel Di Carmine,Hellas Verona,14.4,2,1,0,0,2,0,8,0.0,8,3,0,3,1,3,10,0
694,Federico Di Francesco,SPAL,12.0,11,5,2,6,3,3,15,20.0,12,9,1,8,3,14,2,1
695,Giovanni Di Lorenzo,Napoli,33.0,59,35,27,19,13,32,61,52.5,29,27,11,16,28,87,54,0
696,Angel Di Maria,Paris S-G,22.2,17,12,2,8,7,4,34,11.8,30,14,3,11,11,28,1,3
697,Boulaye Dia,Reims,20.1,15,9,7,6,2,3,10,30.0,7,9,2,7,7,22,16,0
698,Fousseni Diabate,Amiens,13.2,16,10,6,6,4,5,16,31.3,11,11,0,11,8,24,3,1
699,Moussa Diaby,Leverkusen,19.7,10,8,3,7,0,5,15,33.3,10,6,0,6,9,19,4,0
700,Mouctar Diakhaby,Valencia,16.0,11,8,7,3,1,5,8,62.5,3,17,15,2,11,22,73,0
702,Bafode Diakite,Toulouse,15.2,23,19,15,8,0,7,13,53.8,6,18,9,9,20,43,75,0
703,Abdou Diallo,Paris S-G,13.3,20,11,9,10,1,8,14,57.1,6,9,5,4,10,30,32,0
704,Amad Diallo,Atalanta,0.3,1,1,0,1,0,0,0,0.0,0,0,0,0,0,1,0,0
705,Habib Diallo,Metz,24.4,2,1,0,2,0,0,6,0.0,6,6,5,1,4,6,43,0
706,Ibrahima Diallo,Brest,17.3,38,24,15,22,1,12,29,41.4,17,9,2,7,23,61,16,3
707,Moussa Diarra,Toulouse,1.0,3,3,2,1,0,1,1,100.0,0,0,0,0,3,6,2,0
708,Lucas Dias,Nîmes,3.5,1,1,1,0,0,1,1,100.0,0,0,0,0,0,1,2,0
709,Amadou Diawara,Roma,16.9,40,25,14,20,6,8,30,26.7,22,10,1,9,33,73,16,2
710,Brahim Diaz,Real Madrid,0.7,1,0,0,1,0,0,2,0.0,2,2,0,2,0,1,0,0
711,Victor Diaz,Granada,32.0,74,43,38,31,5,31,60,51.7,29,53,23,30,48,122,94,1
712,Bakaye Dibassy,Amiens,20.8,26,14,17,8,1,15,20,75.0,5,29,18,11,37,63,78,2
713,Eric Dier,Tottenham,14.9,21,12,10,10,1,10,20,50.0,10,14,9,5,21,42,65,0
714,Lucas Digne,Everton,33.7,73,49,49,19,5,33,68,48.5,35,39,10,29,42,115,108,0
715,Mitchell Dijks,Bologna,11.2,13,10,6,5,2,8,12,66.7,4,5,1,4,10,23,23,0
716,Javairo Dilrosun,Hertha BSC,14.5,15,8,11,1,3,5,13,38.5,8,20,0,20,18,33,10,0
717,Federico Dimarco,Hellas Verona,5.8,11,5,4,4,3,6,10,60.0,4,3,2,1,4,15,11,0
718,Federico Dimarco,Inter,0.3,1,0,0,1,0,0,0,0.0,0,0,0,0,1,2,1,0
719,Tristan Dingome,Reims,9.9,10,4,3,6,1,2,12,16.7,10,6,0,6,6,16,1,0
720,Lois Diony,Saint-Étienne,7.4,15,5,0,11,4,5,9,55.6,4,3,0,3,1,16,0,0
721,Issa Diop,West Ham,30.7,27,15,18,9,0,16,25,64.0,9,37,21,16,47,74,166,2
722,Papakouli Diop,Eibar,25.0,39,26,13,22,4,18,42,42.9,24,24,7,17,34,73,38,0
723,Assane Diousse,Saint-Étienne,1.3,1,1,0,1,0,0,3,0.0,3,0,0,0,0,1,2,0
724,Axel Disasi,Reims,27.0,32,21,18,13,1,17,27,63.0,10,29,24,5,26,58,97,0
725,Tiago Djalo,Lille,7.3,9,4,5,3,1,2,7,28.6,5,3,2,1,11,20,28,0
726,Djene,Getafe,34.0,42,32,27,15,0,17,30,56.7,13,20,7,13,34,76,105,1
728,Moussa Djenepo,Southampton,10.3,27,21,13,9,5,11,21,52.4,10,15,1,14,9,36,9,0
729,Koffi Djidji,Torino,9.5,27,12,19,8,0,8,18,44.4,10,28,23,5,15,42,53,1
730,Alexander Djiku,Strasbourg,22.9,46,32,27,19,0,21,29,72.4,8,14,8,6,55,101,82,4
731,Berat Djimsiti,Atalanta,30.9,42,23,17,23,2,22,39,56.4,17,21,14,7,49,91,92,0
732,Nais Djouahra,Real Sociedad,0.3,0,0,0,0,0,0,0,0.0,0,0,0,0,0,0,0,0
733,Marko Dmitrovic,Eibar,35.0,3,2,3,0,0,3,5,60.0,2,1,0,1,3,6,24,0
734,Matt Doherty,Wolves,31.5,55,29,34,17,4,27,41,65.9,14,34,4,30,40,95,52,1
735,Kasper Dolberg,Nice,21.0,10,6,0,3,7,4,17,23.5,13,18,2,16,10,20,24,0
736,Keagan Dolly,Montpellier,1.6,6,3,1,3,2,2,5,40.0,3,1,0,1,1,7,0,0
737,Jaume Domenech,Valencia,14.7,0,0,0,0,0,0,1,0.0,1,0,0,0,1,1,3,1
738,Nicolas Dominguez,Bologna,7.8,21,14,15,5,1,7,18,38.9,11,12,2,10,12,33,7,0
739,Giulio Donati,Lecce,19.6,32,21,22,8,2,15,28,53.6,13,19,10,9,25,57,42,0
740,Ji Dong-won,Mainz 05,1.1,0,0,0,0,0,0,1,0.0,1,1,0,1,0,0,0,0
741,Anastasios Donis,Reims,6.8,3,2,2,1,0,1,9,11.1,8,2,0,2,1,4,3,0
742,Alfredo Donnarumma,Brescia,18.7,17,9,3,9,5,6,18,33.3,12,7,0,7,5,22,1,0
743,Gianluigi Donnarumma,Milan,35.6,1,0,1,0,0,1,2,50.0,1,0,0,0,3,4,25,7
744,Gabriel Dos Santos,Lille,23.2,41,29,27,11,3,15,22,68.2,7,27,18,9,22,63,86,2
745,Mathieu Dossevi,Toulouse,19.5,32,20,7,17,8,15,30,50.0,15,17,0,17,14,46,7,0
746,Bas Dost,Eint Frankfurt,16.4,11,7,1,7,3,3,7,42.9,4,6,2,4,5,16,22,0
747,Abdoulaye Doucoure,Watford,35.1,64,30,29,29,6,16,57,28.1,41,46,8,38,31,95,32,0
748,Mamadou Doucoure,M'Gladbach,0.0,0,0,0,0,0,0,0,0.0,0,0,0,0,0,0,0,0
749,Moussa Doumbia,Reims,19.1,16,8,5,6,5,7,24,29.2,17,14,1,13,9,25,5,0
750,Souleyman Doumbia,Angers,5.0,10,4,7,2,1,5,6,83.3,1,5,0,5,6,16,18,0
751,Souleyman Doumbia,Rennes,1.0,1,1,1,0,0,1,1,100.0,0,2,2,0,0,1,3,0
752,Tommy Doyle,Manchester City,0.2,0,0,0,0,0,0,1,0.0,1,0,0,0,0,0,0,0
754,Mohamed Drager,Paderborn 07,16.2,32,21,22,8,2,14,33,42.4,19,17,5,12,18,50,39,0
755,Aleksandar Dragovic,Leverkusen,11.4,18,11,11,6,1,10,21,47.6,11,9,3,6,15,33,39,0
756,Bartlomiej Dragowski,Fiorentina,31.0,0,0,0,0,0,0,1,0.0,1,0,0,0,3,3,8,1
757,Julian Draxler,Paris S-G,7.6,13,10,2,9,2,7,15,46.7,8,7,1,6,10,23,1,0
758,Dominick Drexler,Köln,17.6,34,25,12,19,3,8,32,25.0,24,11,5,6,26,60,11,0
759,Danny Drinkwater,Aston Villa,2.9,5,3,3,2,0,2,18,11.1,16,5,0,5,5,10,5,1
760,Danny Drinkwater,Burnley,0.6,2,1,1,1,0,0,1,0.0,1,0,0,0,1,3,0,0
761,Josip Drmic,Norwich City,7.2,3,2,1,2,0,0,8,0.0,8,6,0,6,1,4,5,1
762,Domingos Duarte,Granada,34.3,30,19,24,5,1,11,20,55.0,9,34,24,10,34,64,153,1
763,Leo Duarte,Milan,4.5,4,3,0,3,1,1,4,25.0,3,9,6,3,3,7,9,0
764,Oscar Duarte,Levante,5.4,12,3,11,1,0,3,4,75.0,1,7,6,1,6,18,29,0
765,Ruben Duarte,Alavés,29.6,61,32,30,28,3,34,60,56.7,26,30,8,22,47,108,71,0
766,Edgaras Dubickas,Lecce,0.0,0,0,0,0,0,0,0,0.0,0,0,0,0,0,0,0,0
767,Leo Dubois,Lyon,15.0,32,23,20,9,3,13,22,59.1,9,12,4,8,18,50,34,1
768,Martin Dubravka,Newcastle Utd,38.0,1,1,1,0,0,1,2,50.0,1,2,0,2,1,2,17,5
769,Ondrej Duda,Norwich City,8.0,18,11,9,6,3,7,16,43.8,9,10,2,8,6,24,8,0
770,Ondrej Duda,Hertha BSC,5.0,6,4,1,2,3,1,10,10.0,9,3,1,2,5,11,5,0
771,Shane Duffy,Brighton,13.8,18,9,14,4,0,6,17,35.3,11,13,7,6,21,39,72,0
772,Haris Duljevic,Nîmes,5.8,11,6,3,7,1,4,12,33.3,8,5,0,5,2,13,1,0
773,Paul Dummett,Newcastle Utd,13.6,27,17,19,7,1,21,27,77.8,6,23,9,14,23,50,69,0
774,Alfred Duncan,Fiorentina,9.9,12,9,11,1,0,2,19,10.5,17,4,0,4,5,17,12,0
775,Alfred Duncan,Sassuolo,9.4,19,12,8,7,4,6,16,37.5,10,7,0,7,9,28,13,0
776,Lewis Dunk,Brighton,35.9,40,24,23,17,0,15,34,44.1,19,55,33,22,55,95,125,2
777,Erik Durm,Eint Frankfurt,5.7,13,6,9,2,2,9,17,52.9,8,11,2,9,3,16,11,0
778,Riza Durmisi,Nice,1.8,1,1,1,0,0,0,0,0.0,0,2,1,1,1,2,3,0
780,Hugo Duro,Getafe,4.2,6,5,2,2,2,4,8,50.0,4,3,0,3,1,7,3,0
781,Jean-Kevin Duverne,Brest,13.1,12,8,5,6,1,2,6,33.3,4,23,8,15,20,32,50,0
782,Paulo Dybala,Juventus,23.9,19,10,6,9,4,9,39,23.1,30,15,0,15,13,32,3,0
783,Edin Dzeko,Roma,31.7,16,11,2,7,7,2,13,15.4,11,11,4,7,6,22,33,0
784,Blerim Dzemaili,Bologna,7.8,19,12,3,13,3,4,22,18.2,18,9,3,6,7,26,6,0
785,Bruno Ecuele Manga,Dijon,28.0,22,15,17,5,0,9,20,45.0,11,34,23,11,37,59,112,2
786,Simone Edera,Torino,4.4,13,5,3,7,3,2,12,16.7,10,1,0,1,1,14,3,0
787,Ederson,Manchester City,34.1,2,2,2,0,0,2,5,40.0,3,0,0,0,3,5,16,6
788,John Egan,Sheffield Utd,35.4,44,27,34,10,0,25,45,55.6,20,39,27,12,58,102,171,4
789,Johannes Eggestein,Werder Bremen,5.7,8,6,2,2,4,3,12,25.0,9,6,0,6,2,10,4,0
790,Maximilian Eggestein,Werder Bremen,31.7,40,28,20,18,2,15,43,34.9,28,37,8,29,36,76,57,0
791,Kingsley Ehizibue,Köln,25.9,79,53,44,30,5,33,53,62.3,20,28,8,20,39,118,79,1
792,Albin Ekdal,Sampdoria,26.5,51,25,18,31,2,24,68,35.3,44,35,14,21,33,84,46,1
793,Harvey Elliott,Liverpool,0.1,0,0,0,0,0,0,0,0.0,0,0,0,0,0,0,0,0
794,Elif Elmas,Napoli,12.6,16,7,5,6,5,5,20,25.0,15,11,1,10,11,27,4,0
795,Ilay Elmkies,Hoffenheim,0.0,1,1,1,0,0,0,0,0.0,0,0,0,0,0,1,0,0
796,Ahmed Elmohamady,Aston Villa,11.5,19,9,10,7,2,10,21,47.6,11,11,5,6,13,32,25,1
797,Aritz Elustondo,Real Sociedad,16.8,28,17,19,8,1,13,23,56.5,10,21,8,13,15,43,67,0
798,Nico Elvedi,M'Gladbach,29.1,45,27,37,8,0,19,38,50.0,19,32,15,17,62,107,112,0
799,Rodrigo Ely,Alavés,23.6,22,13,15,7,0,13,29,44.8,16,23,19,4,32,54,116,0
800,Adri Embarba,Espanyol,15.2,37,22,16,16,5,16,33,48.5,17,28,4,24,16,53,11,0
801,Breel Embolo,M'Gladbach,17.2,22,11,2,15,5,4,15,26.7,11,12,1,11,8,30,5,0
802,Emerson,Betis,31.5,74,46,49,19,6,36,79,45.6,43,30,9,21,31,105,57,1
803,Renaud Emond,Nantes,3.2,3,1,0,2,1,1,5,20.0,4,0,0,0,0,3,7,0
804,Alan Empereur,Hellas Verona,9.5,16,8,11,4,1,6,10,60.0,4,19,12,7,22,38,36,0
806,Youssef En-Nesyri,Leganés,15.4,9,7,1,2,6,3,17,17.6,14,15,2,13,5,14,22,0
807,Youssef En-Nesyri,Sevilla,8.8,7,5,1,6,0,3,10,30.0,7,9,3,6,5,12,7,0
808,Bjorn Engels,Aston Villa,16.1,11,6,8,2,1,8,13,61.5,5,18,17,1,28,39,86,3
809,Sergi Enrich,Eibar,20.7,17,6,4,8,5,4,21,19.0,17,16,2,14,9,26,12,0
810,Javier Eraso,Leganés,9.1,11,5,4,5,2,5,15,33.3,10,5,0,5,7,18,5,0
811,Christian Eriksen,Tottenham,12.2,19,9,10,8,1,7,24,29.2,17,10,1,9,12,31,16,0
812,Christian Eriksen,Inter,7.8,11,6,2,8,1,5,20,25.0,15,3,0,3,0,11,0,0
813,Gonzalo Escalante,Eibar,18.6,41,22,15,17,9,24,41,58.5,17,22,4,18,29,70,14,0
814,Aaron Escandell,Granada,3.0,1,1,1,0,0,1,1,100.0,0,0,0,0,0,1,0,0
815,Sergio Escudero,Sevilla,8.6,29,16,17,10,2,19,28,67.9,9,11,1,10,13,42,35,0
816,Bernardo Espinosa,Espanyol,25.1,24,16,18,4,2,16,28,57.1,12,19,11,8,24,48,108,2
817,Sebastiano Esposito,Inter,2.2,3,2,0,2,1,0,5,0.0,5,3,0,3,3,6,1,0
818,Vicente Esquerdo,Valencia,0.2,1,0,1,0,0,0,0,0.0,0,1,0,1,0,1,1,0
819,Alexander Esswein,Hertha BSC,2.4,6,4,4,2,0,3,8,37.5,5,8,1,7,7,13,7,1
820,Pervis Estupinan,Osasuna,33.1,84,45,53,27,4,42,77,54.5,35,30,7,23,58,142,61,6
821,Oghenekaro Etebo,Getafe,6.4,12,4,5,7,0,7,12,58.3,5,10,1,9,11,23,4,1
822,Benat Etxebarria,Athletic Club,4.4,6,1,2,3,1,2,13,15.4,11,6,1,5,4,10,6,0
823,Xabier Etxeita,Getafe,16.1,20,11,11,9,0,12,23,52.2,11,9,5,4,17,37,68,0
824,Antony Evans,Paderborn 07,1.7,5,4,1,3,1,1,5,20.0,4,1,1,0,2,7,4,0
825,Jonny Evans,Leicester City,37.6,48,34,33,14,1,28,39,71.8,11,33,18,15,57,105,174,4
826,Edu Exposito,Eibar,25.7,52,28,12,31,9,18,49,36.7,31,20,6,14,31,83,18,1
827,Valentin Eysseric,Hellas Verona,3.9,4,4,1,2,1,0,4,0.0,4,3,0,3,1,5,2,0
828,Valentin Eysseric,Fiorentina,0.5,0,0,0,0,0,0,0,0.0,0,1,0,1,0,0,0,0
829,Lukasz Fabianski,West Ham,23.5,2,2,2,0,0,2,4,50.0,2,0,0,0,1,3,5,3
830,Fabinho,Liverpool,23.1,62,35,20,35,7,26,67,38.8,41,25,2,23,34,96,19,1
832,Fabio,Nantes,9.3,38,22,18,20,0,25,35,71.4,10,10,5,5,18,56,19,0
833,Cesc Fabregas,Monaco,10.3,11,4,6,3,2,6,29,20.7,23,8,1,7,7,18,3,0
834,Fabricio,Mallorca,1.0,0,0,0,0,0,0,0,0.0,0,0,0,0,0,0,0,1
835,Ralf Fahrmann,Norwich City,0.2,0,0,0,0,0,0,0,0.0,0,0,0,0,0,0,0,0
836,Faycal Fajr,Getafe,4.5,1,1,0,1,0,0,3,0.0,3,4,0,4,4,5,1,0
837,Luca Falbo,Lazio,0.0,0,0,0,0,0,0,0,0.0,0,0,0,0,0,0,0,0
838,Filippo Falco,Lecce,22.4,13,7,4,5,4,5,18,27.8,13,11,1,10,2,15,1,0
839,Eliseo Falcon,Levante,0.8,0,0,0,0,0,0,0,0.0,0,0,0,0,0,0,2,0
840,Wladimiro Falcone,Sampdoria,2.0,0,0,0,0,0,0,0,0.0,0,0,0,0,0,0,0,0
841,Simon Falette,Eint Frankfurt,1.0,0,0,0,0,0,0,1,0.0,1,3,3,0,3,3,5,0
842,Iago Falque,Torino,1.1,0,0,0,0,0,0,1,0.0,1,1,0,1,0,0,0,0
843,Iago Falque,Genoa,5.8,7,3,1,4,2,4,8,50.0,4,7,0,7,1,8,4,0
844,Akin Famewo,Norwich City,0.0,0,0,0,0,0,0,0,0.0,0,0,0,0,0,0,0,0
845,Andri Fannar Baldursson,Bologna,1.6,1,0,0,1,0,0,1,0.0,1,2,0,2,1,2,3,0
846,Paolo Farago,Cagliari,14.9,41,28,21,15,5,23,46,50.0,23,18,9,9,10,51,58,0
847,Davide Faraoni,Hellas Verona,35.9,67,37,43,19,5,30,67,44.8,37,50,15,35,36,103,115,0
848,Mohamed Fares,SPAL,4.7,6,4,3,2,1,2,10,20.0,8,5,3,2,5,11,8,0
849,Diego Farias,Lecce,9.2,9,6,3,5,1,5,18,27.8,13,7,0,7,4,13,4,0
850,Ansu Fati,Barcelona,11.4,16,8,4,7,5,5,15,33.3,10,14,1,13,8,24,3,0
851,Julien Faussurier,Brest,22.0,36,22,23,13,0,21,53,39.6,32,22,7,15,33,69,46,1
852,Andrea Favilli,Genoa,7.3,8,7,2,3,3,4,11,36.4,7,5,1,4,0,8,7,0
853,Federico Fazio,Roma,13.5,19,11,12,6,1,6,11,54.5,5,8,6,2,19,38,52,0
854,Aleix Febas,Mallorca,18.8,36,24,13,19,4,12,36,33.3,24,15,0,15,17,53,6,0
855,Zouhair Feddal,Betis,15.9,20,13,14,5,1,10,14,71.4,4,15,9,6,23,43,74,0
856,Ljubomir Fejsa,Alavés,8.7,19,13,8,10,1,6,23,26.1,17,8,1,7,6,25,13,0
858,Nabil Fekir,Betis,29.3,41,26,14,19,8,12,37,32.4,25,27,3,24,10,51,3,0
859,Felipe,Atlético Madrid,23.4,27,19,21,6,0,14,24,58.3,10,18,13,5,40,67,130,0
860,Luiz Felipe,Lazio,22.5,42,24,24,15,3,19,32,59.4,13,39,30,9,41,83,69,2
861,Lucas Felippe,Hellas Verona,0.3,1,1,1,0,0,1,1,100.0,0,0,0,0,0,1,0,0
862,Joao Felix,Atlético Madrid,19.4,9,3,3,3,3,4,14,28.6,10,4,0,4,10,19,4,1
863,Ohis Felix Uduokhai,Augsburg,21.8,43,26,30,12,1,19,29,65.5,10,40,30,10,36,79,125,2
864,Kiko Femenia,Watford,24.9,68,38,49,17,2,43,80,53.8,37,16,2,14,36,104,49,0
865,Zinedine Ferhat,Nîmes,25.0,26,16,5,16,5,15,46,32.6,31,15,3,12,16,42,18,0
866,Bruno Fernandes,Manchester Utd,13.2,22,12,9,9,4,5,38,13.2,33,6,0,6,11,33,16,0
867,Edimilson Fernandes,Mainz 05,16.5,33,20,12,15,6,15,33,45.5,18,17,9,8,32,65,47,1
868,Gedson Fernandes,Tottenham,0.8,2,0,2,0,0,0,2,0.0,2,2,0,2,1,3,0,0
869,Gelson Fernandes,Eint Frankfurt,8.6,30,18,13,17,0,7,21,33.3,14,11,3,8,16,46,9,2
870,Matheus Fernandes,Valladolid,1.8,6,2,2,2,2,3,5,60.0,2,4,0,4,2,8,2,0
871,Aitor Fernandez,Levante,36.0,1,1,1,0,0,1,1,100.0,0,0,0,0,2,3,18,3
872,Andres Fernandez,Villarreal,4.0,0,0,0,0,0,0,0,0.0,0,0,0,0,0,0,2,0
873,Carlos Fernandez,Granada,24.5,24,15,7,11,6,3,32,9.4,29,25,2,23,11,35,30,0
874,Federico Fernandez,Newcastle Utd,29.1,42,25,30,10,2,23,46,50.0,23,41,28,13,24,66,190,2
875,Gabriel Fernandez,Celta Vigo,6.2,1,0,0,1,0,1,3,33.3,2,5,1,4,2,3,2,0
876,Joaquin Fernandez,Valladolid,18.4,30,24,17,10,3,9,30,30.0,21,14,10,4,32,62,57,0
877,Fernandinho,Manchester City,26.6,50,35,32,16,2,29,48,60.4,19,28,16,12,25,75,82,0
878,Fernando,Sevilla,29.5,62,33,37,24,1,34,58,58.6,24,38,15,23,67,129,73,1
879,Juan Ferney Otero,Amiens,13.4,17,10,6,9,2,8,24,33.3,16,12,1,11,19,36,10,0
880,Alex Ferrari,Sampdoria,11.2,18,13,13,5,0,7,12,58.3,5,13,8,5,12,30,31,0
881,Facundo Ferreyra,Espanyol,6.4,9,4,4,5,0,3,10,30.0,7,4,0,4,2,11,5,0
882,Jordan Ferri,Montpellier,12.8,22,13,7,12,3,13,44,29.5,31,9,0,9,10,32,10,0
884,Oliver Fink,Düsseldorf,7.5,21,12,7,11,3,5,16,31.3,11,12,1,11,15,36,7,0
885,Alfred Finnbogason,Augsburg,10.7,11,6,1,9,1,2,7,28.6,5,8,2,6,3,14,8,0
886,Roberto Firmino,Liverpool,33.2,37,19,8,14,15,10,43,23.3,33,34,3,31,7,44,11,1
887,Junior Firpo,Barcelona,11.3,23,15,12,8,3,11,17,64.7,6,15,3,12,17,40,12,1
888,John Fleck,Sheffield Utd,28.0,36,25,13,14,9,22,64,34.4,42,25,3,22,24,60,26,0
889,Mark Flekken,Freiburg,10.0,0,0,0,0,0,0,1,0.0,1,0,0,0,0,0,2,2
890,Sergio Floccari,SPAL,10.5,8,3,3,1,4,0,13,0.0,13,9,1,8,5,13,1,0
891,Alessandro Florenzi,Roma,11.1,14,11,8,4,2,7,20,35.0,13,9,3,6,16,30,19,0
892,Alessandro Florenzi,Valencia,8.4,13,9,9,4,0,8,18,44.4,10,11,1,10,14,27,21,0
893,Phil Foden,Manchester City,10.0,14,10,4,6,4,6,19,31.6,13,5,0,5,6,20,2,0
894,Mamadou Fofana,Metz,17.6,57,35,38,15,4,21,41,51.2,20,22,10,12,22,79,61,1
895,Seko Fofana,Udinese,25.0,17,12,8,8,1,9,35,25.7,26,20,1,19,17,34,19,0
896,Wesley Fofana,Saint-Étienne,13.5,25,15,16,9,0,12,18,66.7,6,10,5,5,36,61,55,4
897,Youssouf Fofana,Strasbourg,11.2,25,17,10,12,3,13,30,43.3,17,11,0,11,14,39,7,0
898,Youssouf Fofana,Monaco,6.8,16,9,6,10,0,8,15,53.3,7,12,2,10,8,24,9,0
899,Thomas Foket,Reims,27.0,61,36,31,23,7,30,48,62.5,18,15,4,11,39,100,59,1
900,Lamine Fomba,Nîmes,15.3,65,31,20,37,8,21,43,48.8,22,29,4,25,25,90,11,1
901,Jose Fonte,Lille,24.5,19,11,11,7,1,11,22,50.0,11,19,11,8,28,47,90,1
902,Pablo Fornals,West Ham,24.1,46,28,21,18,7,19,64,29.7,45,35,1,34,25,71,15,0
903,Emil Forsberg,RB Leipzig,12.7,16,10,5,8,3,6,26,23.1,20,15,0,15,5,21,3,0
904,Hernani Fortes,Levante,7.3,5,2,4,0,1,1,3,33.3,2,3,0,3,4,9,9,0
905,Ben Foster,Watford,38.0,1,0,1,0,0,1,3,33.3,2,1,0,1,0,1,16,2
906,Lyle Foster,Monaco,0.7,0,0,0,0,0,0,1,0.0,1,0,0,0,0,0,1,0
907,Timothy Fosu-Mensah,Manchester Utd,1.5,1,1,0,1,0,1,4,25.0,3,0,0,0,4,5,1,0
908,Dimitri Foulquier,Watford,0.7,1,0,1,0,0,0,0,0.0,0,1,0,1,2,3,2,0
910,Dimitri Foulquier,Granada,12.4,25,11,13,9,3,11,20,55.0,9,8,3,5,16,41,32,0
911,Juan Foyth,Tottenham,0.8,7,3,5,2,0,3,4,75.0,1,1,0,1,1,8,3,1
912,Gianluca Frabotta,Juventus,1.0,3,1,0,2,1,2,2,100.0,0,2,0,2,1,4,2,0
913,Raphael Framberger,Augsburg,13.1,43,25,23,16,4,21,29,72.4,8,23,9,14,20,63,26,0
914,Simon Francis,Bournemouth,10.8,13,9,11,2,0,11,21,52.4,10,17,12,5,20,33,71,0
915,Mike Frantz,Freiburg,3.9,4,2,1,3,0,2,9,22.2,7,5,3,2,1,5,4,0
916,Ryan Fraser,Bournemouth,23.0,12,6,5,5,2,7,22,31.8,15,15,3,12,15,27,24,0
917,Fred,Manchester Utd,24.0,60,32,33,22,5,25,100,25.0,75,44,8,36,38,98,32,0
918,Ryan Fredericks,West Ham,24.9,82,56,59,18,5,41,64,64.1,23,20,10,10,24,106,73,1
919,Kieron Freeman,Sheffield Utd,0.1,0,0,0,0,0,0,0,0.0,0,0,0,0,0,0,0,0
920,Luke Freeman,Sheffield Utd,4.1,6,4,2,2,2,2,8,25.0,6,1,0,1,10,16,6,0
921,Remo Freuler,Atalanta,26.0,51,30,18,25,8,22,63,34.9,41,41,6,35,28,79,26,0
922,Marco Friedl,Werder Bremen,24.3,61,39,42,15,4,29,54,53.7,25,29,9,20,34,95,78,0
923,Marvin Friedrich,Union Berlin,31.0,45,31,30,14,1,12,37,32.4,25,46,24,22,42,87,110,0
924,Samuel Fridjonsson,Paderborn 07,2.1,4,1,3,1,0,1,3,33.3,2,4,1,3,4,8,4,0
925,Jorge de Frutos,Valladolid,0.7,2,2,2,0,0,1,2,50.0,1,0,0,0,0,2,1,0
926,Christian Fuchs,Leicester City,8.6,14,9,8,6,0,8,19,42.1,11,8,3,5,17,31,33,1
927,Angelo Fulgini,Angers,17.5,28,18,8,15,5,12,23,52.2,11,6,1,5,19,47,10,0
928,Niclas Fullkrug,Werder Bremen,4.5,2,2,1,1,0,1,3,33.3,2,3,0,3,3,5,6,0
929,Ramiro Funes Mori,Villarreal,5.0,5,2,2,3,0,0,2,0.0,2,8,2,6,3,8,9,1
930,Daniel Fuzato,Roma,1.0,0,0,0,0,0,0,0,0.0,0,0,0,0,0,0,0,0
931,Matteo Gabbia,Milan,7.6,7,5,5,2,0,5,8,62.5,3,6,6,0,9,16,21,0
932,Manolo Gabbiadini,Sampdoria,22.6,9,7,2,3,4,1,7,14.3,6,12,0,12,10,19,11,0
933,Gabriel,Lecce,33.3,2,1,2,0,0,2,3,66.7,1,0,0,0,0,2,11,10
934,Ruben Gabrielsen,Toulouse,7.3,3,2,3,0,0,2,4,50.0,2,5,3,2,8,11,41,0
936,Mijat Gacinovic,Eint Frankfurt,11.6,19,11,7,8,4,6,25,24.0,19,26,2,24,15,34,6,0
937,Luca Gagliano,Cagliari,0.6,0,0,0,0,0,0,0,0.0,0,0,0,0,1,1,0,0
938,Roberto Gagliardini,Inter,20.0,38,19,12,18,8,14,41,34.1,27,28,8,20,30,68,20,1
939,Riccardo Gagliolo,Parma,28.9,57,32,37,12,8,30,60,50.0,30,35,18,17,53,110,100,0
940,Nicolas Gaitan,Lille,0.6,1,0,0,1,0,1,1,100.0,0,1,0,1,0,1,1,0
941,Marvin Gakpa,Metz,5.2,10,6,3,4,3,4,8,50.0,4,3,0,3,5,15,1,0
942,Enric Gallego,Osasuna,9.8,9,5,1,5,3,0,4,0.0,4,10,2,8,4,13,8,0
943,Enric Gallego,Getafe,1.8,3,1,1,1,1,2,4,50.0,2,2,0,2,2,5,1,0
944,Kevin Gameiro,Valencia,17.6,17,9,7,6,4,5,21,23.8,16,10,1,9,5,22,5,0
945,Fran Gamez,Mallorca,19.6,64,42,32,27,5,33,74,44.6,41,31,11,20,29,93,41,0
946,Idrissa Gana Gueye,Paris S-G,18.4,65,34,30,25,10,18,43,41.9,25,29,4,25,33,98,15,0
947,Ignatius Ganago,Nice,13.8,10,6,4,3,3,3,18,16.7,15,8,1,7,4,14,13,0
948,Ezequiel Garay,Valencia,16.0,12,8,9,2,1,7,11,63.6,4,19,17,2,14,26,71,0
949,Dani Garcia,Athletic Club,33.7,59,30,30,27,2,30,86,34.9,56,25,7,18,52,111,56,1
950,David Garcia,Osasuna,31.0,28,16,15,12,1,14,31,45.2,17,20,16,4,48,76,123,2
951,Eric Garcia,Manchester City,8.8,6,1,4,2,0,5,9,55.6,4,2,0,2,18,24,33,0
952,Javi Garcia,Betis,4.2,2,2,2,0,0,2,3,66.7,1,1,0,1,4,6,15,0
953,Manu Garcia,Alavés,21.9,46,23,11,31,4,17,72,23.6,55,28,12,16,28,74,32,1
954,Raul Garcia,Valladolid,11.2,20,12,11,7,2,9,22,40.9,13,12,2,10,8,28,30,0
955,Raul Garcia,Athletic Club,31.9,57,37,19,26,12,16,76,21.1,60,46,6,40,24,81,44,0
956,Raul Garcia,Getafe,2.7,5,3,2,3,0,3,6,50.0,3,3,1,2,4,9,10,0
957,Ruben Garcia,Osasuna,24.3,55,30,22,26,7,18,46,39.1,28,34,5,29,11,66,23,1
958,Unai Garcia,Osasuna,6.0,9,6,4,4,1,5,9,55.6,4,13,9,4,8,17,31,0
959,Victor Garcia,Valladolid,1.0,0,0,0,0,0,0,1,0.0,1,1,0,1,0,0,1,0
960,James Garner,Manchester Utd,0.1,0,0,0,0,0,0,1,0.0,1,0,0,0,0,0,1,0
962,Manuel Garrido,Leganés,1.3,0,0,0,0,0,0,6,0.0,6,3,1,2,1,1,0,0
963,Mario Gaspar,Villarreal,21.8,35,20,16,16,3,15,31,48.4,16,25,10,15,26,61,69,0
964,Daniele Gastaldello,Brescia,4.3,8,5,5,3,0,2,3,66.7,1,6,3,3,5,13,29,1
965,Dwight Gayle,Newcastle Utd,9.4,12,10,4,6,2,4,8,50.0,4,5,0,5,2,14,9,0
966,Paulo Gazzaniga,Tottenham,17.9,0,0,0,0,0,0,0,0.0,0,0,0,0,1,1,4,1
967,Jean-Philippe Gbamin,Everton,1.5,4,3,1,1,2,1,2,50.0,1,1,0,1,1,5,4,0
968,Yann Gboho,Rennes,2.5,2,2,1,0,1,0,2,0.0,2,1,0,1,1,3,0,0
969,David de Gea,Manchester Utd,38.0,0,0,0,0,0,0,0,0.0,0,0,0,0,0,0,7,4
970,Theodor Gebre Selassie,Werder Bremen,27.0,36,27,23,10,3,17,35,48.6,18,26,9,17,63,99,81,0
971,Dennis Geiger,Hoffenheim,12.6,12,5,4,6,2,2,16,12.5,14,9,2,7,6,18,4,0
972,Jeremy Gelin,Rennes,10.3,14,5,10,2,2,8,13,61.5,5,14,7,7,15,29,33,1
973,Christian Gentner,Union Berlin,27.1,53,28,16,32,5,22,73,30.1,51,46,8,38,54,107,50,0
974,Yannick Gerhardt,Wolfsburg,9.2,28,18,7,15,6,8,21,38.1,13,11,3,8,12,40,9,0
975,Valere Germain,Marseille,15.0,22,12,6,11,5,6,31,19.4,25,16,3,13,8,30,26,0
976,Gervinho,Parma,25.2,12,6,5,6,1,6,17,35.3,11,4,0,4,5,17,3,0
977,Anwar El Ghazi,Aston Villa,22.8,20,11,12,5,3,8,26,30.8,18,10,1,9,13,33,16,1
978,Rachid Ghezzal,Fiorentina,9.2,27,15,14,10,3,10,33,30.3,23,6,0,6,11,38,9,0
979,Andrea Ghezzi,Brescia,0.4,2,0,0,1,1,1,1,100.0,0,0,0,0,0,2,0,0
980,Paolo Ghiglione,Genoa,19.1,31,16,15,13,3,18,35,51.4,17,17,2,15,9,40,42,1
981,Andrea Ghion,Sassuolo,0.5,3,1,1,2,0,1,1,100.0,0,0,0,0,0,3,0,0
982,Saman Ghoddos,Amiens,2.6,2,2,0,1,1,1,2,50.0,1,5,0,5,2,4,3,0
983,Faouzi Ghoulam,Napoli,4.2,6,4,1,4,1,2,5,40.0,3,3,2,1,4,10,8,0
984,Morgan Gibbs-White,Wolves,1.4,0,0,0,0,0,0,0,0.0,0,0,0,0,2,2,0,0
985,Niko Giesselmann,Düsseldorf,22.9,46,31,31,11,4,22,45,48.9,23,23,6,17,27,73,55,1
986,Rafal Gikiewicz,Union Berlin,33.0,1,0,1,0,0,1,4,25.0,3,0,0,0,2,3,26,4
988,Bryan Gil,Leganés,6.2,8,4,3,4,1,1,8,12.5,7,6,0,6,3,11,1,0
989,Bryan Gil,Sevilla,0.7,1,1,0,1,0,0,1,0.0,1,0,0,0,0,1,0,0
990,Billy Gilmour,Chelsea,2.2,5,2,3,2,0,2,4,50.0,2,2,0,2,3,8,3,1
991,Daniel Ginczek,Wolfsburg,8.5,4,3,3,1,0,1,11,9.1,10,3,1,2,1,5,3,0
992,Matthias Ginter,M'Gladbach,30.9,34,20,19,14,1,17,31,54.8,14,27,22,5,34,68,125,3
993,Andrei Girotto,Nantes,24.2,76,53,45,29,2,39,71,54.9,32,32,17,15,34,110,111,1
994,Olivier Giroud,Chelsea,11.0,8,3,2,5,1,1,11,9.1,10,14,1,13,2,10,13,0
995,Klaus Gjasula,Paderborn 07,25.3,69,39,30,35,4,30,61,49.2,31,33,6,27,32,101,50,2
996,Kamil Glik,Monaco,23.0,26,14,15,11,0,13,21,61.9,8,23,17,6,27,53,118,0
997,Serge Gnabry,Bayern Munich,24.4,36,16,4,19,13,9,29,31.0,20,17,0,17,16,52,2,1
998,Joris Gnagnon,Rennes,14.2,16,13,14,2,0,10,11,90.9,1,21,17,4,18,34,61,0
999,Eddy Gnahore,Amiens,12.6,24,12,7,15,2,8,28,28.6,20,25,4,21,9,33,25,0
1000,Ben Godfrey,Norwich City,29.4,22,14,18,3,1,10,18,55.6,8,41,37,4,25,47,152,3
1001,Diego Godin,Inter,18.1,38,29,19,16,3,18,32,56.3,14,17,7,10,45,83,60,1
1002,Akaki Gogia,Union Berlin,1.3,2,1,0,0,2,0,2,0.0,2,2,2,0,0,2,0,0
1003,Mauro Goicoechea,Toulouse,2.0,0,0,0,0,0,0,0,0.0,0,0,0,0,0,0,1,2
1004,Edoardo Goldaniga,Genoa,8.7,4,3,3,1,0,2,5,40.0,3,11,6,5,18,22,25,1
1005,Benjamin Goller,Werder Bremen,3.2,8,3,3,4,1,3,10,30.0,7,3,0,3,1,9,1,0
1006,Pierluigi Gollini,Atalanta,32.0,0,0,0,0,0,0,2,0.0,2,0,0,0,0,0,13,2
1007,Aleksandr Golovin,Monaco,22.9,49,27,17,26,6,14,69,20.3,55,28,0,28,31,80,22,0
1008,Andre Gomes,Everton,16.2,22,15,7,11,4,8,62,12.9,54,20,3,17,7,29,7,0
1009,Angel Gomes,Manchester Utd,0.2,0,0,0,0,0,0,0,0.0,0,1,0,1,0,0,0,0
1010,Ibai Gomez,Athletic Club,7.7,5,3,2,2,1,3,8,37.5,5,4,0,4,3,8,6,0
1011,Joe Gomez,Liverpool,22.3,23,16,17,6,0,9,20,45.0,11,15,8,7,38,61,64,2
1012,Maxi Gomez,Valencia,23.8,9,7,1,6,2,4,8,50.0,4,8,1,7,5,14,14,0
1014,Moi Gomez,Villarreal,25.8,30,22,9,14,7,11,33,33.3,22,22,2,20,25,55,23,0
1015,Papu Gomez,Atalanta,31.6,27,13,5,13,9,13,45,28.9,32,24,0,24,17,44,6,1
1016,Sergi Gomez,Sevilla,8.0,9,7,7,2,0,4,4,100.0,0,6,6,0,7,16,30,0
1017,Victor Gomez,Espanyol,14.1,13,5,8,4,1,7,20,35.0,13,10,0,10,21,34,31,0
1018,Alfred Gomis,Dijon,18.0,1,0,1,0,0,1,2,50.0,1,2,0,2,0,1,14,2
1019,Maxime Gonalons,Granada,16.7,62,38,25,35,2,22,54,40.7,32,27,3,24,20,82,20,1
1020,Mathieu Goncalves,Toulouse,3.5,5,3,5,0,0,2,8,25.0,6,4,3,1,4,9,10,0
1021,Jerome Gondorf,Freiburg,1.3,9,6,7,1,1,3,6,50.0,3,3,2,1,0,9,2,0
1022,Alvaro Gonzalez,Marseille,18.1,19,13,14,4,1,9,13,69.2,4,7,4,3,18,37,65,0
1023,Bruno Gonzalez,Getafe,2.0,3,2,3,0,0,1,1,100.0,0,2,0,2,0,3,3,0
1024,Bruno Gonzalez,Levante,5.1,10,8,7,2,1,2,4,50.0,2,7,4,3,2,12,32,0
1025,Edgar Gonzalez,Betis,7.6,8,3,3,5,0,2,14,14.3,12,4,2,2,10,18,16,0
1026,Gonzalo,Levante,0.1,1,0,0,1,0,0,0,0.0,0,0,0,0,0,1,0,0
1027,Anthony Gordon,Everton,4.9,11,7,5,6,0,5,15,33.3,10,6,2,4,8,19,4,0
1028,Leon Goretzka,Bayern Munich,16.8,28,15,7,18,3,10,32,31.3,22,18,2,16,24,52,8,0
1029,Andoni Gorosabel,Real Sociedad,7.9,14,8,9,3,2,10,20,50.0,10,13,1,12,13,27,21,0
1030,Robin Gosens,Atalanta,29.1,53,27,19,26,8,23,51,45.1,28,38,10,28,39,92,40,0
1031,Dan Gosling,Bournemouth,14.0,26,10,14,9,3,6,27,22.2,21,31,11,20,20,46,26,0
1032,Mario Gotze,Dortmund,5.8,10,7,0,6,4,3,12,25.0,9,3,0,3,2,12,1,0
1033,Prince-Desir Gouano,Amiens,3.0,3,1,0,3,0,0,0,0.0,0,6,3,3,2,5,15,0
1034,Amine Gouiri,Lyon,0.0,0,0,0,0,0,0,0,0.0,0,0,0,0,0,0,0,0
1035,Jeffrey Gouweleeuw,Augsburg,18.3,28,16,22,5,1,12,21,57.1,9,15,8,7,37,65,97,0
1036,Max Gradel,Toulouse,18.2,36,20,17,14,5,12,47,25.5,35,11,1,10,11,47,23,0
1037,Samuel Grandsir,Brest,16.6,34,22,13,16,5,11,30,36.7,19,9,0,9,14,48,5,0
1038,Esteban Granero,Espanyol,5.3,10,4,5,3,2,5,11,45.5,6,3,2,1,2,12,5,0
1040,Alberto Grassi,Parma,7.1,10,4,7,3,0,5,13,38.5,8,5,2,3,19,29,9,1
1041,Andre Gray,Watford,8.4,4,3,0,2,2,1,3,33.3,2,4,1,3,1,5,2,0
1042,Demarai Gray,Leicester City,6.9,12,6,6,6,0,6,12,50.0,6,7,0,7,5,17,4,0
1043,Jack Grealish,Aston Villa,35.9,29,19,12,12,5,13,34,38.2,21,33,12,21,22,51,22,1
1044,Mason Greenwood,Manchester Utd,14.7,17,11,5,6,6,5,20,25.0,15,9,0,9,6,23,6,1
1045,Michael Gregoritsch,Augsburg,3.4,2,2,0,2,0,0,4,0.0,4,4,1,3,3,5,7,0
1046,Michael Gregoritsch,Schalke 04,9.2,8,5,0,6,2,0,9,0.0,9,9,1,8,2,10,10,0
1047,Clement Grenier,Rennes,9.3,21,12,6,15,0,11,40,27.5,29,7,2,5,7,28,16,0
1048,Antoine Griezmann,Barcelona,28.3,33,18,12,11,10,9,34,26.5,25,22,3,19,12,45,20,1
1049,Vincenzo Grifo,Hoffenheim,0.2,0,0,0,0,0,0,0,0.0,0,0,0,0,0,0,0,0
1050,Vincenzo Grifo,Freiburg,18.0,15,10,9,3,3,6,25,24.0,19,13,1,12,14,29,18,1
1051,Florian Grillitsch,Hoffenheim,26.8,59,29,34,24,1,29,61,47.5,32,33,6,27,49,108,41,1
1052,Jeremy Grimm,Strasbourg,0.0,0,0,0,0,0,0,0,0.0,0,0,0,0,0,0,0,0
1053,Christian Gross,Werder Bremen,9.7,23,17,16,5,2,9,16,56.3,7,13,7,6,14,37,50,1
1054,Pascal Gross,Brighton,20.0,36,13,8,21,7,14,39,35.9,25,25,3,22,9,45,7,0
1055,Carlos Gruezo,Augsburg,9.8,28,12,12,15,1,5,24,20.8,19,5,0,5,6,34,5,0
1056,Marko Grujic,Hertha BSC,26.8,56,34,21,30,5,19,63,30.2,44,43,9,34,22,78,69,0
1057,Vicente Guaita,Crystal Palace,35.0,1,1,1,0,0,1,2,50.0,1,0,0,0,0,1,18,3
1058,Andres Guardado,Betis,22.7,30,14,15,11,4,15,41,36.6,26,15,4,11,18,48,22,1
1059,Sergi Guardiola,Valladolid,29.5,14,6,3,7,4,4,24,16.7,20,23,0,23,6,20,18,1
1060,Nemanja Gudelj,Sevilla,13.5,20,14,11,8,1,6,19,31.6,13,17,8,9,12,32,35,1
1061,Goncalo Guedes,Valencia,14.1,19,11,11,7,1,9,32,28.1,23,10,1,9,7,26,1,0
1062,Matteo Guendouzi,Arsenal,19.4,31,16,14,13,4,14,43,32.6,29,21,7,14,29,60,38,2
1063,Raphael Guerreiro,Dortmund,25.9,44,24,18,21,5,20,32,62.5,12,27,3,24,42,86,26,0
1064,Adrian Guerrero,Valencia,1.4,2,2,1,1,0,2,3,66.7,1,0,0,0,2,4,1,0
1066,Ander Guevara,Real Sociedad,10.4,27,11,9,17,1,12,30,40.0,18,13,3,10,8,35,15,1
1067,Babacar Gueye,Paderborn 07,1.2,2,0,0,0,2,0,1,0.0,1,1,1,0,0,2,3,0
1068,John Guidetti,Alavés,1.1,2,1,0,1,1,0,0,0.0,0,1,0,1,0,2,0,0
1069,Josuha Guilavogui,Wolfsburg,22.9,41,26,17,23,1,10,30,33.3,20,35,9,26,45,86,64,2
1070,Frederic Guilbert,Aston Villa,22.7,74,43,48,20,6,36,67,53.7,31,33,10,23,49,123,74,2
1071,Bruno Guimaraes,Lyon,3.0,12,7,5,6,1,5,10,50.0,5,1,0,1,4,16,1,0
1072,Serhou Guirassy,Amiens,21.3,7,3,1,4,2,2,7,28.6,5,13,6,7,4,11,21,0
1073,Rafik Guitane,Rennes,0.2,0,0,0,0,0,0,0,0.0,0,0,0,0,0,0,0,0
1074,Peter Gulacsi,RB Leipzig,32.0,0,0,0,0,0,0,0,0.0,0,0,0,0,1,1,18,6
1075,Manuel Gulde,Freiburg,15.2,28,16,17,9,2,15,24,62.5,9,23,13,10,22,50,80,1
1076,Sinan Gumus,Genoa,1.1,0,0,0,0,0,0,4,0.0,4,0,0,0,0,0,1,0
1077,Ilkay Gundogan,Manchester City,22.4,27,16,9,11,7,9,41,22.0,32,17,5,12,31,58,13,0
1078,Angus Gunn,Southampton,10.0,1,1,1,0,0,1,3,33.3,2,0,0,0,0,1,1,0
1079,Christian Gunter,Freiburg,33.7,25,11,17,7,1,12,35,34.3,23,29,13,16,14,39,40,0
1080,Koray Gunter,Hellas Verona,30.4,39,25,22,15,2,19,29,65.5,10,45,39,6,55,94,131,1
1081,Regis Gurtner,Amiens,28.0,1,1,1,0,0,1,2,50.0,1,0,0,0,0,1,10,4
1082,Luiz Gustavo,Marseille,2.1,6,3,3,3,0,3,5,60.0,2,5,2,3,5,11,6,0
1083,Jonathan de Guzman,Eint Frankfurt,1.0,1,1,0,1,0,1,7,14.3,6,2,0,2,1,2,0,0
1084,Erling Haaland,Dortmund,11.8,4,2,1,0,3,0,4,0.0,4,7,4,3,4,8,4,0
1085,Janik Haberer,Freiburg,19.1,26,18,8,14,4,12,45,26.7,33,25,4,21,25,51,23,0
1086,Alexander Hack,Mainz 05,8.9,26,10,19,6,1,16,27,59.3,11,20,9,11,23,49,60,1
1087,Munir El Haddadi,Sevilla,13.9,19,17,6,11,2,4,21,19.0,17,8,0,8,7,26,8,0
1088,Andre Hahn,Augsburg,7.8,15,9,7,5,3,5,21,23.8,16,23,5,18,13,28,14,0
1089,Amadou Haidara,RB Leipzig,8.4,26,16,7,17,2,10,24,41.7,14,14,2,12,8,34,10,1
1090,Achraf Hakimi,Dortmund,30.2,60,41,38,14,8,27,64,42.2,37,26,2,24,30,90,27,2
1092,Sebastien Haller,West Ham,25.2,22,15,8,10,4,3,30,10.0,27,19,5,14,8,30,27,0
1093,Marcel Halstenberg,RB Leipzig,28.0,46,31,27,17,2,28,58,48.3,30,37,11,26,46,92,72,2
1094,Romain Hamouma,Saint-Étienne,9.6,12,9,1,5,6,2,12,16.7,10,12,0,12,0,12,4,0
1095,Samir Handanovic,Inter,35.0,1,1,1,0,0,0,1,0.0,1,0,0,0,0,1,8,3
1096,Grant Hanley,Norwich City,14.0,24,15,17,7,0,8,14,57.1,6,25,18,7,31,55,77,1
1097,Lukas Haraslin,Sassuolo,4.3,5,2,1,3,1,2,9,22.2,7,5,0,5,4,9,1,0
1098,Amine Harit,Schalke 04,23.4,16,7,8,5,3,6,25,24.0,19,13,0,13,7,23,2,1
1099,Martin Harnik,Werder Bremen,0.1,0,0,0,0,0,0,0,0.0,0,0,0,0,0,0,0,0
1100,Makoto Hasebe,Eint Frankfurt,21.9,28,20,16,9,3,18,39,46.2,21,38,10,28,26,54,38,0
1101,Hans Hateboer,Atalanta,26.2,36,23,20,9,7,18,38,47.4,20,22,7,15,10,46,32,1
1102,Kortney Hause,Aston Villa,17.2,21,9,15,5,1,8,15,53.3,7,27,19,8,20,41,98,4
1103,Kai Havertz,Leverkusen,27.3,21,15,5,10,6,6,39,15.4,33,22,0,22,2,23,22,0
1104,Isaac Hayden,Newcastle Utd,24.7,55,27,33,17,5,20,50,40.0,30,24,7,17,38,93,38,0
1105,Eden Hazard,Real Madrid,12.0,7,3,2,3,2,3,15,20.0,12,5,0,5,6,13,0,0
1106,Thorgan Hazard,Dortmund,26.4,40,27,17,14,9,12,50,24.0,38,29,0,29,13,53,2,1
1107,Tom Heaton,Aston Villa,19.9,3,2,3,0,0,3,4,75.0,1,0,0,0,0,3,6,0
1108,Jonas Hector,Köln,27.0,76,49,37,34,5,24,75,32.0,51,44,10,34,46,122,38,1
1109,Dominique Heintz,Freiburg,27.0,47,30,40,6,1,17,43,39.5,26,38,25,13,41,88,131,1
1110,Dean Henderson,Sheffield Utd,36.0,0,0,0,0,0,0,0,0.0,0,0,0,0,1,1,13,1
1111,Jordan Henderson,Liverpool,24.9,63,41,18,33,12,22,55,40.0,33,22,4,18,30,93,21,2
1112,Liam Henderson,Hellas Verona,2.2,3,2,0,3,0,2,3,66.7,1,1,0,1,0,3,4,0
1113,Jeff Hendrick,Burnley,21.5,18,10,7,8,3,7,27,25.9,20,21,8,13,20,38,20,0
1114,Wayne Hennessey,Crystal Palace,3.0,0,0,0,0,0,0,0,0.0,0,0,0,0,1,1,3,1
1115,Rouwen Hennings,Düsseldorf,27.3,11,5,2,7,2,3,18,16.7,15,12,0,12,2,13,33,0
1116,Benjamin Henrichs,Monaco,9.9,26,20,16,9,1,14,33,42.4,19,19,4,15,14,40,18,0
1118,Dalbert Henrique,Fiorentina,27.6,52,25,35,12,5,18,51,35.3,33,34,4,30,19,71,65,0
1119,Christophe Herelle,Nice,12.3,14,11,10,4,0,3,7,42.9,4,14,8,6,17,31,26,1
1120,Mario Hermoso,Atlético Madrid,13.5,15,8,12,2,1,11,20,55.0,9,11,5,6,12,27,61,0
1121,Aridane Hernandez,Osasuna,29.0,35,23,22,13,0,15,19,78.9,4,24,15,9,34,69,137,2
1122,Javier Hernandez,West Ham,1.2,0,0,0,0,0,0,1,0.0,1,0,0,0,1,1,0,0
1123,Javier Hernandez,Sevilla,5.0,6,4,0,4,2,1,6,16.7,5,5,0,5,5,11,1,0
1124,Juan Hernandez,Celta Vigo,1.0,0,0,0,0,0,0,0,0.0,0,0,0,0,1,1,0,0
1125,Lucas Hernandez,Bayern Munich,10.2,18,9,13,3,2,9,15,60.0,6,6,1,5,15,33,17,0
1126,Onel Hernandez,Norwich City,15.4,27,19,13,11,3,9,31,29.0,22,12,1,11,19,46,10,0
1127,Theo Hernandez,Milan,31.3,56,39,32,18,6,33,53,62.3,20,34,6,28,43,99,62,2
1128,Hernani,Parma,26.9,61,31,25,31,5,30,112,26.8,82,53,11,42,50,111,51,1
1129,Ander Herrera,Paris S-G,6.1,19,11,9,9,1,5,14,35.7,9,10,2,8,6,25,4,0
1130,Hector Herrera,Atlético Madrid,12.5,31,21,9,18,4,13,32,40.6,19,16,7,9,17,48,13,2
1131,Sergio Herrera,Osasuna,18.4,1,1,1,0,0,1,4,25.0,3,0,0,0,1,2,13,3
1132,Yangel Herrera,Granada,26.3,88,49,25,53,10,36,80,45.0,44,38,9,29,34,122,28,0
1133,Iago Herrerin,Athletic Club,4.7,0,0,0,0,0,0,0,0.0,0,0,0,0,0,0,0,0
1134,Patrick Herrmann,M'Gladbach,16.1,24,11,8,10,6,5,16,31.3,11,21,4,17,11,35,8,0
1135,Pablo Hervias,Valladolid,11.3,24,20,8,14,2,12,22,54.5,10,8,0,8,5,29,0,0
1136,Son Heung-min,Tottenham,27.5,23,15,10,11,2,9,57,15.8,48,23,0,23,19,42,18,1
1137,Gonzalo Higuain,Juventus,20.7,13,7,2,6,5,4,31,12.9,27,12,0,12,6,19,14,0
1138,Vitorino Hilton,Montpellier,27.9,27,17,20,7,0,13,28,46.4,15,22,18,4,49,76,121,1
1139,Martin Hinteregger,Eint Frankfurt,30.2,66,51,33,30,3,28,57,49.1,29,41,21,20,36,102,96,0
1140,George Hirst,Leicester City,0.1,0,0,0,0,0,0,0,0.0,0,0,0,0,0,0,0,0
1141,Marwin Hitz,Dortmund,3.2,0,0,0,0,0,0,0,0.0,0,0,0,0,0,0,0,0
1142,Andre Hoffmann,Düsseldorf,27.0,48,22,30,18,0,16,50,32.0,34,22,9,13,56,104,90,0
1144,Nicolas Hofler,Freiburg,30.9,65,40,31,28,6,22,64,34.4,42,58,18,40,71,136,59,3
1145,Jonas Hofmann,M'Gladbach,18.1,43,27,22,12,9,22,76,28.9,54,28,3,25,18,61,14,0
1146,Jonas Hofmann,Schalke 04,0.0,0,0,0,0,0,0,0,0.0,0,0,0,0,0,0,2,0
1147,Marco Hoger,Köln,7.5,10,6,4,5,1,6,16,37.5,10,14,4,10,6,16,15,0
1148,Rob Holding,Arsenal,6.5,4,2,3,1,0,1,3,33.3,2,10,6,4,5,9,45,1
1149,Jose Holebas,Watford,11.4,26,15,19,7,0,9,28,32.1,19,11,4,7,3,29,33,0
1150,Lucas Holer,Freiburg,27.6,35,15,11,16,8,11,46,23.9,35,30,9,21,12,47,38,0
1151,Mason Holgate,Everton,22.8,44,26,30,13,1,21,31,67.7,10,26,13,13,34,78,97,0
1152,Nathan Holland,West Ham,0.4,3,1,2,1,0,0,0,0.0,0,1,0,1,0,3,0,0
1153,Gerrit Holtmann,Paderborn 07,11.8,24,14,14,6,4,15,37,40.5,22,21,1,20,6,30,8,0
1154,Josue Homawoo,Nantes,0.5,6,2,3,3,0,2,2,100.0,0,3,2,1,2,8,2,0
1155,Franck Honorat,Saint-Étienne,9.4,16,11,7,8,1,8,23,34.8,15,12,1,11,5,21,13,1
1156,Luca Horn,Wolfsburg,0.1,0,0,0,0,0,0,0,0.0,0,0,0,0,0,0,0,0
1157,Timo Horn,Köln,34.0,0,0,0,0,0,0,5,0.0,5,0,0,0,2,2,15,1
1158,Krisztofer Horvath,SPAL,0.5,1,1,0,1,0,0,0,0.0,0,0,0,0,0,1,0,0
1159,Conor Hourihane,Aston Villa,17.0,16,10,4,8,4,10,25,40.0,15,19,4,15,9,25,31,0
1160,Lukas Hradecky,Leverkusen,34.0,0,0,0,0,0,0,1,0.0,1,0,0,0,2,2,19,2
1161,Benjamin Hubner,Hoffenheim,23.0,42,26,33,9,0,23,45,51.1,22,18,13,5,30,72,98,2
1162,Florian Hubner,Union Berlin,9.4,16,14,12,4,0,7,17,41.2,10,11,7,4,16,32,39,0
1163,Callum Hudson-Odoi,Chelsea,9.6,10,4,4,5,1,1,7,14.3,6,9,0,9,5,15,4,1
1164,Will Hughes,Watford,25.0,75,47,24,41,10,25,67,37.3,42,48,8,40,37,112,28,0
1165,Mats Hummels,Dortmund,28.7,57,30,30,26,1,20,38,52.6,18,41,18,23,59,116,110,1
1166,Uwe Hunemeier,Paderborn 07,13.4,20,15,9,11,0,10,20,50.0,10,22,12,10,24,44,63,0
1167,Adrien Hunou,Rennes,13.4,21,18,5,11,5,4,21,19.0,17,16,1,15,5,26,5,0
1168,Jannik Huth,Paderborn 07,6.0,0,0,0,0,0,0,1,0.0,1,0,0,0,0,0,2,0
1170,Elseid Hysaj,Napoli,16.5,18,9,13,4,1,12,26,46.2,14,16,3,13,24,42,26,0
1171,Suk Hyun-jun,Reims,2.9,3,3,1,1,1,1,2,50.0,1,1,0,1,1,4,2,0
1172,Pierre Hojbjerg,Southampton,30.6,80,49,34,38,8,39,91,42.9,52,44,5,39,46,126,54,2
1173,Simone Iacoponi,Parma,33.9,49,25,36,12,1,26,42,61.9,16,37,29,8,35,84,140,2
1174,Iago,Augsburg,7.5,19,12,12,7,0,9,18,50.0,9,6,2,4,14,33,27,0
1175,Robert Ibanez,Osasuna,6.0,13,8,4,5,4,7,20,35.0,13,7,0,7,5,18,5,0
1176,Roger Ibanez,Roma,6.8,11,8,6,3,2,5,7,71.4,2,9,6,3,18,29,21,1
1177,Jordon Ibe,Bournemouth,0.6,2,2,2,0,0,1,1,100.0,0,0,0,0,0,2,1,0
1178,Vedad Ibisevic,Hertha BSC,14.0,4,3,0,1,3,0,3,0.0,3,4,0,4,1,5,15,0
1179,Vicente Iborra,Villarreal,29.4,61,42,31,25,5,30,67,44.8,37,35,16,19,40,101,63,1
1180,Didier Ibrahim Ndong,Dijon,26.5,62,35,30,31,1,30,59,50.8,29,27,6,21,49,111,31,0
1181,Zlatan Ibrahimovic,Milan,15.1,5,1,0,2,3,1,13,7.7,12,4,3,1,5,10,21,0
1182,Mauro Icardi,Paris S-G,14.1,4,2,1,3,0,1,10,10.0,9,7,1,6,2,6,11,0
1183,Adam Idah,Norwich City,2.5,2,2,1,0,1,2,3,66.7,1,4,0,4,0,2,1,0
1184,Odion Ighalo,Manchester Utd,1.1,2,2,0,2,0,1,3,33.3,2,1,1,0,0,2,0,0
1185,Borja Iglesias,Betis,21.4,7,5,1,4,2,0,9,0.0,9,7,4,3,5,12,18,0
1186,Igor,SPAL,14.9,24,16,13,10,1,14,20,70.0,6,17,9,8,24,48,37,1
1187,Igor,Fiorentina,6.8,12,10,8,2,2,6,7,85.7,1,10,4,6,7,19,16,0
1188,Kelechi Iheanacho,Leicester City,10.7,3,1,1,2,0,1,9,11.1,8,8,1,7,3,6,8,0
1189,Luc Ihorst,Werder Bremen,0.1,1,1,0,0,1,0,0,0.0,0,1,0,1,0,1,0,0
1190,Jonathan Ikone,Lille,22.9,15,7,3,7,5,6,24,25.0,18,26,2,24,5,20,3,0
1191,Yun Il-lok,Montpellier,1.3,1,1,0,1,0,0,4,0.0,4,0,0,0,0,1,0,0
1192,Josip Ilicic,Atalanta,18.5,26,19,7,10,9,7,28,25.0,21,9,0,9,9,35,4,0
1193,Asier Illarramendi,Real Sociedad,2.4,2,2,1,0,1,2,6,33.3,4,2,1,1,5,7,6,0
1194,Stefan Ilsanker,RB Leipzig,4.6,3,1,3,0,0,3,6,50.0,3,6,3,3,7,10,21,0
1196,Stefan Ilsanker,Eint Frankfurt,9.3,23,15,16,7,0,10,23,43.5,13,8,1,7,19,42,26,0
1197,Giannelli Imbula,Lecce,1.4,2,0,2,0,0,0,1,0.0,1,4,1,3,2,4,0,0
1198,Ciro Immobile,Lazio,35.2,8,6,2,4,2,0,24,0.0,24,10,2,8,11,19,7,0
1199,Roberto Inglese,Parma,8.5,9,6,2,2,5,2,10,20.0,8,8,2,6,2,11,1,0
1200,Danny Ings,Southampton,31.2,42,25,16,16,10,13,67,19.4,54,62,4,58,9,51,30,1
1201,Marcus Ingvartsen,Union Berlin,19.1,20,14,5,7,8,9,28,32.1,19,16,1,15,16,36,16,0
1202,Lorenzo Insigne,Napoli,31.2,21,15,6,8,7,6,35,17.1,29,13,0,13,30,51,4,1
1203,Takashi Inui,Eibar,21.8,20,10,7,8,5,11,34,32.4,23,23,4,19,18,38,12,0
1204,Artur Ionita,Cagliari,21.1,38,23,12,22,4,12,37,32.4,25,32,10,22,18,56,24,2
1205,Alexander Isak,Real Sociedad,16.7,7,2,0,3,4,1,8,12.5,7,8,0,8,3,10,6,0
1206,Isco,Real Madrid,13.1,13,9,2,10,1,5,14,35.7,9,9,0,9,7,20,4,1
1207,Nicolas Isimat-Mirin,Toulouse,14.0,14,8,8,6,0,5,11,45.5,6,18,12,6,22,36,71,0
1208,Jakub Iskra,SPAL,0.9,0,0,0,0,0,0,0,0.0,0,0,0,0,1,1,2,0
1209,Ismael,Betis,0.9,2,1,1,1,0,1,2,50.0,1,2,1,1,2,4,2,0
1210,Gian-Luca Itter,Freiburg,0.4,1,1,1,0,0,1,1,100.0,0,0,0,0,1,2,4,0
1211,Ander Iturraspe,Espanyol,2.7,2,0,1,1,0,2,5,40.0,3,0,0,0,1,3,7,0
1212,Alex Iwobi,Everton,17.7,25,17,8,15,2,12,33,36.4,21,18,2,16,14,39,10,1
1213,Armando Izzo,Torino,29.8,42,24,24,14,4,17,35,48.6,18,44,29,15,71,113,121,1
1214,Jacobo,Celta Vigo,0.9,3,3,2,1,0,1,1,100.0,0,0,0,0,0,3,2,0
1215,Phil Jagielka,Sheffield Utd,2.7,5,4,3,2,0,1,3,33.3,2,5,5,0,4,9,19,0
1216,Filip Jagiello,Genoa,6.1,7,2,0,3,4,3,7,42.9,4,4,0,4,5,12,4,0
1217,Alireza Jahanbakhsh,Brighton,3.5,8,4,3,2,3,0,2,0.0,2,5,0,5,3,11,2,0
1218,Mato Jajalo,Udinese,18.3,44,19,19,22,3,14,38,36.8,24,20,7,13,19,63,19,2
1219,Ismail Jakobs,Köln,18.6,34,23,18,9,7,10,23,43.5,13,25,3,22,24,58,30,0
1220,Christophe Jallet,Amiens,9.5,24,16,14,8,2,14,37,37.8,23,8,2,6,18,42,29,0
1222,Daniel James,Manchester Utd,25.4,20,10,5,10,5,7,45,15.6,38,23,4,19,7,27,12,0
1223,Matty James,Leicester City,0.1,0,0,0,0,0,0,0,0.0,0,0,0,0,0,0,0,0
1224,Reece James,Chelsea,16.8,36,23,18,14,4,11,29,37.9,18,19,8,11,22,58,28,0
1225,Marko Jankovic,SPAL,1.3,2,1,0,0,2,1,2,50.0,1,2,1,1,0,2,0,0
1226,Jakub Jankto,Sampdoria,23.3,27,13,14,10,3,10,42,23.8,32,30,3,27,22,49,22,0
1227,Daryl Janmaat,Watford,6.7,14,10,8,6,0,6,13,46.2,7,7,2,5,7,21,23,0
1228,Laurent Jans,Paderborn 07,17.5,42,25,30,8,4,22,48,45.8,26,25,10,15,19,61,49,1
1229,Tony Jantschke,M'Gladbach,11.2,33,21,23,10,0,15,24,62.5,9,20,11,9,27,60,48,0
1230,Adnan Januzaj,Real Sociedad,13.0,8,7,3,2,3,3,16,18.8,13,9,1,8,7,15,2,0
1231,Rune Jarstein,Hertha BSC,28.3,4,1,4,0,0,2,3,66.7,1,0,0,0,1,5,11,3
1232,Jason,Getafe,13.1,29,20,8,16,5,15,33,45.5,18,18,3,15,18,47,9,0
1233,Dennis Jastrzembski,Paderborn 07,2.0,2,0,1,1,0,0,1,0.0,1,3,0,3,3,5,0,0
1234,Corentin Jean,Toulouse,0.1,0,0,0,0,0,0,0,0.0,0,0,0,0,0,0,1,0
1235,Benjamin Jeannot,Dijon,1.9,2,1,0,1,1,0,4,0.0,4,2,0,2,2,4,4,0
1236,Tin Jedvaj,Augsburg,29.3,44,26,25,19,0,23,47,48.9,24,36,18,18,60,104,123,1
1237,Jemerson,Monaco,11.7,28,17,13,14,1,10,21,47.6,11,8,3,5,16,44,24,0
1238,Fredrik Jensen,Augsburg,5.1,3,1,2,1,0,2,7,28.6,5,7,1,6,1,4,3,0
1239,Jese,Paris S-G,0.0,0,0,0,0,0,0,0,0.0,0,0,0,0,0,0,0,0
1240,Gabriel Jesus,Manchester City,22.6,17,10,4,5,8,7,25,28.0,18,26,1,25,11,28,6,0
1241,Juan Jesus,Roma,1.5,2,1,2,0,0,0,3,0.0,3,1,0,1,1,3,7,0
1242,Raul Jimenez,Wolves,36.0,20,12,6,10,4,3,31,9.7,28,26,0,26,16,36,34,1
1243,Joao Pedro,Watford,0.3,0,0,0,0,0,0,0,0.0,0,0,0,0,0,0,0,0
1244,Joaquin,Betis,22.9,14,7,4,8,2,4,11,36.4,7,10,2,8,15,29,22,1
1245,Joelinton,Newcastle Utd,29.8,34,20,7,22,5,9,32,28.1,23,32,6,26,11,45,30,0
1246,Ben Johnson,West Ham,3.0,8,4,7,1,0,7,10,70.0,3,5,2,3,3,11,11,0
1248,Fabian Johnson,M'Gladbach,3.0,5,3,2,2,1,2,4,50.0,2,4,1,3,2,7,3,0
1249,Curtis Jones,Liverpool,1.4,4,4,0,1,3,3,4,75.0,1,2,0,2,2,6,1,0
1250,Phil Jones,Manchester Utd,1.5,2,2,1,1,0,1,1,100.0,0,2,0,2,2,4,9,1
1251,Frenkie de Jong,Barcelona,23.5,26,19,7,12,7,7,22,31.8,15,17,7,10,21,47,9,0
1252,Luuk de Jong,Sevilla,22.9,21,10,4,8,9,6,17,35.3,11,12,1,11,7,28,22,0
1253,Jony,Lazio,13.1,13,9,7,4,2,5,23,21.7,18,11,2,9,14,27,17,0
1254,Joan Jordan,Sevilla,25.0,64,34,27,31,6,21,76,27.6,55,25,5,20,26,90,20,4
1255,Bruno Jordao,Wolves,0.1,0,0,0,0,0,0,0,0.0,0,1,0,1,0,0,0,0
1256,Jorginho,Chelsea,26.4,66,40,24,34,8,35,91,38.5,56,30,5,25,64,130,27,2
1257,Jesse Joronen,Brescia,29.0,3,1,3,0,0,3,3,100.0,0,0,0,0,6,9,22,0
1258,Willian Jose,Real Sociedad,22.3,5,2,0,4,1,2,8,25.0,6,10,4,6,1,6,16,0
1259,Joselu,Alavés,30.9,26,17,4,12,10,4,32,12.5,28,36,5,31,13,39,46,0
1260,Jota,Aston Villa,3.7,3,1,2,0,1,2,5,40.0,3,1,0,1,3,6,6,0
1261,Diogo Jota,Wolves,25.4,28,15,16,10,2,12,48,25.0,36,17,0,17,9,37,10,2
1262,Vukasin Jovanovic,Bordeaux,6.4,18,11,12,6,0,14,21,66.7,7,5,3,2,15,33,15,0
1263,Dejan Joveljic,Eint Frankfurt,1.7,2,2,1,1,0,0,1,0.0,1,0,0,0,0,2,1,0
1264,Stevan Jovetic,Monaco,5.3,2,1,0,1,1,1,5,20.0,4,1,0,1,1,3,5,0
1265,Luka Jovic,Real Madrid,4.8,2,1,0,0,2,1,2,50.0,1,1,0,1,2,4,0,0
1266,Juanmi,Betis,2.9,4,1,1,2,1,1,4,25.0,3,1,0,1,0,4,0,0
1267,David Junca,Celta Vigo,2.9,6,5,4,1,1,2,3,66.7,1,4,1,3,2,8,3,0
1268,Lago Junior,Mallorca,24.3,32,19,12,11,9,12,29,41.4,17,23,5,18,14,46,25,0
1269,Hamed Junior Traore,Sassuolo,17.4,31,15,10,15,6,14,39,35.9,25,22,1,21,11,42,7,0
1270,Vinicius Junior,Real Madrid,15.2,26,16,13,8,5,8,32,25.0,24,14,0,14,3,29,2,0
1271,James Justin,Leicester City,11.2,36,17,22,14,0,15,25,60.0,10,15,7,8,11,47,30,0
1272,Musa Juwara,Bologna,1.7,4,2,1,1,2,1,5,20.0,4,2,1,1,0,4,1,0
1274,Mathias Jorgensen,Düsseldorf,5.5,4,3,3,1,0,2,4,50.0,2,7,3,4,13,17,33,0
1275,Ozan Kabak,Schalke 04,19.7,37,23,28,9,0,14,21,66.7,7,33,19,14,37,74,97,0
1276,Christian Kabasele,Watford,25.0,37,24,26,11,0,17,32,53.1,15,31,23,8,36,73,127,0
1277,Abdoul Kader Bamba,Nantes,16.3,19,15,5,9,5,9,30,30.0,21,8,2,6,16,35,8,0
1278,Pavel Kaderabek,Hoffenheim,27.5,32,22,17,13,2,13,30,43.3,17,29,7,22,27,59,55,1
1279,Florian Kainz,Köln,17.3,21,13,12,6,3,15,33,45.5,18,26,2,24,13,34,11,0
1280,Gael Kakuta,Amiens,22.2,46,27,13,27,6,17,48,35.4,31,15,1,14,16,62,8,2
1281,Lovre Kalinic,Toulouse,3.4,0,0,0,0,0,0,1,0.0,1,0,0,0,0,0,0,0
1282,Nikola Kalinic,Roma,6.3,2,1,0,2,0,0,0,0.0,0,2,0,2,1,3,1,0
1283,Salomon Kalou,Hertha BSC,1.6,1,0,1,0,0,0,2,0.0,2,2,0,2,0,1,1,0
1284,Samuel Kalu,Bordeaux,15.1,33,17,19,12,2,16,36,44.4,20,13,1,12,24,57,10,0
1285,Daichi Kamada,Eint Frankfurt,21.9,29,20,7,17,5,8,42,19.0,34,16,1,15,10,39,6,0
1286,Francois Kamano,Bordeaux,7.2,12,6,5,4,3,8,15,53.3,7,5,0,5,3,15,2,0
1287,Boubacar Kamara,Marseille,23.8,67,34,37,27,3,27,57,47.4,30,27,14,13,34,101,53,1
1288,Hassane Kamara,Reims,19.0,58,47,40,14,4,24,35,68.6,11,17,2,15,58,116,58,0
1289,Kevin Kampl,RB Leipzig,7.5,17,11,7,10,0,7,23,30.4,16,7,2,5,16,33,6,0
1290,Harry Kane,Tottenham,28.7,18,12,3,12,3,4,17,23.5,13,17,7,10,6,24,30,0
1291,Lee Kang-in,Valencia,5.0,3,1,0,2,1,3,6,50.0,3,5,0,5,3,6,0,0
1292,Wilfried Kanga,Angers,0.8,0,0,0,0,0,0,1,0.0,1,0,0,0,0,0,0,0
1293,N'Golo Kante,Chelsea,19.2,44,20,22,14,8,17,36,47.2,19,29,5,24,44,88,32,2
1294,Stefanos Kapino,Werder Bremen,1.0,0,0,0,0,0,0,0,0.0,0,0,0,0,1,1,0,0
1295,Wilfrid Kaptoum,Betis,2.2,5,2,3,2,0,3,3,100.0,0,4,1,3,1,6,3,0
1296,Kenan Karaman,Düsseldorf,15.0,11,5,2,5,4,4,9,44.4,5,9,4,5,2,13,7,0
1297,Yann Karamoh,Parma,6.4,10,7,5,4,1,3,9,33.3,6,5,0,5,2,12,3,0
1298,Mamoudou Karamoko,Wolfsburg,0.1,0,0,0,0,0,0,0,0.0,0,0,0,0,0,0,0,0
1300,Florian Kastenmeier,Düsseldorf,17.0,1,1,1,0,0,0,0,0.0,0,0,0,0,2,3,3,1
1301,Noah Katterbach,Köln,14.6,29,23,21,8,0,11,28,39.3,17,12,1,11,29,58,26,0
1302,Moise Kean,Everton,9.5,6,6,5,1,0,0,0,0.0,0,4,0,4,5,11,1,1
1303,Michael Keane,Everton,28.4,31,16,18,12,1,14,24,58.3,10,35,28,7,44,75,152,0
1304,Thilo Kehrer,Paris S-G,5.3,10,7,4,5,1,5,10,50.0,5,2,0,2,1,11,2,1
1305,Jules Keita,Dijon,1.8,4,3,2,1,1,1,6,16.7,5,1,0,1,3,7,0,0
1306,Naby Keita,Liverpool,9.1,30,14,8,16,6,11,26,42.3,15,18,0,18,10,40,4,0
1307,Yannik Keitel,Freiburg,1.9,2,1,1,1,0,0,6,0.0,6,3,1,2,4,6,4,0
1308,Lloyd Kelly,Bournemouth,7.1,7,3,3,4,0,6,7,85.7,1,9,5,4,6,13,15,1
1309,Martin Kelly,Crystal Palace,17.2,23,18,19,4,0,14,31,45.2,17,18,10,8,16,39,86,1
1310,Kenedy,Getafe,6.5,9,5,3,3,3,2,5,40.0,3,10,0,10,11,20,4,0
1311,Jonjoe Kenny,Schalke 04,30.2,49,29,24,19,6,26,51,51.0,25,45,10,35,26,75,79,0
1312,Franck Kessie,Milan,32.3,54,29,28,18,8,16,52,30.8,36,34,5,29,34,88,32,2
1313,Saif-Eddine Khaoui,Marseille,1.2,3,1,0,3,0,2,5,40.0,3,2,0,2,1,4,4,0
1314,Wahbi Khazri,Saint-Étienne,12.8,17,9,5,7,5,9,27,33.3,18,11,0,11,4,21,0,0
1315,Rani Khedira,Augsburg,29.4,60,36,21,35,4,18,45,40.0,27,47,12,35,48,108,62,0
1316,Sami Khedira,Juventus,7.6,14,7,3,8,3,4,19,21.1,15,12,1,11,3,17,13,0
1317,Kike,Eibar,19.6,13,7,0,5,8,4,12,33.3,8,15,1,14,1,14,9,0
1318,Luca Kilian,Paderborn 07,14.0,33,24,27,6,0,22,41,53.7,19,20,9,11,12,45,67,0
1319,Max Kilman,Wolves,2.1,4,2,1,3,0,2,2,100.0,0,1,1,0,4,8,7,0
1320,Joshua Kimmich,Bayern Munich,31.3,52,29,21,20,11,22,55,40.0,33,38,9,29,29,81,29,0
1321,Presnel Kimpembe,Paris S-G,13.6,33,25,25,8,0,14,20,70.0,6,7,3,4,21,54,33,1
1322,Joshua King,Bournemouth,22.3,16,6,4,8,4,4,16,25.0,12,20,3,17,8,24,9,0
1323,Simon Kjaer,Atalanta,3.2,9,6,1,8,0,3,4,75.0,1,5,4,1,7,16,10,1
1324,Simon Kjaer,Milan,13.8,22,13,17,5,0,10,18,55.6,8,20,16,4,15,37,52,0
1326,Davy Klaassen,Werder Bremen,32.6,55,43,19,23,13,19,57,33.3,38,46,18,28,38,93,45,2
1327,Felix Klaus,Wolfsburg,7.4,24,16,4,13,7,7,19,36.8,12,10,2,8,3,27,5,0
1328,Ragnar Klavan,Cagliari,26.2,29,16,20,9,0,14,28,50.0,14,29,19,10,25,54,118,1
1329,Timm Klose,Norwich City,6.5,8,2,5,2,1,7,11,63.6,4,6,6,0,7,15,29,0
1330,Lukas Klostermann,RB Leipzig,29.4,45,26,24,16,5,18,31,58.1,13,34,16,18,26,71,101,2
1331,Justin Kluivert,Roma,16.8,17,11,4,8,5,7,16,43.8,9,15,0,15,6,23,7,0
1332,Lukas Klunter,Hertha BSC,20.9,44,31,26,16,2,20,30,66.7,10,16,4,12,27,71,61,1
1333,Robin Knoche,Wolfsburg,17.7,29,14,24,5,0,17,30,56.7,13,19,11,8,27,56,77,1
1334,Robin Koch,Freiburg,30.1,34,20,20,13,1,11,26,42.3,15,30,22,8,45,79,94,4
1335,Giorgi Kochorashvili,Levante,0.0,0,0,0,0,0,0,0,0.0,0,0,0,0,0,0,0,0
1336,Jonathan Kodjia,Aston Villa,1.3,0,0,0,0,0,0,1,0.0,1,0,0,0,0,0,1,0
1337,Kenan Kodro,Athletic Club,4.0,1,0,0,0,1,0,2,0.0,2,1,0,1,0,1,4,0
1338,Dominik Kohr,Eint Frankfurt,16.1,44,35,15,25,4,18,53,34.0,35,31,11,20,30,74,16,0
1339,Koke,Atlético Madrid,30.0,70,42,27,30,13,29,89,32.6,60,33,8,25,29,99,28,2
1340,Aleksandar Kolarov,Roma,30.4,37,28,16,16,5,20,37,54.1,17,20,9,11,31,68,57,0
1341,Sead Kolasinac,Arsenal,18.9,29,16,18,6,5,12,23,52.2,11,14,4,10,25,54,34,1
1342,Timothee Kolodziejczak,Saint-Étienne,14.5,17,10,13,4,0,9,21,42.9,12,8,3,5,30,47,44,2
1343,Ghislain Konan,Reims,14.8,43,26,28,14,1,19,28,67.9,9,13,3,10,24,67,34,0
1344,Ibrahima Konate,RB Leipzig,6.3,11,6,10,1,0,2,7,28.6,5,9,4,5,5,16,35,1
1345,Moussa Konate,Amiens,6.8,3,0,0,3,0,0,2,0.0,2,2,0,2,1,4,1,0
1346,Geoffrey Kondogbia,Valencia,20.1,63,40,40,18,5,19,51,37.3,32,25,6,19,57,120,36,2
1347,Kouadio Kone,Toulouse,9.7,35,20,17,14,4,13,30,43.3,17,15,1,14,19,54,10,1
1348,Lamine Kone,Strasbourg,16.4,31,21,20,10,1,12,17,70.6,5,8,5,3,25,56,47,1
1349,Moussa Kone,Nîmes,1.6,2,0,1,1,0,1,3,33.3,2,1,0,1,1,3,0,0
1350,Youssouf Kone,Lyon,9.1,22,14,17,3,2,12,20,60.0,8,2,1,1,8,30,15,0
1352,Ezri Konsa,Aston Villa,22.7,18,9,12,6,0,7,16,43.8,9,34,24,10,25,43,70,2
1353,Pascal Kopke,Hertha BSC,1.3,0,0,0,0,0,0,0,0.0,0,0,0,0,0,0,0,0
1354,Laurent Koscielny,Bordeaux,24.3,28,13,24,4,0,10,20,50.0,10,23,19,4,26,54,104,0
1355,Filip Kostic,Eint Frankfurt,32.9,59,38,30,20,9,22,59,37.3,37,45,2,43,23,82,16,0
1356,Christian Kouame,Fiorentina,3.3,3,2,0,3,0,0,1,0.0,1,5,1,4,1,4,1,0
1357,Christian Kouame,Genoa,10.2,2,1,0,1,1,0,8,0.0,8,8,2,6,1,3,13,0
1358,Tomas Koubek,Augsburg,24.0,3,2,3,0,0,3,11,27.3,8,1,0,1,1,4,23,3
1359,Kalidou Koulibaly,Napoli,23.4,51,33,30,17,4,17,28,60.7,11,28,16,12,31,82,61,1
1360,Efthimis Koulouris,Toulouse,17.1,13,8,5,5,3,3,13,23.1,10,8,4,4,3,16,16,0
1361,Jules Kounde,Sevilla,25.7,23,12,14,5,4,10,18,55.6,8,16,12,4,23,46,91,2
1362,Leonardo Koutris,Mallorca,1.0,1,1,0,0,1,1,2,50.0,1,1,1,0,1,2,6,0
1363,Cheikhou Kouyate,Crystal Palace,28.1,67,32,43,20,4,26,48,54.2,22,35,11,24,43,110,58,1
1364,Mateo Kovacic,Chelsea,23.0,63,38,29,32,2,26,65,40.0,39,15,1,14,22,85,16,1
1365,Dawid Kownacki,Düsseldorf,12.1,13,8,5,7,1,9,20,45.0,11,13,2,11,6,19,8,0
1366,Ismail Koybasi,Granada,2.6,4,4,3,1,0,0,2,0.0,2,4,0,4,5,9,2,0
1367,Thomas Kraft,Hertha BSC,4.0,0,0,0,0,0,0,0,0.0,0,0,0,0,1,1,0,0
1368,Emil Krafth,Newcastle Utd,11.3,18,12,15,2,1,9,20,45.0,11,11,8,3,8,26,45,0
1369,Andrej Kramaric,Hoffenheim,15.8,2,1,1,0,1,1,7,14.3,6,6,0,6,3,5,4,0
1370,Christoph Kramer,M'Gladbach,16.3,45,29,19,21,5,19,49,38.8,30,22,3,19,14,59,19,0
1371,Tom Krauss,RB Leipzig,0.0,1,1,0,1,0,1,2,50.0,1,0,0,0,0,1,0,0
1372,Ladislav Krejci,Bologna,11.7,15,10,6,7,2,9,19,47.4,10,7,4,3,10,25,23,0
1373,Rene Krhin,Nantes,3.6,4,3,1,3,0,2,2,100.0,0,1,0,1,6,10,17,0
1374,Felix Kroos,Union Berlin,4.2,17,9,9,6,2,8,15,53.3,7,6,3,3,3,20,13,1
1375,Toni Kroos,Real Madrid,29.5,56,28,18,29,9,18,70,25.7,52,27,0,27,23,79,15,0
1376,Tim Krul,Norwich City,36.0,0,0,0,0,0,0,1,0.0,1,2,0,2,1,1,13,1
1378,Rade Krunic,Milan,6.0,16,8,8,5,3,9,16,56.3,7,5,0,5,9,25,5,0
1379,Lukas Kubler,Freiburg,2.3,1,1,0,1,0,1,5,20.0,4,2,0,2,1,2,6,0
1380,Takefusa Kubo,Mallorca,25.7,34,22,16,12,6,15,44,34.1,29,19,1,18,23,57,10,0
1381,Juraj Kucka,Parma,21.5,43,22,21,16,6,14,61,23.0,47,21,4,17,29,72,36,0
1382,Dejan Kulusevski,Parma,32.6,41,21,10,24,7,19,64,29.7,45,25,1,24,23,64,17,0
1383,Marash Kumbulla,Hellas Verona,21.7,40,24,21,17,2,19,36,52.8,17,33,24,9,50,90,86,3
1384,Pierre Kunde,Mainz 05,20.7,34,17,15,18,1,12,30,40.0,18,16,4,12,26,60,55,0
1385,Jasmin Kurtic,SPAL,15.7,20,7,8,8,4,6,27,22.2,21,14,2,12,10,30,20,1
1386,Jasmin Kurtic,Parma,18.5,32,23,19,10,3,13,35,37.1,22,19,5,14,15,47,27,2
1387,Layvin Kurzawa,Paris S-G,9.5,23,16,5,14,4,11,23,47.8,12,12,1,11,18,41,24,1
1388,Dereck Kutesa,Reims,5.9,6,5,3,2,1,3,9,33.3,6,5,0,5,1,7,1,0
1389,Ahmed Kutucu,Schalke 04,7.5,11,7,3,6,2,4,15,26.7,11,5,0,5,2,13,5,0
1390,Enock Kwateng,Bordeaux,10.9,36,22,17,17,2,22,47,46.8,25,16,6,10,22,58,41,0
1391,Giorgos Kyriakopoulos,Sassuolo,18.3,35,18,22,7,6,18,32,56.3,14,19,6,13,18,53,41,0
1392,Antonino La Gumina,Sampdoria,2.1,0,0,0,0,0,0,0,0.0,0,0,0,0,0,0,1,0
1393,Andrea La Mantia,Lecce,6.1,1,0,1,0,0,1,5,20.0,4,3,0,3,7,8,11,0
1394,Gaetan Laborde,Montpellier,24.9,21,12,4,10,7,9,38,23.7,29,21,0,21,7,28,32,1
1395,Alexandre Lacazette,Arsenal,20.8,31,16,8,21,2,9,24,37.5,15,14,0,14,7,38,15,0
1396,Riccardo Ladinetti,Cagliari,1.4,2,2,0,2,0,1,1,100.0,0,0,0,0,4,6,0,1
1397,Alban Lafont,Nantes,27.0,1,1,1,0,0,1,1,100.0,0,0,0,0,0,1,12,0
1398,Victor Laguardia,Alavés,29.5,21,15,15,6,0,16,30,53.3,14,24,18,6,37,58,131,1
1399,Jack Lahne,Amiens,0.1,1,1,0,0,1,0,0,0.0,0,0,0,0,0,1,0,0
1400,Konrad Laimer,RB Leipzig,23.5,91,45,30,46,15,43,102,42.2,59,51,8,43,34,125,14,0
1401,Stefan Lainer,M'Gladbach,30.1,51,30,25,19,7,24,54,44.4,30,38,7,31,29,80,71,0
1402,Diego Lainez,Betis,3.9,6,5,2,4,0,5,8,62.5,3,6,0,6,1,7,1,0
1404,Kenny Lala,Strasbourg,22.7,29,16,17,11,1,11,27,40.7,16,14,5,9,20,49,40,1
1405,Adam Lallana,Liverpool,4.2,19,9,7,9,3,6,21,28.6,15,7,0,7,5,24,3,0
1406,Erik Lamela,Tottenham,13.5,24,20,9,13,2,2,21,9.5,19,12,3,9,8,32,10,0
1407,Tariq Lamptey,Chelsea,0.4,2,2,1,1,0,2,2,100.0,0,0,0,0,0,2,0,0
1408,Tariq Lamptey,Brighton,6.5,7,6,6,1,0,2,9,22.2,7,6,0,6,16,23,17,0
1409,Loick Landre,Nîmes,10.3,16,9,12,3,1,7,11,63.6,4,12,9,3,17,33,34,0
1410,Michael Lang,Werder Bremen,6.0,8,5,3,5,0,6,12,50.0,6,5,1,4,7,15,22,0
1411,Sebastian Langkamp,Werder Bremen,3.5,3,2,3,0,0,2,4,50.0,2,5,3,2,3,6,11,1
1412,Henri Lansbury,Aston Villa,2.2,6,2,3,1,2,2,8,25.0,6,4,0,4,0,6,3,0
1413,Manuel Lanzini,West Ham,15.3,14,9,6,6,2,7,39,17.9,32,9,1,8,10,24,3,0
1414,Gianluca Lapadula,Lecce,19.8,15,8,6,8,1,5,16,31.3,11,2,0,2,1,16,14,0
1415,Aymeric Laporte,Manchester City,12.2,13,6,6,7,0,4,9,44.4,5,6,5,1,20,33,26,1
1416,Danilo Larangeira,Bologna,29.3,34,17,19,15,0,16,28,57.1,12,54,39,15,30,64,99,0
1417,Larra,Athletic Club,2.8,2,2,0,1,1,0,0,0.0,0,1,0,1,0,2,0,0
1418,Gautier Larsonneur,Brest,26.6,2,1,2,0,0,2,4,50.0,2,1,0,1,4,6,14,3
1419,Kevin Lasagna,Udinese,28.5,27,14,7,13,7,6,31,19.4,25,23,1,22,10,37,18,1
1420,Jamaal Lascelles,Newcastle Utd,23.1,14,3,10,4,0,4,9,44.4,5,23,20,3,28,42,116,1
1421,Paul Lasne,Brest,13.6,25,13,13,11,1,6,20,30.0,14,7,2,5,7,32,5,0
1422,Toni Lato,Osasuna,5.2,22,15,11,8,3,9,10,90.0,1,9,1,8,8,30,13,1
1423,Danny Latza,Mainz 05,15.3,33,19,15,17,1,16,49,32.7,33,22,5,17,17,50,24,0
1424,Vincent Laurini,Parma,9.8,26,22,11,11,4,14,18,77.8,4,10,3,7,11,37,29,0
1425,Wesley Lautoa,Dijon,20.8,54,29,24,28,2,28,63,44.4,35,31,16,15,42,96,48,2
1426,Diego Laxalt,Torino,6.6,19,10,10,6,3,6,20,30.0,14,12,4,8,6,25,20,0
1427,Diego Laxalt,Milan,1.9,3,3,3,0,0,1,3,33.3,2,4,0,4,0,3,3,0
1428,Valentino Lazaro,Newcastle Utd,5.3,13,9,11,2,0,11,18,61.1,7,2,0,2,3,16,4,0
1430,Valentino Lazaro,Inter,3.6,6,5,3,2,1,4,8,50.0,4,5,0,5,1,7,8,1
1431,Darko Lazovic,Hellas Verona,36.0,26,16,14,8,4,14,27,51.9,13,15,4,11,23,49,53,0
1432,Manuel Lazzari,Lazio,28.3,20,11,10,7,3,10,31,32.3,21,11,1,10,8,28,34,0
1433,Mickael Le Bihan,Nice,1.1,0,0,0,0,0,0,2,0.0,2,0,0,0,0,0,2,0
1434,Robin Le Normand,Real Sociedad,26.6,48,27,33,15,0,26,35,74.3,9,20,7,13,20,68,99,0
1435,Damien Le Tallec,Montpellier,27.3,52,27,20,28,4,24,69,34.8,45,38,18,20,38,90,59,0
1436,James Lea Siliki,Rennes,12.0,28,16,19,9,0,16,29,55.2,13,15,4,11,12,40,12,0
1437,Rafael Leao,Milan,15.6,7,4,2,5,0,3,9,33.3,6,4,0,4,0,7,5,0
1438,Adrien Lebeau,Strasbourg,0.1,1,1,1,0,0,0,1,0.0,1,1,0,1,0,1,0,0
1439,Mathew Leckie,Hertha BSC,2.2,3,1,1,2,0,2,3,66.7,1,6,0,6,2,5,2,1
1440,Benjamin Lecomte,Monaco,28.0,0,0,0,0,0,0,1,0.0,1,1,0,1,0,0,10,5
1441,Pierre Lees-Melou,Nice,25.0,63,27,34,21,8,31,88,35.2,57,38,12,26,32,95,43,0
1442,Jordan Lefort,Amiens,9.4,3,2,2,1,0,3,5,60.0,2,4,1,3,9,12,29,0
1443,Wu Lei,Espanyol,19.1,13,8,5,6,2,4,38,10.5,34,32,1,31,15,28,19,1
1444,Toni Leistner,Köln,11.2,19,12,10,9,0,5,13,38.5,8,16,7,9,32,51,57,0
1445,Moritz Leitner,Norwich City,7.6,16,9,8,7,1,9,25,36.0,16,14,4,10,9,25,10,1
1446,Lucas Leiva,Lazio,20.1,60,35,25,31,4,28,72,38.9,44,29,6,23,47,107,34,1
1447,Florian Lejeune,Newcastle Utd,4.9,8,2,6,2,0,4,7,57.1,3,6,2,4,10,18,15,2
1448,Inigo Lekue,Athletic Club,6.9,22,12,14,6,2,11,14,78.6,3,7,0,7,3,25,11,0
1449,Nicolas Lemaitre,Reims,1.0,0,0,0,0,0,0,1,0.0,1,0,0,0,1,1,1,1
1450,Thomas Lemar,Atlético Madrid,10.3,12,8,4,5,3,2,11,18.2,9,14,1,13,6,18,6,0
1451,Tim Lemperle,Köln,0.2,0,0,0,0,0,0,0,0.0,0,0,0,0,0,0,0,0
1452,Clement Lenglet,Barcelona,26.9,44,31,29,15,0,16,32,50.0,16,29,15,14,35,79,79,1
1453,Aaron Lennon,Burnley,5.5,14,8,7,4,3,7,10,70.0,3,6,1,5,8,22,3,0
1454,Bernd Leno,Arsenal,29.4,0,0,0,0,0,0,2,0.0,2,0,0,0,0,0,9,2
1456,Christopher Lenz,Union Berlin,25.2,63,37,37,20,6,26,49,53.1,23,46,11,35,43,106,65,0
1457,Donovan Leon,Brest,1.4,0,0,0,0,0,0,0,0.0,0,1,0,1,0,0,0,0
1458,Pedro Leon,Eibar,21.1,28,20,8,9,11,12,25,48.0,13,18,1,17,19,47,7,0
1459,Sergio Leon,Levante,7.5,3,3,0,3,0,2,4,50.0,2,3,0,3,1,4,2,0
1460,Lukas Lerager,Genoa,15.4,29,19,13,12,4,10,34,29.4,24,20,5,15,8,37,15,1
1461,Mehdi Leris,Sampdoria,5.7,13,11,4,2,7,7,19,36.8,12,12,4,8,6,19,6,0
1462,Jefferson Lerma,Bournemouth,30.0,54,32,17,31,6,22,48,45.8,26,28,12,16,57,111,54,1
1463,Karlo Letica,SPAL,10.0,0,0,0,0,0,0,2,0.0,2,0,0,0,0,0,4,3
1464,Robert Lewandowski,Bayern Munich,30.7,18,9,3,9,6,3,15,20.0,12,13,1,12,7,25,13,0
1465,Jamal Lewis,Norwich City,25.6,51,35,42,6,3,22,36,61.1,14,27,12,15,25,76,68,0
1466,Aaron Leya Iseka,Toulouse,8.6,2,0,0,2,0,0,3,0.0,3,5,0,5,1,3,7,0
1467,Stephan Lichtsteiner,Augsburg,14.9,23,14,16,5,2,10,22,45.5,12,15,7,8,16,39,35,0
1468,Dimitri Lienard,Strasbourg,16.5,37,24,10,22,5,18,39,46.2,21,18,4,14,17,54,25,0
1469,Philipp Lienhart,Freiburg,20.2,11,4,10,1,0,6,13,46.2,7,24,17,7,28,39,86,0
1470,Matthijs de Ligt,Juventus,27.2,25,15,14,10,1,13,23,56.5,10,30,23,7,25,50,101,2
1471,Isaac Lihadji,Marseille,0.3,0,0,0,0,0,0,0,0.0,0,0,0,0,0,0,0,0
1472,Lillo,Osasuna,2.2,4,2,2,2,0,1,1,100.0,0,2,1,1,2,6,8,0
1473,Anderson Lima,Lazio,0.7,4,0,3,1,0,1,1,100.0,0,4,0,4,0,4,0,0
1474,Lucas Lima,Nantes,3.0,7,2,4,3,0,2,5,40.0,3,2,0,2,1,8,3,0
1475,Anthony Limbombe,Nantes,1.7,3,2,1,2,0,1,1,100.0,0,1,0,1,0,3,3,0
1476,Victor Lindelof,Manchester Utd,34.4,29,15,16,12,1,17,20,85.0,3,25,16,9,26,55,129,0
1477,Karol Linetty,Sampdoria,22.4,61,32,24,25,12,21,65,32.3,44,26,3,23,26,87,17,0
1478,Jesse Lingard,Manchester Utd,10.4,15,8,6,4,5,5,18,27.8,13,5,0,5,3,18,0,0
1479,Pol Lirola,Fiorentina,29.4,34,20,18,10,6,21,38,55.3,17,16,4,12,26,60,52,0
1480,Diego Llorente,Real Sociedad,25.9,30,14,20,9,1,16,28,57.1,12,14,7,7,28,58,101,5
1482,Fernando Llorente,Napoli,5.6,0,0,0,0,0,0,1,0.0,1,4,0,4,1,1,3,0
1483,Marcos Llorente,Atlético Madrid,15.2,29,15,7,16,6,7,21,33.3,14,24,4,20,14,43,9,0
1484,Gautier Lloris,Nice,3.0,5,3,5,0,0,4,5,80.0,1,3,3,0,2,7,11,0
1485,Hugo Lloris,Tottenham,20.1,0,0,0,0,0,0,0,0.0,0,0,0,0,1,1,3,2
1486,Giovani Lo Celso,Tottenham,16.6,51,29,12,33,6,12,59,20.3,47,20,4,16,9,60,19,0
1487,Stanislav Lobotka,Napoli,8.4,11,9,3,5,3,5,12,41.7,7,3,1,2,9,20,2,0
1488,Stanislav Lobotka,Celta Vigo,15.4,19,11,13,5,1,4,19,21.1,15,8,2,6,8,27,7,0
1489,Jurgen Locadia,Brighton,1.0,0,0,0,0,0,0,0,0.0,0,0,0,0,0,0,0,0
1490,Jurgen Locadia,Hoffenheim,5.9,5,4,0,4,1,1,4,25.0,3,1,0,1,0,5,3,0
1491,Manuel Locatelli,Sassuolo,28.7,76,50,35,37,4,33,69,47.8,36,42,14,28,33,109,36,0
1492,Renan Lodi,Atlético Madrid,26.6,73,46,28,35,10,40,65,61.5,25,28,7,21,38,111,56,0
1493,Ruben Loftus-Cheek,Chelsea,2.3,0,0,0,0,0,0,2,0.0,2,1,1,0,2,2,2,0
1494,Enzo Loiodice,Dijon,2.1,6,4,1,4,1,1,3,33.3,2,2,0,2,2,8,1,0
1495,Kevin Long,Burnley,6.3,7,5,6,1,0,4,9,44.4,5,9,7,2,4,11,31,0
1496,Shane Long,Southampton,15.5,19,10,5,8,6,7,19,36.8,12,12,0,12,4,23,16,0
1497,Matthew Longstaff,Newcastle Utd,6.4,3,1,2,1,0,3,14,21.4,11,4,1,3,5,8,3,0
1498,Sean Longstaff,Newcastle Utd,15.3,35,19,17,16,2,20,50,40.0,30,23,5,18,19,54,20,2
1499,Ademola Lookman,RB Leipzig,3.4,6,4,3,1,2,1,1,100.0,0,3,0,3,1,7,0,1
1500,Anthony Lopes,Lyon,26.0,0,0,0,0,0,0,0,0.0,0,0,0,0,1,1,11,0
1501,Rony Lopes,Sevilla,1.5,0,0,0,0,0,0,0,0.0,0,0,0,0,2,2,0,0
1502,Rony Lopes,Monaco,0.9,1,0,0,1,0,0,0,0.0,0,0,0,0,0,1,0,0
1503,Adrian Lopez,Osasuna,16.0,7,5,1,5,1,2,19,10.5,17,6,2,4,4,11,8,0
1504,David Lopez,Espanyol,27.3,38,20,15,20,3,13,41,31.7,28,28,13,15,35,73,63,3
1505,Diego Lopez,Espanyol,35.9,2,2,2,0,0,1,2,50.0,1,0,0,0,2,4,8,1
1506,Javi Lopez,Alavés,1.0,6,5,4,2,0,4,5,80.0,1,1,1,0,1,7,5,0
1508,Javi Lopez,Espanyol,15.4,47,34,23,18,6,19,40,47.5,21,12,6,6,21,68,38,2
1509,Lluis Lopez,Espanyol,3.3,4,2,3,1,0,2,2,100.0,0,4,0,4,1,5,6,1
1510,Maxime Lopez,Marseille,12.3,16,10,5,8,3,4,26,15.4,22,8,2,6,8,24,1,0
1511,Pau Lopez,Roma,32.0,1,0,1,0,0,1,5,20.0,4,0,0,0,1,2,10,3
1512,Roberto Lopez,Real Sociedad,0.6,4,2,1,1,2,2,2,100.0,0,0,0,0,0,4,0,0
1513,Unai Lopez,Athletic Club,19.9,30,22,8,18,4,10,41,24.4,31,13,2,11,18,48,12,1
1514,Losada,Celta Vigo,0.1,0,0,0,0,0,0,0,0.0,0,0,0,0,0,0,0,0
1515,Albert Lottin,Bordeaux,0.5,2,0,2,0,0,1,4,25.0,3,0,0,0,2,4,2,0
1516,Imran Louza,Nantes,22.3,53,27,18,27,8,19,46,41.3,27,18,2,16,17,70,7,0
1517,Matteo Lovato,Hellas Verona,0.1,0,0,0,0,0,0,0,0.0,0,0,0,0,0,0,1,0
1518,Dejan Lovren,Liverpool,8.6,13,8,10,3,0,7,12,58.3,5,9,6,3,10,23,42,0
1519,Eduard Lowen,Augsburg,7.5,10,8,6,2,2,6,18,33.3,12,11,2,9,5,15,7,0
1520,Eduard Lowen,Hertha BSC,3.5,9,6,3,6,0,5,11,45.5,6,2,1,1,7,16,2,0
1521,Matthew Lowton,Burnley,17.0,41,22,20,18,3,22,33,66.7,11,20,6,14,27,68,57,1
1522,Hirving Lozano,Napoli,11.4,6,4,1,5,0,2,15,13.3,13,13,0,13,5,11,5,0
1523,Pol Lozano,Espanyol,1.9,5,3,3,2,0,3,7,42.9,4,3,0,3,1,6,2,0
1524,Jan Luca Rumpf,Paderborn 07,1.0,0,0,0,0,0,0,0,0.0,0,0,0,0,0,0,2,0
1525,Jean Lucas,Lyon,2.2,16,7,8,5,3,2,9,22.2,7,2,2,0,2,18,0,0
1526,Fabio Lucioni,Lecce,34.8,29,13,20,9,0,14,32,43.8,18,48,38,10,36,65,169,5
1527,Jose Luis Gaya,Valencia,22.1,44,30,29,12,3,28,41,68.3,13,22,9,13,18,62,48,1
1528,Jose Luis Morales,Levante,28.0,17,8,5,9,3,6,34,17.6,28,14,1,13,6,23,5,1
1529,Jose Luis Palomino,Atalanta,27.6,81,44,46,33,2,28,54,51.9,26,39,14,25,61,142,74,2
1530,Jose Luis Rodriguez,Alavés,0.2,0,0,0,0,0,0,2,0.0,2,0,0,0,0,0,0,0
1531,David Luiz,Arsenal,31.2,28,16,14,14,0,13,24,54.2,11,42,37,5,32,60,133,2
1532,Douglas Luiz,Aston Villa,29.0,46,24,25,17,4,19,65,29.2,46,42,15,27,36,82,54,1
1534,Jordan Lukaku,Lazio,4.4,4,2,1,1,2,2,4,50.0,2,2,1,1,0,4,9,0
1535,Romelu Lukaku,Inter,33.1,13,7,4,7,2,3,10,30.0,7,14,6,8,1,14,28,0
1536,Dodi Lukebakio,Hertha BSC,22.6,25,18,13,8,4,10,28,35.7,18,22,4,18,10,35,14,0
1537,Sasa Lukic,Torino,20.7,29,17,8,19,2,10,35,28.6,25,21,7,14,29,58,15,0
1538,Senad Lulic,Lazio,17.5,21,13,10,7,4,11,41,26.8,30,20,4,16,21,42,28,1
1539,John Lundstram,Sheffield Utd,27.3,46,30,18,21,7,21,65,32.3,44,18,4,14,33,79,46,1
1540,Sebastiano Luperto,Napoli,5.9,12,9,7,3,2,6,9,66.7,3,5,3,2,6,18,16,0
1541,Arnaud Lusamba,Nice,10.9,20,11,8,10,2,7,23,30.4,16,9,0,9,5,25,6,1
1542,Andreas Luthe,Augsburg,10.0,1,0,1,0,0,1,2,50.0,1,0,0,0,0,1,5,1
1543,Lyanco,Torino,13.1,23,13,9,12,2,7,13,53.8,6,29,19,10,23,46,54,2
1544,Charalambos Lykogiannis,Cagliari,14.9,14,9,9,3,2,7,18,38.9,11,25,9,16,23,37,71,0
1545,Yann M'Vila,Saint-Étienne,21.6,29,14,12,16,1,12,43,27.9,31,14,4,10,40,69,47,1
1546,Alexis Mac Allister,Brighton,3.9,9,5,4,3,2,5,9,55.6,4,12,0,12,1,10,2,0
1547,Darwin Machis,Granada,23.7,23,13,11,8,4,8,23,34.8,15,22,4,18,31,54,9,0
1548,Yvann Macon,Saint-Étienne,1.1,0,0,0,0,0,0,1,0.0,1,2,0,2,3,3,4,0
1549,James Maddison,Leicester City,29.2,59,30,13,31,15,23,68,33.8,45,16,0,16,9,68,7,1
1550,Lisandro Magallan,Alavés,13.3,22,15,10,12,0,8,14,57.1,6,17,6,11,16,38,43,1
1551,Francesco Magnanelli,Sassuolo,15.5,25,13,9,12,4,11,35,31.4,24,12,6,6,19,44,23,1
1552,Giangiacomo Magnani,Brescia,1.3,0,0,0,0,0,0,1,0.0,1,2,2,0,2,2,6,0
1553,Giangiacomo Magnani,Sassuolo,1.6,0,0,0,0,0,0,0,0.0,0,2,1,1,2,2,7,0
1554,Hugo Magnetti,Brest,2.6,16,10,7,7,2,5,9,55.6,4,4,0,4,7,23,4,0
1555,Harry Maguire,Manchester Utd,38.0,37,23,23,14,0,18,34,52.9,16,31,22,9,72,109,159,0
1556,Abdallahi Mahmoud,Alavés,1.7,4,4,2,1,1,1,6,16.7,5,0,0,0,5,9,2,0
1557,Riyad Mahrez,Manchester City,21.6,28,14,11,9,8,11,38,28.9,27,31,1,30,18,46,8,2
1558,Thiago Maia,Lille,0.5,4,4,1,3,0,0,1,0.0,1,0,0,0,1,5,1,0
1560,Arne Maier,Hertha BSC,5.9,9,7,6,1,2,1,10,10.0,9,5,0,5,7,16,2,1
1561,Habib Maiga,Metz,25.2,84,50,36,38,10,24,64,37.5,40,39,4,35,34,118,39,2
1562,Mike Maignan,Lille,28.0,0,0,0,0,0,0,0,0.0,0,0,0,0,2,2,5,0
1563,Ainsley Maitland-Niles,Arsenal,15.4,41,23,34,5,2,22,43,51.2,21,12,3,9,28,69,38,0
1564,Josh Maja,Bordeaux,8.2,5,2,0,2,3,1,10,10.0,9,8,4,4,1,6,3,0
1565,Abdul Majeed Waris,Strasbourg,4.1,6,4,4,2,0,3,8,37.5,5,2,0,2,4,10,0,0
1566,Zan Majer,Lecce,18.5,39,18,19,12,8,17,56,30.4,39,27,6,21,26,65,18,1
1567,Jean-Victor Makengo,Toulouse,11.0,14,11,3,10,1,4,13,30.8,9,7,1,6,3,17,5,1
1568,Nemanja Maksimovic,Getafe,32.2,49,28,12,31,6,10,44,22.7,34,37,7,30,56,105,30,1
1569,Nikola Maksimovic,Napoli,20.0,35,24,21,14,0,10,21,47.6,11,19,11,8,30,65,64,1
1570,Kevin Malcuit,Napoli,2.8,8,6,4,3,1,5,6,83.3,1,4,1,3,3,11,2,0
1571,Daniel Maldini,Milan,0.3,0,0,0,0,0,0,2,0.0,2,1,0,1,1,1,0,0
1572,Ruslan Malinovskyi,Atalanta,17.1,22,14,2,17,3,9,31,29.0,22,13,2,11,5,27,5,0
1573,Yunus Malli,Union Berlin,7.5,8,3,1,5,2,5,10,50.0,5,2,0,2,7,15,7,0
1574,Hugo Mallo,Celta Vigo,21.8,62,42,44,16,2,27,48,56.3,21,24,8,16,22,84,97,1
1575,Streli Mamba,Paderborn 07,16.9,15,9,0,9,6,1,13,7.7,12,12,2,10,6,21,2,0
1576,Hianga Mananga Mbock,Brest,1.6,1,1,1,0,0,0,0,0.0,0,0,0,0,4,5,0,0
1577,Vincent Manceau,Angers,22.0,34,22,18,13,3,16,36,44.4,20,16,3,13,22,56,51,0
1578,Gianluca Mancini,Roma,30.4,49,26,26,18,5,22,44,50.0,22,32,15,17,60,109,98,1
1579,Marco Mancosu,Lecce,27.1,32,18,11,16,5,10,46,21.7,36,34,9,25,16,48,15,1
1580,Steve Mandanda,Marseille,26.3,3,1,3,0,0,3,4,75.0,1,0,0,0,1,4,2,4
1581,Reinildo Mandava,Lille,12.3,37,21,23,11,3,25,41,61.0,16,16,1,15,19,56,20,0
1582,Aissa Mandi,Betis,28.6,33,15,22,8,3,18,28,64.3,10,29,15,14,38,71,93,0
1583,Rolando Mandragora,Udinese,22.8,47,24,15,25,7,15,55,27.3,40,30,5,25,26,73,25,0
1584,Sadio Mane,Liverpool,30.5,44,32,9,20,15,13,40,32.5,27,19,0,19,13,57,11,2
1586,Eliaquim Mangala,Valencia,7.5,4,4,3,1,0,1,2,50.0,1,7,6,1,7,11,40,0
1587,Thomas Mangani,Angers,20.8,33,23,15,16,2,14,47,29.8,33,17,2,15,12,45,20,1
1588,Massimiliano Mangraviti,Brescia,10.8,8,6,1,6,1,3,6,50.0,3,11,6,5,8,16,43,0
1589,Kostas Manolas,Napoli,24.2,23,15,13,10,0,10,17,58.8,7,19,14,5,25,48,76,1
1590,Javier Manquillo,Newcastle Utd,17.8,39,26,27,8,4,24,38,63.2,14,14,2,12,18,57,56,0
1591,Giacomo Manzari,Sassuolo,0.2,0,0,0,0,0,0,0,0.0,0,0,0,0,0,0,0,0
1592,Myziane Maolida,Nice,7.5,14,10,5,6,3,5,12,41.7,7,8,0,8,3,17,3,0
1593,Faitout Maouassa,Rennes,20.0,51,33,27,20,4,14,26,53.8,12,13,5,8,23,74,59,0
1594,Fernando Marcal,Lyon,9.2,28,18,18,7,3,13,26,50.0,13,7,3,4,26,54,32,0
1595,Marcelo,Real Madrid,14.4,19,11,8,8,3,9,28,32.1,19,19,2,17,18,37,21,0
1596,Marcelo,Lyon,16.7,27,18,18,8,1,16,23,69.6,7,12,11,1,22,49,77,0
1597,Solly March,Brighton,12.7,25,12,16,6,3,9,19,47.4,10,16,4,12,20,45,14,2
1598,Gian Marco Ferrari,Sassuolo,21.1,9,5,6,3,0,4,8,50.0,4,25,22,3,26,35,41,1
1599,Oscar de Marcos,Athletic Club,6.0,5,3,2,1,2,3,6,50.0,3,6,0,6,8,13,8,0
1600,Dario Maresic,Reims,1.0,0,0,0,0,0,0,0,0.0,0,1,1,0,1,1,6,0
1601,Miguel Mari,Eibar,0.1,0,0,0,0,0,0,0,0.0,0,0,0,0,0,0,0,0
1602,Pablo Mari,Arsenal,1.3,2,1,2,0,0,0,0,0.0,0,0,0,0,1,3,10,0
1603,Jose Maria Gimenez,Atlético Madrid,19.5,20,16,18,1,1,7,11,63.6,4,14,7,7,23,43,75,1
1604,Mariano,Real Madrid,0.5,0,0,0,0,0,0,1,0.0,1,0,0,0,0,0,0,0
1605,Adrian Mariappa,Watford,16.8,20,14,15,4,1,11,30,36.7,19,22,7,15,11,31,73,0
1606,Jordan Marie,Dijon,2.2,7,5,4,3,0,4,9,44.4,5,3,1,2,4,11,2,0
1607,Federico Marigosu,Cagliari,0.3,0,0,0,0,0,0,0,0.0,0,0,0,0,0,0,1,0
1608,Adrian Marin,Alavés,9.5,22,15,14,6,2,13,15,86.7,2,13,4,9,13,35,32,0
1609,Guillermo Maripan,Alavés,1.0,1,1,1,0,0,1,2,50.0,1,0,0,0,2,3,10,0
1610,Guillermo Maripan,Monaco,19.5,42,26,28,13,1,24,41,58.5,17,30,13,17,25,67,69,2
1612,Marlon,Sassuolo,20.2,40,23,24,15,1,17,27,63.0,10,20,13,7,35,75,69,0
1613,Omar Marmoush,Wolfsburg,0.9,1,1,1,0,0,0,0,0.0,0,1,0,1,1,2,0,0
1614,Gonzalo Maroni,Sampdoria,2.0,3,1,1,1,1,3,7,42.9,4,1,0,1,3,6,0,0
1615,Marquinhos,Paris S-G,16.4,39,20,17,18,4,11,26,42.3,15,25,8,17,25,64,31,1
1616,Bruno Martella,Brescia,14.1,18,9,14,3,1,9,16,56.3,7,13,7,6,17,35,48,1
1617,Roger Marti,Levante,25.2,18,11,8,7,3,7,29,24.1,22,14,0,14,6,24,17,0
1618,Anthony Martial,Manchester Utd,29.2,15,12,1,4,10,1,16,6.3,15,18,1,17,5,20,17,0
1619,Aaron Martin,Mainz 05,19.9,29,15,17,8,4,9,22,40.9,13,11,5,6,30,59,36,0
1620,Daniel Martin,Betis,5.9,0,0,0,0,0,0,0,0.0,0,0,0,0,0,0,3,0
1621,David Martin,West Ham,4.8,0,0,0,0,0,0,0,0.0,0,0,0,0,0,0,1,1
1622,Jonas Martin,Rennes,1.3,6,2,4,0,2,1,1,100.0,0,2,2,0,0,6,0,0
1623,Jonas Martin,Strasbourg,2.7,5,3,4,0,1,1,3,33.3,2,3,0,3,1,6,3,0
1624,Josh Martin,Norwich City,0.4,1,0,0,0,1,0,0,0.0,0,1,0,1,1,2,0,0
1625,Gabriel Martinelli,Arsenal,7.4,20,15,10,6,4,7,20,35.0,13,15,1,14,3,23,8,0
1626,Alex Martinez,Granada,0.2,0,0,0,0,0,0,0,0.0,0,0,0,0,0,0,0,0
1627,Emiliano Martinez,Arsenal,8.6,0,0,0,0,0,0,0,0.0,0,0,0,0,0,0,1,0
1628,Inigo Martinez,Athletic Club,33.0,48,30,33,13,2,27,47,57.4,20,28,13,15,39,87,140,0
1629,Javi Martinez,Osasuna,0.1,0,0,0,0,0,0,0,0.0,0,0,0,0,0,0,1,0
1630,Javi Martinez,Bayern Munich,7.5,16,12,9,7,0,9,11,81.8,2,9,8,1,18,34,30,0
1631,Jose Martinez,Granada,13.2,21,16,12,8,1,14,25,56.0,11,6,4,2,18,39,46,0
1632,Lautaro Martinez,Inter,27.2,22,7,2,8,12,4,34,11.8,30,30,2,28,15,37,11,0
1633,Pablo Martinez,Levante,0.4,2,0,1,1,0,0,1,0.0,1,0,0,0,0,2,2,0
1634,Pablo Martinez,Nîmes,26.0,42,21,26,15,1,21,40,52.5,19,34,22,12,58,100,97,0
1635,Gelson Martins,Monaco,18.6,30,22,11,15,4,17,42,40.5,25,9,2,7,19,49,10,1
1636,Adam Marusic,Lazio,10.5,11,6,7,4,0,4,11,36.4,7,14,2,12,14,25,16,0
1638,Omar Mascarell,Schalke 04,22.5,42,23,17,22,3,21,57,36.8,36,46,14,32,62,104,40,0
1639,Andrea Masiello,Genoa,14.7,26,15,17,8,1,16,32,50.0,16,8,2,6,26,52,55,2
1640,Andrea Masiello,Atalanta,6.0,11,4,6,4,1,7,14,50.0,7,6,4,2,10,21,13,0
1641,Adam Masina,Watford,20.2,38,22,24,11,3,14,37,37.8,23,26,12,14,28,66,66,0
1642,Jordi Masip,Valladolid,35.0,1,1,1,0,0,0,2,0.0,2,0,0,0,1,2,7,3
1643,Arthur Masuaku,West Ham,10.4,41,23,24,13,4,23,39,59.0,16,19,5,14,14,55,23,0
1644,Jaime Mata,Getafe,30.5,21,13,3,11,7,3,20,15.0,17,16,1,15,7,28,15,0
1645,Juan Mata,Manchester Utd,8.4,7,3,1,5,1,2,7,28.6,5,5,1,4,0,7,2,0
1646,Ales Mateju,Brescia,28.3,48,27,33,9,6,23,45,51.1,22,41,24,17,37,85,109,3
1647,Jean-Philippe Mateta,Mainz 05,11.7,2,2,0,2,0,0,6,0.0,6,3,2,1,1,3,11,0
1648,Nemanja Matic,Manchester Utd,17.6,46,24,23,19,4,20,43,46.5,23,21,8,13,22,68,28,1
1649,Joel Matip,Liverpool,7.8,13,9,4,7,2,4,11,36.4,7,8,4,4,12,25,38,0
1650,Rabbi Matondo,Schalke 04,12.9,10,3,3,2,5,3,13,23.1,10,4,0,4,5,15,1,0
1651,Alessandro Matri,Brescia,1.0,1,0,0,0,1,0,0,0.0,0,1,0,1,0,1,1,0
1652,Federico Mattiello,Cagliari,10.3,30,21,19,7,4,11,27,40.7,16,20,7,13,18,48,22,0
1653,Blaise Matuidi,Juventus,24.9,48,27,13,27,8,13,34,38.2,21,35,6,29,22,70,16,0
1654,Neal Maupay,Brighton,30.7,20,12,1,13,6,9,29,31.0,20,24,0,24,4,24,10,0
1655,Stephy Mavididi,Dijon,15.5,18,11,7,8,3,10,26,38.5,16,11,0,11,7,25,5,0
1656,Philipp Max,Augsburg,30.1,42,29,22,16,4,20,45,44.4,25,19,4,15,26,68,50,0
1657,Alexandru Maxim,Mainz 05,1.3,4,2,1,2,1,1,3,33.3,2,0,0,0,1,5,1,0
1658,Eric Maxim Choupo-Moting,Paris S-G,5.0,12,9,3,4,5,4,8,50.0,4,3,0,3,1,13,3,0
1659,Kevin Mayi,Brest,0.0,0,0,0,0,0,0,0,0.0,0,0,0,0,0,0,0,0
1660,Borja Mayoral,Levante,23.8,12,3,4,6,2,2,13,15.4,11,11,0,11,4,16,6,0
1661,Luca Mazzitelli,Sassuolo,0.1,1,1,0,1,0,1,1,100.0,0,0,0,0,0,1,0,0
1662,Kevin Mbabu,Wolfsburg,18.8,69,48,39,24,6,35,54,64.8,19,33,10,23,23,92,53,0
1664,Kylian Mbappe,Paris S-G,16.8,7,2,1,5,1,3,10,30.0,7,4,0,4,3,10,0,0
1665,Ibrahima Mbaye,Bologna,16.7,19,10,13,4,2,7,17,41.2,10,22,11,11,15,34,42,0
1666,Loic Mbe Soh,Paris S-G,0.6,2,2,2,0,0,2,2,100.0,0,0,0,0,1,3,0,0
1667,Isaac Mbenza,Amiens,0.9,0,0,0,0,0,0,1,0.0,1,0,0,0,0,0,0,0
1668,Nathanael Mbuku,Reims,4.4,4,2,2,2,0,0,3,0.0,3,0,0,0,2,6,1,0
1669,James McArthur,Crystal Palace,34.3,88,51,43,34,11,37,106,34.9,69,69,19,50,60,148,56,0
1670,Oliver McBurnie,Sheffield Utd,23.5,37,22,6,27,4,11,40,27.5,29,25,3,22,15,52,43,0
1671,Alex McCarthy,Southampton,28.0,1,1,1,0,0,1,1,100.0,0,1,0,1,0,1,11,3
1672,James McCarthy,Crystal Palace,18.7,82,47,36,36,10,40,76,52.6,36,24,5,19,24,106,11,0
1673,John McGinn,Aston Villa,25.7,53,35,19,23,11,18,62,29.0,44,25,1,24,25,78,18,0
1674,David McGoldrick,Sheffield Utd,20.2,41,26,9,24,8,5,20,25.0,15,14,2,12,3,44,23,0
1675,Michael McGovern,Norwich City,1.8,0,0,0,0,0,0,0,0.0,0,0,0,0,0,0,1,1
1676,Weston McKennie,Schalke 04,23.0,38,20,17,16,5,13,40,32.5,27,38,12,26,46,84,39,0
1677,Kenny McLean,Norwich City,33.0,44,29,20,18,6,14,42,33.3,28,32,7,25,38,82,67,2
1678,Dwight McNeil,Burnley,37.1,47,33,18,22,7,23,71,32.4,48,60,8,52,30,77,34,0
1679,Scott McTominay,Manchester Utd,19.7,43,22,14,25,4,17,32,53.1,15,25,5,20,31,74,34,2
1680,Biagio Meccariello,Lecce,8.5,23,13,15,6,2,12,29,41.4,17,14,2,12,10,33,25,0
1681,Gary Medel,Bologna,19.8,43,22,15,24,4,16,43,37.2,27,24,8,16,34,77,31,2
1682,Ben Mee,Burnley,32.0,41,22,25,16,0,17,29,58.6,12,42,31,11,42,83,165,2
1683,Joshua Mees,Union Berlin,3.6,8,5,3,4,1,4,12,33.3,8,3,0,3,2,10,4,0
1684,Admir Mehmedi,Wolfsburg,13.3,14,6,2,9,3,4,15,26.7,11,10,0,10,5,19,4,0
1685,Soualiho Meite,Torino,24.5,32,18,14,13,5,12,35,34.3,23,31,6,25,24,56,36,0
1686,Farid El Melali,Angers,3.4,7,5,2,2,3,4,14,28.6,10,5,0,5,2,9,4,0
1687,Oscar Melendo,Espanyol,12.4,10,4,4,4,2,4,12,33.3,8,7,2,5,2,12,3,0
1688,Gonzalo Melero,Levante,13.7,20,13,9,9,2,7,27,25.9,20,12,3,9,9,29,15,1
1690,Arthur Melo,Barcelona,13.1,15,10,4,7,4,4,12,33.3,8,9,0,9,4,19,5,2
1691,Memphis,Lyon,11.3,4,3,2,0,2,0,5,0.0,5,0,0,0,2,6,2,0
1692,Pedro Mendes,Montpellier,15.3,28,17,15,13,0,15,24,62.5,9,19,12,7,28,56,42,1
1693,Thiago Mendes,Lyon,20.1,43,29,20,19,4,21,45,46.7,24,21,7,14,46,89,36,0
1694,Brais Mendez,Celta Vigo,16.4,26,11,14,9,3,12,39,30.8,27,20,0,20,12,38,23,1
1695,Edgar Mendez,Alavés,9.6,11,7,4,6,1,5,13,38.5,8,10,2,8,5,16,7,0
1696,Stiven Mendoza,Amiens,12.2,12,7,4,5,3,4,22,18.2,18,13,2,11,9,21,3,1
1697,Alexandre Mendy,Brest,10.0,5,1,1,0,4,1,4,25.0,3,4,1,3,0,5,10,0
1698,Benjamin Mendy,Manchester City,16.6,18,15,7,7,4,9,27,33.3,18,10,2,8,16,34,21,3
1699,Edouard Mendy,Rennes,24.0,0,0,0,0,0,0,0,0.0,0,0,0,0,0,0,5,1
1700,Ferland Mendy,Real Madrid,20.1,32,26,20,9,3,14,18,77.8,4,19,5,14,22,54,30,1
1701,Nampalys Mendy,Leicester City,3.2,7,5,4,1,2,4,5,80.0,1,4,1,3,6,13,6,0
1702,Hamza Mendyl,Dijon,16.0,49,32,31,14,4,29,46,63.0,17,16,4,12,23,72,47,0
1703,Chris Mepham,Bournemouth,10.1,20,9,13,7,0,11,14,78.6,3,17,11,6,17,37,62,1
1704,Levent Mercan,Schalke 04,0.8,0,0,0,0,0,0,0,0.0,0,0,0,0,0,0,2,1
1705,Jorge Mere,Köln,6.9,6,5,2,4,0,1,2,50.0,1,13,11,2,14,20,30,0
1706,Alex Meret,Napoli,21.7,0,0,0,0,0,0,2,0.0,2,1,0,1,1,1,7,2
1707,Fran Merida,Osasuna,12.9,27,15,11,10,6,9,27,33.3,18,15,4,11,25,52,10,0
1708,Mikel Merino,Real Sociedad,34.9,79,52,20,44,15,28,86,32.6,58,46,8,38,51,130,52,0
1709,Sabin Merino,Leganés,0.9,0,0,0,0,0,0,0,0.0,0,0,0,0,0,0,0,0
1710,Yildirim Mert Cetin,Roma,2.9,5,1,4,1,0,3,5,60.0,2,4,3,1,4,9,8,1
1711,Dries Mertens,Napoli,18.8,13,9,1,8,4,2,27,7.4,25,10,1,9,7,20,4,0
1712,Roque Mesa,Leganés,22.4,40,21,17,18,5,13,44,29.5,31,13,4,9,11,51,8,0
1713,Lionel Messi,Barcelona,32.0,21,10,4,7,10,3,21,14.3,18,9,0,9,7,28,1,0
1714,Thomas Meunier,Paris S-G,13.8,27,21,9,12,6,16,26,61.5,10,17,5,12,18,45,19,1
1716,Mexer,Bordeaux,16.5,16,11,14,1,1,10,30,33.3,20,14,13,1,15,31,47,0
1717,Max Meyer,Crystal Palace,7.3,19,11,10,9,0,8,18,44.4,10,6,1,5,7,26,4,0
1718,Kingsley Michael,Bologna,0.8,2,1,0,2,0,0,0,0.0,0,0,0,0,1,3,1,0
1719,Michel,Valladolid,24.2,50,28,26,19,5,22,75,29.3,53,22,4,18,33,83,41,1
1720,Sven Michel,Paderborn 07,15.3,14,12,3,5,6,3,20,15.0,17,13,2,11,7,21,7,0
1721,Miguel,Valladolid,2.6,2,1,1,0,1,1,2,50.0,1,3,1,2,0,2,1,0
1722,Florian Miguel,Nîmes,22.8,51,25,27,20,4,31,52,59.6,21,19,4,15,33,84,32,0
1723,Georges Mikautadze,Metz,0.1,1,0,0,0,1,0,0,0.0,0,0,0,0,0,1,0,0
1724,Nikola Milenkovic,Fiorentina,36.2,46,25,30,16,0,11,31,35.5,20,39,21,18,29,75,129,1
1725,Arkadiusz Milik,Napoli,19.4,12,5,4,1,7,3,11,27.3,8,11,1,10,2,14,12,0
1726,Sergej Milinkovic-Savic,Lazio,33.7,60,35,25,24,11,15,79,19.0,64,67,16,51,37,97,60,1
1727,Eder Militao,Real Madrid,11.4,25,15,15,9,1,10,17,58.8,7,12,6,6,20,45,42,0
1728,Luka Milivojevic,Crystal Palace,27.9,61,32,32,25,4,35,84,41.7,49,30,7,23,42,103,39,4
1729,Vincenzo Millico,Torino,2.4,1,0,1,0,0,1,3,33.3,2,2,0,2,0,1,1,0
1730,James Milner,Liverpool,10.4,16,10,3,10,3,6,26,23.1,20,12,3,9,7,23,17,1
1731,Santi Mina,Celta Vigo,21.6,13,8,8,5,0,5,38,13.2,33,19,2,17,10,23,27,0
1732,Yerry Mina,Everton,25.4,39,22,25,12,2,18,24,75.0,6,20,14,6,28,67,102,1
1733,Takumi Minamino,Liverpool,2.8,3,3,0,2,1,2,10,20.0,8,3,0,3,0,3,3,0
1734,Tyrone Mings,Aston Villa,32.2,15,11,11,3,1,10,13,76.9,3,56,48,8,30,45,190,4
1735,Jorge Miramon,Levante,27.0,52,27,35,13,4,26,45,57.8,19,30,8,22,46,98,61,1
1736,Juan Miranda,Schalke 04,8.7,14,10,8,6,0,6,18,33.3,12,12,4,8,10,24,27,1
1737,Antonio Mirante,Roma,5.0,0,0,0,0,0,0,1,0.0,1,0,0,0,0,0,2,1
1738,Simone Missiroli,SPAL,31.1,42,27,18,20,4,13,43,30.2,30,42,27,15,54,96,62,1
1739,Tyrick Mitchell,Crystal Palace,2.2,5,2,2,2,1,1,7,14.3,6,2,0,2,2,7,3,0
1740,Stefan Mitrovic,Strasbourg,22.8,15,9,10,5,0,6,14,42.9,8,14,9,5,23,38,90,3
1742,Maximilian Mittelstadt,Hertha BSC,21.0,61,38,31,25,5,26,54,48.1,28,38,6,32,53,114,64,0
1743,Henrikh Mkhitaryan,Arsenal,1.2,0,0,0,0,0,0,2,0.0,2,3,0,3,0,0,1,0
1744,Henrikh Mkhitaryan,Roma,17.0,32,22,10,17,5,19,45,42.2,26,27,3,24,11,43,6,0
1745,Anthony Modeste,Köln,12.6,10,5,1,5,4,1,10,10.0,9,5,3,2,0,10,19,0
1746,Luka Modric,Real Madrid,22.2,37,18,9,15,13,16,41,39.0,25,10,2,8,22,59,12,0
1747,Kevin Mohwald,Werder Bremen,0.8,2,1,1,1,0,1,2,50.0,1,0,0,0,0,2,1,0
1748,Niklas Moisander,Werder Bremen,22.0,27,15,19,6,2,11,26,42.3,15,37,19,18,49,76,85,0
1749,Jorge Molina,Getafe,21.0,8,2,0,4,4,0,12,0.0,12,13,2,11,4,12,18,0
1750,Florent Mollet,Montpellier,18.7,13,11,3,8,2,7,28,25.0,21,9,1,8,9,22,2,0
1751,Jon Moncayola,Osasuna,16.6,52,30,26,22,4,27,54,50.0,27,29,5,24,16,68,23,1
1752,Gabriele Moncini,SPAL,1.7,1,0,0,1,0,0,0,0.0,0,2,1,1,1,2,0,0
1753,Thomas Monconduit,Amiens,15.2,26,12,6,18,2,9,26,34.6,17,11,4,7,10,36,25,3
1754,Nacho Monreal,Arsenal,3.0,1,1,1,0,0,1,3,33.3,2,3,1,2,3,4,10,0
1755,Nacho Monreal,Real Sociedad,26.6,38,16,26,9,3,22,42,52.4,20,20,4,16,43,81,66,0
1756,Joan Monterde,Levante,0.1,0,0,0,0,0,0,0,0.0,0,0,0,0,0,0,0,0
1757,Ilario Monterisi,Lecce,0.0,0,0,0,0,0,0,0,0.0,0,0,0,0,0,0,0,0
1758,Angel Montoro,Granada,10.8,19,8,8,9,2,3,13,23.1,10,10,1,9,13,32,15,0
1759,Martin Montoya,Brighton,21.1,57,29,31,20,6,30,56,53.6,26,19,5,14,24,81,40,0
1760,Simon Moore,Sheffield Utd,2.0,1,0,1,0,0,1,1,100.0,0,0,0,0,0,1,0,1
1761,Aaron Mooy,Brighton,23.2,37,24,9,18,10,6,40,15.0,34,36,7,29,23,60,32,1
1762,Wesley Moraes,Aston Villa,19.8,15,8,3,8,4,0,5,0.0,5,10,2,8,4,19,23,0
1763,Alfredo Morales,Düsseldorf,19.2,31,15,11,16,4,11,35,31.4,24,17,6,11,18,49,37,0
1764,Alvaro Morata,Atlético Madrid,23.3,17,8,4,9,4,1,13,7.7,12,12,2,10,5,22,23,0
1765,Jan Moravek,Augsburg,5.3,23,12,9,14,0,11,24,45.8,13,4,1,3,8,31,11,0
1766,Steven Moreira,Toulouse,15.4,37,25,21,15,1,19,31,61.3,12,16,3,13,16,53,29,0
1768,Jeremy Morel,Rennes,20.1,15,9,13,1,1,9,20,45.0,11,21,17,4,17,32,59,1
1769,Alberto Moreno,Villarreal,16.3,27,16,15,11,1,9,25,36.0,16,15,3,12,25,52,36,0
1770,Alex Moreno,Betis,25.2,37,20,27,8,2,12,32,37.5,20,21,8,13,23,60,47,1
1771,Gerard Moreno,Villarreal,30.5,19,8,4,10,5,5,46,10.9,41,19,3,16,10,29,51,0
1772,Mateu Morey,Dortmund,2.2,0.0,4,0.0,0.0,0.0,0.0,0.0,0.0,0.0,0.0,0.0,0.0,4,0.0,0.0,0.0
1773,Wes Morgan,Leicester City,4.8,4,1,3,1,0,0,3,0.0,3,5,3,2,7,11,19,0
1774,Manu Morlanes,Villarreal,2.8,7,3,3,4,0,2,9,22.2,7,1,1,0,2,9,2,0
1775,Raul Moro,Lazio,0.0,0,0,0,0,0,0,0,0.0,0,0,0,0,0,0,0,0
1776,Loren Moron,Betis,22.6,18,12,6,7,5,9,23,39.1,14,25,6,19,9,27,13,0
1777,Leonardo Morosini,Brescia,0.3,1,1,1,0,0,0,0,0.0,0,1,0,1,1,2,1,0
1778,Ravel Morrison,Sheffield Utd,0.1,0,0,0,0,0,0,0,0.0,0,0,0,0,0,0,0,0
1779,Victor Moses,Inter,4.7,4,3,1,2,1,2,8,25.0,6,4,0,4,0,4,4,0
1780,Lebo Mothiba,Strasbourg,11.6,4,3,1,1,2,1,6,16.7,5,5,0,5,3,7,1,0
1781,Harold Moukoudi,Saint-Étienne,11.0,28,19,20,7,1,11,14,78.6,3,16,10,6,16,44,42,2
1782,Jessy Moulin,Saint-Étienne,5.0,0,0,0,0,0,0,0,0.0,0,0,0,0,1,1,2,0
1783,Mason Mount,Chelsea,31.9,37,17,8,19,10,9,42,21.4,33,25,3,22,16,53,18,0
1784,Lucas Moura,Tottenham,24.9,57,33,25,22,10,16,58,27.6,42,29,2,27,15,72,27,0
1785,Lys Mousset,Sheffield Utd,13.8,9,5,0,5,4,3,7,42.9,4,3,0,3,4,13,2,0
1786,Wesley Moustache,Nantes,0.5,0,0,0,0,0,0,0,0.0,0,1,0,1,0,0,2,0
1787,Joao Moutinho,Wolves,34.5,93,50,43,41,9,46,139,33.1,93,43,13,30,50,143,18,1
1788,Samuel Moutoussamy,Nantes,5.8,4,1,2,1,1,2,7,28.6,5,2,0,2,4,8,7,0
1789,Toni Moya,Atlético Madrid,0.0,0,0,0,0,0,0,0,0.0,0,0,0,0,0,0,0,0
1790,Javi Moyano,Valladolid,24.7,19,8,11,8,0,8,20,40.0,12,18,5,13,27,46,63,0
1791,Nordi Mukiele,RB Leipzig,19.8,61,39,39,12,10,25,38,65.8,13,26,4,22,47,108,57,0
1792,Mert Muldur,Sassuolo,14.1,47,27,33,8,6,27,42,64.3,15,10,0,10,22,69,42,0
1794,Florian Muller,Mainz 05,12.5,0,0,0,0,0,0,0,0.0,0,0,0,0,2,2,3,1
1795,Thomas Muller,Bayern Munich,25.1,45,27,7,26,12,22,69,31.9,47,27,3,24,12,57,8,0
1796,Marshall Munetsi,Reims,9.3,27,19,12,12,3,6,12,50.0,6,13,7,6,12,39,20,1
1797,Iker Muniain,Athletic Club,26.5,26,19,11,10,5,4,24,16.7,20,9,0,9,12,38,7,0
1798,Aihen Munoz,Real Sociedad,10.9,28,18,13,12,3,18,27,66.7,9,13,2,11,2,30,19,0
1799,Javier Munoz,Alavés,0.6,0,0,0,0,0,0,0,0.0,0,1,1,0,0,0,0,0
1800,Simone Muratore,Juventus,1.8,2,0,0,1,1,1,3,33.3,2,1,0,1,3,5,0,0
1801,Alessandro Murgia,SPAL,19.4,27,17,16,8,3,14,34,41.2,20,10,3,7,18,45,15,0
1802,Luis Muriel,Atalanta,14.0,15,9,3,8,4,3,14,21.4,11,12,0,12,4,19,0,0
1803,Jeison Murillo,Sampdoria,7.4,18,6,14,4,0,10,19,52.6,9,8,4,4,10,28,28,0
1804,Jeison Murillo,Celta Vigo,17.0,37,20,30,6,1,18,27,66.7,9,13,9,4,20,57,74,2
1805,Glenn Murray,Brighton,8.9,5,2,0,3,2,2,9,22.2,7,6,2,4,1,6,12,0
1806,Nicola Murru,Sampdoria,25.1,40,22,24,8,8,21,41,51.2,20,22,4,18,27,67,58,0
1807,Mateo Musacchio,Milan,16.3,15,8,11,4,0,7,20,35.0,13,10,7,3,22,37,50,0
1808,Torben Musel,M'Gladbach,0.0,0,0,0,0,0,0,0,0.0,0,0,0,0,1,1,0,0
1809,Jamal Musiala,Bayern Munich,0.0,0,0,0,0,0,0,0,0.0,0,0,0,0,0,0,0,0
1810,Juan Musso,Udinese,38.0,0,0,0,0,0,0,1,0.0,1,0,0,0,1,1,18,2
1811,Shkodran Mustafi,Arsenal,13.4,17,10,11,5,1,6,12,50.0,6,10,6,4,18,35,72,0
1812,Yoshinori Muto,Newcastle Utd,2.4,3,2,1,2,0,1,2,50.0,1,0,0,0,0,3,0,0
1813,Yvon Mvogo,RB Leipzig,2.0,0,0,0,0,0,0,0,0.0,0,0,0,0,0,0,0,1
1814,Phillipp Mwene,Mainz 05,3.5,11,5,9,2,0,7,12,58.3,5,10,1,9,3,14,11,0
1815,Obite N'Dicka,Eint Frankfurt,19.1,27,13,13,11,3,15,28,53.6,13,28,6,22,29,56,57,0
1816,Kevin N'Doram,Metz,18.3,43,28,19,21,3,17,40,42.5,23,20,8,12,26,69,23,0
1817,Abdallah N'dour,Strasbourg,4.1,5,4,2,3,0,5,10,50.0,5,4,1,3,4,9,5,1
1818,Ferris N'Goma,Brest,0.3,0,0,0,0,0,0,0,0.0,0,1,0,1,0,0,0,0
1820,Nathan N'Goumou,Toulouse,0.1,0,0,0,0,0,0,0,0.0,0,0,0,0,0,0,1,0
1821,Georges-Kevin N'Koudou,Tottenham,0.0,0,0,0,0,0,0,1,0.0,1,0,0,0,0,0,0,0
1822,Stanley N'Soki,Nice,14.1,40,29,24,16,0,23,42,54.8,19,14,6,8,32,72,37,0
1823,Nacho,Valladolid,21.0,43,22,24,15,4,17,48,35.4,31,36,8,28,25,68,61,0
1824,Nacho,Real Madrid,4.9,11,6,6,3,2,6,10,60.0,4,5,3,2,12,23,18,1
1825,Radja Nainggolan,Cagliari,23.0,30,18,9,12,9,9,29,31.0,20,25,6,19,13,43,30,0
1826,Marvelous Nakamba,Aston Villa,20.4,55,28,28,20,7,24,67,35.8,43,50,11,39,39,94,38,3
1827,Naldo,Espanyol,14.8,24,13,15,9,0,7,15,46.7,8,11,7,4,21,45,50,1
1828,Nahitan Nandez,Cagliari,32.2,58,38,37,17,4,25,69,36.2,44,30,1,29,25,83,26,0
1829,Matija Nastasic,Schalke 04,15.2,26,16,17,9,0,14,17,82.4,3,28,16,12,22,48,79,0
1830,Marc Navarro,Leganés,2.4,3,3,2,1,0,1,1,100.0,0,2,1,1,0,3,3,0
1831,Ximo Navarro,Alavés,21.1,34,19,17,15,2,16,28,57.1,12,20,7,13,52,86,76,2
1832,Jesus Navas,Sevilla,37.4,27,15,16,7,4,15,32,46.9,17,20,7,13,31,58,70,0
1833,Keylor Navas,Paris S-G,21.0,0,0,0,0,0,0,0,0.0,0,1,0,1,0,0,4,2
1834,Raul Navas,Osasuna,7.9,10,5,4,6,0,4,13,30.8,9,10,4,6,18,28,30,0
1835,Michel Ndary Adopo,Torino,0.0,0,0,0,0,0,0,0,0.0,0,1,1,0,0,0,0,0
1836,Papa Ndiaga Yade,Metz,0.0,0,0,0,0,0,0,0,0.0,0,0,0,0,0,0,0,0
1837,Wilfred Ndidi,Leicester City,29.7,128,67,56,61,11,45,91,49.5,46,52,6,46,80,208,69,3
1838,Emanuele Ndoj,Brescia,6.2,9,6,2,6,1,3,13,23.1,10,7,0,7,5,14,5,0
1839,Tanguy Ndombele,Tottenham,11.2,24,16,10,13,1,9,22,40.9,13,20,3,17,14,38,7,0
1840,Reiss Nelson,Arsenal,7.0,11,8,5,4,2,7,17,41.2,10,13,2,11,3,14,3,0
1841,Ilija Nestorovski,Udinese,13.9,10,7,5,5,0,6,21,28.6,15,13,2,11,4,14,12,0
1842,Neto,Barcelona,2.0,0,0,0,0,0,0,0,0.0,0,0,0,0,0,0,1,0
1843,Pedro Neto,Wolves,10.4,9,4,3,6,0,4,15,26.7,11,2,0,2,6,15,4,0
1844,Manuel Neuer,Bayern Munich,33.0,2,1,1,0,1,2,4,50.0,2,0,0,0,0,2,15,4
1846,Florian Neuhaus,M'Gladbach,26.2,42,23,13,22,7,12,54,22.2,42,24,4,20,27,69,8,0
1847,Carlos Neva,Granada,24.5,16,11,12,3,1,9,21,42.9,12,15,2,13,28,44,60,0
1848,Ruben Neves,Wolves,34.0,62,33,27,32,3,34,86,39.5,52,38,9,29,56,118,34,1
1849,Neymar,Paris S-G,14.6,12,7,1,9,2,3,21,14.3,18,10,0,10,4,16,1,0
1850,Jeremy Ngakia,West Ham,4.9,15,7,10,5,0,9,21,42.9,12,6,1,5,7,22,16,0
1851,Jessic Ngankam,Hertha BSC,0.9,2,2,1,1,0,2,2,100.0,0,2,0,2,0,2,1,0
1852,Muzinga Ngonda,Dijon,6.0,15,6,10,3,2,7,10,70.0,3,5,4,1,11,26,23,0
1853,Ahmad Ngouyamsa,Dijon,0.6,1,0,1,0,0,0,3,0.0,3,1,1,0,1,2,5,0
1854,Opa Nguette,Metz,20.3,44,28,23,15,6,11,39,28.2,28,17,3,14,12,56,12,0
1855,Moussa Niakhate,Mainz 05,33.0,35,22,29,6,0,16,29,55.2,13,40,26,14,40,75,124,4
1856,Ibrahima Niane,Metz,10.6,8,7,2,5,1,5,16,31.3,11,5,1,4,10,18,11,1
1857,M'Baye Niang,Rennes,23.6,17,10,3,11,3,6,21,28.6,15,10,1,9,5,22,20,0
1858,Tanguy Nianzou,Paris S-G,5.0,2,1,0,1,1,1,3,33.3,2,4,2,2,3,5,6,0
1859,Cheikh Niasse,Lille,0.2,0,0,0,0,0,0,0,0.0,0,0,0,0,0,0,0,0
1860,Oumar Niasse,Everton,0.2,4,0,0,2,2,0,0,0.0,0,0,0,0,1,5,0,0
1861,Moritz Nicolas,Union Berlin,1.0,0,0,0,0,0,0,0,0.0,0,0,0,0,0,0,0,0
1862,Florian Niederlechner,Augsburg,30.2,21,13,7,9,5,4,21,19.0,17,21,5,16,8,29,38,0
1863,Saul Niguez,Atlético Madrid,34.1,95,59,44,42,9,39,88,44.3,49,58,13,45,55,150,68,1
1864,Casimir Ninga,Angers,7.6,5,5,4,0,1,1,5,20.0,4,5,0,5,3,8,2,0
1865,Fernando Nino,Villarreal,0.9,1,0,0,1,0,1,2,50.0,1,0,0,0,0,1,2,0
1866,Timothee Nkada,Reims,1.6,1,0,1,0,0,0,1,0.0,1,0,0,0,0,1,1,0
1867,Eddie Nketiah,Arsenal,7.0,7,5,3,4,0,2,6,33.3,4,9,0,9,2,9,5,0
1868,Nicolas Nkoulou,Torino,29.9,34,24,21,11,2,16,22,72.7,6,40,18,22,70,104,138,2
1869,Christopher Nkunku,RB Leipzig,21.4,21,13,4,11,6,9,33,27.3,24,25,2,23,20,41,8,0
1870,Lukas Nmecha,Wolfsburg,1.5,0,0,0,0,0,0,0,0.0,0,0,0,0,0,0,0,0
1872,Mark Noble,West Ham,29.7,52,30,19,28,5,22,64,34.4,42,20,6,14,20,72,10,1
1873,Nolito,Sevilla,10.0,21,12,5,11,5,7,20,35.0,13,7,0,7,1,22,1,0
1874,Nolito,Celta Vigo,3.6,7,5,5,2,0,3,8,37.5,5,4,1,3,1,8,4,0
1875,Arnaud Nordin,Saint-Étienne,10.1,7,3,3,3,1,4,13,30.8,9,11,1,10,4,11,6,0
1876,Havard Nordtveit,Hoffenheim,7.8,4,1,3,1,0,3,7,42.9,4,17,12,5,13,17,45,0
1877,Oliver Norwood,Sheffield Utd,34.3,66,37,35,24,7,28,97,28.9,69,34,12,22,47,113,40,1
1878,Alexander Nubel,Schalke 04,25.7,0,0,0,0,0,0,0,0.0,0,0,0,0,2,2,9,6
1879,Kasim Nuhu,Düsseldorf,11.1,14,7,12,1,1,9,19,47.4,10,16,12,4,25,39,54,0
1880,Unai Nunez,Athletic Club,17.5,13,10,10,2,1,6,16,37.5,10,25,17,8,23,36,71,0
1881,Bram Nuytinck,Udinese,24.7,46,32,30,13,3,17,27,63.0,10,50,32,18,27,73,96,1
1882,Gerzino Nyamsi,Rennes,1.3,1,0,1,0,0,0,0,0.0,0,1,0,1,1,2,5,0
1883,Orjan Nyland,Aston Villa,6.0,0,0,0,0,0,0,0,0.0,0,0,0,0,0,0,1,1
1884,Allan Nyom,Getafe,26.9,45,25,26,15,4,20,37,54.1,17,24,5,19,14,59,50,1
1885,Steven Nzonzi,Rennes,4.3,5,4,3,1,1,1,2,50.0,1,2,2,0,4,9,18,0
1886,Jack O'Connell,Sheffield Utd,32.4,23,14,15,6,2,10,20,50.0,10,38,17,21,42,65,154,1
1887,Michael Obafemi,Southampton,7.4,7,3,1,3,3,2,14,14.3,12,3,0,3,6,13,0,0
1888,Pedro Obiang,Sassuolo,18.6,46,31,21,19,6,19,40,47.5,21,24,10,14,21,67,31,1
1889,Jan Oblak,Atlético Madrid,37.7,0,0,0,0,0,0,0,0.0,0,0,0,0,1,1,4,2
1890,Rafel Obrador,Mallorca,0.0,0,0,0,0,0,0,1,0.0,1,0,0,0,0,0,1,0
1891,Lucas Ocampos,Sevilla,30.5,54,31,30,19,5,30,72,41.7,42,33,2,31,22,76,27,0
1892,Bastian Oczipka,Schalke 04,33.5,72,50,42,21,9,36,62,58.1,26,35,6,29,37,109,68,0
1893,Alvaro Odriozola,Real Madrid,3.8,5,2,4,0,1,5,8,62.5,3,4,0,4,2,7,8,0
1894,Alvaro Odriozola,Bayern Munich,1.7,2,2,1,0,1,2,3,66.7,1,1,0,1,1,3,2,0
1895,Kelvin Ofori,Düsseldorf,0.4,0,0,0,0,0,0,0,0.0,0,0,0,0,0,0,0,0
1896,Angelo Ogbonna,West Ham,31.0,38,24,20,14,4,18,32,56.3,14,50,32,18,27,65,134,1
1898,Stefano Okaka,Udinese,26.8,19,11,6,8,5,7,27,25.9,20,23,2,21,8,27,28,0
1899,Kwasi Okyere Wriedt,Bayern Munich,0.2,0,0,0,0,0,0,0,0.0,0,0,0,0,0,0,0,0
1900,Lucas Olaza,Celta Vigo,34.9,56,39,36,17,3,39,59,66.1,20,37,10,27,31,87,60,1
1901,Oier Olazabal,Espanyol,2.0,0,0,0,0,0,0,0,0.0,0,1,0,1,0,0,0,0
1902,Christian Oliva,Cagliari,5.2,13,7,9,4,0,5,15,33.3,10,5,0,5,7,20,14,0
1903,Kiko Olivas,Valladolid,32.7,33,16,25,7,1,13,35,37.1,22,30,16,14,61,94,112,2
1904,Paulo Oliveira,Eibar,23.2,31,19,22,8,1,18,30,60.0,12,23,13,10,42,73,107,1
1905,Cauly Oliveira Souza,Paderborn 07,8.0,11,7,5,5,1,3,11,27.3,8,9,0,9,6,17,1,0
1906,Mathias Olivera,Getafe,20.8,64,40,34,16,14,27,45,60.0,18,32,3,29,23,87,44,0
1907,Maximiliano Olivera,Fiorentina,0.1,1,0,1,0,0,0,0,0.0,0,0,0,0,0,1,0,0
1908,Marco Olivieri,Juventus,0.3,1,1,1,0,0,1,2,50.0,1,0,0,0,0,1,0,0
1909,Dani Olmo,RB Leipzig,8.3,20,14,5,10,5,1,13,7.7,12,7,1,6,4,24,6,0
1910,Robin Olsen,Cagliari,16.9,0,0,0,0,0,0,1,0.0,1,0,0,0,0,0,8,0
1911,Kenneth Omeruo,Leganés,20.8,28,17,25,3,0,11,18,61.1,7,21,12,9,36,64,112,2
1912,Jean Onana,Lille,0.9,0,0,0,0,0,0,2,0.0,2,1,0,1,1,1,0,0
1913,Karim Onisiwo,Mainz 05,19.2,27,19,6,10,11,5,13,38.5,8,20,3,17,7,34,11,0
1914,Javier Ontiveros,Villarreal,9.9,29,14,13,14,2,8,35,22.9,27,13,1,12,5,34,7,0
1915,Henry Onyekuru,Monaco,1.8,1,1,1,0,0,0,0,0.0,0,1,0,1,1,2,0,0
1916,Nicholas Opoku,Udinese,5.3,13,8,8,3,2,6,11,54.5,5,6,4,2,4,17,19,0
1917,Nicholas Opoku,Amiens,7.0,7,5,6,1,0,7,14,50.0,7,6,2,4,7,14,32,0
1918,Willi Orban,RB Leipzig,9.5,20,12,13,7,0,12,20,60.0,8,14,3,11,16,36,52,1
1919,Fabian Orellana,Eibar,26.6,29,18,10,6,13,14,52,26.9,38,9,0,9,20,49,2,0
1920,Divock Origi,Liverpool,8.0,12,9,2,5,5,4,9,44.4,5,2,0,2,4,16,5,0
1921,Aimar Oroz,Osasuna,0.1,0,0,0,0,0,0,0,0.0,0,1,0,1,0,0,0,0
1922,Riccardo Orsolini,Bologna,29.8,36,22,21,10,5,12,47,25.5,35,23,1,22,16,52,20,0
1924,Yuya Osako,Werder Bremen,20.5,29,16,5,19,5,3,29,10.3,26,10,1,9,6,35,13,1
1925,Ben Osborn,Sheffield Utd,6.6,15,10,11,3,1,3,16,18.8,13,6,1,5,6,21,7,0
1926,Victor Osimhen,Lille,25.4,8,4,1,0,7,1,11,9.1,10,8,0,8,11,19,32,0
1927,David Ospina,Napoli,16.3,0,0,0,0,0,0,0,0.0,0,0,0,0,0,0,2,1
1928,Nicolas Otamendi,Manchester City,19.1,28,14,21,6,1,16,33,48.5,17,15,9,6,21,49,76,2
1929,Otavio,Bordeaux,24.6,80,45,23,52,5,35,82,42.7,47,26,9,17,41,121,40,6
1930,Paulo Otavio,Wolfsburg,4.2,21,16,11,9,1,10,13,76.9,3,12,2,10,9,30,11,0
1931,Abou Ouattara,Lille,0.1,0,0,0,0,0,0,0,0.0,0,0,0,0,0,0,1,0
1932,Remi Oudin,Bordeaux,6.2,9,6,4,4,1,4,14,28.6,10,7,1,6,9,18,5,0
1933,Remi Oudin,Reims,15.5,15,7,8,5,2,6,19,31.6,13,16,1,15,18,33,18,1
1934,Alexandre Oukidja,Metz,26.5,0,0,0,0,0,0,1,0.0,1,1,0,1,0,0,15,1
1935,Zinedine Ould Khaled,Angers,0.7,2,1,0,2,0,2,4,50.0,2,0,0,0,4,6,0,0
1936,Adam Ounas,Nice,12.5,10,5,2,6,2,5,13,38.5,8,9,1,8,11,21,8,1
1937,Reece Oxford,Augsburg,4.2,7,4,2,4,1,2,8,25.0,6,8,5,3,5,12,10,1
1938,Alex Oxlade-Chamberlain,Liverpool,16.5,18,9,4,6,8,5,21,23.8,16,26,1,25,22,40,10,0
1939,Mikel Oyarzabal,Real Sociedad,33.9,36,15,13,15,8,16,46,34.8,30,32,2,30,13,49,19,1
1940,Ambroise Oyongo,Montpellier,20.2,25,10,16,6,3,16,28,57.1,12,8,0,8,17,42,35,0
1941,Mesut Ozil,Arsenal,16.0,17,8,9,7,1,4,23,17.4,19,4,0,4,5,22,1,0
1942,Levin Oztunali,Mainz 05,19.8,28,19,13,12,3,12,35,34.3,23,27,1,26,9,37,14,2
1943,Pablo,Bordeaux,24.1,27,15,22,5,0,16,31,51.6,15,25,14,11,40,67,130,2
1944,Fernando Pacheco,Alavés,26.2,1,0,1,0,0,1,3,33.3,2,0,0,0,0,1,10,0
1945,Jon Pacheco,Real Sociedad,0.9,0,0,0,0,0,0,0,0.0,0,1,0,1,0,0,2,0
1946,Goncalo Paciencia,Eint Frankfurt,14.3,9,5,1,4,4,3,13,23.1,10,9,1,8,1,10,11,0
1947,Daniele Padelli,Inter,3.0,0,0,0,0,0,0,0,0.0,0,0,0,0,0,0,1,1
1948,Marko Pajac,Genoa,8.4,8,4,4,3,1,7,16,43.8,9,6,0,6,8,16,9,0
1950,Vincent Pajot,Angers,1.3,2,2,1,1,0,1,1,100.0,0,3,0,3,5,7,0,0
1951,Vincent Pajot,Metz,5.8,16,11,8,7,1,2,4,50.0,2,5,1,4,9,25,13,0
1952,Rodrigo Palacio,Bologna,28.0,19,11,0,9,10,4,27,14.8,23,17,3,14,5,24,38,2
1953,Exequiel Palacios,Leverkusen,2.0,8,7,4,4,0,2,5,40.0,3,2,0,2,1,9,0,0
1954,Sergi Palencia,Saint-Étienne,5.2,16,10,6,10,0,5,7,71.4,2,6,1,5,8,24,4,0
1955,Nicolas Pallois,Nantes,21.0,47,36,28,17,2,31,55,56.4,24,18,13,5,40,87,77,1
1956,Emerson Palmieri,Chelsea,11.4,23,12,8,11,4,10,15,66.7,5,13,1,12,18,41,19,0
1957,Alberto Paloschi,SPAL,4.9,3,0,3,0,0,2,8,25.0,6,3,0,3,0,3,2,0
1958,Alberto Paloschi,Cagliari,2.3,0,0,0,0,0,0,1,0.0,1,1,0,1,1,1,3,0
1959,Martin Palumbo,Udinese,0.0,0,0,0,0,0,0,0,0.0,0,0,0,0,0,0,0,0
1960,Goran Pandev,Genoa,18.7,12,8,2,7,3,3,25,12.0,22,4,1,3,0,12,5,1
1961,Jonathan Panzo,Monaco,1.2,2,2,2,0,0,1,1,100.0,0,3,1,2,3,5,7,0
1962,Sokratis Papastathopoulos,Arsenal,18.8,25,16,17,7,1,10,21,47.6,11,30,24,6,17,42,68,1
1963,Andrea Papetti,Brescia,10.2,9,7,8,1,0,4,14,28.6,10,15,11,4,15,24,39,0
1964,Lucas Paqueta,Milan,12.3,33,19,12,17,4,14,37,37.8,23,17,2,15,8,41,9,0
1965,Gaetan Paquiez,Nîmes,17.0,36,25,14,13,9,17,47,36.2,30,18,5,13,33,69,43,0
1966,Ruben Pardo,Bordeaux,2.1,3,2,2,1,0,2,3,66.7,1,0,0,0,1,4,2,1
1967,Leandro Paredes,Paris S-G,9.0,22,14,7,14,1,13,29,44.8,16,7,1,6,15,37,7,0
1968,Daniel Parejo,Valencia,33.6,67,41,29,32,6,32,101,31.7,69,38,11,27,22,89,20,2
1969,Michael Parensen,Union Berlin,7.0,11,6,5,6,0,5,10,50.0,5,14,8,6,12,23,17,0
1970,Miquel Parera,Mallorca,1.0,0,0,0,0,0,0,0,0.0,0,0,0,0,0,0,0,0
1971,Marco Parolo,Lazio,18.9,54,26,19,27,8,18,46,39.1,28,44,15,29,26,80,49,0
1972,Troy Parrott,Tottenham,0.1,0,0,0,0,0,0,0,0.0,0,0,0,0,0,0,0,0
1973,Thomas Partey,Atlético Madrid,28.3,70,41,34,30,6,26,58,44.8,32,32,8,24,48,118,41,7
1974,Mario Pasalic,Atalanta,26.9,47,21,17,18,12,16,52,30.8,36,27,7,20,27,74,22,2
1976,Javier Pastore,Roma,5.7,14,10,3,5,6,5,12,41.7,7,4,0,4,5,19,5,0
1977,Patric,Lazio,18.6,34,20,24,7,3,18,25,72.0,7,19,9,10,15,49,45,0
1978,Rui Patricio,Wolves,38.0,0,0,0,0,0,0,2,0.0,2,2,0,2,2,2,5,2
1979,Paulinho,Leverkusen,3.4,4,3,3,1,0,1,2,50.0,1,5,1,4,1,5,0,0
1980,Paulino,Alavés,0.8,0,0,0,0,0,0,1,0.0,1,1,0,1,1,1,0,0
1981,Gabriel Paulista,Valencia,31.1,22,14,17,2,3,15,25,60.0,10,36,29,7,48,70,151,3
1982,Benjamin Pavard,Bayern Munich,31.0,34,22,15,10,9,16,28,57.1,12,28,10,18,52,86,60,0
1983,Jiri Pavlenka,Werder Bremen,33.0,1,0,1,0,0,1,2,50.0,1,1,0,1,5,6,11,3
1984,Mateo Pavlovic,Angers,9.0,8,2,6,2,0,5,7,71.4,2,4,2,2,5,13,38,1
1985,Leonardo Pavoletti,Cagliari,0.5,0,0,0,0,0,0,0,0.0,0,0,0,0,1,1,3,0
1986,Dimitri Payet,Marseille,21.4,22,12,8,8,6,10,26,38.5,16,8,1,7,8,30,12,0
1987,Nehuen Paz,Bologna,1.3,1,1,0,1,0,0,2,0.0,2,3,3,0,5,6,12,0
1988,Nehuen Paz,Lecce,9.4,14,5,11,3,0,10,12,83.3,2,12,6,6,20,34,38,1
1989,Giampaolo Pazzini,Hellas Verona,3.4,1,0,0,1,0,0,4,0.0,4,2,0,2,1,2,4,0
1990,Mads Pedersen,Augsburg,1.1,4,2,3,0,1,2,6,33.3,4,3,1,2,2,6,0,0
1991,Alfonso Pedraza,Betis,15.0,30,19,16,11,3,19,33,57.6,14,18,6,12,16,46,26,1
1992,Marc Pedraza,Mallorca,1.4,1,1,1,0,0,1,5,20.0,4,0,0,0,4,5,1,0
1993,Pedro,Chelsea,7.3,15,7,5,9,1,3,15,20.0,12,9,0,9,9,24,1,0
1994,Pedro,Fiorentina,0.7,1,1,0,0,1,0,0,0.0,0,1,0,1,0,1,0,0
1995,Joao Pedro,Cagliari,35.0,17,11,5,7,5,4,24,16.7,20,35,8,27,9,26,39,0
1996,Adria Pedrosa,Espanyol,12.1,19,13,8,9,2,7,25,28.0,18,12,1,11,11,30,32,0
1997,Daouda Peeters,Juventus,0.2,1,0,0,1,0,1,1,100.0,0,0,0,0,0,1,0,0
1998,Jordan Pefok,Rennes,4.9,7,6,1,4,2,0,2,0.0,2,3,0,3,1,8,2,0
1999,Gianluca Pegolo,Sassuolo,5.0,0,0,0,0,0,0,0,0.0,0,0,0,0,0,0,4,0
2000,Peter Pekarik,Hertha BSC,8.5,14,7,7,3,4,8,20,40.0,12,11,4,7,7,21,31,0
2002,Yohann Pele,Marseille,1.7,0,0,0,0,0,0,0,0.0,0,0,0,0,0,0,0,0
2003,Lorenzo Pellegrini,Roma,23.3,30,13,9,13,8,12,33,36.4,21,28,0,28,15,45,18,0
2004,Luca Pellegrini,Cagliari,21.2,31,15,20,7,4,15,38,39.5,23,19,2,17,21,52,45,2
2005,Theo Pellenard,Angers,5.1,11,8,6,3,2,6,13,46.2,7,4,0,4,5,16,8,0
2006,Andy Pelmard,Nice,8.5,22,14,13,9,0,9,11,81.8,2,12,4,8,15,37,28,1
2007,Federico Peluso,Sassuolo,16.8,19,16,8,8,3,8,9,88.9,1,14,9,5,22,41,58,1
2008,Ruben Pena,Villarreal,21.2,42,24,23,19,0,17,50,34.0,33,25,8,17,35,77,58,2
2009,Philipp Pentke,Hoffenheim,4.0,0,0,0,0,0,0,0,0.0,0,0,0,0,0,0,2,0
2010,Nicolas Pepe,Arsenal,22.3,32,17,15,13,4,8,16,50.0,8,15,2,13,8,40,5,0
2011,Luis Perea,Osasuna,0.2,0,0,0,0,0,0,0,0.0,0,0,0,0,0,0,1,0
2012,Andreas Pereira,Manchester Utd,16.5,24,13,8,9,7,10,39,25.6,29,13,0,13,7,31,7,0
2013,Mathias Pereira Lage,Angers,17.1,30,18,16,13,1,12,37,32.4,25,19,0,19,17,47,9,0
2014,Ricardo Pereira,Leicester City,28.0,119,68,65,36,18,53,106,50.0,53,38,6,32,49,168,86,0
2015,Gaston Pereiro,Cagliari,3.9,2,2,2,0,0,1,4,25.0,3,1,0,1,0,2,1,1
2016,Bruno Peres,Roma,11.7,14,10,10,3,1,8,21,38.1,13,12,3,9,15,29,19,2
2017,Roberto Pereyra,Watford,18.3,20,8,11,7,2,9,28,32.1,19,21,0,21,14,34,12,1
2018,Ayoze Perez,Leicester City,22.3,45,28,14,26,5,8,54,14.8,46,33,1,32,14,59,9,1
2019,Carles Perez,Roma,6.3,12,8,4,6,2,3,10,30.0,7,6,1,5,3,15,1,0
2020,Carles Perez,Barcelona,5.3,7,4,2,2,3,3,15,20.0,12,5,2,3,1,8,1,0
2021,Inigo Perez,Osasuna,12.0,15,11,3,7,5,8,22,36.4,14,7,1,6,12,27,6,0
2022,Juan Perez,Osasuna,2.0,1,1,1,0,0,1,2,50.0,1,0,0,0,0,1,0,0
2023,Kike Perez,Valladolid,2.4,6,1,1,3,2,3,7,42.9,4,1,0,1,10,16,4,0
2024,Lucas Perez,Alavés,27.7,12,6,2,8,2,3,13,23.1,10,13,2,11,2,14,0,0
2025,Ruben Perez,Leganés,24.4,50,27,21,23,6,16,47,34.0,31,21,4,17,38,88,33,0
2026,Samu Perez,Valladolid,0.3,0,0,0,0,0,0,0,0.0,0,0,0,0,0,0,0,0
2028,Mattia Perin,Genoa,21.0,1,1,1,0,0,1,1,100.0,0,1,0,1,0,1,5,1
2029,Ivan Perisic,Bayern Munich,13.4,16,12,5,6,5,8,33,24.2,25,14,3,11,4,20,8,0
2030,Diego Perotti,Roma,9.7,16,13,5,8,3,5,20,25.0,15,14,0,14,3,19,6,0
2031,Romain Perraud,Brest,18.6,29,14,18,9,2,14,28,50.0,14,24,9,15,27,56,50,0
2032,Loic Perrin,Saint-Étienne,19.0,27,20,16,11,0,11,14,78.6,3,23,17,6,39,66,59,0
2033,Lucas Perrin,Marseille,4.0,5,2,3,2,0,2,7,28.6,5,3,2,1,10,15,17,0
2034,Pavao Pervan,Wolfsburg,8.0,0,0,0,0,0,0,1,0.0,1,0,0,0,0,0,4,0
2035,Matteo Pessina,Hellas Verona,27.7,35,21,9,20,6,12,33,36.4,21,28,8,20,25,60,40,2
2036,Andrea Petagna,SPAL,33.7,9,4,2,7,0,3,17,17.6,14,11,5,6,1,10,27,0
2037,Nils Petersen,Freiburg,27.1,19,14,7,9,3,10,28,35.7,18,32,6,26,10,29,67,0
2038,Danijel Petkovic,Angers,2.0,0,0,0,0,0,0,0,0.0,0,0,0,0,0,0,2,0
2039,Denis Petric,Nantes,1.0,1,1,1,0,0,1,1,100.0,0,0,0,0,0,1,0,0
2040,Jacopo Petriccione,Lecce,23.8,38,20,29,9,0,15,57,26.3,42,20,7,13,28,66,25,2
2041,German Pezzella,Fiorentina,31.4,36,18,26,9,1,14,32,43.8,18,31,20,11,55,91,134,1
2042,Giuseppe Pezzella,Udinese,0.9,0,0,0,0,0,0,0,0.0,0,0,0,0,1,1,4,0
2043,Giuseppe Pezzella,Parma,10.5,20,12,17,3,0,11,19,57.9,8,13,9,4,6,26,30,0
2044,Rayan Philippe,Dijon,0.3,0,0,0,0,0,0,1,0.0,1,0,0,0,1,1,1,1
2045,Romain Philippoteaux,Nîmes,22.2,23,12,11,11,1,9,43,20.9,34,22,1,21,13,36,10,0
2046,Krzysztof Piatek,Milan,13.1,9,4,0,7,2,3,11,27.3,8,5,2,3,3,12,10,0
2047,Krzysztof Piatek,Hertha BSC,10.1,5,4,1,1,3,0,11,0.0,11,7,0,7,5,10,3,0
2048,Pablo Piatti,Espanyol,0.6,2,2,1,1,0,1,2,50.0,1,1,0,1,0,2,1,0
2049,Cristiano Piccini,Valencia,0.8,5,4,1,0,4,4,4,100.0,0,0,0,0,2,7,1,0
2050,Stefano Piccinini,Sassuolo,0.1,0,0,0,0,0,0,0,0.0,0,0,0,0,0,0,0,0
2051,Roberto Piccoli,Atalanta,0.2,0,0,0,0,0,0,0,0.0,0,1,0,1,0,0,0,0
2052,Jordan Pickford,Everton,38.0,0,0,0,0,0,0,4,0.0,4,0,0,0,3,3,12,6
2054,Jeremy Pied,Lille,5.0,18,10,6,11,1,11,16,68.8,5,8,0,8,7,25,10,0
2055,Ronael Pierre-Gabriel,Mainz 05,6.4,16,10,9,6,1,7,13,53.8,6,7,0,7,8,24,31,1
2056,Brandon Pierrick,Crystal Palace,0.2,0,0,0,0,0,0,0,0.0,0,0,0,0,0,0,1,0
2057,Erik Pieters,Burnley,20.9,54,32,18,29,7,28,69,40.6,41,30,4,26,28,82,60,1
2058,Tomas Pina Isla,Alavés,14.9,37,22,13,21,3,12,24,50.0,12,15,5,10,16,53,31,0
2059,Andrea Pinamonti,Genoa,24.8,19,12,1,7,11,5,25,20.0,20,19,2,17,9,28,25,0
2060,Simone Pinna,Cagliari,1.0,1,1,0,1,0,0,0,0.0,0,3,1,2,5,6,4,1
2061,Carlo Pinsoglio,Juventus,0.2,0,0,0,0,0,0,0,0.0,0,0,0,0,0,0,0,0
2062,Pipa,Espanyol,5.3,9,8,5,4,0,4,6,66.7,2,8,0,8,6,15,17,0
2063,Gerard Pique,Barcelona,34.4,32,23,20,11,1,16,26,61.5,10,39,24,15,36,68,157,0
2064,Lorenzo Pirola,Inter,0.1,0,0,0,0,0,0,0,0.0,0,0,0,0,1,1,0,0
2065,Fabio Pisacane,Cagliari,27.1,32,21,22,10,0,21,37,56.8,16,36,28,8,27,59,110,2
2066,Lukasz Piszczek,Dortmund,23.4,45,32,27,16,2,28,50,56.0,22,27,11,16,26,71,47,1
2067,Claudio Pizarro,Werder Bremen,2.6,2,1,0,1,1,0,1,0.0,1,2,0,2,2,4,2,0
2068,Miralem Pjanic,Juventus,25.3,46,21,16,23,7,21,63,33.3,42,29,12,17,32,78,30,0
2069,Oscar Plano,Valladolid,27.8,48,30,25,19,4,20,61,32.8,41,36,3,33,35,83,29,0
2070,Marvin Plattenhardt,Hertha BSC,15.5,18,12,13,4,1,12,17,70.6,5,18,7,11,11,29,47,0
2071,Alassane Plea,M'Gladbach,23.8,16,7,5,6,5,8,28,28.6,20,21,2,19,9,25,7,0
2072,Thomas Pledl,Düsseldorf,1.0,4,2,2,2,0,0,1,0.0,1,0,0,0,0,4,1,0
2073,Daniel Podence,Wolves,3.2,3,3,2,0,1,0,2,0.0,2,4,1,3,2,5,1,0
2074,Paul Pogba,Manchester Utd,13.4,20,9,8,8,4,8,16,50.0,8,12,4,8,7,27,10,2
2075,Joel Pohjanpalo,Leverkusen,0.0,0,0,0,0,0,0,0,0.0,0,0,0,0,0,0,0,0
2076,Andrea Poli,Bologna,21.3,44,24,19,21,4,16,52,30.8,36,19,3,16,40,84,11,0
2077,Matteo Politano,Napoli,8.3,12,6,8,2,2,5,14,35.7,9,6,0,6,5,17,3,0
2078,Matteo Politano,Inter,2.9,0,0,0,0,0,0,2,0.0,2,1,0,1,0,0,1,0
2080,Sebastian Polter,Union Berlin,3.7,2,2,0,1,1,1,3,33.3,2,2,0,2,1,3,1,0
2081,Marin Pongracic,Wolfsburg,10.3,14,9,11,2,1,9,10,90.0,1,11,7,4,19,33,21,1
2082,Pere Pons,Alavés,12.1,28,16,14,12,2,12,26,46.2,14,16,3,13,12,40,8,1
2083,Nick Pope,Burnley,38.0,1,1,1,0,0,1,2,50.0,1,0,0,0,3,4,15,3
2084,Pedro Porro,Valladolid,8.2,18,10,11,7,0,10,18,55.6,8,3,0,3,7,25,19,1
2085,Francisco Portillo,Getafe,4.2,11,6,3,6,2,4,12,33.3,8,2,0,2,2,13,3,0
2086,Portu,Real Sociedad,26.6,32,21,10,15,7,13,33,39.4,20,28,3,25,13,45,5,0
2087,Stefan Posch,Hoffenheim,25.6,63,34,35,27,1,35,63,55.6,28,57,25,32,40,103,101,1
2088,Sergio Postigo,Levante,26.4,32,15,23,7,2,11,18,61.1,7,24,15,9,34,66,132,1
2089,Florent Poulolo,Getafe,0.0,0,0,0,0,0,0,0,0.0,0,0,0,0,0,0,1,0
2090,Yussuf Poulsen,RB Leipzig,13.6,14,10,2,10,2,4,21,19.0,17,12,0,12,4,18,15,0
2091,Maxime Poundje,Bordeaux,0.0,0,0,0,0,0,0,0,0.0,0,0,0,0,0,0,0,0
2092,Dario Poveda,Atlético Madrid,0.1,1,0,0,1,0,0,0,0.0,0,0,0,0,0,1,0,0
2093,Alejandro Pozo Pozo,Mallorca,16.6,38,24,30,6,2,19,38,50.0,19,23,2,21,23,61,29,1
2094,Alejandro Pozo Pozo,Sevilla,0.4,1,1,1,0,0,1,1,100.0,0,0,0,0,0,1,1,0
2095,Percy Prado,Nantes,2.1,6,5,3,2,1,5,9,55.6,4,1,0,1,1,7,5,0
2096,Dennis Praet,Leicester City,12.6,33,18,8,21,4,9,29,31.0,20,19,1,18,17,50,12,0
2097,Abdon Prats,Mallorca,3.1,1,1,0,0,1,0,1,0.0,1,1,0,1,0,1,1,0
2098,Sanjin Prcic,Strasbourg,0.9,1,0,0,0,1,1,2,50.0,1,1,1,0,1,2,0,0
2099,Nicolas de Preville,Bordeaux,22.2,35,21,9,22,4,18,56,32.1,38,15,3,12,6,41,19,0
2100,Sebastian Prodl,Watford,0.6,0,0,0,0,0,0,0,0.0,0,0,0,0,0,0,4,0
2101,Kai Proger,Paderborn 07,23.1,43,22,21,17,5,17,58,29.3,41,34,6,28,14,57,20,1
2102,Grischa Promel,Union Berlin,10.3,14,11,6,6,2,7,19,36.8,12,10,2,8,14,28,9,0
2103,Davy Propper,Brighton,31.4,64,35,28,28,8,23,74,31.1,51,27,8,19,38,102,36,4
2104,Antonio Puertas,Granada,28.5,37,24,8,18,11,16,53,30.2,37,21,3,18,12,49,21,0
2106,Riqui Puig,Barcelona,5.7,11,7,1,9,1,5,17,29.4,12,2,0,2,5,16,1,0
2107,Teemu Pukki,Norwich City,32.1,12,6,3,5,4,1,23,4.3,22,13,0,13,6,18,7,0
2108,Erick Pulgar,Fiorentina,32.8,73,46,25,41,7,22,96,22.9,74,45,15,30,49,122,53,1
2109,Christian Pulisic,Chelsea,19.1,23,11,13,4,6,7,24,29.2,17,15,0,15,6,29,11,0
2110,Ignacio Pussetto,Watford,0.8,7,4,4,2,1,3,8,37.5,5,2,1,1,3,10,4,0
2111,Ignacio Pussetto,Udinese,3.8,8,4,4,3,1,1,4,25.0,3,3,0,3,4,12,7,0
2112,Fabio Quagliarella,Sampdoria,25.3,9,5,0,6,3,2,30,6.7,28,13,0,13,8,17,15,0
2113,Robin Quaison,Mainz 05,28.9,25,17,15,7,3,11,32,34.4,21,27,5,22,11,36,8,0
2114,Domingos Quina,Watford,0.2,2,0,1,1,0,1,2,50.0,1,3,0,3,0,2,0,0
2115,Quini,Granada,8.0,25,14,16,7,2,13,22,59.1,9,5,1,4,10,35,14,0
2116,Xavi Quintilla,Villarreal,17.5,22,12,14,4,4,10,20,50.0,10,11,4,7,12,34,35,0
2117,Quique,Eibar,5.4,2,1,1,0,1,0,0,0.0,0,3,0,3,0,2,3,0
2118,Adrien Rabiot,Juventus,21.2,47,31,16,19,12,15,41,36.6,26,36,6,30,32,79,19,0
2119,Nemanja Radoja,Levante,22.1,43,19,27,16,0,15,46,32.6,31,21,4,17,23,66,24,0
2120,Nemanja Radonjic,Marseille,9.8,10,3,4,3,3,6,17,35.3,11,7,0,7,2,12,7,0
2121,Ivan Radovanovic,Genoa,14.6,27,14,18,9,0,10,26,38.5,16,17,3,14,8,35,39,0
2122,Ionut Radu,Genoa,17.0,0,0,0,0,0,0,2,0.0,2,0,0,0,1,1,7,1
2123,Stefan Radu,Lazio,25.6,43,25,24,15,4,28,43,65.1,15,19,9,10,34,77,85,0
2124,Boris Radunovic,Hellas Verona,3.0,0,0,0,0,0,0,0,0.0,0,0,0,0,0,0,1,0
2125,Rafael,Cagliari,5.0,0,0,0,0,0,0,0,0.0,0,0,0,0,0,0,3,0
2126,Rafael,Lyon,7.8,24,16,12,8,4,10,18,55.6,8,6,3,3,10,34,14,0
2127,Raffael,M'Gladbach,0.7,0,0,0,0,0,0,2,0.0,2,2,0,2,0,0,0,0
2128,Rafinha,Barcelona,2.1,3,2,1,1,1,1,2,50.0,1,0,0,0,1,4,0,0
2129,Rafinha,Celta Vigo,23.5,71,37,29,37,5,20,62,32.3,42,37,4,33,33,104,25,0
2130,Daniele Ragatzu,Cagliari,3.5,3,2,0,2,1,1,3,33.3,2,1,0,1,1,4,5,0
2132,Baba Rahman,Mallorca,1.2,3,2,2,0,1,0,0,0.0,0,2,1,1,1,4,2,0
2133,Antonio Raillo,Mallorca,30.8,31,21,24,7,0,13,19,68.4,6,31,26,5,22,53,112,1
2134,Predrag Rajkovic,Reims,27.0,1,1,1,0,0,1,1,100.0,0,0,0,0,1,2,9,0
2135,Ivan Rakitic,Barcelona,17.7,27,14,8,15,4,10,28,35.7,18,19,6,13,15,42,18,1
2136,Benito Raman,Schalke 04,17.8,18,9,4,9,5,7,24,29.2,17,11,1,10,7,25,1,0
2137,Gaston Ramirez,Sampdoria,15.5,32,21,7,16,9,8,30,26.7,22,28,2,26,11,43,10,0
2138,Sandro Ramirez,Valladolid,14.5,12,10,2,6,4,2,20,10.0,18,11,1,10,7,19,2,0
2139,Ivan Ramis,Eibar,5.1,3,2,2,1,0,1,4,25.0,3,2,0,2,4,7,23,2
2140,Adrian Ramos,Granada,2.5,6,2,0,2,4,2,3,66.7,1,2,0,2,1,7,1,0
2141,Sergio Ramos,Real Madrid,33.5,46,31,26,17,3,20,42,47.6,22,22,9,13,49,95,102,4
2142,Aaron Ramsdale,Bournemouth,37.0,4,3,4,0,0,3,3,100.0,0,0,0,0,0,4,25,1
2143,Aaron Ramsey,Juventus,11.7,20,15,6,8,6,6,24,25.0,18,18,3,15,11,31,12,0
2144,Darren Randolph,West Ham,2.0,0,0,0,0,0,0,0,0.0,0,0,0,0,0,0,2,0
2145,Luca Ranieri,Fiorentina,2.6,2,2,2,0,0,2,3,66.7,1,1,0,1,2,4,7,0
2146,Andrea Ranocchia,Inter,5.8,17,10,10,7,0,5,8,62.5,3,11,6,5,8,25,18,0
2147,Raphinha,Rennes,18.8,22,18,5,12,5,10,32,31.3,22,23,1,22,17,39,14,1
2148,Tobias Raschl,Dortmund,0.3,0,0,0,0,0,0,1,0.0,1,1,0,1,0,0,0,0
2149,Marcus Rashford,Manchester Utd,29.4,13,9,1,6,6,9,23,39.1,14,23,0,23,10,23,19,0
2150,Milot Rashica,Werder Bremen,25.2,21,14,13,6,2,9,33,27.3,24,15,2,13,6,27,16,1
2151,Giacomo Raspadori,Sassuolo,2.9,8,6,5,2,1,3,4,75.0,1,5,0,5,1,9,0,0
2152,Raul,Betis,0.2,0,0,0,0,0,0,2,0.0,2,0,0,0,0,0,0,0
2153,Ante Rebic,Milan,15.5,16,11,4,9,3,7,34,20.6,27,14,1,13,3,19,12,0
2154,Ante Rebic,Eint Frankfurt,1.0,1,0,0,1,0,0,0,0.0,0,0,0,0,0,1,1,0
2155,Arkadiusz Reca,SPAL,21.4,38,23,22,10,6,13,39,33.3,26,15,2,13,32,70,48,1
2156,Recio,Leganés,17.4,30,19,13,12,5,10,40,25.0,30,14,3,11,22,52,9,0
2158,Daishawn Redan,Hertha BSC,0.2,0,0,0,0,0,0,1,0.0,1,0,0,0,0,0,0,0
2159,Nathan Redmond,Southampton,30.7,49,29,17,23,9,21,57,36.8,36,39,2,37,16,65,16,0
2160,Fabian Reese,Schalke 04,1.0,1,1,1,0,0,0,0,0.0,0,1,1,0,0,1,1,0
2161,Vasco Regini,Sampdoria,1.9,4,2,3,1,0,0,0,0.0,0,4,2,2,1,5,6,0
2162,Vasco Regini,Parma,0.6,0,0,0,0,0,0,0,0.0,0,0,0,0,0,0,3,0
2163,Sergio Reguilon,Sevilla,27.9,57,30,28,25,4,27,64,42.2,37,25,5,20,33,90,53,0
2164,Ken Reichel,Union Berlin,5.9,6,3,2,3,1,3,13,23.1,10,8,1,7,9,15,12,0
2165,Manolo Reina,Mallorca,36.0,0,0,0,0,0,0,1,0.0,1,2,0,2,5,5,9,1
2166,Pepe Reina,Aston Villa,12.0,0,0,0,0,0,0,2,0.0,2,0,0,0,0,0,9,1
2167,Pepe Reina,Milan,1.0,0,0,0,0,0,0,0,0.0,0,0,0,0,0,0,0,1
2168,Jeff Reine-Adelaide,Angers,0.9,3,1,1,2,0,1,1,100.0,0,1,0,1,0,3,1,0
2169,Jeff Reine-Adelaide,Lyon,8.7,10,8,3,3,4,5,13,38.5,8,3,1,2,7,17,4,0
2170,Karim Rekik,Hertha BSC,14.0,16,10,10,6,0,3,6,50.0,3,23,15,8,18,34,44,0
2171,Alex Remiro,Real Sociedad,25.0,0,0,0,0,0,0,1,0.0,1,0,0,0,0,0,25,1
2172,Loic Remy,Lille,10.7,4,1,0,3,1,0,4,0.0,4,1,1,0,0,4,7,0
2173,Panagiotis Retsos,Leverkusen,1.3,6,3,4,2,0,1,4,25.0,3,2,0,2,2,8,2,0
2174,Marco Reus,Dortmund,16.6,26,16,5,11,10,3,19,15.8,16,17,2,15,9,35,11,0
2175,Elvis Rexhbecaj,Köln,6.9,16,12,9,5,2,5,13,38.5,8,7,0,7,3,19,4,0
2176,Gio Reyna,Dortmund,3.9,6,2,1,5,0,1,4,25.0,3,3,0,3,0,6,2,0
2177,Baptiste Reynet,Toulouse,22.6,1,1,1,0,0,1,3,33.3,2,0,0,0,0,1,12,0
2178,Nico Ribaudo,Espanyol,2.0,3,1,1,0,2,2,6,33.3,4,1,0,1,1,4,0,0
2179,Lucas Ribeiro,Hoffenheim,0.7,1,0,1,0,0,0,3,0.0,3,1,0,1,1,2,1,0
2180,Franck Ribery,Fiorentina,15.7,20,14,7,10,3,4,20,20.0,16,9,0,9,3,23,3,0
2181,Davide Riccardi,Lecce,0.2,0,0,0,0,0,0,1,0.0,1,0,0,0,0,0,1,0
2182,Declan Rice,West Ham,38.0,116,60,64,48,4,47,98,48.0,51,41,9,32,77,193,55,0
2184,Chris Richards,Bayern Munich,0.1,0,0,0,0,0,0,0,0.0,0,0,0,0,0,0,1,0
2185,Richarlison,Everton,34.1,70,47,28,28,14,27,56,48.2,29,34,4,30,12,82,42,0
2186,Marco Richter,Augsburg,25.3,21,16,7,9,5,14,51,27.5,37,15,0,15,24,45,17,0
2187,Diego Rico,Bournemouth,25.9,61,39,32,24,5,29,59,49.2,30,31,7,24,84,145,91,0
2188,Sergio Rico,Paris S-G,2.0,0,0,0,0,0,0,0,0.0,0,0,0,0,0,0,1,2
2189,Jairo Riedewald,Crystal Palace,8.5,14,10,4,10,0,7,11,63.6,4,7,2,5,17,31,23,1
2190,Emiliano Rigoni,Sampdoria,4.8,5,4,2,1,2,3,10,30.0,7,5,1,4,3,8,1,0
2191,Tomas Rincon,Torino,30.0,56,25,23,25,8,23,65,35.4,42,20,3,17,36,92,62,0
2192,Luis Rioja,Alavés,18.2,18,12,11,6,1,8,25,32.0,17,21,0,21,16,34,6,0
2193,Renaud Ripart,Nîmes,22.5,39,23,17,20,2,18,46,39.1,28,17,2,15,12,51,37,0
2194,Rodrigo Riquelme,Atlético Madrid,0.1,0,0,0,0,0,0,0,0.0,0,0,0,0,0,0,0,0
2195,Andrea Rispoli,Lecce,21.2,24,18,14,9,1,15,30,50.0,15,28,7,21,32,56,62,1
2196,Marcel Risse,Köln,1.5,3,2,3,0,0,1,1,100.0,0,1,0,1,1,4,1,0
2197,Mihailo Ristic,Montpellier,9.0,18,14,7,11,0,9,20,45.0,11,7,2,5,7,25,18,0
2198,Matt Ritchie,Newcastle Utd,14.6,22,15,9,10,3,3,15,20.0,12,20,5,15,14,36,31,1
2199,Marlon Ritter,Paderborn 07,4.8,7,5,5,2,0,4,9,44.4,5,7,0,7,8,15,3,0
2200,Cristian Rivera,Leganés,3.5,6,4,3,2,1,2,4,50.0,2,4,3,1,4,10,7,0
2201,Maxence Rivera,Saint-Étienne,0.3,0,0,0,0,0,0,1,0.0,1,1,0,1,0,0,0,0
2202,Rober,Levante,2.1,3,1,2,0,1,2,2,100.0,0,0,0,0,3,6,2,0
2203,Roberto,West Ham,7.6,0,0,0,0,0,0,0,0.0,0,0,0,0,0,0,2,2
2204,Roberto,Alavés,8.8,1,1,1,0,0,1,1,100.0,0,0,0,0,0,1,2,0
2205,Sergi Roberto,Barcelona,26.0,35,22,16,11,8,15,25,60.0,10,12,3,9,33,68,36,0
2206,Patrick Roberts,Norwich City,0.3,0,0,0,0,0,0,0,0.0,0,0,0,0,0,0,0,0
2207,Andrew Robertson,Liverpool,34.6,54,31,17,25,12,27,61,44.3,34,29,7,22,38,92,72,1
2208,Callum Robinson,Sheffield Utd,7.5,6,3,2,2,2,2,7,28.6,5,3,0,3,7,13,3,0
2210,Jack Robinson,Sheffield Utd,5.6,10,5,5,5,0,1,6,16.7,5,12,5,7,8,18,24,0
2211,Joel Robles,Betis,32.1,0,0,0,0,0,0,2,0.0,2,0,0,0,0,0,13,2
2212,Marc Roca,Espanyol,33.4,82,52,29,44,9,29,82,35.4,53,28,10,18,31,113,53,2
2213,Ruben Rochina,Levante,20.8,41,26,22,9,10,19,52,36.5,33,16,0,16,12,53,19,1
2214,Sebastian Rode,Eint Frankfurt,21.5,58,33,27,27,4,17,59,28.8,42,32,5,27,34,92,13,0
2215,Rodri,Manchester City,27.6,50,30,17,25,8,23,63,36.5,40,19,5,14,26,76,35,0
2216,Rodrigo,Valencia,20.9,10,6,4,5,1,2,23,8.7,21,9,1,8,9,19,13,0
2217,Kevin Rodrigues,Leganés,21.5,56,31,31,17,8,25,46,54.3,21,30,3,27,31,87,26,1
2218,Kevin Rodrigues,Real Sociedad,0.1,1,0,1,0,0,1,1,100.0,0,0,0,0,0,1,0,0
2219,Angel Rodriguez,Getafe,15.6,14,8,2,8,4,2,18,11.1,16,10,1,9,3,17,10,0
2220,Oscar Rodriguez Arnaiz,Leganés,21.3,23,10,11,7,5,13,41,31.7,28,19,0,19,14,37,13,0
2221,Dani Rodriguez,Mallorca,33.8,59,32,24,28,7,18,61,29.5,43,35,3,32,38,97,27,1
2222,Guido Rodriguez,Betis,10.4,24,16,11,11,2,15,25,60.0,10,13,4,9,10,34,21,0
2223,James Rodriguez,Real Madrid,4.7,17,13,6,8,3,6,12,50.0,6,3,0,3,3,20,1,0
2224,Jay Rodriguez,Burnley,22.4,29,19,4,13,12,8,33,24.2,25,33,6,27,5,34,12,0
2225,Mario Rodriguez,Granada,0.0,0,0,0,0,0,0,0,0.0,0,0,0,0,0,0,0,0
2226,Ricardo Rodriguez,Milan,4.3,6,1,2,2,2,2,6,33.3,4,3,2,1,5,11,17,0
2227,Rodrygo,Real Madrid,11.3,6,1,2,3,1,2,21,9.5,19,13,0,13,10,16,5,0
2228,Jack Rodwell,Sheffield Utd,0.2,0,0,0,0,0,0,0,0.0,0,0,0,0,0,0,1,0
2229,Marko Rog,Cagliari,25.7,69,47,31,29,9,22,84,26.2,62,40,12,28,22,91,23,0
2230,Agustin Rogel,Toulouse,9.5,15,8,12,3,0,7,13,53.8,6,13,10,3,11,26,35,2
2231,Rogerio,Sassuolo,11.3,22,14,12,8,2,16,23,69.6,7,13,3,10,9,31,34,0
2232,Marcos Rojo,Manchester Utd,1.4,3,1,2,1,0,1,2,50.0,1,2,1,1,0,3,6,0
2233,Filippo Romagna,Sassuolo,16.4,7,6,2,5,0,5,6,83.3,1,24,17,7,10,17,69,0
2234,Alessio Romagnoli,Milan,34.3,46,25,28,15,3,16,27,59.3,11,32,18,14,56,102,157,1
2236,Alaixys Romao,Reims,19.8,46,29,31,14,1,17,57,29.8,40,12,3,9,26,72,38,3
2237,Cristian Romero,Genoa,28.6,52,35,36,12,4,12,41,29.3,29,59,33,26,75,127,116,2
2238,Luka Romero,Mallorca,0.1,0,0,0,0,0,0,0,0.0,0,0,0,0,0,0,0,0
2239,Oriol Romeu,Southampton,20.7,55,35,23,30,2,27,75,36.0,48,35,13,22,34,89,32,0
2240,Romulo,Brescia,19.1,30,19,12,14,4,12,34,35.3,22,18,1,17,8,38,12,1
2241,Romulo,Genoa,0.2,2,1,1,1,0,0,0,0.0,0,0,0,0,0,2,1,0
2242,Cristiano Ronaldo,Juventus,32.4,14,10,3,3,8,4,20,20.0,16,10,3,7,6,20,21,1
2243,Facundo Roncaglia,Osasuna,14.2,24,20,12,10,2,11,20,55.0,9,18,3,15,22,46,46,0
2244,Valentin Rongier,Marseille,19.9,76,51,25,41,10,22,63,34.9,41,30,4,26,36,112,16,2
2245,Valentin Rongier,Nantes,3.0,5,4,0,2,3,3,5,60.0,2,4,0,4,2,7,0,0
2246,Marten de Roon,Atalanta,30.2,77,43,36,29,12,34,75,45.3,41,32,8,24,46,123,45,0
2247,Roberto Rosales,Leganés,20.8,42,23,23,17,2,19,43,44.2,24,17,4,13,30,72,48,0
2248,Antonio Rosati,Torino,1.0,0,0,0,0,0,0,0,0.0,0,0,0,0,0,0,0,1
2249,Danny Rose,Tottenham,9.9,18,11,6,10,2,9,20,45.0,11,14,6,8,8,26,34,2
2250,Danny Rose,Newcastle Utd,9.6,21,12,11,8,2,12,21,57.1,9,11,4,7,10,31,14,1
2251,Luca Rossettini,Lecce,25.1,25,14,18,7,0,17,34,50.0,17,31,22,9,35,60,126,1
2252,Francesco Rossi,Atalanta,0.1,0,0,0,0,0,0,0,0.0,0,0,0,0,0,0,0,0
2253,Jerome Roussillon,Wolfsburg,26.3,48,29,26,18,4,15,29,51.7,14,33,5,28,30,78,58,0
2254,Nolan Roux,Nîmes,6.5,5,2,1,3,1,1,3,33.3,2,2,0,2,4,9,5,0
2255,Nicolo Rovella,Genoa,1.2,0,0,0,0,0,0,1,0.0,1,0,0,0,4,4,0,0
2256,Amir Rrahmani,Hellas Verona,35.9,50,31,26,19,5,26,46,56.5,20,50,31,19,30,80,151,1
2257,Ruben,Osasuna,17.6,1,1,1,0,0,1,1,100.0,0,0,0,0,0,1,9,1
2258,Waldo Rubio,Valladolid,9.8,13,8,10,3,0,5,31,16.1,26,12,0,12,7,20,7,0
2259,Antonio Rudiger,Chelsea,19.0,28,18,19,7,2,16,25,64.0,9,15,9,6,16,44,59,1
2260,Sebastian Rudy,Hoffenheim,30.4,73,49,31,29,13,28,75,37.3,47,26,5,21,27,100,38,0
2262,Stephane Ruffier,Saint-Étienne,22.0,0,0,0,0,0,0,0,0.0,0,0,0,0,0,0,5,3
2263,Dion Ruffo Luci,Bologna,0.0,0,0,0,0,0,0,0,0.0,0,0,0,0,0,0,0,0
2264,Daniele Rugani,Juventus,7.7,8,6,4,4,0,4,5,80.0,1,4,4,0,11,19,18,0
2265,Mario Rui,Napoli,21.8,31,17,12,12,7,11,29,37.9,18,24,5,19,21,52,43,0
2266,Aitor Ruibal,Leganés,13.6,27,17,14,11,2,16,39,41.0,23,18,1,17,8,35,11,0
2267,Fabian Ruiz Pena,Napoli,29.8,43,26,19,18,6,24,65,36.9,41,32,4,28,32,75,18,2
2268,Geronimo Rulli,Montpellier,25.0,3,1,3,0,0,3,4,75.0,1,1,0,1,2,5,9,1
2269,Lukas Rupp,Norwich City,7.7,15,9,7,5,3,5,17,29.4,12,11,0,11,15,30,4,0
2270,Lukas Rupp,Hoffenheim,3.8,9,4,3,5,1,3,6,50.0,3,5,0,5,5,14,3,0
2271,Mathew Ryan,Brighton,38.0,1,1,1,0,0,1,4,25.0,3,0,0,0,2,3,13,2
2272,Julian Ryerson,Union Berlin,4.1,7,5,2,1,4,3,6,50.0,3,5,3,2,5,12,9,0
2273,Frederik Ronnow,Eint Frankfurt,9.0,0,0,0,0,0,0,1,0.0,1,0,0,0,0,0,1,0
2274,Joao Victor Santos Sa,Wolfsburg,18.1,35,22,12,17,6,10,38,26.3,28,31,1,30,9,44,9,0
2275,Roli Pereira de Sa,Nantes,0.1,0,0,0,0,0,0,0,0.0,0,0,0,0,0,0,0,0
2276,Youssouf Sabaly,Bordeaux,10.1,18,11,9,4,5,6,22,27.3,16,8,1,7,18,36,23,0
2277,Stefano Sabelli,Brescia,35.2,83,44,51,28,4,50,106,47.2,56,40,13,27,58,141,107,0
2278,Abdelhamid Sabiri,Paderborn 07,11.6,20,16,6,11,3,9,27,33.3,18,9,2,7,8,28,18,1
2279,Marcel Sabitzer,RB Leipzig,27.8,39,25,15,18,6,19,56,33.9,37,27,4,23,23,62,25,0
2280,Ihsan Sacko,Nice,1.6,1,1,1,0,0,0,1,0.0,1,0,0,0,0,1,0,0
2281,Alexis Saelemaekers,Milan,7.6,14,8,5,7,2,6,20,30.0,14,13,1,12,8,22,1,0
2282,Jorge Saenz,Celta Vigo,4.1,6,1,4,2,0,3,5,60.0,2,5,2,3,10,16,15,0
2283,Nuri Sahin,Werder Bremen,13.9,27,16,10,14,3,11,35,31.4,24,15,7,8,37,64,38,0
2284,Wesley Said,Toulouse,12.9,20,9,8,10,2,2,13,15.4,11,6,0,6,9,29,8,0
2285,Allan Saint-Maximin,Newcastle Utd,20.7,13,8,7,4,2,4,18,22.2,14,5,2,3,9,22,6,0
2286,Theo Sainte-Luce,Nîmes,0.2,0,0,0,0,0,0,0,0.0,0,0,0,0,0,0,0,0
2288,Borja Sainz,Alavés,6.4,16,9,4,9,3,8,26,30.8,18,14,0,14,3,19,0,0
2289,Romain Saiss,Wolves,30.1,55,38,37,15,3,32,46,69.6,14,31,16,15,55,110,127,3
2290,Bukayo Saka,Arsenal,19.5,36,21,21,8,7,19,37,51.4,18,12,3,9,12,48,19,0
2291,Hiroki Sakai,Marseille,18.0,57,36,26,24,7,25,40,62.5,15,20,5,15,23,80,34,1
2292,Mamadou Sakho,Crystal Palace,10.3,7,5,5,1,1,2,5,40.0,3,12,5,7,20,27,46,2
2293,Jacopo Sala,SPAL,9.5,29,24,17,11,1,17,31,54.8,14,4,0,4,13,42,15,1
2294,Mohamed Salah,Liverpool,32.0,16,6,1,4,11,5,22,22.7,17,3,1,2,8,24,2,1
2295,Bartosz Salamon,SPAL,3.8,2,1,2,0,0,1,2,50.0,1,4,4,0,6,8,14,0
2296,Eddie Salcedo,Hellas Verona,7.6,3,1,2,0,1,0,5,0.0,5,4,0,4,1,4,2,0
2297,William Saliba,Saint-Étienne,11.0,19,9,15,3,1,5,10,50.0,5,13,4,9,21,40,36,1
2298,Yannis Salibur,Mallorca,0.9,0,0,0,0,0,0,4,0.0,4,0,0,0,1,1,1,0
2299,Romain Salin,Rennes,4.0,0,0,0,0,0,0,1,0.0,1,0,0,0,0,0,3,0
2300,Mohammed Salisu,Valladolid,30.3,41,24,28,13,0,21,34,61.8,13,32,26,6,35,76,158,3
2301,Roland Sallai,Freiburg,12.9,17,10,4,9,4,7,20,35.0,13,12,2,10,7,24,4,0
2302,Lazar Samardzic,Hertha BSC,0.4,4,4,2,2,0,1,4,25.0,3,2,1,1,0,4,0,0
2303,Diadie Samassekou,Hoffenheim,14.6,37,18,14,17,6,12,34,35.3,22,25,8,17,40,77,27,1
2304,Mbwana Samatta,Aston Villa,10.5,6,4,0,3,3,1,8,12.5,7,7,0,7,1,7,6,0
2305,Mama Samba Balde,Dijon,18.6,24,13,9,8,7,7,30,23.3,23,17,0,17,7,31,24,0
2306,Junior Sambia,Montpellier,6.5,8,6,4,2,2,3,13,23.1,10,4,0,4,8,16,6,0
2307,Frederic Sammaritano,Dijon,5.8,9,7,4,4,1,4,11,36.4,7,6,1,5,2,11,3,1
2308,Fede San Emeterio,Valladolid,19.5,26,13,18,6,2,7,29,24.1,22,20,8,12,28,54,13,1
2309,Mikel San Jose,Athletic Club,4.0,9,4,2,4,3,2,10,20.0,8,3,1,2,9,18,12,0
2310,Antonio Sanabria,Genoa,15.4,14,11,2,7,5,3,14,21.4,11,13,1,12,5,19,12,1
2311,Oihan Sancet,Athletic Club,8.2,11,7,5,4,2,4,11,36.4,7,6,0,6,2,13,2,0
2312,Renato Sanches,Lille,16.5,28,15,9,15,4,8,33,24.2,25,19,1,18,15,43,10,1
2314,Renato Sanches,Bayern Munich,0.1,0,0,0,0,0,0,0,0.0,0,0,0,0,0,0,0,0
2315,Alexis Sanchez,Inter,10.3,9,7,1,4,4,5,13,38.5,8,7,0,7,3,12,1,0
2316,Carlos Sanchez,West Ham,1.3,1,0,0,1,0,1,1,100.0,0,1,0,1,2,3,1,0
2317,Davinson Sanchez,Tottenham,27.0,44,27,32,12,0,22,44,50.0,22,40,28,12,34,78,128,5
2318,German Sanchez,Granada,25.5,16,10,12,4,0,6,16,37.5,10,29,23,6,33,49,115,2
2319,Javi Sanchez,Valladolid,5.5,5,4,3,2,0,1,3,33.3,2,4,2,2,4,9,24,0
2320,Manu Sanchez,Atlético Madrid,3.6,13,7,2,7,4,8,15,53.3,7,3,0,3,7,20,1,0
2321,Victor Sanchez,Espanyol,18.8,66,36,36,23,7,30,71,42.3,41,31,8,23,27,93,23,1
2322,Jadon Sancho,Dortmund,25.4,14,11,6,6,2,8,24,33.3,16,8,0,8,14,28,6,0
2323,Alex Sandro,Juventus,26.5,44,26,23,14,7,12,33,36.4,21,26,6,20,47,91,46,3
2324,Leroy Sane,Manchester City,0.1,0,0,0,0,0,0,0,0.0,0,0,0,0,0,0,0,0
2325,Salif Sane,Schalke 04,12.5,16,9,12,4,0,11,19,57.9,8,19,7,12,21,37,50,0
2326,Luca Sangalli,Real Sociedad,4.1,1,0,0,1,0,1,8,12.5,7,3,0,3,1,2,0,0
2327,Ibrahim Sangare,Toulouse,24.2,84,54,37,42,5,33,74,44.6,41,28,10,18,39,123,49,4
2328,Oier Sanjurjo,Osasuna,25.8,65,34,21,34,10,28,64,43.8,36,33,8,25,35,100,39,1
2329,Yaya Sanogo,Toulouse,10.1,6,3,2,3,1,1,2,50.0,1,4,1,3,7,13,14,0
2330,Morgan Sanson,Marseille,24.1,60,28,20,29,11,13,52,25.0,39,39,5,34,23,83,9,0
2331,Nicola Sansone,Bologna,25.2,34,20,12,18,4,15,59,25.4,44,21,0,21,11,45,9,0
2332,Baptiste Santamaria,Angers,27.8,91,53,39,43,9,35,79,44.3,44,27,5,22,43,134,36,0
2333,Federico Santander,Bologna,8.6,13,8,3,0,10,1,4,25.0,3,3,0,3,7,20,12,0
2334,Davide Santon,Roma,6.9,11,6,6,5,0,6,17,35.3,11,2,1,1,11,22,13,0
2335,Samir Santos,Udinese,17.2,35,27,24,8,3,12,23,52.2,11,16,6,10,33,68,64,1
2336,Riccardo Saponara,Genoa,1.9,4,3,2,2,0,0,2,0.0,2,2,1,1,0,4,2,0
2337,Riccardo Saponara,Lecce,10.5,12,8,4,8,0,6,13,46.2,7,2,0,2,5,17,7,0
2338,Ivan Saponjic,Atlético Madrid,0.1,0,0,0,0,0,0,0,0.0,0,0,0,0,0,0,0,0
2340,Pablo Sarabia,Paris S-G,12.9,12,7,3,6,3,4,25,16.0,21,19,1,18,10,22,5,0
2341,Marcelo Saracchi,RB Leipzig,2.0,8,6,2,5,1,5,6,83.3,1,3,1,2,1,9,5,0
2342,Josh Sargent,Werder Bremen,15.7,11,6,5,4,2,2,12,16.7,10,17,1,16,14,25,21,0
2343,Bouna Sarr,Marseille,24.0,60,37,30,19,11,30,53,56.6,23,17,1,16,32,92,38,0
2344,Ismaila Sarr,Watford,22.5,11,10,5,2,4,5,23,21.7,18,9,1,8,18,29,10,0
2345,Malang Sarr,Nice,16.2,19,11,13,6,0,9,22,40.9,13,10,4,6,38,57,31,4
2346,Sidy Sarr,Nîmes,12.9,35,18,15,16,4,11,34,32.4,23,13,3,10,15,50,18,0
2347,Joan Sastre Vanrell,Mallorca,15.1,30,17,26,3,1,17,39,43.6,22,8,2,6,23,53,27,1
2348,Teji Savanier,Montpellier,16.9,52,39,16,30,6,25,77,32.5,52,10,0,10,35,87,21,1
2349,Stefan Savic,Atlético Madrid,22.0,22,17,11,10,1,11,18,61.1,7,16,9,7,24,46,91,1
2350,Fabian Schar,Newcastle Utd,18.6,39,21,25,14,0,19,40,47.5,21,35,18,17,47,86,74,2
2351,Louis Schaub,Köln,6.9,15,12,2,9,4,5,14,35.7,9,10,1,9,3,18,2,0
2352,Ezequiel Schelotto,Brighton,4.0,4,3,1,2,1,2,8,25.0,6,3,0,3,7,11,14,0
2353,Patrik Schick,RB Leipzig,14.4,7,3,1,3,3,2,9,22.2,7,8,2,6,2,9,17,0
2354,Julian Schieber,Augsburg,0.5,1,1,0,1,0,0,0,0.0,0,0,0,0,0,1,0,0
2355,Kingsley Schindler,Köln,9.4,8,5,3,5,0,4,12,33.3,8,6,1,5,6,14,17,0
2356,Xaver Schlager,Wolfsburg,19.1,47,29,13,30,4,14,44,31.8,30,16,2,14,17,64,12,0
2357,Keven Schlotterbeck,Union Berlin,21.5,52,27,36,15,1,17,29,58.6,12,40,21,19,40,92,113,1
2358,Nico Schlotterbeck,Freiburg,4.1,6,3,4,2,0,2,5,40.0,3,7,5,2,3,9,20,1
2359,Jeffrey Schlupp,Crystal Palace,11.5,18,9,10,7,1,6,16,37.5,10,11,3,8,13,31,15,0
2360,Kasper Schmeichel,Leicester City,38.0,1,1,1,0,0,1,2,50.0,1,0,0,0,1,2,4,2
2361,Marcel Schmelzer,Dortmund,0.7,2,1,1,1,0,1,1,100.0,0,0,0,0,1,3,2,0
2362,Jonathan Schmid,Freiburg,31.5,42,27,19,19,4,19,37,51.4,18,23,8,15,35,77,84,0
2363,Manuel Schmiedebach,Union Berlin,2.0,4,1,0,3,1,1,7,14.3,6,1,1,0,3,7,3,0
2364,Benno Schmitz,Köln,12.9,28,17,13,11,4,16,36,44.4,20,11,1,10,16,44,27,0
2366,Morgan Schneiderlin,Everton,11.1,31,22,13,16,2,8,24,33.3,16,13,3,10,21,52,20,1
2367,Lasse Schone,Genoa,27.0,42,26,16,22,4,15,48,31.3,33,22,6,16,37,79,25,2
2368,Sebastian Schonlau,Paderborn 07,23.0,64,43,50,14,0,41,66,62.1,25,36,15,21,40,104,138,1
2369,Alessandro Schopf,Schalke 04,15.9,29,16,11,10,8,12,33,36.4,21,17,1,16,26,55,8,0
2370,Jerdy Schouten,Bologna,12.0,26,16,13,11,2,10,26,38.5,16,19,7,12,26,52,22,0
2371,Markus Schubert,Schalke 04,8.2,0,0,0,0,0,0,1,0.0,1,0,0,0,0,0,9,4
2372,Nico Schulz,Dortmund,6.6,11,7,3,6,2,8,13,61.5,5,14,4,10,9,20,9,0
2373,Alexander Schwolow,Freiburg,23.2,0,0,0,0,0,0,0,0.0,0,2,0,2,1,1,8,3
2374,Matteo Scozzarella,Parma,10.2,23,15,8,13,2,14,29,48.3,15,19,14,5,27,50,28,0
2375,Aleksandar Sedlar,Mallorca,9.0,13,6,10,2,1,7,11,63.6,4,17,11,6,16,29,31,0
2376,Davie Selke,Hertha BSC,10.7,6,3,2,2,2,4,7,57.1,3,7,1,6,1,7,11,0
2377,Davie Selke,Werder Bremen,5.1,2,0,1,1,0,0,2,0.0,2,1,0,1,0,2,2,0
2378,Matz Sels,Strasbourg,27.0,0,0,0,0,0,0,1,0.0,1,0,0,0,1,1,6,0
2379,Ken Sema,Udinese,27.3,59,41,43,15,1,36,68,52.9,32,26,6,20,17,76,41,1
2380,Nelson Semedo,Barcelona,23.3,51,30,27,18,6,21,36,58.3,15,18,3,15,22,73,30,0
2381,Alessandro Semprini,Brescia,7.0,10,4,7,3,0,7,9,77.8,2,10,3,7,9,19,16,0
2382,Josep Sene,Mallorca,1.7,2,1,2,0,0,2,5,40.0,3,2,1,1,0,2,2,0
2383,Stefano Sensi,Inter,8.0,18,10,10,7,1,6,22,27.3,16,15,1,14,9,27,4,0
2384,Luigi Sepe,Parma,34.0,1,0,1,0,0,1,2,50.0,1,0,0,0,0,1,6,2
2385,Suat Serdar,Schalke 04,17.8,56,37,16,33,7,18,61,29.5,43,39,7,32,24,80,7,0
2386,Ryan Sessegnon,Tottenham,3.8,6,4,2,4,0,3,6,50.0,3,0,0,0,3,9,12,0
2387,Salva Sevilla,Mallorca,28.5,27,21,11,16,0,9,30,30.0,21,17,5,12,29,56,17,1
2388,Yevhen Shakhov,Lecce,12.1,28,16,12,13,3,8,27,29.6,19,11,3,8,14,42,9,1
2389,Xherdan Shaqiri,Liverpool,2.1,1,0,0,1,0,0,1,0.0,1,0,0,0,0,1,0,0
2390,Billy Sharp,Sheffield Utd,11.7,6,5,2,1,3,1,6,16.7,5,2,0,2,1,7,2,0
2392,Luke Shaw,Manchester Utd,19.3,34,18,19,11,4,19,33,57.6,14,26,6,20,24,58,56,1
2393,Khiry Shelton,Paderborn 07,0.4,1,1,1,0,0,0,0,0.0,0,0,0,0,0,1,0,0
2394,Jonjo Shelvey,Newcastle Utd,23.5,29,19,17,12,0,11,42,26.2,31,14,5,9,23,52,38,0
2395,Gen Shoji,Toulouse,0.5,2,2,2,0,0,1,1,100.0,0,0,0,0,0,2,2,0
2396,Djibril Sidibe,Everton,20.3,83,44,48,25,10,43,72,59.7,29,19,3,16,40,123,41,0
2397,Kalidou Sidibe,Toulouse,1.0,3,3,0,3,0,2,5,40.0,3,0,0,0,1,4,0,0
2398,Sidnei,Betis,13.1,23,19,17,6,0,9,14,64.3,5,15,12,3,21,44,57,0
2399,Kaj Sierhuis,Reims,0.1,0,0,0,0,0,0,0,0.0,0,0,0,0,0,0,0,0
2400,Gylfi Sigurdsson,Everton,28.4,50,26,15,24,11,19,70,27.1,51,30,4,26,37,87,17,1
2401,Luca Siligardi,Parma,3.7,6,2,3,2,1,4,8,50.0,4,3,0,3,3,9,5,0
2402,Adrien Silva,Monaco,13.6,37,22,14,19,4,10,37,27.0,27,19,6,13,12,49,14,2
2403,Andre Silva,Milan,0.7,2,1,0,0,2,0,1,0.0,1,0,0,0,0,2,0,0
2404,Andre Silva,Eint Frankfurt,17.5,7,2,0,5,2,2,14,14.3,12,9,0,9,8,15,4,0
2405,Bernardo Silva,Manchester City,22.6,36,18,8,21,7,13,44,29.5,31,25,1,24,24,60,13,0
2406,David Silva,Manchester City,20.3,26,14,3,15,8,10,28,35.7,18,18,3,15,13,39,5,0
2407,Gabriel Silva,Saint-Étienne,2.6,4,1,1,2,1,2,3,66.7,1,2,0,2,4,8,8,0
2408,Jonathan Silva,Leganés,30.9,60,34,32,22,6,27,52,51.9,25,12,4,8,34,94,46,0
2409,Matheus Pereira da Silva,Dijon,5.2,10,6,1,6,3,4,10,40.0,6,11,0,11,6,16,5,0
2410,Rui Silva,Granada,35.0,2,1,2,0,0,2,2,100.0,0,0,0,0,2,4,22,3
2411,Thiago Silva,Paris S-G,17.5,28,16,15,13,0,13,16,81.3,3,18,15,3,26,54,54,0
2412,Marco Silvestri,Hellas Verona,35.0,1,0,1,0,0,1,2,50.0,1,0,0,0,4,5,11,1
2413,Mohamed Simakan,Strasbourg,16.7,54,32,35,16,3,22,34,64.7,12,14,3,11,31,85,25,0
2414,Giovanni Simeone,Cagliari,32.5,24,13,9,10,5,5,32,15.6,27,24,7,17,11,35,16,1
2415,Moses Simon,Nantes,24.2,15,7,5,4,6,6,21,28.6,15,6,0,6,8,23,6,0
2416,Unai Simon,Athletic Club,33.2,0,0,0,0,0,0,1,0.0,1,1,0,1,1,1,10,1
2418,Jack Simpson,Bournemouth,2.7,5,2,4,1,0,2,8,25.0,6,1,0,1,2,7,12,1
2419,Sarpreet Singh,Bayern Munich,0.8,1,0,0,1,0,0,1,0.0,1,0,0,0,0,1,0,0
2420,Wilfried Singo,Torino,1.5,1,0,0,1,0,0,0,0.0,0,0,0,0,1,2,2,0
2421,Daley Sinkgraven,Leverkusen,10.1,20,16,11,6,3,8,24,33.3,16,12,3,9,10,30,16,0
2422,Dimitris Siovas,Leganés,21.3,42,31,24,15,3,19,28,67.9,9,14,1,13,46,88,69,0
2423,Salvatore Sirigu,Torino,36.0,0,0,0,0,0,0,0,0.0,0,0,0,0,2,2,12,0
2424,Ibrahima Sissoko,Strasbourg,17.8,46,27,21,21,4,16,48,33.3,32,14,5,9,20,66,25,0
2425,Moussa Sissoko,Tottenham,27.2,39,25,25,12,2,20,48,41.7,28,19,4,15,27,66,43,2
2426,Sambou Sissoko,Reims,0.4,0,0,0,0,0,0,0,0.0,0,0,0,0,1,1,2,0
2427,Pione Sisto,Celta Vigo,9.9,17,8,5,6,6,4,19,21.1,15,18,0,18,6,23,4,1
2428,Antonio Sivera,Alavés,3.0,0,0,0,0,0,0,0,0.0,0,0,0,0,0,0,2,0
2429,Ellyes Skhiri,Köln,29.7,74,52,30,37,7,29,77,37.7,48,47,9,38,67,141,33,0
2430,Oliver Skipp,Tottenham,0.9,2,2,0,2,0,1,4,25.0,3,3,2,1,0,2,0,0
2431,Lukasz Skorupski,Bologna,37.0,1,0,1,0,0,0,1,0.0,1,0,0,0,2,3,15,5
2432,Andreas Skov Olsen,Bologna,8.4,11,8,5,5,1,4,12,33.3,8,10,1,9,8,19,5,0
2433,Robert Skov,Hoffenheim,29.0,41,28,30,9,2,26,50,52.0,24,26,6,20,20,61,40,0
2434,Simon Skrabb,Brescia,2.9,7,6,2,4,1,6,12,50.0,6,4,1,3,0,7,3,0
2435,Milan Skriniar,Inter,29.2,39,20,24,14,1,14,33,42.4,19,19,11,8,28,67,85,1
2436,Steven Skrzybski,Düsseldorf,5.9,4,4,2,1,1,0,16,0.0,16,10,0,10,10,14,4,0
2437,Petar Skuletic,Montpellier,1.2,6,4,2,2,2,2,4,50.0,2,0,0,0,0,6,1,0
2438,Islam Slimani,Monaco,14.3,8,4,0,2,6,4,15,26.7,11,5,0,5,1,9,11,1
2439,William Smallbone,Southampton,4.4,10,5,2,8,0,5,10,50.0,5,7,1,6,1,11,2,0
2440,Chris Smalling,Roma,28.5,25,16,15,9,1,10,13,76.9,3,44,35,9,56,81,126,2
2441,Dennis Smarsch,Hertha BSC,1.7,0,0,0,0,0,0,0,0.0,0,0,0,0,0,0,1,0
2442,Adam Smith,Bournemouth,22.8,47,32,29,16,2,23,50,46.0,27,27,6,21,25,72,64,1
2444,Emile Smith Rowe,Arsenal,1.1,1,1,1,0,0,1,3,33.3,2,0,0,0,1,2,2,0
2445,Fyodor Smolov,Celta Vigo,8.3,2,1,0,2,0,1,9,11.1,8,6,0,6,7,9,9,0
2446,Robert Snodgrass,West Ham,16.8,29,16,17,10,2,13,44,29.5,31,12,1,11,4,33,11,0
2447,Cedric Soares,Arsenal,2.8,8,6,2,6,0,1,3,33.3,2,3,0,3,3,11,4,0
2448,Cedric Soares,Southampton,14.5,45,26,19,24,2,25,41,61.0,16,18,4,14,19,64,51,0
2449,Rafa Soares,Eibar,4.8,6,5,5,0,1,5,11,45.5,6,1,0,1,2,8,6,0
2450,Lasse Sobiech,Köln,1.0,1,0,0,0,1,0,0,0.0,0,0,0,0,4,5,6,0
2451,Marcel Sobottka,Düsseldorf,7.8,15,10,6,8,1,4,13,30.8,9,9,1,8,9,24,12,0
2452,Ruben Sobrino,Valencia,1.9,7,5,3,2,2,2,3,66.7,1,1,0,1,0,7,1,0
2453,Dominic Solanke,Bournemouth,18.3,8,4,2,5,1,5,33,15.2,28,9,1,8,8,16,18,1
2454,Roberto Soldado,Granada,26.1,16,9,2,7,7,7,24,29.2,17,16,4,12,4,20,16,0
2455,Carlos Soler,Valencia,23.0,21,10,10,10,1,9,39,23.1,30,16,6,10,9,30,14,0
2456,Oumar Solet,Lyon,0.1,0,0,0,0,0,0,0,0.0,0,1,1,0,0,0,1,0
2457,Yann Sommer,M'Gladbach,34.0,0,0,0,0,0,0,1,0.0,1,0,0,0,1,1,11,6
2458,Kevin Soni,Espanyol,0.0,0,0,0,0,0,0,0,0.0,0,0,0,0,0,0,0,0
2459,David Soria,Getafe,38.0,2,1,2,0,0,2,4,50.0,2,0,0,0,3,5,17,5
2460,Bruno Soriano,Villarreal,2.9,4,0,1,2,1,1,1,100.0,0,4,0,4,1,5,7,0
2461,Juan Soriano,Leganés,11.0,0,0,0,0,0,0,0,0.0,0,0,0,0,0,0,1,1
2462,Roberto Soriano,Bologna,27.4,43,25,15,21,7,10,46,21.7,36,19,0,19,17,60,23,1
2463,Riccardo Sottil,Fiorentina,5.7,6,4,4,2,0,3,10,30.0,7,4,0,4,0,6,0,0
2464,Tomas Soucek,West Ham,11.6,29,15,13,15,1,10,23,43.5,13,7,1,6,22,51,35,0
2465,Adama Soumaoro,Genoa,7.1,3,2,3,0,0,1,3,33.3,2,12,12,0,11,14,32,0
2466,Adama Soumaoro,Lille,4.6,1,1,0,1,0,0,0,0.0,0,6,5,1,4,5,17,0
2467,Boubakary Soumare,Lille,13.5,19,12,6,13,0,9,19,47.4,10,6,0,6,16,35,9,0
2468,Bryan Soumare,Dijon,4.3,12,1,6,5,1,6,9,66.7,3,1,0,1,2,14,1,0
2470,Arnaud Souquet,Montpellier,22.4,62,40,45,13,4,30,67,44.8,37,20,6,14,17,79,44,0
2471,Djibril Sow,Eint Frankfurt,19.4,56,33,26,17,13,16,47,34.0,31,15,3,12,30,86,9,0
2472,Caglar Soyuncu,Leicester City,33.7,60,40,41,18,1,27,46,58.7,19,35,19,16,43,103,156,1
2473,Nikolas Spalek,Brescia,17.5,24,10,6,11,7,7,31,22.6,24,15,1,14,6,30,10,0
2474,Leonardo Spinazzola,Roma,17.2,24,12,11,8,5,12,21,57.1,9,13,5,8,20,44,41,0
2475,Marco Sportiello,Atalanta,5.8,0,0,0,0,0,0,0,0.0,0,0,0,0,0,0,3,0
2476,Mattia Sprocati,Parma,6.6,4,2,3,1,0,0,1,0.0,1,5,1,4,2,6,2,0
2477,Bassem Srarfi,Nice,1.5,0,0,0,0,0,0,2,0.0,2,0,0,0,2,2,0,0
2478,Dennis Srbeny,Norwich City,0.5,5,5,3,2,0,1,3,33.3,2,1,0,1,0,5,1,0
2479,Dennis Srbeny,Paderborn 07,12.4,11,6,4,4,3,5,18,27.8,13,11,1,10,3,14,9,0
2480,Jerry St. Juste,Mainz 05,23.5,46,25,34,10,2,14,34,41.2,20,35,19,16,52,98,86,1
2481,Jack Stacey,Bournemouth,17.2,21,11,9,11,1,8,22,36.4,14,27,11,16,18,39,64,1
2482,Kostas Stafylidis,Hoffenheim,4.4,10,3,7,2,1,4,10,40.0,6,10,3,7,2,12,17,0
2483,Benjamin Stambouli,Schalke 04,9.0,31,19,14,15,2,11,21,52.4,10,16,6,10,12,43,28,1
2484,Junior Stanislas,Bournemouth,7.9,10,7,2,3,5,3,8,37.5,5,6,0,6,4,14,6,0
2485,Niklas Stark,Hertha BSC,19.2,36,20,24,10,2,9,21,42.9,12,27,12,15,21,57,97,2
2486,Jed Steer,Aston Villa,0.1,0,0,0,0,0,0,0,0.0,0,0,0,0,0,0,0,0
2487,Renato Steffen,Wolfsburg,17.6,25,18,4,14,7,14,39,35.9,25,25,2,23,23,48,10,0
2488,Zack Steffen,Düsseldorf,17.0,0,0,0,0,0,0,0,0.0,0,0,0,0,0,0,5,4
2489,Dale Stephens,Brighton,28.1,73,44,30,37,6,25,75,33.3,50,31,11,20,58,131,42,2
2490,Jack Stephens,Southampton,27.2,44,27,30,13,1,24,46,52.2,22,38,22,16,31,75,120,2
2491,Mariusz Stepinski,Hellas Verona,7.8,5,3,2,1,2,1,2,50.0,1,3,1,2,1,6,7,0
2492,Raheem Sterling,Manchester City,29.5,27,15,8,10,9,6,28,21.4,22,16,2,14,15,42,4,0
2493,Enda Stevens,Sheffield Utd,37.2,81,46,48,26,7,42,96,43.8,54,27,8,19,35,116,71,3
2494,Marco Stiepermann,Norwich City,13.1,20,8,8,9,3,5,21,23.8,16,11,3,8,5,25,16,0
2496,Lars Stindl,M'Gladbach,15.9,27,16,4,15,8,10,28,35.7,18,18,2,16,10,37,7,0
2497,Kevin Stoger,Düsseldorf,14.1,21,15,10,7,4,6,24,25.0,18,24,2,22,26,47,7,1
2498,Vlatko Stojanovski,Nîmes,1.4,3,3,0,3,0,1,1,100.0,0,0,0,0,0,3,1,0
2499,John Stones,Manchester City,12.5,16,10,8,7,1,3,5,60.0,2,5,3,2,9,25,32,2
2500,Thomas Strakosha,Lazio,38.0,0,0,0,0,0,0,1,0.0,1,0,0,0,0,0,7,2
2501,Gabriel Strefezza,SPAL,23.4,64,40,28,26,10,22,54,40.7,32,29,3,26,21,85,17,0
2502,Tobias Strobl,M'Gladbach,6.8,9,6,5,4,0,3,8,37.5,5,8,4,4,11,20,5,0
2503,Christian Strohdiek,Paderborn 07,15.1,26,22,21,5,0,20,42,47.6,22,16,10,6,25,51,92,0
2504,Kevin Strootman,Marseille,15.7,39,27,13,23,3,20,49,40.8,29,16,1,15,17,56,24,0
2505,Jens Stryger Larsen,Udinese,31.0,27,19,15,9,3,17,30,56.7,13,20,5,15,20,47,52,0
2506,Stefano Sturaro,Genoa,13.9,38,22,14,19,5,15,39,38.5,24,16,4,12,10,48,26,1
2507,Damian Suarez,Getafe,28.8,62,32,32,21,9,38,72,52.8,34,25,2,23,27,89,41,0
2508,Denis Suarez,Celta Vigo,18.1,22,15,14,7,1,10,37,27.0,27,9,1,8,14,36,12,1
2509,Luis Suarez,Barcelona,22.2,4,0,0,1,3,2,12,16.7,10,6,1,5,1,5,11,0
2510,Mathias Suarez,Montpellier,0.7,2,2,2,0,0,2,3,66.7,1,0,0,0,1,3,3,0
2511,Neven Subotic,Union Berlin,21.8,30,18,12,16,2,8,32,25.0,24,21,8,13,34,64,89,0
2512,Isaac Success,Watford,0.8,0,0,0,0,0,0,0,0.0,0,0,0,0,1,1,0,0
2513,Marek Suchy,Augsburg,4.4,7,5,7,0,0,4,6,66.7,2,4,1,3,6,13,15,0
2514,Niklas Sule,Bayern Munich,7.1,10,6,8,2,0,4,5,80.0,1,8,6,2,8,18,22,1
2515,Ki Sung-yueng,Newcastle Utd,1.5,1,1,0,1,0,1,3,33.3,2,1,0,1,3,4,2,0
2516,Ki Sung-yueng,Mallorca,0.1,0,0,0,0,0,0,1,0.0,1,0,0,0,0,0,0,0
2517,Stoppila Sunzu,Metz,15.0,16,8,12,4,0,10,15,66.7,5,22,15,7,24,40,63,0
2518,Andrew Surman,Bournemouth,2.6,4,2,2,2,0,1,3,33.3,2,1,0,1,1,5,5,1
2519,Sam Surridge,Bournemouth,0.3,0,0,0,0,0,0,0,0.0,0,1,0,1,1,1,0,0
2520,Suso,Milan,15.1,7,3,2,3,2,2,10,20.0,8,5,0,5,8,15,3,0
2522,Suso,Sevilla,8.7,9,4,4,4,1,7,16,43.8,9,6,0,6,2,11,0,0
2523,Bosko Sutalo,Atalanta,3.1,3,2,2,1,0,0,2,0.0,2,4,0,4,6,9,6,1
2524,Markus Suttner,Düsseldorf,14.9,21,16,11,9,1,11,24,45.8,13,22,7,15,13,34,33,0
2525,Mattias Svanberg,Bologna,11.7,13,8,9,4,0,6,31,19.4,25,15,4,11,13,26,10,0
2526,Issiaga Sylla,Toulouse,28.0,73,49,44,21,8,40,69,58.0,29,31,7,24,67,140,90,2
2527,Moussa Sylla,Monaco,0.1,0,0,0,0,0,0,0,0.0,0,0,0,0,0,0,0,0
2528,Eddy Sylvestre,Nice,0.4,0,0,0,0,0,0,1,0.0,1,0,0,0,0,0,0,0
2529,Adam Szalai,Mainz 05,12.7,8,4,0,6,2,1,11,9.1,10,9,0,9,2,10,14,0
2530,Wojciech Szczesny,Juventus,28.8,0,0,0,0,0,0,0,0.0,0,0,0,0,1,1,10,1
2531,Andrea Tabanelli,Lecce,10.7,22,13,10,9,3,8,28,28.6,20,13,2,11,11,33,19,0
2532,Tachi,Alavés,2.6,2,1,2,0,0,1,4,25.0,3,5,4,1,4,6,12,0
2533,Panagiotis Tachtsidis,Lecce,22.3,52,27,26,20,6,20,56,35.7,36,27,11,16,35,87,32,2
2534,Jonathan Tah,Leverkusen,23.2,36,26,23,11,2,18,29,62.1,11,25,13,12,27,63,98,2
2535,Flavien Tait,Rennes,9.8,20,13,12,6,2,9,28,32.1,19,7,0,7,9,29,5,1
2536,Mahdi Talal,Amiens,0.2,0,0,0,0,0,0,1,0.0,1,1,0,1,0,0,2,0
2537,Adrien Tameze,Atalanta,2.3,4,3,1,1,2,1,2,50.0,1,3,1,2,3,7,4,1
2538,Adrien Tameze,Nice,5.8,6,2,2,3,1,4,16,25.0,12,7,2,5,7,13,1,1
2539,Japhet Tanganga,Tottenham,5.8,17,9,10,6,1,10,17,58.8,7,7,6,1,11,28,31,2
2540,Adil Taoui,Toulouse,0.3,2,2,0,2,0,0,2,0.0,2,0,0,0,2,4,0,0
2541,Edmond Tapsoba,Leverkusen,11.8,24,15,17,5,2,15,25,60.0,10,9,5,4,9,33,44,0
2542,Matt Targett,Aston Villa,25.5,52,29,37,11,4,22,53,41.5,31,28,8,20,56,108,82,0
2543,Rodrigo Tarin,Leganés,10.6,10,7,8,2,0,9,14,64.3,5,7,3,4,9,19,51,0
2544,James Tarkowski,Burnley,38.0,66,43,47,19,0,31,54,57.4,23,63,47,16,63,129,204,4
2545,Ciprian Tatarusanu,Lyon,2.0,0,0,0,0,0,0,0,0.0,0,0,0,0,0,0,0,1
2546,Julio Tavares,Dijon,22.2,12,8,1,6,5,4,17,23.5,13,9,2,7,8,20,29,0
2548,Charlie Taylor,Burnley,21.6,39,24,26,9,4,19,39,48.7,20,29,9,20,29,68,78,1
2549,Neil Taylor,Aston Villa,12.1,16,11,12,4,0,11,20,55.0,9,15,5,10,20,36,43,0
2550,Aurelien Tchouameni,Bordeaux,12.3,30,14,15,13,2,11,27,40.7,16,11,3,8,13,43,19,1
2551,Aurelien Tchouameni,Monaco,0.7,0,0,0,0,0,0,2,0.0,2,0,0,0,0,0,2,1
2552,Georg Teigl,Augsburg,1.2,3,1,1,2,0,2,4,50.0,2,0,0,0,3,6,1,0
2553,Alvaro Tejero,Eibar,16.1,30,18,17,10,3,14,23,60.9,9,17,4,13,28,58,38,0
2554,Bernard Tekpetey,Düsseldorf,5.0,4,4,1,2,1,0,2,0.0,2,5,0,5,2,6,0,0
2555,Nathan Tella,Southampton,0.0,0,0,0,0,0,0,0,0.0,0,0,0,0,0,0,0,0
2556,Cristian Tello,Betis,8.7,8,5,2,2,4,4,8,50.0,4,5,0,5,4,12,0,0
2557,Lino Tempelmann,Freiburg,0.4,1,0,1,0,0,1,1,100.0,0,1,1,0,0,1,0,0
2558,Lukasz Teodorczyk,Udinese,2.5,7,5,1,5,1,3,7,42.9,4,2,0,2,0,7,1,0
2559,Hidde ter Avest,Udinese,7.6,18,9,13,3,2,14,17,82.4,3,6,1,5,9,27,27,0
2560,Marc-Andre ter Stegen,Barcelona,36.0,2,2,2,0,0,2,3,66.7,1,0,0,0,2,4,17,6
2561,Simon Terodde,Köln,9.0,8,5,4,3,1,3,13,23.1,10,14,3,11,2,10,14,0
2562,Pietro Terracciano,Fiorentina,6.9,0,0,0,0,0,0,0,0.0,0,0,0,0,0,0,4,0
2563,Martin Terrier,Lyon,13.3,20,15,7,10,3,3,14,21.4,11,14,1,13,10,30,11,0
2564,Aleksa Terzic,Fiorentina,0.1,0,0,0,0,0,0,0,0.0,0,0,0,0,0,0,0,0
2565,Kenny Tete,Lyon,11.9,33,21,12,16,5,15,23,65.2,8,12,3,9,19,52,34,0
2566,Alexander Tettey,Norwich City,26.0,23,18,7,16,0,11,39,28.2,28,20,9,11,43,66,72,1
2567,Florian Thauvin,Marseille,0.2,1,0,0,1,0,0,1,0.0,1,0,0,0,0,1,0,0
2568,Demba Thiam,SPAL,2.0,0,0,0,0,0,0,0,0.0,0,0,0,0,1,1,0,0
2569,Malick Thiaw,Schalke 04,0.8,2,0,1,1,0,1,2,50.0,1,2,2,0,2,4,4,1
2570,Niclas Thiede,Freiburg,0.8,0,0,0,0,0,0,0,0.0,0,0,0,0,0,0,1,0
2571,Jan Thielmann,Köln,6.2,9,6,2,6,1,5,12,41.7,7,8,0,8,8,17,6,0
2572,Sada Thioub,Angers,16.8,20,12,8,9,3,5,18,27.8,13,9,1,8,4,24,5,0
2574,Jordan Thomas,Norwich City,0.0,0,0,0,0,0,0,0,0.0,0,0,0,0,0,0,0,0
2575,Luke Thomas,Leicester City,3.0,1,0,0,1,0,0,3,0.0,3,2,0,2,3,4,7,0
2576,Romain Thomas,Angers,26.0,24,17,16,7,1,8,18,44.4,10,35,18,17,39,63,118,1
2577,Adrien Thomasson,Strasbourg,23.0,36,21,11,16,9,15,47,31.9,32,21,1,20,9,45,9,0
2578,Erik Thommy,Düsseldorf,25.1,40,23,16,16,8,15,39,38.5,24,23,2,21,16,56,20,1
2579,Max Thompson,Burnley,0.0,0,0,0,0,0,0,0,0.0,0,0,0,0,0,0,0,0
2580,Morten Thorsby,Sampdoria,20.7,53,34,17,23,13,27,52,51.9,25,24,6,18,17,70,34,0
2581,Khephren Thuram,Nice,6.6,22,7,14,8,0,6,17,35.3,11,12,2,10,7,29,13,0
2582,Marcus Thuram,M'Gladbach,24.5,26,18,7,8,11,11,29,37.9,18,20,1,19,12,38,18,0
2583,Youri Tielemans,Leicester City,31.4,52,29,17,30,5,24,74,32.4,50,43,4,39,22,74,18,0
2584,Kieran Tierney,Arsenal,11.0,20,16,13,6,1,11,15,73.3,4,10,4,6,9,29,37,1
2585,Cheick Timite,Amiens,1.3,1,0,0,1,0,0,1,0.0,1,0,0,0,2,3,1,0
2586,David Timor,Getafe,10.5,9,6,4,5,0,5,16,31.3,11,8,3,5,18,27,23,0
2587,Marcel Tisserand,Wolfsburg,13.4,21,10,14,5,2,7,12,58.3,5,13,4,9,32,53,49,2
2588,Jean-Clair Todibo,Barcelona,0.9,1,0,1,0,0,0,1,0.0,1,0,0,0,0,1,6,0
2589,Jean-Clair Todibo,Schalke 04,4.1,15,10,10,5,0,8,9,88.9,1,2,0,2,15,30,24,0
2590,Karl Toko Ekambi,Villarreal,11.0,5,3,0,3,2,1,4,25.0,3,2,0,2,3,8,2,0
2591,Karl Toko Ekambi,Lyon,6.0,5,2,0,1,4,3,5,60.0,2,2,0,2,5,10,1,0
2592,Corentin Tolisso,Bayern Munich,7.1,9,4,4,3,2,1,9,11.1,8,9,3,6,4,13,2,1
2593,Jeremy Toljan,Sassuolo,24.3,37,21,24,10,3,18,35,51.4,17,23,12,11,18,55,58,1
2594,Rafael Toloi,Atalanta,29.0,56,29,28,23,5,33,76,43.4,43,31,17,14,45,101,80,0
2595,Raul de Tomas,Espanyol,11.9,9,7,3,4,2,4,13,30.8,9,8,1,7,10,19,4,0
2596,Takehiro Tomiyasu,Bologna,28.1,42,24,25,13,4,22,41,53.7,19,34,9,25,49,91,78,1
2597,James Tomkins,Crystal Palace,17.6,29,17,21,8,0,18,25,72.0,7,17,15,2,21,50,103,0
2598,Fikayo Tomori,Chelsea,14.3,29,16,21,8,0,10,15,66.7,5,13,7,6,22,51,48,2
2600,Nenad Tomovic,SPAL,19.5,26,19,18,6,2,10,21,47.6,11,32,23,9,30,56,65,1
2601,Sandro Tonali,Brescia,33.5,39,25,16,20,3,16,55,29.1,39,36,14,22,41,80,42,0
2602,Lorenzo Tonelli,Sampdoria,7.8,13,9,13,0,0,4,10,40.0,6,10,7,3,4,17,23,0
2603,Tono,Levante,17.7,26,19,18,7,1,15,28,53.6,13,11,3,8,13,39,34,1
2604,Omer Toprak,Werder Bremen,7.9,7,2,4,2,1,3,6,50.0,3,6,4,2,12,19,41,0
2605,Ernesto Torregrossa,Brescia,20.5,17,7,5,10,2,6,22,27.3,16,10,2,8,5,22,22,0
2606,Lucas Torreira,Arsenal,16.8,31,16,11,15,5,16,39,41.0,23,24,8,16,34,65,24,0
2607,Ferran Torres,Valencia,25.0,23,15,6,16,1,8,30,26.7,22,20,3,17,14,37,12,0
2608,Oliver Torres,Sevilla,17.7,45,27,12,26,7,23,60,38.3,37,23,1,22,13,58,9,1
2609,Pau Torres,Villarreal,33.0,34,21,24,10,0,16,24,66.7,8,39,23,16,27,61,153,1
2610,Roberto Torres,Osasuna,30.2,33,16,12,18,3,21,49,42.9,28,41,2,39,31,64,37,0
2611,Lucas Torro,Eint Frankfurt,3.7,12,7,6,6,0,8,16,50.0,8,2,1,1,8,20,3,0
2612,Jordan Torunarigha,Hertha BSC,16.2,32,19,21,11,0,18,27,66.7,9,33,18,15,31,63,75,0
2613,Cenk Tosun,Crystal Palace,2.0,2,2,2,0,0,0,2,0.0,2,0,0,0,0,2,1,0
2614,Cenk Tosun,Everton,3.2,2,0,0,0,2,0,1,0.0,1,1,0,1,0,2,1,0
2615,Abdoulaye Toure,Nantes,24.7,32,21,10,21,1,10,30,33.3,20,31,11,20,29,61,18,1
2616,Almamy Toure,Eint Frankfurt,16.6,32,19,18,11,3,11,22,50.0,11,18,7,11,23,55,54,1
2617,Lucas Tousart,Lyon,19.6,58,32,19,34,5,17,56,30.4,39,19,7,12,31,89,27,1
2618,Andros Townsend,Crystal Palace,14.4,34,21,12,17,5,15,37,40.5,22,18,0,18,15,49,10,1
2619,Aleksandar Trajkovski,Mallorca,3.7,2,0,1,1,0,1,7,14.3,6,2,0,2,3,5,1,0
2620,Adama Traore,Wolves,28.9,33,21,6,14,13,8,23,34.8,15,19,3,16,13,46,14,2
2621,Adama Traore,Metz,11.2,3,1,1,2,0,3,12,25.0,9,7,2,5,3,6,5,0
2622,Adama Traore,Monaco,0.3,0,0,0,0,0,0,0,0.0,0,0,0,0,1,1,0,0
2623,Bertrand Traore,Lyon,13.9,27,14,8,12,7,8,19,42.1,11,17,2,15,21,48,16,0
2624,Charles Traore,Nantes,19.3,48,35,27,19,2,36,61,59.0,25,21,4,17,39,87,64,0
2626,Hamari Traore,Rennes,26.8,55,26,34,18,3,32,64,50.0,32,22,5,17,48,103,59,1
2627,Ibrahima Traore,M'Gladbach,1.7,4,3,1,1,2,1,7,14.3,6,1,0,1,1,5,3,0
2628,Ismael Traore,Angers,22.8,23,12,14,7,2,10,17,58.8,7,23,13,10,27,50,85,1
2629,Kevin Trapp,Eint Frankfurt,22.0,0,0,0,0,0,0,1,0.0,1,0,0,0,3,3,5,0
2630,Miguel Trauco,Saint-Étienne,16.4,32,20,16,12,4,19,44,43.2,25,8,1,7,23,55,25,0
2631,Mark Travers,Bournemouth,1.0,0,0,0,0,0,0,0,0.0,0,0,0,0,0,0,1,1
2632,Luca Tremolada,Brescia,0.2,0,0,0,0,0,0,0,0.0,0,0,0,0,0,0,0,0
2633,Trezeguet,Aston Villa,21.7,38,16,18,15,5,9,44,20.5,35,23,2,21,25,63,18,0
2634,Manu Trigueros,Villarreal,17.2,34,21,10,17,7,12,45,26.7,33,23,12,11,4,38,21,0
2635,Christopher Trimmel,Union Berlin,31.8,71,41,35,32,4,32,54,59.3,22,31,10,21,51,122,88,1
2636,Alessandro Tripaldelli,Sassuolo,1.5,4,4,1,3,0,1,3,33.3,2,1,0,1,3,7,3,0
2637,Kieran Trippier,Atlético Madrid,22.0,52,34,24,21,7,34,53,64.2,19,33,7,26,24,76,46,0
2638,William Troost-Ekong,Udinese,28.6,37,19,25,12,0,10,18,55.6,8,41,29,12,31,68,135,2
2639,Leandro Trossard,Brighton,22.3,22,17,7,12,3,6,38,15.8,32,16,1,15,9,31,8,0
2640,Tom Trybull,Norwich City,12.6,39,25,15,18,6,16,60,26.7,44,20,5,15,16,55,35,0
2641,Axel Tuanzebe,Manchester Utd,2.1,2,2,0,2,0,1,2,50.0,1,1,0,1,5,7,5,1
2642,Georgi Tunjov,SPAL,3.2,4,4,3,1,0,1,11,9.1,10,3,1,2,1,5,0,0
2643,Stefano Turati,Sassuolo,2.0,0,0,0,0,0,0,0,0.0,0,0,0,0,0,0,1,0
2644,Gennaro Tutino,Hellas Verona,2.5,0,0,0,0,0,0,0,0.0,0,0,0,0,2,2,1,0
2645,Matthieu Udol,Metz,12.2,29,19,19,8,2,13,24,54.2,11,21,4,17,23,52,43,0
2646,Hwang Ui-jo,Bordeaux,18.1,9,7,2,5,2,4,20,20.0,16,7,0,7,5,14,5,0
2647,Anthony Ujah,Union Berlin,10.5,8,6,4,2,2,1,6,16.7,5,0,0,0,3,11,10,0
2648,Samir Ujkani,Torino,1.0,0,0,0,0,0,0,0,0.0,0,0,0,0,0,0,1,0
2649,Sven Ulreich,Bayern Munich,1.0,0,0,0,0,0,0,0,0.0,0,0,0,0,0,0,0,0
2650,Samuel Umtiti,Barcelona,10.5,11,5,5,5,1,5,8,62.5,3,4,2,2,22,33,32,0
2652,Enes Unal,Valladolid,26.0,20,12,6,11,3,6,28,21.4,22,17,5,12,6,26,13,0
2653,Cengiz Under,Roma,9.7,10,6,4,4,2,2,9,22.2,7,7,2,5,8,18,7,0
2654,Dayot Upamecano,RB Leipzig,26.2,52,31,37,15,0,23,43,53.5,20,31,17,14,43,95,88,1
2655,Mark Uth,Köln,12.9,19,12,4,10,5,9,32,28.1,23,15,0,15,7,26,3,0
2656,Mark Uth,Schalke 04,3.9,3,2,1,1,1,0,3,0.0,3,4,0,4,1,4,0,0
2657,Tomas Vaclik,Sevilla,32.5,0,0,0,0,0,0,1,0.0,1,0,0,0,0,0,7,0
2658,Alvaro Vadillo,Granada,13.5,16,11,6,8,2,9,16,56.3,7,12,0,12,7,23,2,0
2659,William Vainqueur,Toulouse,19.1,68,36,30,32,6,22,60,36.7,38,21,5,16,29,97,23,0
2660,Mirko Valdifiori,SPAL,15.6,31,15,14,17,0,16,33,48.5,17,8,3,5,4,35,25,0
2661,Pierrick Valdivia,Nîmes,0.8,1,1,0,0,1,0,1,0.0,1,0,0,0,0,1,0,0
2662,German Valera,Atlético Madrid,0.0,0,0,0,0,0,0,0,0.0,0,1,0,1,0,0,0,0
2663,Antoine Valerio,Nîmes,1.0,1,1,0,1,0,0,2,0.0,2,2,0,2,3,4,1,0
2664,Borja Valero,Inter,10.3,18,7,9,3,6,6,24,25.0,18,12,3,9,8,26,9,0
2665,Yan Valery,Southampton,8.7,20,7,9,7,4,11,19,57.9,8,9,1,8,13,33,32,2
2666,Martin Valjent,Mallorca,35.4,25,17,14,10,1,13,25,52.0,12,39,27,12,37,62,146,1
2667,Jesus Vallejo,Wolves,1.8,1,1,1,0,0,1,2,50.0,1,4,3,1,2,3,8,1
2668,Jesus Vallejo,Granada,7.0,6,5,4,2,0,3,4,75.0,1,7,4,3,5,11,28,0
2669,Manu Vallejo,Valencia,4.6,7,3,0,3,4,5,9,55.6,4,4,0,4,2,9,2,0
2670,Luca Valls,Nîmes,0.1,1,0,1,0,0,1,1,100.0,0,1,0,1,0,1,0,0
2671,Theo Valls,Nîmes,18.1,39,16,12,26,1,16,50,32.0,34,17,0,17,13,52,6,0
2672,Mattia Valoti,SPAL,17.0,48,30,21,25,2,16,43,37.2,27,27,6,21,16,64,18,0
2673,Federico Valverde,Real Madrid,21.2,38,19,9,19,10,12,36,33.3,24,38,4,34,21,59,12,2
2674,Virgil van Dijk,Liverpool,38.0,23,12,18,5,0,6,13,46.2,7,20,15,5,40,63,166,2
2675,Raphael Varane,Real Madrid,31.4,30,17,15,14,1,12,23,52.2,11,32,16,16,31,61,124,0
2676,Jamie Vardy,Leicester City,33.7,15,12,0,9,6,2,4,50.0,2,22,4,18,2,17,22,0
2678,Matias Vargas,Espanyol,11.4,13,5,7,3,3,4,23,17.4,19,12,2,10,3,16,5,0
2679,Ruben Vargas,Augsburg,28.1,32,16,18,7,7,8,36,22.2,28,26,1,25,26,58,35,0
2680,Thibaut Vargas,Montpellier,1.7,3,1,3,0,0,2,5,40.0,3,1,1,0,0,3,3,0
2681,Sebastian Vasiliadis,Paderborn 07,31.2,73,45,34,31,8,28,81,34.6,53,47,6,41,34,107,50,0
2682,Indiana Vassilev,Aston Villa,0.6,0,0,0,0,0,0,0,0.0,0,0,0,0,0,0,0,0
2683,Denis Vavro,Lazio,3.6,3,3,2,1,0,1,3,33.3,2,8,6,2,5,8,10,0
2684,Franco Vazquez,Sevilla,12.2,25,17,9,14,2,6,36,16.7,30,13,0,13,10,35,10,0
2685,Kevin Vazquez,Celta Vigo,14.7,26,15,16,6,4,15,28,53.6,13,18,1,17,26,52,28,0
2686,Lucas Vazquez,Real Madrid,9.4,23,17,10,13,0,11,26,42.3,15,10,0,10,10,33,8,1
2687,Matias Vecino,Inter,14.2,31,20,14,11,6,9,36,25.0,27,20,3,17,15,46,26,0
2688,Koke Vegas,Levante,2.0,0,0,0,0,0,0,1,0.0,1,0,0,0,0,0,3,0
2689,Milos Veljkovic,Werder Bremen,22.8,55,33,36,18,1,33,53,62.3,20,25,11,14,26,81,92,1
2690,Miguel Veloso,Hellas Verona,31.2,52,29,20,28,4,18,60,30.0,42,36,12,24,32,84,46,1
2691,Unai Vencedor Paris,Athletic Club,0.8,0,0,0,0,0,0,0,0.0,0,0,0,0,0,0,0,0
2692,Lorenzo Venuti,Fiorentina,9.5,20,10,12,6,2,13,19,68.4,6,5,1,4,11,31,15,0
2693,Brayan Vera,Lecce,1.7,4,1,2,1,1,3,7,42.9,4,1,0,1,1,5,4,0
2694,Simone Verdi,Torino,23.0,19,10,4,12,3,9,38,23.7,29,14,0,14,7,26,1,0
2695,Jordan Veretout,Roma,29.2,36,18,13,16,7,14,43,32.6,29,35,5,30,18,54,31,1
2696,Marco Verratti,Paris S-G,16.5,54,32,22,22,10,20,56,35.7,36,23,3,20,19,73,9,0
2697,Valerio Verre,Hellas Verona,19.7,25,15,4,11,10,9,23,39.1,14,5,0,5,13,38,9,0
2698,Birger Verstraete,Köln,7.4,20,11,9,10,1,11,21,52.4,10,8,1,7,4,24,10,1
2699,Jan Vertonghen,Tottenham,18.3,40,24,25,14,1,20,31,64.5,11,18,10,8,33,73,68,0
2700,Mikel Vesga,Athletic Club,14.1,25,17,7,12,6,9,45,20.0,36,18,7,11,31,56,24,1
2701,Jannik Vestergaard,Southampton,16.6,19,12,14,5,0,11,28,39.3,17,15,9,6,26,45,99,2
2702,Ruben Vezo,Levante,29.0,41,24,28,13,0,19,35,54.3,16,37,29,8,42,83,144,2
2704,Francesco Vicari,SPAL,32.2,27,13,20,6,1,12,25,48.0,13,48,37,11,38,65,145,1
2705,Fede Vico,Granada,9.7,5,1,2,3,0,2,11,18.2,9,12,1,11,5,10,2,0
2706,Aleix Vidal,Alavés,24.1,21,14,8,11,2,8,37,21.6,29,14,1,13,23,44,18,0
2707,Arturo Vidal,Barcelona,18.6,63,38,22,30,11,24,58,41.4,34,31,7,24,17,80,16,1
2708,Clement Vidal,Montpellier,1.0,0,0,0,0,0,0,2,0.0,2,1,1,0,0,0,6,0
2709,Nacho Vidal,Osasuna,25.9,45,29,26,13,6,21,38,55.3,17,24,6,18,44,89,70,1
2710,Ronaldo Vieira,Sampdoria,20.2,33,19,13,17,3,6,28,21.4,22,14,2,12,21,54,31,0
2711,Mauro Vigorito,Lecce,4.7,0,0,0,0,0,0,0,0.0,0,0,0,0,0,0,3,1
2712,Didac Vila,Espanyol,27.7,73,42,44,23,6,25,61,41.0,36,31,5,26,40,113,63,0
2713,Toni Villa,Valladolid,15.0,31,16,13,14,4,13,50,26.0,37,16,1,15,8,39,11,0
2714,Asier Villalibre,Athletic Club,5.9,0,0,0,0,0,0,3,0.0,3,3,0,3,1,1,4,0
2715,Gonzalo Villar,Roma,3.3,5,3,4,0,1,2,4,50.0,2,2,0,2,2,7,3,0
2716,Ivan Villar,Celta Vigo,3.1,0,0,0,0,0,0,0,0.0,0,0,0,0,0,0,5,0
2717,Juan Villar,Osasuna,2.7,1,0,0,1,0,0,2,0.0,2,4,1,3,1,2,0,0
2718,Ruben Vinagre,Wolves,7.2,23,13,15,6,2,12,15,80.0,3,7,2,5,11,34,22,0
2719,Luigi Vitale,Hellas Verona,0.5,1,0,0,1,0,0,0,0.0,0,1,0,1,0,1,0,0
2720,Vitolo,Atlético Madrid,13.6,15,12,7,7,1,5,17,29.4,12,9,0,9,10,25,9,0
2721,Mattia Viviani,Brescia,3.8,3,1,0,3,0,1,8,12.5,7,3,3,0,9,12,2,1
2722,Dusan Vlahovic,Fiorentina,16.7,6,2,1,4,1,4,13,30.8,9,5,2,3,7,13,6,0
2723,Kevin Vogt,Hoffenheim,10.7,7,5,4,3,0,3,9,33.3,6,12,6,6,8,15,52,1
2724,Kevin Vogt,Werder Bremen,12.3,14,10,8,6,0,8,16,50.0,8,15,12,3,25,39,37,1
2725,Jake Vokins,Southampton,1.0,2,2,0,0,2,1,1,100.0,0,0,0,0,0,2,1,0
2726,Kevin Volland,Leverkusen,22.7,16,6,5,6,5,5,16,31.3,11,14,2,12,5,21,7,0
2727,Mario Vrancic,Norwich City,7.1,27,16,14,11,2,16,27,59.3,11,9,0,9,10,37,4,2
2728,Stefan de Vrij,Inter,31.4,33,18,20,12,1,14,27,51.9,13,34,24,10,52,85,121,1
2730,Giacomo Vrioni,Juventus,0.1,0,0,0,0,0,0,0,0.0,0,0,0,0,0,0,0,0
2731,Sime Vrsaljko,Atlético Madrid,4.0,6,5,6,0,0,5,6,83.3,1,5,3,2,8,14,11,0
2732,Nikola Vukcevic,Levante,17.4,41,26,17,17,7,15,40,37.5,25,19,7,12,12,53,16,0
2733,Matej Vydra,Burnley,9.1,4,3,0,3,1,3,6,50.0,3,7,3,4,1,5,6,0
2734,Molla Wague,Nantes,7.6,15,12,11,4,0,7,7,100.0,0,10,8,2,15,30,42,0
2735,Moussa Wague,Barcelona,1.0,2,1,1,0,1,1,1,100.0,0,0,0,0,1,3,0,0
2736,Moussa Wague,Nice,2.2,6,4,3,3,0,2,3,66.7,1,2,1,1,2,8,2,0
2737,Wakaso,Alavés,14.3,54,31,25,24,5,16,33,48.5,17,23,5,18,17,71,17,1
2738,Walace,Udinese,12.7,28,9,19,6,3,13,42,31.0,29,14,6,8,33,61,19,0
2739,Theo Walcott,Everton,14.3,13,8,6,5,2,3,15,20.0,12,13,0,13,8,21,1,0
2740,Luca Waldschmidt,Freiburg,14.1,10,7,3,5,2,2,18,11.1,16,11,2,9,4,14,4,0
2741,Kyle Walker,Manchester City,26.6,28,18,12,15,1,12,29,41.4,17,15,6,9,28,56,42,1
2742,Kyle Walker-Peters,Southampton,7.8,13,8,5,6,2,6,16,37.5,10,10,3,7,14,27,21,1
2743,Kyle Walker-Peters,Tottenham,2.7,8,5,8,0,0,5,9,55.6,4,4,2,2,3,11,5,1
2744,Remi Walter,Nice,0.6,1,1,0,1,0,1,1,100.0,0,0,0,0,0,1,0,0
2745,Sebastian Walukiewicz,Cagliari,12.9,25,11,17,8,0,14,22,63.6,8,21,14,7,14,39,41,0
2746,Aaron Wan-Bissaka,Manchester Utd,34.1,129,80,71,50,8,64,86,74.4,22,46,13,33,66,195,83,0
2747,Victor Wanyama,Tottenham,0.3,0,0,0,0,0,0,0,0.0,0,0,0,0,0,0,0,0
2748,Joel Ward,Crystal Palace,26.5,69,42,48,16,5,39,56,69.6,17,13,6,7,48,117,93,1
2749,James Ward-Prowse,Southampton,38.0,92,48,39,39,14,39,94,41.5,55,48,14,34,60,152,75,1
2750,Daniel Wass,Valencia,30.4,44,25,25,13,6,25,57,43.9,32,22,5,17,31,75,91,1
2751,Kelland Watts,Newcastle Utd,0.2,1,0,1,0,0,1,1,100.0,0,0,0,0,0,1,0,0
2752,Timothy Weah,Lille,0.9,0,0,0,0,0,0,1,0.0,1,0,0,0,0,0,1,0
2753,Adam Webster,Brighton,29.6,30,17,21,8,1,14,32,43.8,18,43,26,17,45,75,110,2
2754,Wout Weghorst,Wolfsburg,30.4,15,8,4,5,6,1,17,5.9,16,17,4,13,2,17,30,0
2756,Julian Weigl,Dortmund,11.3,16,9,12,3,1,9,16,56.3,7,10,0,10,8,24,21,0
2757,Mitchell Weiser,Leverkusen,13.0,41,29,20,17,4,18,30,60.0,12,19,2,17,24,65,22,1
2758,Danny Welbeck,Watford,9.1,14,6,6,5,3,3,11,27.3,8,12,1,11,5,19,7,0
2759,Wendell,Leverkusen,21.1,64,42,26,26,12,41,66,62.1,25,30,4,26,36,100,36,0
2760,Oscar Wendt,M'Gladbach,18.7,26,14,16,8,2,12,31,38.7,19,27,6,21,20,46,45,0
2761,Timo Werner,RB Leipzig,31.1,20,9,6,7,7,3,16,18.8,13,16,0,16,5,25,2,0
2762,Ashley Westwood,Burnley,35.0,54,33,15,32,7,17,48,35.4,31,23,11,12,32,86,32,3
2763,Connor Wickham,Crystal Palace,1.1,1,1,1,0,0,0,0,0.0,0,1,0,1,1,2,0,0
2764,Felix Wiedwald,Eint Frankfurt,3.0,0,0,0,0,0,0,0,0.0,0,0,0,0,0,0,2,1
2765,Georginio Wijnaldum,Liverpool,32.6,38,20,12,21,5,10,40,25.0,30,18,4,14,17,55,34,3
2766,Jetro Willems,Newcastle Utd,16.6,37,19,29,6,2,18,39,46.2,21,20,5,15,17,54,42,1
2767,William,Wolfsburg,15.2,55,26,34,14,7,27,59,45.8,32,10,3,7,24,79,38,1
2768,Brandon Williams,Manchester Utd,11.2,21,15,11,6,4,9,29,31.0,20,9,4,5,16,37,27,0
2769,Inaki Williams,Athletic Club,32.7,15,5,0,7,8,5,18,27.8,13,18,2,16,5,20,29,0
2770,Neco Williams,Liverpool,2.6,5,3,1,3,1,4,5,80.0,1,3,1,2,9,14,6,0
2771,Willian,Chelsea,28.9,45,27,14,24,7,14,43,32.6,29,15,0,15,20,65,7,0
2772,Joe Willock,Arsenal,9.5,25,16,9,12,4,8,21,38.1,13,16,2,14,4,29,11,2
2773,Jack Wilshere,West Ham,2.4,1,0,1,0,0,0,4,0.0,4,3,0,3,1,2,0,0
2774,Callum Wilson,Bournemouth,32.3,12,9,3,6,3,2,17,11.8,15,16,2,14,4,16,16,0
2775,Harry Wilson,Bournemouth,18.3,23,13,8,10,5,11,34,32.4,23,26,2,24,11,34,15,1
2776,Harry Winks,Tottenham,24.7,40,24,18,20,2,17,54,31.5,37,27,8,19,36,76,32,1
2777,Florian Wirtz,Leverkusen,4.1,4,2,0,4,0,2,4,50.0,2,4,0,4,2,6,1,0
2778,Axel Witsel,Dortmund,24.9,28,20,10,17,1,14,33,42.4,19,26,7,19,31,59,19,1
2779,Hannes Wolf,RB Leipzig,0.6,3,0,0,1,2,1,4,25.0,3,0,0,0,0,3,0,0
2780,Marius Wolf,Hertha BSC,15.7,19,11,9,7,3,10,27,37.0,17,14,1,13,17,36,13,0
2782,Nick Woltemade,Werder Bremen,1.0,2,1,0,2,0,0,1,0.0,1,1,0,1,0,2,2,0
2783,Chris Wood,Burnley,27.1,7,4,2,4,1,5,15,33.3,10,15,2,13,4,11,18,0
2784,Xeka,Lille,7.9,18,10,3,13,2,9,29,31.0,20,11,1,10,4,22,7,1
2785,Granit Xhaka,Arsenal,28.7,45,25,20,19,6,25,55,45.5,30,32,16,16,21,66,59,3
2786,Jawad El Yamiq,Genoa,2.2,3,2,3,0,0,1,4,25.0,3,3,2,1,1,4,3,0
2787,Andriy Yarmolenko,West Ham,11.0,13,8,5,6,2,5,20,25.0,15,3,1,2,6,19,4,0
2788,Yusuf Yazici,Lille,9.4,17,8,2,11,4,5,13,38.5,8,6,1,5,5,22,1,1
2789,DeAndre Yedlin,Newcastle Utd,10.4,18,13,10,6,2,8,16,50.0,8,13,7,6,10,28,20,0
2790,Yoel,Eibar,3.0,0,0,0,0,0,0,0,0.0,0,0,0,0,1,1,1,0
2791,Okay Yokuslu,Celta Vigo,21.9,41,27,18,21,2,20,42,47.6,22,12,5,7,28,69,71,1
2792,Maya Yoshida,Southampton,6.2,8,5,4,1,3,3,7,42.9,4,6,2,4,4,12,27,1
2793,Maya Yoshida,Sampdoria,13.2,4,3,2,2,0,2,6,33.3,4,15,12,3,27,31,72,0
2794,Elie Youan,Nantes,1.8,0,0,0,0,0,0,7,0.0,7,2,0,2,0,0,3,0
2795,Amin Younes,Napoli,2.0,3,2,1,2,0,2,4,50.0,2,2,0,2,0,3,1,0
2796,Ashley Young,Manchester Utd,10.6,14,7,7,4,3,5,17,29.4,12,8,2,6,11,25,29,0
2797,Ashley Young,Inter,13.2,11,5,3,5,3,6,19,31.6,13,11,3,8,14,25,24,0
2798,Zaydou Youssouf,Saint-Étienne,12.0,40,22,12,26,2,15,35,42.9,20,7,1,6,16,56,13,0
2799,Pablo Zabaleta,West Ham,6.6,18,10,12,5,1,6,13,46.2,7,5,3,2,14,32,21,0
2800,Mattia Zaccagni,Hellas Verona,23.5,20,11,10,5,5,3,15,20.0,12,14,3,11,20,40,21,0
2801,Dan-Axel Zagadou,Dortmund,10.9,16,10,12,4,0,6,8,75.0,2,12,8,4,15,31,38,0
2802,Arthur Zagre,Paris S-G,0.3,1,0,1,0,0,0,0,0.0,0,1,0,1,1,2,0,0
2803,Wilfried Zaha,Crystal Palace,36.4,43,19,18,12,13,12,49,24.5,37,22,2,20,18,61,4,0
2804,Denis Zakaria,M'Gladbach,21.6,49,30,23,23,3,20,39,51.3,19,39,12,27,37,86,31,1
2805,Joseba Zaldua,Real Sociedad,28.3,62,43,39,18,5,31,59,52.5,28,31,7,24,37,99,71,0
2806,Andre-Frank Zambo Anguissa,Villarreal,28.7,76,49,29,40,7,26,78,33.3,52,42,6,36,44,120,30,0
2808,Luca Zanimacchia,Juventus,1.3,5,1,1,2,2,1,2,50.0,1,1,0,1,0,5,0,0
2809,Nicolo Zaniolo,Roma,16.7,15,11,4,7,4,3,24,12.5,21,14,0,14,5,20,5,0
2810,Cristian Zapata,Genoa,19.1,23,17,16,7,0,8,16,50.0,8,29,17,12,24,47,75,0
2811,Duvan Zapata,Atalanta,22.5,7,3,1,2,4,1,6,16.7,5,18,7,11,2,9,11,0
2812,Davide Zappacosta,Roma,5.0,7,3,2,3,2,4,8,50.0,4,3,1,2,6,13,8,1
2813,Simone Zaza,Torino,18.2,15,10,6,4,5,3,10,30.0,7,11,0,11,9,24,13,1
2814,Marvin Zeegelaar,Udinese,6.6,15,9,8,4,3,6,11,54.5,5,9,2,7,5,20,10,0
2815,Mootaz Zemzemi,Strasbourg,0.3,0,0,0,0,0,0,0,0.0,0,0,0,0,1,1,0,0
2816,Arber Zeneli,Reims,0.1,0,0,0,0,0,0,0,0.0,0,0,0,0,0,0,0,0
2817,Robin Zentner,Mainz 05,21.5,1,1,1,0,0,1,1,100.0,0,0,0,0,0,1,11,0
2818,Piotr Zielinski,Napoli,32.5,26,16,10,11,5,12,30,40.0,18,28,5,23,21,47,15,0
2819,Jean Zimmer,Düsseldorf,8.0,11,6,5,5,1,5,10,50.0,5,3,1,2,3,14,0,0
2820,Christoph Zimmermann,Norwich City,15.9,32,21,26,6,0,21,30,70.0,9,22,18,4,19,51,87,2
2821,Matthias Zimmermann,Düsseldorf,32.5,62,47,26,27,9,31,64,48.4,33,41,15,26,43,105,59,0
2822,Oleksandr Zinchenko,Manchester City,14.2,31,19,16,11,4,17,32,53.1,15,9,0,9,17,48,21,1
2823,Leopold Zingerle,Paderborn 07,28.0,3,1,3,0,0,2,4,50.0,2,0,0,0,0,3,7,2
2824,Joshua Zirkzee,Bayern Munich,3.3,5,2,0,2,3,2,4,50.0,2,2,0,2,1,6,0,0
2825,Richairo Zivkovic,Sheffield Utd,1.2,2,2,0,2,0,1,2,50.0,1,1,0,1,0,2,0,0
2826,Jaromir Zmrhal,Brescia,12.5,10,4,2,5,3,5,18,27.8,13,8,1,7,4,14,11,0
2827,Kevin Zohi,Strasbourg,5.9,8,6,3,3,2,3,6,50.0,3,1,0,1,4,12,2,0
2828,Ben Zolinski,Paderborn 07,13.4,17,9,7,9,1,7,27,25.9,20,12,0,12,8,25,4,0
2829,Kurt Zouma,Chelsea,26.0,23,14,17,6,0,9,16,56.3,7,22,14,8,58,81,116,2
2830,Igor Zubeldia,Real Sociedad,29.3,42,21,18,19,5,17,35,48.6,18,38,21,17,26,68,82,2
2831,Steven Zuber,Hoffenheim,8.3,11,10,7,2,2,9,19,47.4,10,4,1,3,9,20,12,0
2832,Martin Zubimendi,Real Sociedad,5.8,16,12,9,7,0,6,12,50.0,6,7,0,7,9,25,2,0
2834,Ervin Zukanovic,SPAL,2.3,1,0,0,0,1,1,1,100.0,0,3,1,2,3,4,15,0
2835,Bongani Zungu,Amiens,11.0,27,11,10,13,4,18,31,58.1,13,8,2,6,16,43,21,0
2836,Szymon Zurkowski,Fiorentina,0.1,1,0,0,0,1,0,2,0.0,2,0,0,0,0,1,1,0
2837,David Zurutuza,Real Sociedad,1.7,4,3,0,3,1,1,2,50.0,1,1,0,1,4,8,3,0
2838,Martin Odegaard,Real Sociedad,28.1,27,19,5,14,8,7,34,20.6,27,13,0,13,17,44,5,0
2839,Filip Duricic,Sassuolo,18.1,23,14,2,10,11,3,19,15.8,16,20,3,17,8,31,14,0
2840,Hugo Guillamon,Valencia,5.5,0.0,2,0.0,0.0,0.0,0.0,0.0,0.0,0.0,0.0,0.0,0.0,7,0.0,0.0,0.0
