,Player,90s,Tackles - Tkl,Tackles - TklW,Tackles - Def 3rd,Tackles - Mid 3rd,Tackles - Att 3rd,Challenges - Tkl,Challenges - Att,Challenges - Tkl%,Challenges - Lost,Blocks - Blocks,Blocks - Sh,Blocks - Pass,Int,Tkl+Int,Clr,Err
0,Patrick van Aanholt,27.9,43,23,31,10,2,23,50,46.0,27,31,9,22,45,88,52,1
1,Max Aarons,36.0,48,30,33,9,6,18,36,50.0,18,46,29,17,37,85,97,1
2,Yunis Abdelhamid,28.0,46,33,29,15,2,17,30,56.7,13,26,14,12,47,93,99,1
3,Suleiman Abdullahi,1.7,0,0,0,0,0,0,3,0.0,3,2,1,1,1,1,1,0
4,Mehdi Abeid,20.2,55,29,18,32,5,20,53,37.7,33,16,3,13,23,78,8,1
5,Charles Abi,6.9,9,9,2,5,2,2,7,28.6,5,2,0,2,4,13,4,0
6,David Abraham,18.8,21,14,16,4,1,15,32,46.9,17,27,11,16,25,46,61,1
7,Tammy Abraham,24.6,8,4,2,5,1,3,14,21.4,11,20,2,18,6,14,27,0
8,Amir Abrashi,7.4,16,8,7,8,1,10,19,52.6,9,18,3,15,7,23,16,2
9,Francesco Acerbi,35.1,59,29,42,12,5,14,20,70.0,6,40,27,13,42,101,109,1
10,Che Adams,12.3,6,4,1,5,0,1,4,25.0,3,9,1,8,2,8,10,0
11,Tyler Adams,10.6,22,15,13,8,1,12,25,48.0,13,16,1,15,14,36,14,0
12,Sargis Adamyan,8.3,11,7,3,6,2,3,21,14.3,18,8,1,7,2,13,4,0
14,Bobby Adekanye,2.1,3,2,0,3,0,0,5,0.0,5,0,0,0,2,5,1,0
15,Claud Adjapong,2.6,5,3,4,1,0,2,3,66.7,1,4,3,1,3,8,7,0
16,Amine Adli,0.5,0,0,0,0,0,0,1,0.0,1,0,0,0,1,1,0,0
17,Yacine Adli,11.3,22,14,4,15,3,11,34,32.4,23,10,0,10,8,30,3,0
18,Adrian,9.7,1,1,1,0,0,1,1,100.0,0,0,0,0,0,1,8,3
20,Lumor Agbenyenu,20.1,31,21,19,9,3,16,35,45.7,19,13,2,11,21,52,66,1
21,Martin Agirregabiria,23.3,55,30,32,18,5,30,54,55.6,24,19,7,12,18,73,48,0
23,Kevin Agudelo,0.7,2,1,0,1,1,0,1,0.0,1,1,0,1,1,3,0,0
24,Kevin Agudelo,7.4,23,14,9,12,2,10,20,50.0,10,12,1,11,6,29,2,0
26,Nayef Aguerd,10.6,13,9,7,5,1,8,12,66.7,4,11,11,0,18,31,54,0
27,Sergio Aguero,16.1,7,4,0,4,3,1,8,12.5,7,9,1,8,3,10,2,0
28,Ruben Aguilar,11.9,36,22,19,15,2,19,28,67.9,9,6,2,4,11,47,21,0
29,Emmanuel Agyemang-Badu,2.6,1,1,0,1,0,1,2,50.0,1,2,2,0,1,2,6,0
30,Jean-Eudes Aholou,7.0,16,12,2,11,3,3,9,33.3,6,6,1,5,15,31,10,0
31,Joseph Aidoo,27.8,43,27,30,11,2,13,27,48.1,14,31,14,17,45,88,124,3
32,Ola Aina,23.1,45,24,23,18,4,17,37,45.9,20,24,6,18,41,86,61,0
33,Youssef Ait Bennasser,6.0,11,8,6,4,1,4,24,16.7,20,6,1,5,4,15,10,1
34,Rayan Ait Nouri,14.2,29,22,14,8,7,10,21,47.6,11,14,1,13,18,47,33,0
36,Ludovic Ajorque,22.9,15,10,2,10,3,2,13,15.4,11,11,0,11,2,17,20,0
37,Manuel Akanji,25.7,38,21,23,14,1,12,20,60.0,8,20,11,9,30,68,61,2
38,Marley Ake,1.1,2,2,1,1,0,1,3,33.3,2,0,0,0,1,3,1,0
39,Nathan Ake,27.8,31,21,23,8,0,14,23,60.9,9,40,29,11,36,67,152,0
40,Chadrac Akolo,6.0,16,8,8,6,2,5,12,41.7,7,6,1,5,5,21,5,0
41,Kevin Akpoguma,12.7,24,16,20,4,0,13,24,54.2,11,21,11,10,13,37,48,0
42,David Alaba,27.8,30,17,14,15,1,16,25,64.0,9,19,10,9,29,59,40,0
43,Sofiane Alakouch,15.6,45,26,25,13,7,25,48,52.1,23,13,2,11,23,68,39,3
44,Lucas Alario,13.0,6,3,0,4,2,1,8,12.5,7,12,2,10,1,7,9,0
45,Jordi Alba,24.3,20,13,9,7,4,6,27,22.2,21,12,3,9,37,57,40,0
46,Luis Alberto,34.6,50,30,21,19,10,27,82,32.9,55,32,1,31,21,71,9,1
47,Raul Albiol,36.0,43,23,27,16,0,18,27,66.7,9,29,21,8,42,85,175,2
48,Marc Albrighton,9.6,24,17,10,13,1,9,30,30.0,21,19,2,17,10,34,8,0
49,Paco Alcacer,10.3,3,3,2,1,0,1,7,14.3,6,4,1,3,2,5,10,0
50,Paco Alcacer,5.9,2,2,0,2,0,1,5,20.0,4,4,1,3,2,4,3,0
52,Thiago Alcantara,19.7,45,26,17,23,5,12,33,36.4,21,12,3,9,45,90,13,1
53,Ruben Alcaraz,21.4,61,30,37,20,4,30,63,47.6,33,46,15,31,15,76,41,0
54,Toby Alderweireld,32.9,40,29,24,13,3,11,24,45.8,13,48,32,16,31,71,172,2
55,Haitam Aleesami,21.3,36,16,25,9,2,18,43,41.9,25,33,10,23,34,70,59,1
57,Carles Alena,1.9,2,1,1,1,0,1,4,25.0,3,1,0,1,0,2,0,0
58,Carles Alena,8.2,14,9,5,7,2,3,17,17.6,14,4,1,3,1,15,3,0
59,Runar Alex Runarsson,10.0,0,0,0,0,0,0,2,0.0,2,0,0,0,0,0,3,3
60,Trent Alexander-Arnold,35.3,55,34,35,17,3,36,78,46.2,42,27,9,18,45,100,84,3
62,Rachid Alioui,17.4,8,5,0,7,1,2,13,15.4,11,3,0,3,2,10,9,0
63,Alisson,28.3,0,0,0,0,0,0,2,0.0,2,0,0,0,1,1,13,3
64,Allan,14.2,50,27,20,21,9,18,54,33.3,36,19,3,16,16,66,11,1
65,Dele Alli,20.5,34,16,11,20,3,13,37,35.1,24,35,3,32,17,51,17,2
66,Miguel Almiron,33.6,60,39,32,20,8,19,52,36.5,33,25,1,24,31,91,25,0
67,Marcos Alonso,15.9,28,16,20,6,2,14,33,42.4,19,18,2,16,20,48,32,0
68,Mickael Alphonse,15.3,39,25,26,12,1,23,37,62.2,14,19,3,16,17,56,64,0
69,Sergio Alvarez,12.7,37,22,11,24,2,8,24,33.3,16,16,2,14,17,54,26,1
71,Yeray Alvarez,31.2,36,19,28,7,1,17,30,56.7,13,33,22,11,62,98,138,2
72,Bruno Alves,29.7,17,11,12,5,0,8,13,61.5,5,30,21,9,25,42,150,2
73,Steven Alzate,13.2,33,19,20,11,2,17,27,63.0,10,18,3,15,14,47,13,0
74,Ibrahim Amadou,8.4,18,11,9,8,1,3,11,27.3,8,8,5,3,16,34,55,1
75,Ibrahim Amadou,8.6,16,9,5,9,2,4,11,36.4,7,5,0,5,12,28,6,0
76,Romain Amalfitano,18.8,43,27,18,21,4,21,61,34.4,40,23,9,14,36,79,14,2
78,Amath,0.7,2,1,1,1,0,0,5,0.0,5,2,0,2,0,2,0,0
79,Jordan Amavi,24.0,55,29,31,19,5,31,64,48.4,33,27,6,21,56,111,97,0
80,Thierry Ambrose,6.1,7,5,2,2,3,2,7,28.6,5,3,0,3,3,10,3,0
81,Kelvin Amian,18.1,27,21,21,5,1,14,25,56.0,11,14,7,7,18,45,56,0
82,Nadiem Amiri,20.6,26,16,7,15,4,16,34,47.1,18,12,2,10,14,40,8,1
83,Ethan Ampadu,0.9,5,4,3,2,0,1,1,100.0,0,3,1,2,1,6,3,0
84,Opoku Ampomah,5.6,9,4,3,4,2,3,12,25.0,9,3,0,3,4,13,5,0
85,Sofyan Amrabat,32.4,58,36,26,21,11,26,55,47.3,29,29,10,19,31,89,15,1
86,Joachim Andersen,17.0,17,9,15,2,0,7,19,36.8,12,16,12,4,10,27,74,2
88,Felipe Anderson,16.6,46,32,20,21,5,11,47,23.4,36,19,1,18,22,68,11,0
89,Sebastian Andersson,29.8,20,10,0,12,8,4,19,21.1,15,19,3,16,5,25,36,0
90,Florin Andone,0.8,1,1,0,1,0,1,1,100.0,0,1,1,0,0,1,1,0
91,Benjamin Andre,22.8,72,44,31,35,6,29,74,39.2,45,32,9,23,59,131,40,1
92,Lorenzo Andrenacci,5.9,1,0,1,0,0,1,3,33.3,2,0,0,0,0,1,0,0
93,Robert Andrich,28.6,52,27,28,18,6,19,60,31.7,41,27,7,20,47,99,36,0
94,Victorien Angban,11.4,23,18,11,11,1,11,24,45.8,13,9,2,7,8,31,5,0
95,Miguel Angel Guerrero,8.8,1,0,0,1,0,1,10,10.0,9,4,0,4,2,3,4,0
96,Jose Angel,26.2,54,31,26,25,3,26,43,60.5,17,23,7,16,33,87,61,1
97,Miguel Angel Moya,13.0,0,0,0,0,0,0,1,0.0,1,0,0,0,1,1,6,2
98,Angelino,4.7,5,2,3,1,1,5,7,71.4,2,1,0,1,9,14,15,0
99,Angelino,12.2,15,9,7,5,3,5,15,33.3,10,14,1,13,19,34,24,0
101,Peter Ankersen,11.8,16,4,7,7,2,4,13,30.8,9,19,5,14,9,25,25,1
102,Cristian Ansaldi,19.6,37,25,24,7,6,19,34,55.9,15,23,3,20,14,51,20,4
105,Michail Antonio,19.6,13,9,5,4,4,4,14,28.6,10,17,2,15,9,22,5,0
106,Antonito,11.4,26,18,19,7,0,12,20,60.0,8,9,0,9,15,41,20,1
107,Mirko Antonucci,0.9,4,3,1,0,3,3,3,100.0,0,2,0,2,2,6,1,0
109,Christopher Antwi-Adjei,27.4,25,16,13,9,3,9,33,27.3,24,29,2,27,15,40,14,0
110,Anuar,2.1,4,2,1,2,1,2,6,33.3,4,7,3,4,5,9,0,0
111,Houssem Aouar,21.7,28,12,6,18,4,10,35,28.6,25,15,1,14,13,41,11,0
112,Adil Aouchiche,0.7,3,2,1,2,0,2,4,50.0,2,3,0,3,0,3,0,0
113,Dennis Appiah,17.8,58,35,32,20,6,28,52,53.8,24,9,3,6,23,81,34,0
114,Mauro Arambarri,34.1,72,33,24,40,8,31,69,44.9,38,52,5,47,43,115,40,2
115,Guilherme Arana,0.9,4,4,1,3,0,3,5,60.0,2,0,0,0,2,6,0,0
116,Charles Aranguiz,23.5,56,37,19,29,8,27,74,36.5,47,27,6,21,22,78,21,1
117,Luiz Araujo,9.2,20,11,3,8,9,5,31,16.1,26,14,0,14,4,24,6,0
118,Nestor Araujo,32.1,44,27,35,8,1,22,36,61.1,14,26,18,8,52,96,142,0
119,Ronald Araujo,2.6,3,2,2,1,0,1,1,100.0,0,6,2,4,0,3,9,0
120,Anaitz Arbilla,22.3,33,20,23,8,2,16,34,47.1,18,20,4,16,29,62,82,0
123,Santiago Arias,12.0,36,24,20,12,4,10,18,55.6,8,12,7,5,19,55,20,1
124,Nicolo Armini,0.0,1,1,1,0,0,1,1,100.0,0,0,0,0,0,1,1,0
125,Stuart Armstrong,19.1,32,19,19,11,2,9,38,23.7,29,22,4,18,11,43,23,1
126,Jose Arnaiz,8.8,3,2,0,2,1,0,12,0.0,12,7,0,7,5,8,5,0
127,Jose Arnaiz,3.7,3,0,1,2,0,2,5,40.0,3,4,0,4,2,5,1,0
128,Maximilian Arnold,31.3,42,24,15,23,4,16,62,25.8,46,25,6,19,25,67,35,0
130,Kepa Arrizabalaga,33.0,1,1,1,0,0,1,2,50.0,1,0,0,0,1,2,7,2
131,Kwadwo Asamoah,7.1,10,8,4,5,1,6,14,42.9,8,8,1,7,9,19,13,0
132,Santiago Ascacibar,7.0,26,13,15,11,0,11,28,39.3,17,13,2,11,16,42,13,0
133,Sergio Asenjo,34.0,0,0,0,0,0,0,2,0.0,2,0,0,0,1,1,15,1
134,Marco Asensio,3.7,4,3,3,1,0,1,4,25.0,3,2,0,2,1,5,4,0
136,Iago Aspas,36.2,29,19,7,9,13,12,45,26.7,33,16,1,15,22,51,7,0
137,Roger Assale,5.9,3,2,1,0,2,1,9,11.1,8,8,0,8,0,3,1,0
138,Youcef Atal,11.1,24,11,15,6,3,13,31,41.9,18,12,1,11,24,48,11,1
139,Miguel Atienza,0.3,1,1,0,1,0,1,2,50.0,1,1,1,0,2,3,1,0
140,Christian Atsu,8.3,10,8,5,5,0,5,14,35.7,9,19,0,19,5,15,9,0
141,Pierre-Emerick Aubameyang,34.8,31,19,10,12,9,12,51,23.5,39,39,1,38,14,45,16,0
142,Emil Audero,36.0,1,1,1,0,0,1,3,33.3,2,0,0,0,0,1,21,1
143,Tommaso Augello,12.6,14,9,6,3,5,5,7,71.4,2,8,0,8,15,29,21,1
144,Jean-Kevin Augustin,3.0,3,0,1,2,0,1,6,16.7,5,2,0,2,3,6,0,0
145,Ludwig Augustinsson,10.3,29,12,15,9,5,12,23,52.2,11,19,5,14,10,39,29,0
146,Serge Aurier,30.0,93,69,58,27,8,39,69,56.5,30,38,6,32,47,140,98,2
147,Mathias Autret,13.6,23,17,5,11,7,8,25,32.0,17,14,1,13,10,33,3,0
148,Ezequiel Avila,17.7,17,12,6,7,4,6,18,33.3,12,12,0,12,3,20,5,0
149,Javier Aviles,2.0,9,7,2,7,0,2,4,50.0,2,3,0,3,3,12,1,0
150,Chidozie Awaziem,22.2,34,22,29,5,0,16,27,59.3,11,26,15,11,28,62,73,1
151,Taiwo Awoniyi,5.4,2,0,0,2,0,0,4,0.0,4,4,2,2,2,4,3,0
152,Florian Aye,15.3,17,9,9,5,3,6,13,46.2,7,17,2,15,4,21,18,1
153,Jordan Ayew,35.0,48,30,10,22,16,17,49,34.7,32,29,4,25,15,63,21,0
154,Kaan Ayhan,30.3,38,25,26,11,1,20,37,54.1,17,28,15,13,45,83,72,1
156,Ramon Azeez,15.1,11,8,2,8,1,7,19,36.8,12,8,2,6,19,30,11,1
157,Cesar Azpilicueta,35.9,86,56,40,32,14,35,69,50.7,34,56,21,35,67,153,94,0
158,Ludovic Baal,9.2,27,15,13,12,2,10,22,45.5,12,9,3,6,17,44,20,0
159,Iddrisu Baba,32.3,59,37,26,29,4,20,70,28.6,50,31,8,23,39,98,42,0
160,Khouma Babacar,15.8,12,8,2,6,4,1,7,14.3,6,12,3,9,3,15,34,0
161,Carlos Bacca,7.6,5,1,1,2,2,2,6,33.3,4,4,0,4,0,5,7,0
162,Milan Badelj,17.6,29,17,10,16,3,15,50,30.0,35,21,3,18,45,74,34,1
163,Matthias Bader,0.1,1,1,1,0,0,1,2,50.0,1,0,0,0,0,1,1,0
164,Benoit Badiashile,15.7,18,12,12,5,1,6,12,50.0,6,20,11,9,27,45,57,1
167,Stephane Bahoken,10.1,7,4,1,2,4,1,7,14.3,6,4,1,3,2,9,2,0
168,Daniel Baier,21.6,33,17,14,14,5,15,43,34.9,28,19,7,12,58,91,27,0
169,Leon Bailey,12.1,6,3,1,5,0,6,16,37.5,10,9,0,9,8,14,3,0
170,Eric Bailly,1.7,0,0,0,0,0,0,1,0.0,1,3,3,0,4,4,7,1
171,Denys Bain,14.1,21,14,15,6,0,9,9,100.0,0,13,10,3,28,49,66,0
172,Leighton Baines,4.5,10,6,6,2,2,8,10,80.0,2,5,2,3,5,15,14,0
174,Tiemoue Bakayoko,19.1,48,24,16,27,5,29,54,53.7,25,12,4,8,29,77,17,0
175,Lewis Baker,6.1,8,5,6,2,0,2,10,20.0,8,5,2,3,2,10,5,0
176,Mitchel Bakker,1.0,2,2,1,1,0,1,1,100.0,0,0,0,0,0,2,2,0
177,Ridle Baku,26.1,54,31,25,22,7,26,53,49.1,27,45,7,38,42,96,57,0
178,Fabian Balbuena,13.1,17,12,13,3,1,9,25,36.0,16,15,5,10,26,43,75,3
179,Keita Balde,9.5,6,5,1,1,4,3,9,33.3,6,4,1,3,2,8,7,1
180,George Baldock,38.0,62,43,35,17,10,27,47,57.4,20,26,3,23,34,96,83,3
182,Gareth Bale,12.1,9,5,5,2,2,3,14,21.4,11,8,2,6,6,15,9,0
183,Mikel Balenziaga,6.3,15,10,4,10,1,9,11,81.8,2,4,1,3,2,17,20,0
184,Leonardo Balerdi,1.5,2,1,1,1,0,2,2,100.0,0,0,0,0,4,6,3,0
186,Fode Ballo-Toure,18.7,36,25,21,11,4,17,32,53.1,15,10,1,9,24,60,45,0
187,Florent Balmont,4.5,12,6,5,7,0,7,12,58.3,5,6,0,6,1,13,3,0
188,Mario Balotelli,15.6,2,2,0,2,0,0,2,0.0,2,1,1,0,8,10,22,0
189,Abdoulaye Bamba,6.2,10,7,7,1,2,8,15,53.3,7,4,1,3,4,14,18,0
190,Jonathan Bamba,21.5,12,6,5,5,2,7,29,24.1,22,19,3,16,16,28,8,2
191,Ever Banega,27.5,43,28,16,18,9,21,70,30.0,49,19,1,18,15,58,5,0
192,Mattia Bani,24.5,47,28,27,19,1,25,36,69.4,11,29,15,14,52,99,92,2
193,Antonin Barak,2.2,5,4,3,0,2,1,5,20.0,4,6,1,5,0,5,4,0
194,Antonin Barak,15.2,19,10,9,10,0,6,24,25.0,18,18,1,17,9,28,20,2
195,Federico Barba,5.0,12,6,10,2,0,7,9,77.8,2,5,2,3,8,20,12,0
196,Danilo Barbosa,12.5,28,21,17,9,2,13,29,44.8,16,21,6,15,20,48,38,0
198,Enis Bardhi,23.5,24,11,7,15,2,8,35,22.9,27,15,4,11,15,39,19,0
199,Phil Bardsley,21.0,49,36,16,24,9,24,37,64.9,13,24,11,13,30,79,73,0
200,Nicolo Barella,22.4,36,21,14,15,7,8,37,21.6,29,20,5,15,14,50,14,0
201,Philipp Bargfrede,6.5,15,12,8,5,2,6,23,26.1,17,8,2,6,16,31,15,0
202,Antonino Barilla,18.8,43,31,22,19,2,16,45,35.6,29,26,8,18,17,60,32,0
203,Kike Barja,3.5,1,1,1,0,0,1,1,100.0,0,3,1,2,0,1,2,0
204,Ross Barkley,12.3,16,9,6,6,4,5,18,27.8,13,7,2,5,7,23,7,0
205,Aymen Barkok,0.9,1,1,0,0,1,0,2,0.0,2,2,0,2,3,4,1,0
206,Ashley Barnes,15.0,10,5,3,5,2,3,9,33.3,6,7,2,5,6,16,9,0
208,Harvey Barnes,23.1,16,11,7,7,2,5,23,21.7,18,13,3,10,8,24,6,1
209,Antonio Barragan,7.1,7,5,4,2,1,3,6,50.0,3,2,2,0,8,15,22,0
210,Antonio Barreca,12.2,10,7,5,3,2,4,5,80.0,1,12,7,5,1,11,22,0
211,Leandro Barreiro Martins,10.4,38,21,16,19,3,14,29,48.3,15,18,3,15,9,47,18,1
212,Ander Barrenetxea,4.9,12,9,5,5,2,4,10,40.0,6,3,0,3,3,15,4,0
213,Edgar Barreto,1.0,4,3,0,1,3,2,3,66.7,1,1,0,1,0,4,0,0
214,Musa Barrow,15.0,20,13,11,7,2,6,20,30.0,14,15,0,15,5,25,11,0
215,Musa Barrow,2.1,1,1,0,0,1,1,4,25.0,3,4,0,4,0,1,1,0
216,Fin Bartels,3.8,9,5,4,4,1,3,12,25.0,9,3,1,2,1,10,1,0
217,Marc Bartra,28.0,62,34,39,23,0,27,54,50.0,27,45,24,21,35,97,127,0
218,Daniele Baselli,14.2,43,23,17,19,7,13,40,32.5,27,20,4,16,25,68,25,0
219,Chris Basham,36.0,85,48,58,20,7,48,81,59.3,33,38,15,23,77,162,173,1
220,Toma Basic,11.0,26,22,9,16,1,12,27,44.4,15,14,2,12,9,35,12,1
221,Thomas Basila,4.6,6,3,2,4,0,4,4,100.0,0,0,0,0,4,10,14,0
222,Gil Bastiao Dias,4.0,19,14,10,6,3,7,17,41.2,10,4,1,3,3,22,7,0
223,Gil Bastiao Dias,11.7,53,33,30,21,2,29,58,50.0,29,15,1,14,13,66,22,1
224,Borja Baston,0.2,1,0,0,1,0,0,2,0.0,2,1,0,1,0,1,0,1
225,Alessandro Bastoni,21.3,32,17,14,11,7,15,24,62.5,9,18,9,9,26,58,54,0
226,Bastos,8.5,9,5,6,3,0,4,11,36.4,7,13,8,5,13,22,26,0
227,Oliver Batista-Meier,0.1,0,0,0,0,0,0,2,0.0,2,0,0,0,0,0,0,0
228,Michy Batshuayi,2.7,4,1,2,2,0,0,5,0.0,5,1,1,0,0,4,1,0
229,Cristian Battocchio,15.5,31,24,13,13,5,14,36,38.9,22,13,4,9,19,50,21,0
231,Julian Baumgartlinger,19.9,42,21,15,21,6,18,42,42.9,24,37,4,33,20,62,16,1
232,Christoph Baumgartner,16.6,32,17,15,16,1,10,37,27.0,27,25,1,24,8,40,13,0
234,Noah Joel Sarenren Bazee,4.2,4,3,0,4,0,1,4,25.0,3,2,1,1,5,9,4,0
235,Ihlas Bebou,23.4,27,15,9,13,5,8,23,34.8,15,25,4,21,11,38,25,0
236,Rodrigo Becao,24.6,56,25,34,19,3,26,46,56.5,20,40,20,20,45,101,77,0
237,Sheraldo Becker,6.0,2,1,2,0,0,1,3,33.3,2,1,0,1,0,2,1,0
238,Timo Becker,3.7,10,9,3,6,1,5,9,55.6,4,6,1,5,3,13,8,0
239,Jan Bednarek,34.0,65,38,41,18,6,31,61,50.8,30,44,23,21,77,142,198,4
241,Valon Behrami,12.3,34,26,13,17,4,8,32,25.0,24,25,10,15,9,43,16,0
242,Maximilian Beier,1.2,5,2,0,1,4,1,2,50.0,1,2,0,2,0,5,0,0
243,Gaetan Belaud,6.4,13,7,10,2,1,4,8,50.0,4,8,3,5,15,28,15,0
244,Ishak Belfodil,3.0,0,0,0,0,0,0,1,0.0,1,0,0,0,0,0,2,0
245,Haris Belkebla,20.2,44,24,17,17,10,10,28,35.7,18,25,5,20,53,97,21,2
247,Raoul Bellanova,0.7,1,1,1,0,0,0,1,0.0,1,0,0,0,0,1,0,0
248,Karim Bellarabi,15.8,19,11,9,7,3,9,28,32.1,19,16,0,16,10,29,4,0
249,Jean-Ricner Bellegarde,16.6,40,27,18,19,3,13,21,61.9,8,16,3,13,22,62,6,0
250,Hector Bellerin,12.9,20,13,7,11,2,11,29,37.9,18,20,4,16,19,39,27,1
251,Andrea Belotti,33.4,29,16,7,17,5,5,31,16.1,26,23,5,18,5,34,20,1
252,Fran Beltran,20.3,31,19,15,12,4,11,35,31.4,24,14,1,13,14,45,17,0
253,Sami Ben Amar,0.2,1,1,0,0,1,1,1,100.0,0,1,0,1,1,2,0,0
254,Hatem Ben Arfa,1.8,0,0,0,0,0,0,4,0.0,4,1,0,1,0,0,0,0
255,Wissam Ben Yedder,24.0,22,16,2,12,8,8,19,42.1,11,12,0,12,4,26,1,0
256,Marco Benassi,10.9,18,12,9,5,4,10,24,41.7,14,11,1,10,4,22,9,0
257,Cristian Benavente,3.9,8,5,2,5,1,2,8,25.0,6,1,0,1,3,11,0,0
258,Lars Bender,15.3,42,26,17,20,5,19,38,50.0,19,32,6,26,24,66,30,0
260,Sven Bender,30.3,53,34,29,17,7,23,48,47.9,25,42,13,29,67,120,88,2
261,Dario Benedetto,23.3,12,9,0,9,3,3,18,16.7,15,15,2,13,3,15,23,1
262,Laszlo Benes,10.0,15,8,3,5,7,6,19,31.6,13,6,2,4,8,23,3,1
263,Walter Benitez,26.0,1,1,1,0,0,1,3,33.3,2,0,0,0,0,1,8,0
264,Loris Benito,21.1,40,25,23,11,6,16,43,37.2,27,14,5,9,29,69,58,1
265,Bilal Benkhedim,1.5,3,3,1,1,1,1,4,25.0,3,1,0,1,1,4,0,0
266,Ismael Bennacer,27.6,67,47,21,34,12,29,73,39.7,44,25,7,18,54,121,15,2
267,Ryan Bennett,6.7,4,2,4,0,0,2,6,33.3,4,14,8,6,9,13,29,0
268,Ryan Bennett,3.7,5,4,3,2,0,4,6,66.7,2,3,1,2,7,12,8,0
269,Keanan Bennetts,0.0,0,0,0,0,0,0,1,0.0,1,0,0,0,0,0,0,0
270,Yassine Benrahou,1.9,3,0,1,1,1,2,5,40.0,3,1,0,1,2,5,1,0
271,Yassine Benrahou,8.5,13,8,3,3,7,5,16,31.3,11,1,0,1,2,15,0,0
272,Ramy Bensebaini,16.1,33,17,17,12,4,18,31,58.1,13,24,4,20,38,71,49,0
273,Nabil Bentaleb,8.3,23,13,14,9,0,7,25,28.0,18,9,2,7,19,42,9,1
274,Rodrigo Bentancur,24.4,58,32,27,18,13,31,66,47.0,35,44,9,35,32,90,34,1
275,Christian Benteke,14.0,9,5,1,6,2,0,10,0.0,10,11,4,7,4,13,28,1
276,Romario Benzar,1.1,2,2,1,1,0,2,3,66.7,1,1,0,1,0,2,2,0
277,Karim Benzema,34.9,18,8,3,11,4,2,16,12.5,14,16,4,12,7,25,30,1
278,Yassine Benzia,1.9,3,2,2,1,0,1,6,16.7,5,4,2,2,3,6,1,0
279,Domenico Berardi,27.7,32,16,19,8,5,13,59,22.0,46,31,3,28,33,65,27,0
280,Yuri Berchiche,31.7,48,35,32,15,1,21,40,52.5,19,26,4,22,30,78,73,1
281,Alex Berenguer,20.3,20,6,6,13,1,8,33,24.2,25,17,1,16,18,38,17,0
282,Bartosz Bereszynski,26.7,53,35,25,23,5,26,52,50.0,26,38,16,22,35,88,88,1
283,Johann Berg Gudmundsson,6.9,4,2,2,2,0,1,8,12.5,7,8,1,7,7,11,9,0
286,Sander Berge,10.5,22,15,3,14,5,5,10,50.0,5,15,1,14,10,32,16,0
287,Steven Bergwijn,7.8,10,6,3,6,1,4,12,33.3,8,12,0,12,1,11,5,0
288,Robert Beric,4.6,3,2,0,2,1,0,5,0.0,5,2,0,2,4,7,2,0
289,Etrit Berisha,26.0,3,2,3,0,0,2,3,66.7,1,0,0,0,1,4,9,0
290,Valon Berisha,0.4,1,1,0,1,0,1,2,50.0,1,0,0,0,0,1,1,0
291,Valon Berisha,10.5,14,9,3,8,3,6,21,28.6,15,4,1,3,9,23,8,0
293,Bernard,14.2,32,22,12,14,6,13,44,29.5,31,22,2,20,16,48,7,0
294,Federico Bernardeschi,17.5,13,5,4,5,4,5,25,20.0,20,11,0,11,13,26,12,1
295,Bernardo,7.5,27,16,12,9,6,13,17,76.5,4,7,3,4,6,33,24,0
296,Paul Bernardoni,24.5,0,0,0,0,0,0,1,0.0,1,0,0,0,0,0,11,1
297,Juan Bernat,15.4,42,27,19,16,7,20,51,39.2,31,13,1,12,10,52,26,0
299,Andrea Bertolacci,5.9,7,4,2,3,2,1,8,12.5,7,4,1,3,2,9,13,0
300,Ryan Bertrand,30.5,47,29,22,15,10,26,58,44.8,32,27,12,15,37,84,31,1
301,Muhamed Besic,2.8,8,6,4,4,0,2,5,40.0,3,4,0,4,1,9,6,0
302,Jordan Beyer,1.2,3,1,3,0,0,0,1,0.0,1,4,2,2,1,4,4,0
303,Ermin Bicakcic,13.1,7,3,5,2,0,4,11,36.4,7,14,8,6,25,32,64,2
304,Pedro Bigas,19.7,18,9,11,7,0,9,19,47.4,10,16,10,6,36,54,82,0
305,Lucas Biglia,7.6,13,7,7,6,0,4,15,26.7,11,12,4,8,7,20,10,1
307,Philip Billing,28.1,72,46,30,37,5,17,65,26.2,48,59,16,43,66,138,97,1
308,Cristiano Biraghi,17.5,22,6,10,8,4,10,24,41.7,14,21,7,14,13,35,41,0
309,Davide Biraschi,21.9,32,17,17,13,2,15,26,57.7,11,22,12,10,34,66,69,0
310,Valter Birsa,4.8,10,6,3,6,1,7,21,33.3,14,6,1,5,4,14,3,0
312,Dimitri Bisoli,23.9,64,35,34,20,10,30,49,61.2,19,41,7,34,25,89,49,0
313,Yves Bissouma,14.0,49,38,24,22,3,17,40,42.5,23,18,2,16,21,70,23,0
315,Leonardo Bittencourt,21.0,52,28,23,18,11,9,51,17.6,42,20,3,17,12,64,14,0
316,Birkir Bjarnason,8.9,5,3,1,3,1,2,13,15.4,11,9,4,5,5,10,4,0
317,Ruben Blanco,32.9,1,1,1,0,0,1,1,100.0,0,0,0,0,0,1,14,1
318,Ludovic Blas,20.5,26,18,7,15,4,5,26,19.2,21,17,1,16,14,40,11,0
319,Pablo de Blasis,17.8,41,32,22,13,6,30,63,47.6,33,13,0,13,24,65,21,0
320,Alejandro Blesa,0.0,0,0,0,0,0,0,1,0.0,1,0,0,0,0,0,0,0
321,Alexis Blin,20.5,39,25,18,15,6,20,61,32.8,41,25,6,19,16,55,49,0
322,Jerome Boateng,20.0,21,14,9,12,0,11,22,50.0,11,15,11,4,33,54,58,1
323,Kevin-Prince Boateng,6.7,3,1,0,2,1,2,8,25.0,6,3,0,3,1,4,7,0
324,Antonin Bobichon,2.0,4,3,1,3,0,3,3,100.0,0,1,0,1,1,5,0,0
325,Antonin Bobichon,7.2,9,4,4,5,0,2,19,10.5,17,7,0,7,7,16,4,0
326,Salvatore Bocchetti,3.4,5,3,3,2,0,2,3,66.7,1,2,2,0,17,22,23,0
327,Mathieu Bodmer,1.0,0,0,0,0,0,0,1,0.0,1,1,1,0,1,1,1,0
328,Adam Bodzek,22.4,42,26,21,20,1,14,46,30.4,32,34,11,23,25,67,39,0
329,Jean-Paul Boetius,25.2,63,33,21,31,11,20,57,35.1,37,38,1,37,26,89,6,0
330,Sacha Boey,1.9,6,4,3,1,2,4,8,50.0,4,0,0,0,2,8,5,0
331,Jeremie Boga,27.9,12,7,3,8,1,6,20,30.0,14,24,0,24,3,15,4,0
332,Melayro Bogarde,0.6,2,1,2,0,0,2,2,100.0,0,0,0,0,0,2,3,0
333,Quentin Boisgard,12.7,31,19,10,14,7,14,35,40.0,21,11,0,11,12,43,4,1
334,Willy Boly,22.0,57,33,36,21,0,25,43,58.1,18,28,11,17,39,96,108,3
335,Giacomo Bonaventura,14.9,16,9,5,6,5,5,17,29.4,12,8,3,5,7,23,10,0
336,Federico Bonazzoli,8.3,7,5,1,4,2,0,7,0.0,7,3,0,3,5,12,2,0
339,Kevin Bonifazi,2.7,9,8,6,3,0,5,6,83.3,1,3,2,1,5,14,10,0
340,Kevin Bonifazi,13.2,16,9,15,1,0,9,18,50.0,9,20,12,8,35,51,50,2
342,Leonardo Bonucci,34.2,28,17,18,8,2,12,17,70.6,5,32,29,3,31,59,94,2
343,Fabio Borini,9.0,2,1,2,0,0,0,4,0.0,4,3,0,3,13,15,6,0
344,Fabio Borini,0.8,2,2,0,0,2,0,2,0.0,2,1,0,1,0,2,3,0
346,Robin Bormuth,2.0,2,1,2,0,0,2,3,66.7,1,6,5,1,0,2,12,0
347,Sebastiaan Bornauw,27.2,37,24,24,12,1,20,39,51.3,19,32,12,20,42,79,99,0
348,Brandon Borrello,3.3,10,4,6,4,0,4,10,40.0,6,7,1,6,1,11,1,0
349,Gabriel Boschilia,1.4,3,1,0,3,0,1,5,20.0,4,1,1,0,2,5,2,0
350,Denis Bouanga,22.7,45,34,10,25,10,20,55,36.4,35,30,0,30,10,55,15,0
351,Hicham Boudaoui,5.4,20,10,6,11,3,9,23,39.1,14,10,3,7,13,33,7,0
352,Ryad Boudebouz,17.7,25,16,9,14,2,8,25,32.0,17,14,1,13,7,32,5,0
353,Sofiane Boufal,8.5,16,8,6,5,5,6,15,40.0,9,17,0,17,4,20,1,0
354,Nassim Boujellab,4.7,12,10,5,4,3,5,14,35.7,9,8,1,7,7,19,5,0
355,Farid Boulaya,9.1,14,10,7,4,3,7,19,36.8,12,5,0,5,6,20,3,0
357,Mehdi Bourabia,10.3,19,9,8,10,1,9,22,40.9,13,12,2,10,22,41,23,0
358,Benjamin Bourigeaud,21.1,40,12,18,20,2,17,68,25.0,51,38,7,31,20,60,25,0
359,Bilal Boutobba,0.1,0,0,0,0,0,0,1,0.0,1,0,0,0,0,0,0,0
360,Jarrod Bowen,10.2,19,15,7,9,3,4,17,23.5,13,6,0,6,16,35,8,0
361,Dedryck Boyata,27.1,24,18,17,5,2,4,12,33.3,8,39,32,7,62,86,158,1
362,John Boye,23.5,30,19,25,5,0,19,32,59.4,13,31,18,13,31,61,116,0
364,Can Bozdogan,2.6,8,6,5,3,0,3,12,25.0,9,2,0,2,2,10,2,0
365,Domagoj Bradaric,15.8,28,11,9,17,2,12,27,44.4,15,16,3,13,22,50,28,0
366,Filip Bradaric,7.8,12,9,5,5,2,3,8,37.5,5,12,3,9,17,29,19,0
367,Robbie Brady,5.0,11,9,5,4,2,3,10,30.0,7,10,2,8,5,16,8,0
368,Martin Braithwaite,4.5,2,2,2,0,0,0,8,0.0,8,3,0,3,1,3,1,0
369,Martin Braithwaite,21.5,13,7,4,5,4,4,12,33.3,8,10,2,8,4,17,9,0
371,Brandon,4.5,5,3,1,3,1,0,5,0.0,5,4,0,4,0,5,1,0
372,Julian Brandt,24.5,48,33,15,21,12,25,55,45.5,30,35,2,33,16,64,10,1
373,Jarrad Branthwaite,3.3,8,7,5,3,0,3,5,60.0,2,6,3,3,2,10,12,0
374,Darko Brasanac,24.9,45,25,14,26,5,15,41,36.6,26,19,4,15,20,65,21,0
376,Josip Brekalo,18.6,18,8,5,6,7,5,23,21.7,18,26,0,26,16,34,4,0
377,Gleison Bremer,25.2,63,36,37,20,6,20,34,58.8,14,48,22,26,74,137,118,1
379,Anthony Briancon,19.3,29,19,20,9,0,17,34,50.0,17,22,16,6,39,68,80,0
380,Jimmy Briand,16.9,12,8,5,4,3,3,13,23.1,10,8,4,4,6,18,12,0
381,Yan Brice Eteki,16.7,37,21,14,18,5,15,31,48.4,16,17,4,13,24,61,20,1
383,Dylan Bronn,9.0,7,5,6,1,0,4,7,57.1,3,11,9,2,6,13,42,0
384,David Brooks,5.6,5,5,1,2,2,2,14,14.3,12,5,1,4,2,7,1,0
385,John Brooks,24.7,38,27,27,9,2,24,49,49.0,25,31,12,19,41,79,93,0
386,Daniel Brosinski,19.0,40,27,13,23,4,15,34,44.1,19,16,2,14,14,54,58,0
387,Josh Brownhill,8.9,14,8,5,7,2,5,13,38.5,8,9,4,5,14,28,18,0
388,Marcelo Brozovic,30.0,67,35,26,31,10,19,71,26.8,52,26,9,17,46,113,46,2
390,Gaston Brugman,16.2,47,24,25,15,7,19,46,41.3,27,33,15,18,27,74,19,2
391,Jeffrey Bruma,9.0,9,5,4,5,0,7,13,53.8,6,6,3,3,13,22,51,1
392,Jeffrey Bruma,7.5,12,8,8,4,0,4,6,66.7,2,11,5,6,6,18,34,1
393,Jacob Bruun Larsen,4.3,3,2,3,0,0,3,8,37.5,5,3,0,3,3,6,1,0
395,Lucas Buades,1.3,4,4,3,1,0,1,5,20.0,4,0,0,0,1,5,3,0
396,Ante Budimir,30.7,31,15,4,22,5,7,29,24.1,22,21,4,17,8,39,29,0
397,Emi Buendia,27.4,82,39,57,21,4,38,118,32.2,80,58,5,53,23,105,32,2
399,Marius Bulter,25.8,38,22,19,13,6,17,54,31.5,37,37,3,34,11,49,20,1
400,Esteban Burgos,12.4,11,9,9,2,0,5,9,55.6,4,11,6,5,17,28,66,2
401,Guido Burgstaller,13.7,7,3,0,5,2,4,15,26.7,11,12,3,9,4,11,10,0
403,Jonathan Burkardt,2.8,9,4,2,5,2,3,8,37.5,5,6,1,5,0,9,1,0
404,Oliver Burke,15.9,19,14,8,9,2,10,23,43.5,13,24,0,24,8,27,16,0
405,Roman Burki,30.8,2,2,2,0,0,2,3,66.7,1,1,0,1,2,4,13,1
406,Dan Burn,32.0,67,42,35,27,5,25,53,47.2,28,44,20,24,42,109,130,0
407,Patrick Burner,15.9,35,25,15,17,3,14,25,56.0,11,11,2,9,30,65,37,0
408,Sergio Busquets,27.6,80,44,23,43,14,41,71,57.7,30,36,5,31,44,124,24,2
409,Unai Bustinza,29.8,66,40,40,19,7,32,53,60.4,21,30,9,21,65,131,77,0
410,Ludovic Butelle,26.0,1,1,1,0,0,1,2,50.0,1,1,0,1,0,1,10,4
412,Sam Byram,14.4,40,22,24,11,5,18,37,48.6,19,16,8,8,26,66,73,0
413,Erick Cabaco,3.0,3,2,1,2,0,0,3,0.0,3,1,1,0,3,6,11,0
414,Erick Cabaco,9.0,12,9,9,3,0,4,6,66.7,2,12,7,5,12,24,50,1
417,Yohan Cabaye,9.5,29,18,11,14,4,14,25,56.0,11,10,0,10,22,51,7,1
418,Manuel Cabit,3.0,3,1,1,2,0,2,10,20.0,8,5,0,5,4,7,5,0
419,Ariday Cabrera,0.4,1,1,1,0,0,0,1,0.0,1,2,0,2,0,1,0,0
420,Leandro Cabrera,17.0,10,6,5,5,0,5,12,41.7,7,10,4,6,21,31,66,0
421,Leandro Cabrera,17.0,27,11,17,9,1,17,28,60.7,11,19,12,7,21,48,78,1
422,Fabrizio Cacciatore,12.8,14,4,9,4,1,6,9,66.7,3,10,6,4,16,30,44,0
423,Martin Caceres,26.2,47,31,34,11,2,16,34,47.1,18,29,13,16,31,78,74,2
424,Anthony Caci,7.7,29,17,19,9,1,8,17,47.1,9,15,5,10,19,48,15,1
425,Jhonder Cadiz,8.9,16,8,6,7,3,3,7,42.9,4,4,2,2,1,17,9,0
426,Mathieu Cafaro,10.3,12,6,5,5,2,6,17,35.3,11,13,0,13,2,14,0,0
427,Jonathan Cafu,2.2,7,3,4,3,0,4,7,57.1,3,1,0,1,1,8,3,0
428,Gary Cahill,24.1,15,8,11,4,0,7,15,46.7,8,34,25,9,18,33,114,1
429,Felipe Caicedo,15.6,17,10,4,7,6,2,11,18.2,9,9,1,8,4,21,2,0
430,Arturo Calabresi,20.9,53,33,29,20,4,33,75,44.0,42,24,11,13,29,82,60,0
431,Davide Calabria,18.0,52,33,28,22,2,17,41,41.5,24,23,5,18,21,73,47,1
432,Riccardo Calafiori,0.7,0,0,0,0,0,0,1,0.0,1,0,0,0,2,2,0,0
433,Mattia Caldara,10.7,21,11,12,8,1,5,11,45.5,6,9,5,4,30,51,22,1
434,Marco Calderoni,22.9,38,25,22,13,3,20,39,51.3,19,27,10,17,37,75,54,1
435,Fernando Calero,11.6,14,9,10,4,0,7,15,46.7,8,13,5,8,8,22,42,1
436,Duje Caleta-Car,21.0,29,15,17,11,1,18,26,69.2,8,17,6,11,26,55,98,0
437,Hakan Calhanoglu,30.0,42,21,15,21,6,12,35,34.3,23,26,2,24,26,68,26,1
438,Daniel Caligiuri,25.5,58,37,18,25,15,27,74,36.5,47,67,6,61,25,83,39,0
439,Jose Callejon,24.1,13,9,3,7,3,9,25,36.0,16,15,3,12,10,23,14,1
440,Jonathan Calleri,20.1,12,8,6,4,2,3,24,12.5,21,11,3,8,7,19,22,0
442,Dominic Calvert-Lewin,29.2,7,5,1,4,2,1,10,10.0,9,15,2,13,6,13,36,0
443,Mahdi Camara,10.0,33,20,12,16,5,18,32,56.3,14,20,2,18,18,51,5,0
444,Souleymane Camara,1.8,0,0,0,0,0,0,2,0.0,2,0,0,0,0,0,1,0
446,Victor Camarasa,14.4,18,10,5,10,3,7,18,38.9,11,8,3,5,15,33,12,0
447,Eduardo Camavinga,23.4,105,64,45,56,4,48,96,50.0,48,26,8,18,34,139,35,0
449,Jose Campana,35.1,38,25,15,13,10,13,53,24.5,40,30,5,25,44,82,42,2
450,Xisco Campos,5.3,7,4,5,2,0,5,9,55.6,4,8,5,3,11,18,23,0
451,Victor Campuzano,9.7,12,9,1,6,5,3,19,15.8,16,8,0,8,2,14,4,0
452,Emre Can,3.2,10,7,5,3,2,3,10,30.0,7,4,0,4,2,12,3,0
453,Emre Can,10.6,19,12,11,7,1,5,12,41.7,7,14,6,8,19,38,15,0
454,Sergio Canales,35.1,25,16,14,6,5,7,28,25.0,21,30,1,29,13,38,16,0
455,Joao Cancelo,13.4,40,24,21,12,7,24,40,60.0,16,9,2,7,21,61,18,0
456,Antonio Candreva,22.1,11,6,9,1,1,7,29,24.1,22,26,10,16,14,25,33,1
458,Todd Cantwell,27.7,51,31,19,27,5,26,73,35.6,47,38,2,36,18,69,35,1
459,Ander Capa,31.9,64,36,37,21,6,24,59,40.7,35,26,7,19,28,92,63,0
460,Pierrick Capelle,19.4,42,32,18,16,8,16,48,33.3,32,17,3,14,21,63,28,0
461,Etienne Capoue,29.2,75,40,38,30,7,37,85,43.5,48,30,11,19,68,143,61,0
462,Gianluca Caprari,7.4,9,7,1,6,2,4,13,30.8,9,5,0,5,7,16,1,0
463,Gianluca Caprari,6.5,1,1,0,1,0,0,5,0.0,5,7,2,5,4,5,2,0
464,Francesco Caputo,32.6,7,4,3,2,2,3,11,27.3,8,15,0,15,1,8,8,0
465,Maxence Caqueret,6.3,24,15,10,13,1,11,25,44.0,14,14,2,12,9,33,6,1
466,Andrea Carboni,4.1,8,4,3,5,0,3,4,75.0,1,6,6,0,7,15,20,0
468,Irvin Cardona,16.1,13,8,5,6,2,9,32,28.1,23,8,0,8,1,14,7,0
469,Marc Cardona,7.8,1,0,0,1,0,0,8,0.0,8,3,1,2,2,3,2,0
470,Diego Carlos,34.8,35,23,25,9,1,15,25,60.0,10,33,24,9,37,72,176,1
471,Lionel Carole,14.1,23,8,15,6,2,13,17,76.5,4,2,1,1,19,42,22,0
472,Yannick Carrasco,7.0,11,7,4,4,3,7,21,33.3,14,9,0,9,5,16,2,0
473,Daniel Carrico,9.4,8,2,4,3,1,1,6,16.7,5,4,3,1,8,16,23,0
474,Guido Carrillo,13.5,13,10,3,6,4,2,14,14.3,12,9,1,8,3,16,22,0
475,Andy Carroll,7.0,5,3,3,2,0,2,8,25.0,6,2,1,1,2,7,24,1
476,Dani Carvajal,30.4,65,46,33,25,7,23,42,54.8,19,43,14,29,36,101,53,0
477,Matis Carvalho,0.8,0,0,0,0,0,0,1,0.0,1,0,0,0,0,0,1,0
478,William Carvalho,9.9,7,4,4,2,1,4,14,28.6,10,7,5,2,4,11,8,1
479,Casemiro,34.3,96,60,43,45,8,39,99,39.4,60,53,10,43,68,164,72,0
480,Moreto Cassama,6.6,17,11,2,13,2,5,7,71.4,2,7,2,5,5,22,6,0
481,Francesco Cassata,16.2,20,10,12,5,3,9,30,30.0,21,12,2,10,11,31,11,0
482,Timothy Castagne,19.7,31,20,9,16,6,13,25,52.0,12,34,5,29,17,48,23,0
484,Jean-Charles Castelletto,20.4,18,9,13,5,0,9,18,50.0,9,20,16,4,33,51,87,1
485,Samu Castillejo,13.4,24,15,10,11,3,9,42,21.4,33,17,2,15,24,48,5,0
486,Jonny Castro,32.1,91,55,54,26,11,29,82,35.4,53,45,10,35,53,144,45,2
487,Lucas Castro,4.7,13,5,5,5,3,2,4,50.0,2,4,0,4,2,15,3,0
488,Lucas Castro,6.7,7,3,3,4,0,1,12,8.3,11,6,1,5,8,15,14,0
489,Gaetano Castrovilli,29.7,59,31,25,23,11,18,53,34.0,35,29,2,27,15,74,31,1
490,Danilo Cataldi,6.6,17,11,10,5,2,10,20,50.0,10,7,1,6,13,30,10,0
491,Craig Cathcart,27.6,41,26,25,15,1,10,24,41.7,14,19,16,3,25,66,136,1
492,Edinson Cavani,6.7,5,1,0,2,3,0,3,0.0,3,7,0,7,1,6,2,0
494,Santi Cazorla,27.2,48,25,14,21,13,20,57,35.1,37,23,1,22,19,67,16,2
495,Dani Ceballos,18.8,45,23,26,14,5,18,61,29.5,43,14,3,11,32,77,16,1
496,Federico Ceccherini,9.3,14,8,11,3,0,10,10,100.0,0,9,5,4,13,27,37,1
498,Zeki Celik,23.0,53,28,18,28,7,27,60,45.0,33,24,4,20,26,79,39,0
499,Fabien Centonze,28.0,76,49,53,22,1,34,57,59.6,23,30,11,19,59,135,98,0
500,Luca Ceppitelli,13.8,22,15,16,6,0,6,11,54.5,5,23,17,6,23,45,66,2
501,Alberto Cerri,4.7,2,1,0,2,0,1,3,33.3,2,1,0,1,0,2,3,0
502,Alberto Cerri,2.7,3,1,1,0,2,2,6,33.3,4,1,0,1,2,5,4,0
503,Julian Chabot,6.3,11,7,6,5,0,6,11,54.5,5,3,2,1,15,26,26,0
505,Fouad Chafik,17.0,32,21,22,7,3,17,36,47.2,19,12,5,7,26,58,36,0
506,Sofian Chakla,2.0,0,0,0,0,0,0,1,0.0,1,2,1,1,3,3,7,1
507,Nathaniel Chalobah,10.3,30,11,13,13,4,12,27,44.4,15,10,4,6,18,48,20,0
508,Calum Chambers,12.2,26,10,12,8,6,11,16,68.8,5,13,7,6,16,42,43,1
509,Jhon Chancellor,24.9,30,14,22,8,0,11,22,50.0,11,34,29,5,34,64,145,3
510,Timothy Chandler,13.6,22,10,9,8,5,9,16,56.3,7,9,4,5,13,35,21,0
511,Kwon Chang-hoon,7.5,7,4,2,3,2,1,10,10.0,9,5,1,4,7,14,14,0
512,Gaetan Charbonnier,22.9,36,16,11,11,14,10,35,28.6,25,19,6,13,7,43,33,1
513,Brendan Chardonnet,9.1,12,6,10,2,0,7,12,58.3,5,8,5,3,15,27,50,0
514,Charles,14.5,10,5,0,6,4,4,22,18.2,18,7,2,5,7,17,6,0
515,Xavier Chavalerin,23.9,71,52,29,33,9,19,49,38.8,30,23,8,15,36,107,36,0
516,Pablo Chavarria,2.3,1,1,0,1,0,0,4,0.0,4,1,1,0,1,2,2,0
517,Aurelien Chedjou,21.9,27,19,18,9,0,10,22,45.5,12,15,11,4,40,67,120,3
518,Pape Cheikh Diop,6.7,10,4,6,3,1,2,12,16.7,10,4,2,2,5,15,3,0
520,Chema,3.4,4,3,1,3,0,1,2,50.0,1,1,0,1,5,9,12,0
521,Rayan Cherki,1.6,3,2,0,1,2,3,4,75.0,1,3,0,3,0,3,0,0
522,Denis Cheryshev,10.3,16,9,5,4,7,3,17,17.6,14,15,1,14,7,23,10,0
523,Giorgio Chiellini,2.2,3,0,3,0,0,1,1,100.0,0,2,2,0,1,4,9,0
524,Federico Chiesa,29.3,38,22,13,15,10,10,52,19.2,42,19,0,19,6,44,6,0
525,Ben Chilwell,26.4,43,26,28,13,2,23,52,44.2,29,30,6,24,28,71,68,2
526,Vlad Chiriches,7.9,14,9,12,2,0,7,10,70.0,3,13,8,5,11,25,28,2
528,Joris Chotard,13.9,30,18,13,17,0,15,35,42.9,20,12,5,7,20,50,12,1
529,Hamza Choudhury,9.9,17,8,7,8,2,3,25,12.0,22,15,6,9,24,41,13,0
530,Mounir Chouiar,16.7,36,23,13,18,5,12,42,28.6,30,8,0,8,13,49,13,0
531,Andreas Christensen,19.5,38,21,25,12,1,15,21,71.4,6,12,8,4,29,67,56,0
532,Samuel Chukwueze,22.8,23,14,12,6,5,13,30,43.3,17,15,1,14,10,33,14,1
533,Darko Churlinov,0.2,1,1,1,0,0,1,2,50.0,1,0,0,0,1,2,0,0
534,Churripi,2.7,1,1,1,0,0,1,1,100.0,0,0,0,0,0,1,2,0
535,Luca Cigarini,17.8,37,20,23,13,1,16,40,40.0,24,28,10,18,20,57,29,0
536,Per Ciljan Skjelbred,18.1,50,30,18,29,3,17,41,41.5,24,14,3,11,23,73,17,0
537,Jasper Cillessen,23.3,0,0,0,0,0,0,1,0.0,1,0,0,0,3,3,3,1
538,Thiago Cionek,24.1,53,32,36,12,5,22,53,41.5,31,30,11,19,46,99,91,2
541,Andrea Cistana,20.4,20,8,13,7,0,6,17,35.3,11,38,34,4,33,53,96,1
542,Ciaran Clark,13.2,20,12,18,2,0,9,15,60.0,6,18,14,4,11,31,82,0
544,Alexis Claude-Maurice,18.1,26,16,8,11,7,13,35,37.1,22,20,4,16,11,37,4,0
550,Carlos Clerc,20.5,28,16,14,13,1,12,20,60.0,8,22,9,13,22,50,61,0
551,Tom Cleverley,10.8,28,15,8,14,6,9,36,25.0,27,13,1,12,10,38,15,0
552,Conor Coady,38.0,36,23,30,6,0,15,30,50.0,15,22,15,7,28,64,119,2
553,Marcus Coco,0.2,1,0,1,0,0,1,1,100.0,0,0,0,0,0,1,0,0
554,Renaud Cohade,8.5,28,20,11,12,5,12,28,42.9,16,14,3,11,8,36,6,0
555,Coke,11.0,25,18,14,8,3,14,30,46.7,16,9,2,7,13,38,19,0
556,Seamus Coleman,20.4,42,31,24,14,4,19,25,76.0,6,21,9,12,24,66,43,1
558,Ebrima Colley,0.9,2,1,1,0,1,1,2,50.0,1,1,0,1,1,3,0,0
559,Omar Colley,30.8,42,26,27,14,1,12,24,50.0,12,33,22,11,59,101,155,1
560,Jamilu Collins,29.6,69,43,44,21,4,37,62,59.7,25,53,19,34,70,139,91,1
563,Racine Coly,7.2,21,13,15,5,1,9,17,52.9,8,5,0,5,12,33,23,0
564,Kingsley Coman,16.7,19,11,6,7,6,12,27,44.4,15,9,0,9,4,23,3,0
565,Daniel Congre,21.6,37,27,20,16,1,18,38,47.4,20,8,7,1,47,84,66,1
566,Aaron Connolly,14.0,7,6,1,4,2,3,10,30.0,7,11,0,11,0,7,3,0
567,Andrea Consigli,31.0,0,0,0,0,0,0,1,0.0,1,0,0,0,4,4,19,2
568,Andrea Conti,19.2,41,25,23,15,3,21,49,42.9,28,21,8,13,43,84,42,1
569,Lewis Cook,15.0,27,14,15,9,3,10,47,21.3,37,17,5,12,17,44,17,1
570,Steve Cook,27.0,22,11,18,4,0,8,20,40.0,12,32,23,9,44,66,153,1
572,Francis Coquelin,21.2,37,21,25,11,1,16,38,42.1,22,19,9,10,38,75,25,0
573,Gabriele Corbo,1.4,1,1,1,0,0,0,3,0.0,3,2,2,0,4,5,5,0
574,Sebastien Corchia,3.0,2,1,2,0,0,2,4,50.0,2,5,2,3,5,7,8,0
575,Inigo Cordoba,16.0,33,20,16,12,5,14,52,26.9,38,30,2,28,16,49,13,0
576,Jhon Cordoba,22.2,9,6,1,5,3,3,13,23.1,10,19,1,18,5,14,17,0
577,Sergio Cordova,4.1,3,0,0,2,1,1,10,10.0,9,0,0,0,0,3,3,0
578,Benjamin Corgnet,2.9,1,1,1,0,0,1,3,33.3,2,2,0,2,2,3,3,0
579,Jack Cork,29.0,35,24,10,20,5,12,62,19.4,50,34,12,22,28,63,49,0
580,Andreas Cornelius,16.6,9,4,2,5,2,4,11,36.4,7,7,0,7,2,11,26,0
581,Maxwel Cornet,14.8,30,19,18,8,4,13,23,56.5,10,16,1,15,21,51,19,1
582,Quentin Cornette,3.9,8,3,3,2,3,3,9,33.3,6,7,1,6,6,14,5,0
583,Angel Correa,22.9,25,9,7,9,9,9,36,25.0,27,23,5,18,14,39,21,0
584,Joaquin Correa,22.2,13,7,3,7,3,5,24,20.8,19,5,1,4,7,20,10,0
585,Rober Correa,10.3,13,6,8,3,2,6,10,60.0,4,6,4,2,16,29,31,0
586,Edmilson Correia,0.5,0,0,0,0,0,0,1,0.0,1,1,0,1,1,1,0,0
587,Thierry Correia,2.9,8,3,5,3,0,1,2,50.0,1,5,0,5,2,10,10,0
588,Antonio Cortes,2.0,1,1,0,1,0,0,1,0.0,1,0,0,0,0,1,2,0
589,Danny da Costa,15.4,26,17,14,8,4,6,16,37.5,10,16,1,15,15,41,26,0
590,Diego Costa,15.0,9,5,1,4,4,1,10,10.0,9,4,2,2,3,12,10,0
591,Douglas Costa,8.9,2,1,1,1,0,1,12,8.3,11,7,0,7,5,7,5,0
592,Jaume Costa,15.4,27,23,17,8,2,14,28,50.0,14,11,6,5,24,51,52,1
594,Nuno da Costa,5.9,15,10,3,8,4,4,10,40.0,6,7,0,7,4,19,3,0
595,David Costas,3.8,4,3,3,1,0,2,4,50.0,2,3,3,0,8,12,12,0
596,Benoit Costil,28.0,0,0,0,0,0,0,3,0.0,3,0,0,0,2,2,9,0
598,Kalifa Coulibaly,18.0,11,7,0,5,6,3,5,60.0,2,3,1,2,6,17,32,0
599,Senou Coulibaly,7.4,14,7,11,3,0,2,4,50.0,2,11,10,1,10,24,44,1
600,Yoann Court,16.3,48,26,28,17,3,20,64,31.3,44,21,0,21,15,63,14,0
601,Thibaut Courtois,34.0,0,0,0,0,0,0,2,0.0,2,0,0,0,2,2,18,2
602,Philippe Coutinho,15.7,21,15,1,13,7,2,13,15.4,11,9,2,7,6,27,0,0
603,Nicolas Cozza,6.2,5,5,3,2,0,2,3,66.7,1,8,6,2,9,14,18,0
605,Aaron Cresswell,30.3,43,26,21,18,4,23,46,50.0,23,33,10,23,35,78,75,2
606,Domenico Criscito,22.8,53,33,34,12,7,24,56,42.9,32,25,13,12,53,106,81,1
607,Bryan Cristante,18.0,25,15,6,14,5,8,27,29.6,19,13,4,9,22,47,23,0
608,Sebastian Cristoforo,1.0,5,5,2,2,1,1,5,20.0,4,2,1,1,1,6,0,0
609,Sebastian Cristoforo,9.7,35,19,11,14,10,13,32,40.6,19,25,3,22,8,43,2,0
610,Juan Cuadrado,29.5,67,43,32,28,7,35,62,56.5,27,22,8,14,35,102,47,0
611,Cucho,16.5,15,8,6,8,1,6,21,28.6,15,14,1,13,10,25,15,0
612,Marc Cucurella,36.0,74,51,23,38,13,24,76,31.6,52,58,8,50,36,110,28,1
613,Ivan Cuellar,27.0,0,0,0,0,0,0,2,0.0,2,0,0,0,0,0,28,2
614,Jaume Cuellar,0.8,1,0,0,0,1,0,1,0.0,1,0,0,0,0,1,0,0
615,Mickael Cuisance,3.4,2,1,0,2,0,1,9,11.1,8,1,1,0,3,5,0,0
616,Matheus Cunha,8.3,10,5,6,4,0,4,11,36.4,7,11,1,10,10,20,1,0
617,Matheus Cunha,3.1,6,2,0,1,5,0,2,0.0,2,5,1,4,1,7,0,0
619,Patrick Cutrone,3.3,4,2,2,1,1,1,5,20.0,4,1,1,0,2,6,1,0
620,Patrick Cutrone,9.3,4,2,2,1,1,1,15,6.7,14,6,1,5,2,6,6,0
621,Wylan Cyprien,19.7,17,11,5,12,0,7,27,25.9,20,8,2,6,19,36,16,3
622,Rafael Czichos,24.5,43,34,26,16,1,22,45,48.9,23,24,13,11,35,78,110,1
625,Marco D'Alessandro,8.7,11,8,5,3,3,5,8,62.5,3,11,0,11,5,16,6,0
626,Danilo D'Ambrosio,15.6,30,16,16,12,2,16,33,48.5,17,15,4,11,14,44,25,0
628,Lucas Da Cunha,0.8,1,0,1,0,0,1,1,100.0,0,0,0,0,0,1,0,0
630,Damien Da Silva,24.9,27,14,20,5,2,10,19,52.6,9,21,13,8,26,53,143,1
632,Moanes Dabbur,8.5,8,5,1,3,4,3,10,30.0,7,6,2,4,4,12,1,0
633,Bryan Dabo,12.5,18,10,13,4,1,5,15,33.3,10,13,2,11,9,27,14,0
634,Colin Dagba,7.4,10,4,2,4,4,5,9,55.6,4,6,1,5,6,16,9,0
635,Mahmoud Dahoud,6.2,10,6,4,4,2,6,18,33.3,12,8,2,6,8,18,4,0
636,Leon Dajaku,0.1,0,0,0,0,0,0,1,0.0,1,0,0,0,0,0,0,0
637,Felipe dal Belo,11.1,13,6,9,4,0,9,15,60.0,6,14,12,2,9,22,30,0
639,Diogo Dalot,0.7,3,2,3,0,0,3,4,75.0,1,1,0,1,2,5,1,0
640,Charlie Daniels,1.4,1,1,0,1,0,0,1,0.0,1,2,0,2,1,2,5,1
641,Danilo,16.0,30,20,16,12,2,18,30,60.0,12,12,3,9,26,56,44,0
642,Arnaut Danjuma,7.0,4,2,3,1,0,1,4,25.0,3,2,0,2,8,12,4,1
643,Scott Dann,14.1,8,4,7,1,0,8,14,57.1,6,9,7,2,14,22,67,0
644,Kevin Danso,3.1,6,4,3,3,0,4,7,57.1,3,7,3,4,2,8,7,0
645,Dante,21.0,34,21,24,10,0,17,25,68.0,8,27,16,11,26,60,79,0
647,Sergi Darder,29.5,47,23,11,26,10,17,58,29.3,41,30,1,29,24,71,23,1
648,Vladimir Darida,25.1,50,27,14,31,5,11,48,22.9,37,44,7,37,27,77,19,2
650,Matteo Darmian,29.8,81,42,48,30,3,40,83,48.2,43,38,16,22,25,106,78,1
651,Alphonso Davies,24.8,70,43,35,24,11,38,58,65.5,20,35,6,29,31,101,51,0
652,Ben Davies,15.9,28,15,13,11,4,7,21,33.3,14,28,12,16,22,50,47,0
653,Tom Davies,22.5,38,17,12,22,4,17,55,30.9,38,12,4,8,35,73,28,0
654,Keinan Davis,6.1,1,1,0,1,0,0,3,0.0,3,4,0,4,0,1,3,0
655,Pawel Dawidowicz,7.7,15,12,11,4,0,5,11,45.5,6,6,5,1,12,27,26,0
656,Craig Dawson,26.2,29,18,16,13,0,17,31,54.8,14,41,32,9,34,63,116,0
657,Kevin De Bruyne,31.0,45,24,8,20,17,18,66,27.3,48,26,4,22,18,63,24,2
658,Sebastien De Maio,16.7,18,11,11,7,0,7,11,63.6,4,28,20,8,32,50,86,2
659,Rodrigo De Paul,31.4,61,31,31,26,4,27,65,41.5,38,38,3,35,29,90,8,1
660,Mattia De Sciglio,5.2,10,8,6,4,0,6,14,42.9,8,5,2,3,8,18,18,1
661,Lorenzo De Silvestri,24.9,15,8,4,7,4,11,27,40.7,16,20,7,13,19,34,72,0
662,Lucas Deaux,14.8,49,26,16,29,4,16,45,35.6,29,20,4,16,15,64,19,0
663,Mathieu Debuchy,19.7,44,26,22,15,7,24,47,51.1,23,21,11,10,43,87,59,0
664,Troy Deeney,24.7,19,12,6,10,3,6,29,20.7,23,13,1,12,11,30,27,0
665,Gregoire Defrel,10.9,12,8,4,6,2,4,15,26.7,11,9,0,9,3,15,5,0
667,Alessandro Deiola,8.0,16,9,9,7,0,9,24,37.5,15,12,4,8,8,24,14,1
668,Romain Del Castillo,13.8,20,14,5,11,4,6,27,22.2,21,12,2,10,7,27,7,0
669,Thomas Delaine,13.9,25,16,18,6,1,12,21,57.1,9,17,1,16,15,40,28,0
670,Thomas Delaney,9.2,22,10,10,11,1,9,15,60.0,6,16,7,9,26,48,26,0
672,Cristian Dell'Orco,11.2,22,12,14,7,1,8,14,57.1,6,11,7,4,16,38,33,0
673,Andy Delort,25.3,28,18,11,9,8,7,27,25.9,20,21,6,15,3,31,10,0
674,Fabian Delph,13.2,26,12,10,13,3,9,22,40.9,13,12,3,9,15,41,19,1
676,Moussa Dembele,24.3,12,7,2,5,5,4,14,28.6,10,14,3,11,5,17,31,0
677,Ousmane Dembele,4.0,2,2,1,1,0,2,5,40.0,3,4,0,4,0,2,0,1
678,Merih Demiral,4.6,8,7,5,3,0,1,3,33.3,2,4,3,1,4,12,16,1
679,Kerem Demirbay,17.5,35,19,10,21,4,12,31,38.7,19,19,5,14,22,57,7,1
680,Diego Demme,10.0,18,8,14,3,1,8,23,34.8,15,9,1,8,8,26,9,0
681,Diego Demme,13.5,41,18,17,19,5,17,42,40.5,25,14,2,12,15,56,14,0
682,Jason Denayer,23.7,17,13,12,5,0,10,14,71.4,4,32,29,3,20,37,83,0
683,Leander Dendoncker,31.1,68,31,41,19,8,28,67,41.8,39,39,12,27,38,106,64,2
684,Kevin Denkey,6.7,10,5,1,8,1,6,10,60.0,4,7,0,7,2,12,1,1
685,Stefano Denswil,24.9,49,28,29,19,1,26,44,59.1,18,23,8,15,31,80,68,0
686,Fabio Depaoli,20.6,41,28,26,10,5,17,31,54.8,14,29,3,26,16,57,39,0
687,Kastriot Dermaku,11.4,13,5,10,3,0,3,5,60.0,2,20,16,4,12,25,61,1
688,Daniele Dessena,20.8,21,11,5,14,2,6,25,24.0,19,11,1,10,11,32,21,0
689,Mattia Destro,2.1,3,2,1,2,0,1,3,33.3,2,1,0,1,0,3,0,0
691,Gerard Deulofeu,23.3,33,16,18,9,6,12,59,20.3,47,10,0,10,25,58,6,0
692,Deyverson,2.3,0,0,0,0,0,0,1,0.0,1,2,1,1,0,0,5,0
693,Samuel Di Carmine,14.4,2,1,0,0,2,0,8,0.0,8,3,0,3,1,3,10,0
694,Federico Di Francesco,12.0,11,5,2,6,3,3,15,20.0,12,9,1,8,3,14,2,1
695,Giovanni Di Lorenzo,33.0,59,35,27,19,13,32,61,52.5,29,27,11,16,28,87,54,0
696,Angel Di Maria,22.2,17,12,2,8,7,4,34,11.8,30,14,3,11,11,28,1,3
697,Boulaye Dia,20.1,15,9,7,6,2,3,10,30.0,7,9,2,7,7,22,16,0
698,Fousseni Diabate,13.2,16,10,6,6,4,5,16,31.3,11,11,0,11,8,24,3,1
699,Moussa Diaby,19.7,10,8,3,7,0,5,15,33.3,10,6,0,6,9,19,4,0
700,Mouctar Diakhaby,16.0,11,8,7,3,1,5,8,62.5,3,17,15,2,11,22,73,0
702,Bafode Diakite,15.2,23,19,15,8,0,7,13,53.8,6,18,9,9,20,43,75,0
703,Abdou Diallo,13.3,20,11,9,10,1,8,14,57.1,6,9,5,4,10,30,32,0
705,Habib Diallo,24.4,2,1,0,2,0,0,6,0.0,6,6,5,1,4,6,43,0
706,Ibrahima Diallo,17.3,38,24,15,22,1,12,29,41.4,17,9,2,7,23,61,16,3
707,Moussa Diarra,1.0,3,3,2,1,0,1,1,100.0,0,0,0,0,3,6,2,0
708,Lucas Dias,3.5,1,1,1,0,0,1,1,100.0,0,0,0,0,0,1,2,0
709,Amadou Diawara,16.9,40,25,14,20,6,8,30,26.7,22,10,1,9,33,73,16,2
710,Brahim Diaz,0.7,1,0,0,1,0,0,2,0.0,2,2,0,2,0,1,0,0
711,Victor Diaz,32.0,74,43,38,31,5,31,60,51.7,29,53,23,30,48,122,94,1
712,Bakaye Dibassy,20.8,26,14,17,8,1,15,20,75.0,5,29,18,11,37,63,78,2
713,Eric Dier,14.9,21,12,10,10,1,10,20,50.0,10,14,9,5,21,42,65,0
714,Lucas Digne,33.7,73,49,49,19,5,33,68,48.5,35,39,10,29,42,115,108,0
715,Mitchell Dijks,11.2,13,10,6,5,2,8,12,66.7,4,5,1,4,10,23,23,0
716,Javairo Dilrosun,14.5,15,8,11,1,3,5,13,38.5,8,20,0,20,18,33,10,0
717,Federico Dimarco,5.8,11,5,4,4,3,6,10,60.0,4,3,2,1,4,15,11,0
719,Tristan Dingome,9.9,10,4,3,6,1,2,12,16.7,10,6,0,6,6,16,1,0
720,Lois Diony,7.4,15,5,0,11,4,5,9,55.6,4,3,0,3,1,16,0,0
721,Issa Diop,30.7,27,15,18,9,0,16,25,64.0,9,37,21,16,47,74,166,2
722,Papakouli Diop,25.0,39,26,13,22,4,18,42,42.9,24,24,7,17,34,73,38,0
723,Assane Diousse,1.3,1,1,0,1,0,0,3,0.0,3,0,0,0,0,1,2,0
724,Axel Disasi,27.0,32,21,18,13,1,17,27,63.0,10,29,24,5,26,58,97,0
725,Tiago Djalo,7.3,9,4,5,3,1,2,7,28.6,5,3,2,1,11,20,28,0
726,Djene,34.0,42,32,27,15,0,17,30,56.7,13,20,7,13,34,76,105,1
728,Moussa Djenepo,10.3,27,21,13,9,5,11,21,52.4,10,15,1,14,9,36,9,0
729,Koffi Djidji,9.5,27,12,19,8,0,8,18,44.4,10,28,23,5,15,42,53,1
730,Alexander Djiku,22.9,46,32,27,19,0,21,29,72.4,8,14,8,6,55,101,82,4
731,Berat Djimsiti,30.9,42,23,17,23,2,22,39,56.4,17,21,14,7,49,91,92,0
733,Marko Dmitrovic,35.0,3,2,3,0,0,3,5,60.0,2,1,0,1,3,6,24,0
734,Matt Doherty,31.5,55,29,34,17,4,27,41,65.9,14,34,4,30,40,95,52,1
735,Kasper Dolberg,21.0,10,6,0,3,7,4,17,23.5,13,18,2,16,10,20,24,0
736,Keagan Dolly,1.6,6,3,1,3,2,2,5,40.0,3,1,0,1,1,7,0,0
737,Jaume Domenech,14.7,0,0,0,0,0,0,1,0.0,1,0,0,0,1,1,3,1
738,Nicolas Dominguez,7.8,21,14,15,5,1,7,18,38.9,11,12,2,10,12,33,7,0
739,Giulio Donati,19.6,32,21,22,8,2,15,28,53.6,13,19,10,9,25,57,42,0
740,Ji Dong-won,1.1,0,0,0,0,0,0,1,0.0,1,1,0,1,0,0,0,0
741,Anastasios Donis,6.8,3,2,2,1,0,1,9,11.1,8,2,0,2,1,4,3,0
742,Alfredo Donnarumma,18.7,17,9,3,9,5,6,18,33.3,12,7,0,7,5,22,1,0
743,Gianluigi Donnarumma,35.6,1,0,1,0,0,1,2,50.0,1,0,0,0,3,4,25,7
744,Gabriel Dos Santos,23.2,41,29,27,11,3,15,22,68.2,7,27,18,9,22,63,86,2
745,Mathieu Dossevi,19.5,32,20,7,17,8,15,30,50.0,15,17,0,17,14,46,7,0
746,Bas Dost,16.4,11,7,1,7,3,3,7,42.9,4,6,2,4,5,16,22,0
747,Abdoulaye Doucoure,35.1,64,30,29,29,6,16,57,28.1,41,46,8,38,31,95,32,0
749,Moussa Doumbia,19.1,16,8,5,6,5,7,24,29.2,17,14,1,13,9,25,5,0
750,Souleyman Doumbia,5.0,10,4,7,2,1,5,6,83.3,1,5,0,5,6,16,18,0
751,Souleyman Doumbia,1.0,1,1,1,0,0,1,1,100.0,0,2,2,0,0,1,3,0
752,Tommy Doyle,0.2,0,0,0,0,0,0,1,0.0,1,0,0,0,0,0,0,0
754,Mohamed Drager,16.2,32,21,22,8,2,14,33,42.4,19,17,5,12,18,50,39,0
755,Aleksandar Dragovic,11.4,18,11,11,6,1,10,21,47.6,11,9,3,6,15,33,39,0
756,Bartlomiej Dragowski,31.0,0,0,0,0,0,0,1,0.0,1,0,0,0,3,3,8,1
757,Julian Draxler,7.6,13,10,2,9,2,7,15,46.7,8,7,1,6,10,23,1,0
758,Dominick Drexler,17.6,34,25,12,19,3,8,32,25.0,24,11,5,6,26,60,11,0
759,Danny Drinkwater,2.9,5,3,3,2,0,2,18,11.1,16,5,0,5,5,10,5,1
760,Danny Drinkwater,0.6,2,1,1,1,0,0,1,0.0,1,0,0,0,1,3,0,0
761,Josip Drmic,7.2,3,2,1,2,0,0,8,0.0,8,6,0,6,1,4,5,1
762,Domingos Duarte,34.3,30,19,24,5,1,11,20,55.0,9,34,24,10,34,64,153,1
763,Leo Duarte,4.5,4,3,0,3,1,1,4,25.0,3,9,6,3,3,7,9,0
764,Oscar Duarte,5.4,12,3,11,1,0,3,4,75.0,1,7,6,1,6,18,29,0
765,Ruben Duarte,29.6,61,32,30,28,3,34,60,56.7,26,30,8,22,47,108,71,0
767,Leo Dubois,15.0,32,23,20,9,3,13,22,59.1,9,12,4,8,18,50,34,1
768,Martin Dubravka,38.0,1,1,1,0,0,1,2,50.0,1,2,0,2,1,2,17,5
769,Ondrej Duda,8.0,18,11,9,6,3,7,16,43.8,9,10,2,8,6,24,8,0
770,Ondrej Duda,5.0,6,4,1,2,3,1,10,10.0,9,3,1,2,5,11,5,0
771,Shane Duffy,13.8,18,9,14,4,0,6,17,35.3,11,13,7,6,21,39,72,0
772,Haris Duljevic,5.8,11,6,3,7,1,4,12,33.3,8,5,0,5,2,13,1,0
773,Paul Dummett,13.6,27,17,19,7,1,21,27,77.8,6,23,9,14,23,50,69,0
774,Alfred Duncan,9.9,12,9,11,1,0,2,19,10.5,17,4,0,4,5,17,12,0
775,Alfred Duncan,9.4,19,12,8,7,4,6,16,37.5,10,7,0,7,9,28,13,0
776,Lewis Dunk,35.9,40,24,23,17,0,15,34,44.1,19,55,33,22,55,95,125,2
777,Erik Durm,5.7,13,6,9,2,2,9,17,52.9,8,11,2,9,3,16,11,0
780,Hugo Duro,4.2,6,5,2,2,2,4,8,50.0,4,3,0,3,1,7,3,0
781,Jean-Kevin Duverne,13.1,12,8,5,6,1,2,6,33.3,4,23,8,15,20,32,50,0
782,Paulo Dybala,23.9,19,10,6,9,4,9,39,23.1,30,15,0,15,13,32,3,0
783,Edin Dzeko,31.7,16,11,2,7,7,2,13,15.4,11,11,4,7,6,22,33,0
784,Blerim Dzemaili,7.8,19,12,3,13,3,4,22,18.2,18,9,3,6,7,26,6,0
785,Bruno Ecuele Manga,28.0,22,15,17,5,0,9,20,45.0,11,34,23,11,37,59,112,2
786,Simone Edera,4.4,13,5,3,7,3,2,12,16.7,10,1,0,1,1,14,3,0
787,Ederson,34.1,2,2,2,0,0,2,5,40.0,3,0,0,0,3,5,16,6
788,John Egan,35.4,44,27,34,10,0,25,45,55.6,20,39,27,12,58,102,171,4
789,Johannes Eggestein,5.7,8,6,2,2,4,3,12,25.0,9,6,0,6,2,10,4,0
790,Maximilian Eggestein,31.7,40,28,20,18,2,15,43,34.9,28,37,8,29,36,76,57,0
791,Kingsley Ehizibue,25.9,79,53,44,30,5,33,53,62.3,20,28,8,20,39,118,79,1
792,Albin Ekdal,26.5,51,25,18,31,2,24,68,35.3,44,35,14,21,33,84,46,1
794,Elif Elmas,12.6,16,7,5,6,5,5,20,25.0,15,11,1,10,11,27,4,0
796,Ahmed Elmohamady,11.5,19,9,10,7,2,10,21,47.6,11,11,5,6,13,32,25,1
797,Aritz Elustondo,16.8,28,17,19,8,1,13,23,56.5,10,21,8,13,15,43,67,0
798,Nico Elvedi,29.1,45,27,37,8,0,19,38,50.0,19,32,15,17,62,107,112,0
799,Rodrigo Ely,23.6,22,13,15,7,0,13,29,44.8,16,23,19,4,32,54,116,0
800,Adri Embarba,15.2,37,22,16,16,5,16,33,48.5,17,28,4,24,16,53,11,0
801,Breel Embolo,17.2,22,11,2,15,5,4,15,26.7,11,12,1,11,8,30,5,0
802,Emerson,31.5,74,46,49,19,6,36,79,45.6,43,30,9,21,31,105,57,1
803,Renaud Emond,3.2,3,1,0,2,1,1,5,20.0,4,0,0,0,0,3,7,0
804,Alan Empereur,9.5,16,8,11,4,1,6,10,60.0,4,19,12,7,22,38,36,0
806,Youssef En-Nesyri,15.4,9,7,1,2,6,3,17,17.6,14,15,2,13,5,14,22,0
807,Youssef En-Nesyri,8.8,7,5,1,6,0,3,10,30.0,7,9,3,6,5,12,7,0
808,Bjorn Engels,16.1,11,6,8,2,1,8,13,61.5,5,18,17,1,28,39,86,3
809,Sergi Enrich,20.7,17,6,4,8,5,4,21,19.0,17,16,2,14,9,26,12,0
810,Javier Eraso,9.1,11,5,4,5,2,5,15,33.3,10,5,0,5,7,18,5,0
811,Christian Eriksen,12.2,19,9,10,8,1,7,24,29.2,17,10,1,9,12,31,16,0
812,Christian Eriksen,7.8,11,6,2,8,1,5,20,25.0,15,3,0,3,0,11,0,0
813,Gonzalo Escalante,18.6,41,22,15,17,9,24,41,58.5,17,22,4,18,29,70,14,0
814,Aaron Escandell,3.0,1,1,1,0,0,1,1,100.0,0,0,0,0,0,1,0,0
815,Sergio Escudero,8.6,29,16,17,10,2,19,28,67.9,9,11,1,10,13,42,35,0
816,Bernardo Espinosa,25.1,24,16,18,4,2,16,28,57.1,12,19,11,8,24,48,108,2
817,Sebastiano Esposito,2.2,3,2,0,2,1,0,5,0.0,5,3,0,3,3,6,1,0
819,Alexander Esswein,2.4,6,4,4,2,0,3,8,37.5,5,8,1,7,7,13,7,1
820,Pervis Estupinan,33.1,84,45,53,27,4,42,77,54.5,35,30,7,23,58,142,61,6
821,Oghenekaro Etebo,6.4,12,4,5,7,0,7,12,58.3,5,10,1,9,11,23,4,1
822,Benat Etxebarria,4.4,6,1,2,3,1,2,13,15.4,11,6,1,5,4,10,6,0
823,Xabier Etxeita,16.1,20,11,11,9,0,12,23,52.2,11,9,5,4,17,37,68,0
824,Antony Evans,1.7,5,4,1,3,1,1,5,20.0,4,1,1,0,2,7,4,0
825,Jonny Evans,37.6,48,34,33,14,1,28,39,71.8,11,33,18,15,57,105,174,4
826,Edu Exposito,25.7,52,28,12,31,9,18,49,36.7,31,20,6,14,31,83,18,1
827,Valentin Eysseric,3.9,4,4,1,2,1,0,4,0.0,4,3,0,3,1,5,2,0
829,Lukasz Fabianski,23.5,2,2,2,0,0,2,4,50.0,2,0,0,0,1,3,5,3
830,Fabinho,23.1,62,35,20,35,7,26,67,38.8,41,25,2,23,34,96,19,1
832,Fabio,9.3,38,22,18,20,0,25,35,71.4,10,10,5,5,18,56,19,0
833,Cesc Fabregas,10.3,11,4,6,3,2,6,29,20.7,23,8,1,7,7,18,3,0
836,Faycal Fajr,4.5,1,1,0,1,0,0,3,0.0,3,4,0,4,4,5,1,0
838,Filippo Falco,22.4,13,7,4,5,4,5,18,27.8,13,11,1,10,2,15,1,0
841,Simon Falette,1.0,0,0,0,0,0,0,1,0.0,1,3,3,0,3,3,5,0
842,Iago Falque,1.1,0,0,0,0,0,0,1,0.0,1,1,0,1,0,0,0,0
843,Iago Falque,5.8,7,3,1,4,2,4,8,50.0,4,7,0,7,1,8,4,0
845,Andri Fannar Baldursson,1.6,1,0,0,1,0,0,1,0.0,1,2,0,2,1,2,3,0
846,Paolo Farago,14.9,41,28,21,15,5,23,46,50.0,23,18,9,9,10,51,58,0
847,Davide Faraoni,35.9,67,37,43,19,5,30,67,44.8,37,50,15,35,36,103,115,0
848,Mohamed Fares,4.7,6,4,3,2,1,2,10,20.0,8,5,3,2,5,11,8,0
849,Diego Farias,9.2,9,6,3,5,1,5,18,27.8,13,7,0,7,4,13,4,0
850,Ansu Fati,11.4,16,8,4,7,5,5,15,33.3,10,14,1,13,8,24,3,0
851,Julien Faussurier,22.0,36,22,23,13,0,21,53,39.6,32,22,7,15,33,69,46,1
852,Andrea Favilli,7.3,8,7,2,3,3,4,11,36.4,7,5,1,4,0,8,7,0
853,Federico Fazio,13.5,19,11,12,6,1,6,11,54.5,5,8,6,2,19,38,52,0
854,Aleix Febas,18.8,36,24,13,19,4,12,36,33.3,24,15,0,15,17,53,6,0
855,Zouhair Feddal,15.9,20,13,14,5,1,10,14,71.4,4,15,9,6,23,43,74,0
856,Ljubomir Fejsa,8.7,19,13,8,10,1,6,23,26.1,17,8,1,7,6,25,13,0
858,Nabil Fekir,29.3,41,26,14,19,8,12,37,32.4,25,27,3,24,10,51,3,0
859,Felipe,23.4,27,19,21,6,0,14,24,58.3,10,18,13,5,40,67,130,0
860,Luiz Felipe,22.5,42,24,24,15,3,19,32,59.4,13,39,30,9,41,83,69,2
861,Lucas Felippe,0.3,1,1,1,0,0,1,1,100.0,0,0,0,0,0,1,0,0
862,Joao Felix,19.4,9,3,3,3,3,4,14,28.6,10,4,0,4,10,19,4,1
863,Ohis Felix Uduokhai,21.8,43,26,30,12,1,19,29,65.5,10,40,30,10,36,79,125,2
864,Kiko Femenia,24.9,68,38,49,17,2,43,80,53.8,37,16,2,14,36,104,49,0
865,Zinedine Ferhat,25.0,26,16,5,16,5,15,46,32.6,31,15,3,12,16,42,18,0
866,Bruno Fernandes,13.2,22,12,9,9,4,5,38,13.2,33,6,0,6,11,33,16,0
867,Edimilson Fernandes,16.5,33,20,12,15,6,15,33,45.5,18,17,9,8,32,65,47,1
868,Gedson Fernandes,0.8,2,0,2,0,0,0,2,0.0,2,2,0,2,1,3,0,0
869,Gelson Fernandes,8.6,30,18,13,17,0,7,21,33.3,14,11,3,8,16,46,9,2
870,Matheus Fernandes,1.8,6,2,2,2,2,3,5,60.0,2,4,0,4,2,8,2,0
871,Aitor Fernandez,36.0,1,1,1,0,0,1,1,100.0,0,0,0,0,2,3,18,3
873,Carlos Fernandez,24.5,24,15,7,11,6,3,32,9.4,29,25,2,23,11,35,30,0
874,Federico Fernandez,29.1,42,25,30,10,2,23,46,50.0,23,41,28,13,24,66,190,2
875,Gabriel Fernandez,6.2,1,0,0,1,0,1,3,33.3,2,5,1,4,2,3,2,0
876,Joaquin Fernandez,18.4,30,24,17,10,3,9,30,30.0,21,14,10,4,32,62,57,0
877,Fernandinho,26.6,50,35,32,16,2,29,48,60.4,19,28,16,12,25,75,82,0
878,Fernando,29.5,62,33,37,24,1,34,58,58.6,24,38,15,23,67,129,73,1
879,Juan Ferney Otero,13.4,17,10,6,9,2,8,24,33.3,16,12,1,11,19,36,10,0
880,Alex Ferrari,11.2,18,13,13,5,0,7,12,58.3,5,13,8,5,12,30,31,0
881,Facundo Ferreyra,6.4,9,4,4,5,0,3,10,30.0,7,4,0,4,2,11,5,0
882,Jordan Ferri,12.8,22,13,7,12,3,13,44,29.5,31,9,0,9,10,32,10,0
884,Oliver Fink,7.5,21,12,7,11,3,5,16,31.3,11,12,1,11,15,36,7,0
885,Alfred Finnbogason,10.7,11,6,1,9,1,2,7,28.6,5,8,2,6,3,14,8,0
886,Roberto Firmino,33.2,37,19,8,14,15,10,43,23.3,33,34,3,31,7,44,11,1
887,Junior Firpo,11.3,23,15,12,8,3,11,17,64.7,6,15,3,12,17,40,12,1
888,John Fleck,28.0,36,25,13,14,9,22,64,34.4,42,25,3,22,24,60,26,0
889,Mark Flekken,10.0,0,0,0,0,0,0,1,0.0,1,0,0,0,0,0,2,2
890,Sergio Floccari,10.5,8,3,3,1,4,0,13,0.0,13,9,1,8,5,13,1,0
891,Alessandro Florenzi,11.1,14,11,8,4,2,7,20,35.0,13,9,3,6,16,30,19,0
892,Alessandro Florenzi,8.4,13,9,9,4,0,8,18,44.4,10,11,1,10,14,27,21,0
893,Phil Foden,10.0,14,10,4,6,4,6,19,31.6,13,5,0,5,6,20,2,0
894,Mamadou Fofana,17.6,57,35,38,15,4,21,41,51.2,20,22,10,12,22,79,61,1
895,Seko Fofana,25.0,17,12,8,8,1,9,35,25.7,26,20,1,19,17,34,19,0
896,Wesley Fofana,13.5,25,15,16,9,0,12,18,66.7,6,10,5,5,36,61,55,4
897,Youssouf Fofana,11.2,25,17,10,12,3,13,30,43.3,17,11,0,11,14,39,7,0
898,Youssouf Fofana,6.8,16,9,6,10,0,8,15,53.3,7,12,2,10,8,24,9,0
899,Thomas Foket,27.0,61,36,31,23,7,30,48,62.5,18,15,4,11,39,100,59,1
900,Lamine Fomba,15.3,65,31,20,37,8,21,43,48.8,22,29,4,25,25,90,11,1
901,Jose Fonte,24.5,19,11,11,7,1,11,22,50.0,11,19,11,8,28,47,90,1
902,Pablo Fornals,24.1,46,28,21,18,7,19,64,29.7,45,35,1,34,25,71,15,0
903,Emil Forsberg,12.7,16,10,5,8,3,6,26,23.1,20,15,0,15,5,21,3,0
904,Hernani Fortes,7.3,5,2,4,0,1,1,3,33.3,2,3,0,3,4,9,9,0
905,Ben Foster,38.0,1,0,1,0,0,1,3,33.3,2,1,0,1,0,1,16,2
906,Lyle Foster,0.7,0,0,0,0,0,0,1,0.0,1,0,0,0,0,0,1,0
907,Timothy Fosu-Mensah,1.5,1,1,0,1,0,1,4,25.0,3,0,0,0,4,5,1,0
910,Dimitri Foulquier,12.4,25,11,13,9,3,11,20,55.0,9,8,3,5,16,41,32,0
911,Juan Foyth,0.8,7,3,5,2,0,3,4,75.0,1,1,0,1,1,8,3,1
912,Gianluca Frabotta,1.0,3,1,0,2,1,2,2,100.0,0,2,0,2,1,4,2,0
913,Raphael Framberger,13.1,43,25,23,16,4,21,29,72.4,8,23,9,14,20,63,26,0
914,Simon Francis,10.8,13,9,11,2,0,11,21,52.4,10,17,12,5,20,33,71,0
915,Mike Frantz,3.9,4,2,1,3,0,2,9,22.2,7,5,3,2,1,5,4,0
916,Ryan Fraser,23.0,12,6,5,5,2,7,22,31.8,15,15,3,12,15,27,24,0
917,Fred,24.0,60,32,33,22,5,25,100,25.0,75,44,8,36,38,98,32,0
918,Ryan Fredericks,24.9,82,56,59,18,5,41,64,64.1,23,20,10,10,24,106,73,1
920,Luke Freeman,4.1,6,4,2,2,2,2,8,25.0,6,1,0,1,10,16,6,0
921,Remo Freuler,26.0,51,30,18,25,8,22,63,34.9,41,41,6,35,28,79,26,0
922,Marco Friedl,24.3,61,39,42,15,4,29,54,53.7,25,29,9,20,34,95,78,0
923,Marvin Friedrich,31.0,45,31,30,14,1,12,37,32.4,25,46,24,22,42,87,110,0
924,Samuel Fridjonsson,2.1,4,1,3,1,0,1,3,33.3,2,4,1,3,4,8,4,0
925,Jorge de Frutos,0.7,2,2,2,0,0,1,2,50.0,1,0,0,0,0,2,1,0
926,Christian Fuchs,8.6,14,9,8,6,0,8,19,42.1,11,8,3,5,17,31,33,1
927,Angelo Fulgini,17.5,28,18,8,15,5,12,23,52.2,11,6,1,5,19,47,10,0
928,Niclas Fullkrug,4.5,2,2,1,1,0,1,3,33.3,2,3,0,3,3,5,6,0
929,Ramiro Funes Mori,5.0,5,2,2,3,0,0,2,0.0,2,8,2,6,3,8,9,1
931,Matteo Gabbia,7.6,7,5,5,2,0,5,8,62.5,3,6,6,0,9,16,21,0
932,Manolo Gabbiadini,22.6,9,7,2,3,4,1,7,14.3,6,12,0,12,10,19,11,0
933,Gabriel,33.3,2,1,2,0,0,2,3,66.7,1,0,0,0,0,2,11,10
934,Ruben Gabrielsen,7.3,3,2,3,0,0,2,4,50.0,2,5,3,2,8,11,41,0
936,Mijat Gacinovic,11.6,19,11,7,8,4,6,25,24.0,19,26,2,24,15,34,6,0
938,Roberto Gagliardini,20.0,38,19,12,18,8,14,41,34.1,27,28,8,20,30,68,20,1
939,Riccardo Gagliolo,28.9,57,32,37,12,8,30,60,50.0,30,35,18,17,53,110,100,0
940,Nicolas Gaitan,0.6,1,0,0,1,0,1,1,100.0,0,1,0,1,0,1,1,0
941,Marvin Gakpa,5.2,10,6,3,4,3,4,8,50.0,4,3,0,3,5,15,1,0
942,Enric Gallego,9.8,9,5,1,5,3,0,4,0.0,4,10,2,8,4,13,8,0
943,Enric Gallego,1.8,3,1,1,1,1,2,4,50.0,2,2,0,2,2,5,1,0
944,Kevin Gameiro,17.6,17,9,7,6,4,5,21,23.8,16,10,1,9,5,22,5,0
945,Fran Gamez,19.6,64,42,32,27,5,33,74,44.6,41,31,11,20,29,93,41,0
946,Idrissa Gana Gueye,18.4,65,34,30,25,10,18,43,41.9,25,29,4,25,33,98,15,0
947,Ignatius Ganago,13.8,10,6,4,3,3,3,18,16.7,15,8,1,7,4,14,13,0
948,Ezequiel Garay,16.0,12,8,9,2,1,7,11,63.6,4,19,17,2,14,26,71,0
949,Dani Garcia,33.7,59,30,30,27,2,30,86,34.9,56,25,7,18,52,111,56,1
950,David Garcia,31.0,28,16,15,12,1,14,31,45.2,17,20,16,4,48,76,123,2
951,Eric Garcia,8.8,6,1,4,2,0,5,9,55.6,4,2,0,2,18,24,33,0
952,Javi Garcia,4.2,2,2,2,0,0,2,3,66.7,1,1,0,1,4,6,15,0
953,Manu Garcia,21.9,46,23,11,31,4,17,72,23.6,55,28,12,16,28,74,32,1
954,Raul Garcia,11.2,20,12,11,7,2,9,22,40.9,13,12,2,10,8,28,30,0
955,Raul Garcia,31.9,57,37,19,26,12,16,76,21.1,60,46,6,40,24,81,44,0
956,Raul Garcia,2.7,5,3,2,3,0,3,6,50.0,3,3,1,2,4,9,10,0
957,Ruben Garcia,24.3,55,30,22,26,7,18,46,39.1,28,34,5,29,11,66,23,1
958,Unai Garcia,6.0,9,6,4,4,1,5,9,55.6,4,13,9,4,8,17,31,0
959,Victor Garcia,1.0,0,0,0,0,0,0,1,0.0,1,1,0,1,0,0,1,0
960,James Garner,0.1,0,0,0,0,0,0,1,0.0,1,0,0,0,0,0,1,0
962,Manuel Garrido,1.3,0,0,0,0,0,0,6,0.0,6,3,1,2,1,1,0,0
963,Mario Gaspar,21.8,35,20,16,16,3,15,31,48.4,16,25,10,15,26,61,69,0
964,Daniele Gastaldello,4.3,8,5,5,3,0,2,3,66.7,1,6,3,3,5,13,29,1
965,Dwight Gayle,9.4,12,10,4,6,2,4,8,50.0,4,5,0,5,2,14,9,0
967,Jean-Philippe Gbamin,1.5,4,3,1,1,2,1,2,50.0,1,1,0,1,1,5,4,0
968,Yann Gboho,2.5,2,2,1,0,1,0,2,0.0,2,1,0,1,1,3,0,0
970,Theodor Gebre Selassie,27.0,36,27,23,10,3,17,35,48.6,18,26,9,17,63,99,81,0
971,Dennis Geiger,12.6,12,5,4,6,2,2,16,12.5,14,9,2,7,6,18,4,0
972,Jeremy Gelin,10.3,14,5,10,2,2,8,13,61.5,5,14,7,7,15,29,33,1
973,Christian Gentner,27.1,53,28,16,32,5,22,73,30.1,51,46,8,38,54,107,50,0
974,Yannick Gerhardt,9.2,28,18,7,15,6,8,21,38.1,13,11,3,8,12,40,9,0
975,Valere Germain,15.0,22,12,6,11,5,6,31,19.4,25,16,3,13,8,30,26,0
976,Gervinho,25.2,12,6,5,6,1,6,17,35.3,11,4,0,4,5,17,3,0
977,Anwar El Ghazi,22.8,20,11,12,5,3,8,26,30.8,18,10,1,9,13,33,16,1
978,Rachid Ghezzal,9.2,27,15,14,10,3,10,33,30.3,23,6,0,6,11,38,9,0
979,Andrea Ghezzi,0.4,2,0,0,1,1,1,1,100.0,0,0,0,0,0,2,0,0
980,Paolo Ghiglione,19.1,31,16,15,13,3,18,35,51.4,17,17,2,15,9,40,42,1
981,Andrea Ghion,0.5,3,1,1,2,0,1,1,100.0,0,0,0,0,0,3,0,0
982,Saman Ghoddos,2.6,2,2,0,1,1,1,2,50.0,1,5,0,5,2,4,3,0
983,Faouzi Ghoulam,4.2,6,4,1,4,1,2,5,40.0,3,3,2,1,4,10,8,0
985,Niko Giesselmann,22.9,46,31,31,11,4,22,45,48.9,23,23,6,17,27,73,55,1
986,Rafal Gikiewicz,33.0,1,0,1,0,0,1,4,25.0,3,0,0,0,2,3,26,4
988,Bryan Gil,6.2,8,4,3,4,1,1,8,12.5,7,6,0,6,3,11,1,0
989,Bryan Gil,0.7,1,1,0,1,0,0,1,0.0,1,0,0,0,0,1,0,0
990,Billy Gilmour,2.2,5,2,3,2,0,2,4,50.0,2,2,0,2,3,8,3,1
991,Daniel Ginczek,8.5,4,3,3,1,0,1,11,9.1,10,3,1,2,1,5,3,0
992,Matthias Ginter,30.9,34,20,19,14,1,17,31,54.8,14,27,22,5,34,68,125,3
993,Andrei Girotto,24.2,76,53,45,29,2,39,71,54.9,32,32,17,15,34,110,111,1
994,Olivier Giroud,11.0,8,3,2,5,1,1,11,9.1,10,14,1,13,2,10,13,0
995,Klaus Gjasula,25.3,69,39,30,35,4,30,61,49.2,31,33,6,27,32,101,50,2
996,Kamil Glik,23.0,26,14,15,11,0,13,21,61.9,8,23,17,6,27,53,118,0
997,Serge Gnabry,24.4,36,16,4,19,13,9,29,31.0,20,17,0,17,16,52,2,1
998,Joris Gnagnon,14.2,16,13,14,2,0,10,11,90.9,1,21,17,4,18,34,61,0
999,Eddy Gnahore,12.6,24,12,7,15,2,8,28,28.6,20,25,4,21,9,33,25,0
1000,Ben Godfrey,29.4,22,14,18,3,1,10,18,55.6,8,41,37,4,25,47,152,3
1001,Diego Godin,18.1,38,29,19,16,3,18,32,56.3,14,17,7,10,45,83,60,1
1002,Akaki Gogia,1.3,2,1,0,0,2,0,2,0.0,2,2,2,0,0,2,0,0
1004,Edoardo Goldaniga,8.7,4,3,3,1,0,2,5,40.0,3,11,6,5,18,22,25,1
1005,Benjamin Goller,3.2,8,3,3,4,1,3,10,30.0,7,3,0,3,1,9,1,0
1006,Pierluigi Gollini,32.0,0,0,0,0,0,0,2,0.0,2,0,0,0,0,0,13,2
1007,Aleksandr Golovin,22.9,49,27,17,26,6,14,69,20.3,55,28,0,28,31,80,22,0
1008,Andre Gomes,16.2,22,15,7,11,4,8,62,12.9,54,20,3,17,7,29,7,0
1010,Ibai Gomez,7.7,5,3,2,2,1,3,8,37.5,5,4,0,4,3,8,6,0
1011,Joe Gomez,22.3,23,16,17,6,0,9,20,45.0,11,15,8,7,38,61,64,2
1012,Maxi Gomez,23.8,9,7,1,6,2,4,8,50.0,4,8,1,7,5,14,14,0
1014,Moi Gomez,25.8,30,22,9,14,7,11,33,33.3,22,22,2,20,25,55,23,0
1015,Papu Gomez,31.6,27,13,5,13,9,13,45,28.9,32,24,0,24,17,44,6,1
1016,Sergi Gomez,8.0,9,7,7,2,0,4,4,100.0,0,6,6,0,7,16,30,0
1017,Victor Gomez,14.1,13,5,8,4,1,7,20,35.0,13,10,0,10,21,34,31,0
1018,Alfred Gomis,18.0,1,0,1,0,0,1,2,50.0,1,2,0,2,0,1,14,2
1019,Maxime Gonalons,16.7,62,38,25,35,2,22,54,40.7,32,27,3,24,20,82,20,1
1020,Mathieu Goncalves,3.5,5,3,5,0,0,2,8,25.0,6,4,3,1,4,9,10,0
1021,Jerome Gondorf,1.3,9,6,7,1,1,3,6,50.0,3,3,2,1,0,9,2,0
1022,Alvaro Gonzalez,18.1,19,13,14,4,1,9,13,69.2,4,7,4,3,18,37,65,0
1023,Bruno Gonzalez,2.0,3,2,3,0,0,1,1,100.0,0,2,0,2,0,3,3,0
1024,Bruno Gonzalez,5.1,10,8,7,2,1,2,4,50.0,2,7,4,3,2,12,32,0
1025,Edgar Gonzalez,7.6,8,3,3,5,0,2,14,14.3,12,4,2,2,10,18,16,0
1027,Anthony Gordon,4.9,11,7,5,6,0,5,15,33.3,10,6,2,4,8,19,4,0
1028,Leon Goretzka,16.8,28,15,7,18,3,10,32,31.3,22,18,2,16,24,52,8,0
1029,Andoni Gorosabel,7.9,14,8,9,3,2,10,20,50.0,10,13,1,12,13,27,21,0
1030,Robin Gosens,29.1,53,27,19,26,8,23,51,45.1,28,38,10,28,39,92,40,0
1031,Dan Gosling,14.0,26,10,14,9,3,6,27,22.2,21,31,11,20,20,46,26,0
1032,Mario Gotze,5.8,10,7,0,6,4,3,12,25.0,9,3,0,3,2,12,1,0
1035,Jeffrey Gouweleeuw,18.3,28,16,22,5,1,12,21,57.1,9,15,8,7,37,65,97,0
1036,Max Gradel,18.2,36,20,17,14,5,12,47,25.5,35,11,1,10,11,47,23,0
1037,Samuel Grandsir,16.6,34,22,13,16,5,11,30,36.7,19,9,0,9,14,48,5,0
1038,Esteban Granero,5.3,10,4,5,3,2,5,11,45.5,6,3,2,1,2,12,5,0
1040,Alberto Grassi,7.1,10,4,7,3,0,5,13,38.5,8,5,2,3,19,29,9,1
1041,Andre Gray,8.4,4,3,0,2,2,1,3,33.3,2,4,1,3,1,5,2,0
1042,Demarai Gray,6.9,12,6,6,6,0,6,12,50.0,6,7,0,7,5,17,4,0
1043,Jack Grealish,35.9,29,19,12,12,5,13,34,38.2,21,33,12,21,22,51,22,1
1044,Mason Greenwood,14.7,17,11,5,6,6,5,20,25.0,15,9,0,9,6,23,6,1
1045,Michael Gregoritsch,3.4,2,2,0,2,0,0,4,0.0,4,4,1,3,3,5,7,0
1046,Michael Gregoritsch,9.2,8,5,0,6,2,0,9,0.0,9,9,1,8,2,10,10,0
1047,Clement Grenier,9.3,21,12,6,15,0,11,40,27.5,29,7,2,5,7,28,16,0
1048,Antoine Griezmann,28.3,33,18,12,11,10,9,34,26.5,25,22,3,19,12,45,20,1
1050,Vincenzo Grifo,18.0,15,10,9,3,3,6,25,24.0,19,13,1,12,14,29,18,1
1051,Florian Grillitsch,26.8,59,29,34,24,1,29,61,47.5,32,33,6,27,49,108,41,1
1053,Christian Gross,9.7,23,17,16,5,2,9,16,56.3,7,13,7,6,14,37,50,1
1054,Pascal Gross,20.0,36,13,8,21,7,14,39,35.9,25,25,3,22,9,45,7,0
1055,Carlos Gruezo,9.8,28,12,12,15,1,5,24,20.8,19,5,0,5,6,34,5,0
1056,Marko Grujic,26.8,56,34,21,30,5,19,63,30.2,44,43,9,34,22,78,69,0
1057,Vicente Guaita,35.0,1,1,1,0,0,1,2,50.0,1,0,0,0,0,1,18,3
1058,Andres Guardado,22.7,30,14,15,11,4,15,41,36.6,26,15,4,11,18,48,22,1
1059,Sergi Guardiola,29.5,14,6,3,7,4,4,24,16.7,20,23,0,23,6,20,18,1
1060,Nemanja Gudelj,13.5,20,14,11,8,1,6,19,31.6,13,17,8,9,12,32,35,1
1061,Goncalo Guedes,14.1,19,11,11,7,1,9,32,28.1,23,10,1,9,7,26,1,0
1062,Matteo Guendouzi,19.4,31,16,14,13,4,14,43,32.6,29,21,7,14,29,60,38,2
1063,Raphael Guerreiro,25.9,44,24,18,21,5,20,32,62.5,12,27,3,24,42,86,26,0
1064,Adrian Guerrero,1.4,2,2,1,1,0,2,3,66.7,1,0,0,0,2,4,1,0
1066,Ander Guevara,10.4,27,11,9,17,1,12,30,40.0,18,13,3,10,8,35,15,1
1067,Babacar Gueye,1.2,2,0,0,0,2,0,1,0.0,1,1,1,0,0,2,3,0
1069,Josuha Guilavogui,22.9,41,26,17,23,1,10,30,33.3,20,35,9,26,45,86,64,2
1070,Frederic Guilbert,22.7,74,43,48,20,6,36,67,53.7,31,33,10,23,49,123,74,2
1071,Bruno Guimaraes,3.0,12,7,5,6,1,5,10,50.0,5,1,0,1,4,16,1,0
1072,Serhou Guirassy,21.3,7,3,1,4,2,2,7,28.6,5,13,6,7,4,11,21,0
1075,Manuel Gulde,15.2,28,16,17,9,2,15,24,62.5,9,23,13,10,22,50,80,1
1076,Sinan Gumus,1.1,0,0,0,0,0,0,4,0.0,4,0,0,0,0,0,1,0
1077,Ilkay Gundogan,22.4,27,16,9,11,7,9,41,22.0,32,17,5,12,31,58,13,0
1078,Angus Gunn,10.0,1,1,1,0,0,1,3,33.3,2,0,0,0,0,1,1,0
1079,Christian Gunter,33.7,25,11,17,7,1,12,35,34.3,23,29,13,16,14,39,40,0
1080,Koray Gunter,30.4,39,25,22,15,2,19,29,65.5,10,45,39,6,55,94,131,1
1081,Regis Gurtner,28.0,1,1,1,0,0,1,2,50.0,1,0,0,0,0,1,10,4
1082,Luiz Gustavo,2.1,6,3,3,3,0,3,5,60.0,2,5,2,3,5,11,6,0
1083,Jonathan de Guzman,1.0,1,1,0,1,0,1,7,14.3,6,2,0,2,1,2,0,0
1084,Erling Haaland,11.8,4,2,1,0,3,0,4,0.0,4,7,4,3,4,8,4,0
1085,Janik Haberer,19.1,26,18,8,14,4,12,45,26.7,33,25,4,21,25,51,23,0
1086,Alexander Hack,8.9,26,10,19,6,1,16,27,59.3,11,20,9,11,23,49,60,1
1087,Munir El Haddadi,13.9,19,17,6,11,2,4,21,19.0,17,8,0,8,7,26,8,0
1088,Andre Hahn,7.8,15,9,7,5,3,5,21,23.8,16,23,5,18,13,28,14,0
1089,Amadou Haidara,8.4,26,16,7,17,2,10,24,41.7,14,14,2,12,8,34,10,1
1090,Achraf Hakimi,30.2,60,41,38,14,8,27,64,42.2,37,26,2,24,30,90,27,2
1092,Sebastien Haller,25.2,22,15,8,10,4,3,30,10.0,27,19,5,14,8,30,27,0
1093,Marcel Halstenberg,28.0,46,31,27,17,2,28,58,48.3,30,37,11,26,46,92,72,2
1094,Romain Hamouma,9.6,12,9,1,5,6,2,12,16.7,10,12,0,12,0,12,4,0
1095,Samir Handanovic,35.0,1,1,1,0,0,0,1,0.0,1,0,0,0,0,1,8,3
1096,Grant Hanley,14.0,24,15,17,7,0,8,14,57.1,6,25,18,7,31,55,77,1
1097,Lukas Haraslin,4.3,5,2,1,3,1,2,9,22.2,7,5,0,5,4,9,1,0
1098,Amine Harit,23.4,16,7,8,5,3,6,25,24.0,19,13,0,13,7,23,2,1
1100,Makoto Hasebe,21.9,28,20,16,9,3,18,39,46.2,21,38,10,28,26,54,38,0
1101,Hans Hateboer,26.2,36,23,20,9,7,18,38,47.4,20,22,7,15,10,46,32,1
1102,Kortney Hause,17.2,21,9,15,5,1,8,15,53.3,7,27,19,8,20,41,98,4
1103,Kai Havertz,27.3,21,15,5,10,6,6,39,15.4,33,22,0,22,2,23,22,0
1104,Isaac Hayden,24.7,55,27,33,17,5,20,50,40.0,30,24,7,17,38,93,38,0
1105,Eden Hazard,12.0,7,3,2,3,2,3,15,20.0,12,5,0,5,6,13,0,0
1106,Thorgan Hazard,26.4,40,27,17,14,9,12,50,24.0,38,29,0,29,13,53,2,1
1107,Tom Heaton,19.9,3,2,3,0,0,3,4,75.0,1,0,0,0,0,3,6,0
1108,Jonas Hector,27.0,76,49,37,34,5,24,75,32.0,51,44,10,34,46,122,38,1
1109,Dominique Heintz,27.0,47,30,40,6,1,17,43,39.5,26,38,25,13,41,88,131,1
1111,Jordan Henderson,24.9,63,41,18,33,12,22,55,40.0,33,22,4,18,30,93,21,2
1112,Liam Henderson,2.2,3,2,0,3,0,2,3,66.7,1,1,0,1,0,3,4,0
1113,Jeff Hendrick,21.5,18,10,7,8,3,7,27,25.9,20,21,8,13,20,38,20,0
1115,Rouwen Hennings,27.3,11,5,2,7,2,3,18,16.7,15,12,0,12,2,13,33,0
1116,Benjamin Henrichs,9.9,26,20,16,9,1,14,33,42.4,19,19,4,15,14,40,18,0
1118,Dalbert Henrique,27.6,52,25,35,12,5,18,51,35.3,33,34,4,30,19,71,65,0
1119,Christophe Herelle,12.3,14,11,10,4,0,3,7,42.9,4,14,8,6,17,31,26,1
1120,Mario Hermoso,13.5,15,8,12,2,1,11,20,55.0,9,11,5,6,12,27,61,0
1121,Aridane Hernandez,29.0,35,23,22,13,0,15,19,78.9,4,24,15,9,34,69,137,2
1122,Javier Hernandez,1.2,0,0,0,0,0,0,1,0.0,1,0,0,0,1,1,0,0
1123,Javier Hernandez,5.0,6,4,0,4,2,1,6,16.7,5,5,0,5,5,11,1,0
1125,Lucas Hernandez,10.2,18,9,13,3,2,9,15,60.0,6,6,1,5,15,33,17,0
1126,Onel Hernandez,15.4,27,19,13,11,3,9,31,29.0,22,12,1,11,19,46,10,0
1127,Theo Hernandez,31.3,56,39,32,18,6,33,53,62.3,20,34,6,28,43,99,62,2
1128,Hernani,26.9,61,31,25,31,5,30,112,26.8,82,53,11,42,50,111,51,1
1129,Ander Herrera,6.1,19,11,9,9,1,5,14,35.7,9,10,2,8,6,25,4,0
1130,Hector Herrera,12.5,31,21,9,18,4,13,32,40.6,19,16,7,9,17,48,13,2
1131,Sergio Herrera,18.4,1,1,1,0,0,1,4,25.0,3,0,0,0,1,2,13,3
1132,Yangel Herrera,26.3,88,49,25,53,10,36,80,45.0,44,38,9,29,34,122,28,0
1134,Patrick Herrmann,16.1,24,11,8,10,6,5,16,31.3,11,21,4,17,11,35,8,0
1135,Pablo Hervias,11.3,24,20,8,14,2,12,22,54.5,10,8,0,8,5,29,0,0
1136,Son Heung-min,27.5,23,15,10,11,2,9,57,15.8,48,23,0,23,19,42,18,1
1137,Gonzalo Higuain,20.7,13,7,2,6,5,4,31,12.9,27,12,0,12,6,19,14,0
1138,Vitorino Hilton,27.9,27,17,20,7,0,13,28,46.4,15,22,18,4,49,76,121,1
1139,Martin Hinteregger,30.2,66,51,33,30,3,28,57,49.1,29,41,21,20,36,102,96,0
1142,Andre Hoffmann,27.0,48,22,30,18,0,16,50,32.0,34,22,9,13,56,104,90,0
1144,Nicolas Hofler,30.9,65,40,31,28,6,22,64,34.4,42,58,18,40,71,136,59,3
1145,Jonas Hofmann,18.1,43,27,22,12,9,22,76,28.9,54,28,3,25,18,61,14,0
1147,Marco Hoger,7.5,10,6,4,5,1,6,16,37.5,10,14,4,10,6,16,15,0
1148,Rob Holding,6.5,4,2,3,1,0,1,3,33.3,2,10,6,4,5,9,45,1
1149,Jose Holebas,11.4,26,15,19,7,0,9,28,32.1,19,11,4,7,3,29,33,0
1150,Lucas Holer,27.6,35,15,11,16,8,11,46,23.9,35,30,9,21,12,47,38,0
1151,Mason Holgate,22.8,44,26,30,13,1,21,31,67.7,10,26,13,13,34,78,97,0
1153,Gerrit Holtmann,11.8,24,14,14,6,4,15,37,40.5,22,21,1,20,6,30,8,0
1154,Josue Homawoo,0.5,6,2,3,3,0,2,2,100.0,0,3,2,1,2,8,2,0
1155,Franck Honorat,9.4,16,11,7,8,1,8,23,34.8,15,12,1,11,5,21,13,1
1157,Timo Horn,34.0,0,0,0,0,0,0,5,0.0,5,0,0,0,2,2,15,1
1159,Conor Hourihane,17.0,16,10,4,8,4,10,25,40.0,15,19,4,15,9,25,31,0
1160,Lukas Hradecky,34.0,0,0,0,0,0,0,1,0.0,1,0,0,0,2,2,19,2
1161,Benjamin Hubner,23.0,42,26,33,9,0,23,45,51.1,22,18,13,5,30,72,98,2
1162,Florian Hubner,9.4,16,14,12,4,0,7,17,41.2,10,11,7,4,16,32,39,0
1163,Callum Hudson-Odoi,9.6,10,4,4,5,1,1,7,14.3,6,9,0,9,5,15,4,1
1164,Will Hughes,25.0,75,47,24,41,10,25,67,37.3,42,48,8,40,37,112,28,0
1165,Mats Hummels,28.7,57,30,30,26,1,20,38,52.6,18,41,18,23,59,116,110,1
1166,Uwe Hunemeier,13.4,20,15,9,11,0,10,20,50.0,10,22,12,10,24,44,63,0
1167,Adrien Hunou,13.4,21,18,5,11,5,4,21,19.0,17,16,1,15,5,26,5,0
1168,Jannik Huth,6.0,0,0,0,0,0,0,1,0.0,1,0,0,0,0,0,2,0
1170,Elseid Hysaj,16.5,18,9,13,4,1,12,26,46.2,14,16,3,13,24,42,26,0
1171,Suk Hyun-jun,2.9,3,3,1,1,1,1,2,50.0,1,1,0,1,1,4,2,0
1172,Pierre Hojbjerg,30.6,80,49,34,38,8,39,91,42.9,52,44,5,39,46,126,54,2
1173,Simone Iacoponi,33.9,49,25,36,12,1,26,42,61.9,16,37,29,8,35,84,140,2
1174,Iago,7.5,19,12,12,7,0,9,18,50.0,9,6,2,4,14,33,27,0
1175,Robert Ibanez,6.0,13,8,4,5,4,7,20,35.0,13,7,0,7,5,18,5,0
1176,Roger Ibanez,6.8,11,8,6,3,2,5,7,71.4,2,9,6,3,18,29,21,1
1177,Jordon Ibe,0.6,2,2,2,0,0,1,1,100.0,0,0,0,0,0,2,1,0
1178,Vedad Ibisevic,14.0,4,3,0,1,3,0,3,0.0,3,4,0,4,1,5,15,0
1179,Vicente Iborra,29.4,61,42,31,25,5,30,67,44.8,37,35,16,19,40,101,63,1
1180,Didier Ibrahim Ndong,26.5,62,35,30,31,1,30,59,50.8,29,27,6,21,49,111,31,0
1181,Zlatan Ibrahimovic,15.1,5,1,0,2,3,1,13,7.7,12,4,3,1,5,10,21,0
1182,Mauro Icardi,14.1,4,2,1,3,0,1,10,10.0,9,7,1,6,2,6,11,0
1183,Adam Idah,2.5,2,2,1,0,1,2,3,66.7,1,4,0,4,0,2,1,0
1184,Odion Ighalo,1.1,2,2,0,2,0,1,3,33.3,2,1,1,0,0,2,0,0
1185,Borja Iglesias,21.4,7,5,1,4,2,0,9,0.0,9,7,4,3,5,12,18,0
1186,Igor,14.9,24,16,13,10,1,14,20,70.0,6,17,9,8,24,48,37,1
1187,Igor,6.8,12,10,8,2,2,6,7,85.7,1,10,4,6,7,19,16,0
1188,Kelechi Iheanacho,10.7,3,1,1,2,0,1,9,11.1,8,8,1,7,3,6,8,0
1190,Jonathan Ikone,22.9,15,7,3,7,5,6,24,25.0,18,26,2,24,5,20,3,0
1191,Yun Il-lok,1.3,1,1,0,1,0,0,4,0.0,4,0,0,0,0,1,0,0
1192,Josip Ilicic,18.5,26,19,7,10,9,7,28,25.0,21,9,0,9,9,35,4,0
1193,Asier Illarramendi,2.4,2,2,1,0,1,2,6,33.3,4,2,1,1,5,7,6,0
1194,Stefan Ilsanker,4.6,3,1,3,0,0,3,6,50.0,3,6,3,3,7,10,21,0
1196,Stefan Ilsanker,9.3,23,15,16,7,0,10,23,43.5,13,8,1,7,19,42,26,0
1197,Giannelli Imbula,1.4,2,0,2,0,0,0,1,0.0,1,4,1,3,2,4,0,0
1198,Ciro Immobile,35.2,8,6,2,4,2,0,24,0.0,24,10,2,8,11,19,7,0
1199,Roberto Inglese,8.5,9,6,2,2,5,2,10,20.0,8,8,2,6,2,11,1,0
1200,Danny Ings,31.2,42,25,16,16,10,13,67,19.4,54,62,4,58,9,51,30,1
1201,Marcus Ingvartsen,19.1,20,14,5,7,8,9,28,32.1,19,16,1,15,16,36,16,0
1202,Lorenzo Insigne,31.2,21,15,6,8,7,6,35,17.1,29,13,0,13,30,51,4,1
1203,Takashi Inui,21.8,20,10,7,8,5,11,34,32.4,23,23,4,19,18,38,12,0
1204,Artur Ionita,21.1,38,23,12,22,4,12,37,32.4,25,32,10,22,18,56,24,2
1205,Alexander Isak,16.7,7,2,0,3,4,1,8,12.5,7,8,0,8,3,10,6,0
1206,Isco,13.1,13,9,2,10,1,5,14,35.7,9,9,0,9,7,20,4,1
1207,Nicolas Isimat-Mirin,14.0,14,8,8,6,0,5,11,45.5,6,18,12,6,22,36,71,0
1209,Ismael,0.9,2,1,1,1,0,1,2,50.0,1,2,1,1,2,4,2,0
1210,Gian-Luca Itter,0.4,1,1,1,0,0,1,1,100.0,0,0,0,0,1,2,4,0
1211,Ander Iturraspe,2.7,2,0,1,1,0,2,5,40.0,3,0,0,0,1,3,7,0
1212,Alex Iwobi,17.7,25,17,8,15,2,12,33,36.4,21,18,2,16,14,39,10,1
1213,Armando Izzo,29.8,42,24,24,14,4,17,35,48.6,18,44,29,15,71,113,121,1
1214,Jacobo,0.9,3,3,2,1,0,1,1,100.0,0,0,0,0,0,3,2,0
1215,Phil Jagielka,2.7,5,4,3,2,0,1,3,33.3,2,5,5,0,4,9,19,0
1216,Filip Jagiello,6.1,7,2,0,3,4,3,7,42.9,4,4,0,4,5,12,4,0
1217,Alireza Jahanbakhsh,3.5,8,4,3,2,3,0,2,0.0,2,5,0,5,3,11,2,0
1218,Mato Jajalo,18.3,44,19,19,22,3,14,38,36.8,24,20,7,13,19,63,19,2
1219,Ismail Jakobs,18.6,34,23,18,9,7,10,23,43.5,13,25,3,22,24,58,30,0
1220,Christophe Jallet,9.5,24,16,14,8,2,14,37,37.8,23,8,2,6,18,42,29,0
1222,Daniel James,25.4,20,10,5,10,5,7,45,15.6,38,23,4,19,7,27,12,0
1224,Reece James,16.8,36,23,18,14,4,11,29,37.9,18,19,8,11,22,58,28,0
1225,Marko Jankovic,1.3,2,1,0,0,2,1,2,50.0,1,2,1,1,0,2,0,0
1226,Jakub Jankto,23.3,27,13,14,10,3,10,42,23.8,32,30,3,27,22,49,22,0
1227,Daryl Janmaat,6.7,14,10,8,6,0,6,13,46.2,7,7,2,5,7,21,23,0
1228,Laurent Jans,17.5,42,25,30,8,4,22,48,45.8,26,25,10,15,19,61,49,1
1229,Tony Jantschke,11.2,33,21,23,10,0,15,24,62.5,9,20,11,9,27,60,48,0
1230,Adnan Januzaj,13.0,8,7,3,2,3,3,16,18.8,13,9,1,8,7,15,2,0
1231,Rune Jarstein,28.3,4,1,4,0,0,2,3,66.7,1,0,0,0,1,5,11,3
1232,Jason,13.1,29,20,8,16,5,15,33,45.5,18,18,3,15,18,47,9,0
1233,Dennis Jastrzembski,2.0,2,0,1,1,0,0,1,0.0,1,3,0,3,3,5,0,0
1235,Benjamin Jeannot,1.9,2,1,0,1,1,0,4,0.0,4,2,0,2,2,4,4,0
1236,Tin Jedvaj,29.3,44,26,25,19,0,23,47,48.9,24,36,18,18,60,104,123,1
1237,Jemerson,11.7,28,17,13,14,1,10,21,47.6,11,8,3,5,16,44,24,0
1238,Fredrik Jensen,5.1,3,1,2,1,0,2,7,28.6,5,7,1,6,1,4,3,0
1240,Gabriel Jesus,22.6,17,10,4,5,8,7,25,28.0,18,26,1,25,11,28,6,0
1241,Juan Jesus,1.5,2,1,2,0,0,0,3,0.0,3,1,0,1,1,3,7,0
1242,Raul Jimenez,36.0,20,12,6,10,4,3,31,9.7,28,26,0,26,16,36,34,1
1244,Joaquin,22.9,14,7,4,8,2,4,11,36.4,7,10,2,8,15,29,22,1
1245,Joelinton,29.8,34,20,7,22,5,9,32,28.1,23,32,6,26,11,45,30,0
1246,Ben Johnson,3.0,8,4,7,1,0,7,10,70.0,3,5,2,3,3,11,11,0
1248,Fabian Johnson,3.0,5,3,2,2,1,2,4,50.0,2,4,1,3,2,7,3,0
1249,Curtis Jones,1.4,4,4,0,1,3,3,4,75.0,1,2,0,2,2,6,1,0
1250,Phil Jones,1.5,2,2,1,1,0,1,1,100.0,0,2,0,2,2,4,9,1
1251,Frenkie de Jong,23.5,26,19,7,12,7,7,22,31.8,15,17,7,10,21,47,9,0
1252,Luuk de Jong,22.9,21,10,4,8,9,6,17,35.3,11,12,1,11,7,28,22,0
1253,Jony,13.1,13,9,7,4,2,5,23,21.7,18,11,2,9,14,27,17,0
1254,Joan Jordan,25.0,64,34,27,31,6,21,76,27.6,55,25,5,20,26,90,20,4
1256,Jorginho,26.4,66,40,24,34,8,35,91,38.5,56,30,5,25,64,130,27,2
1257,Jesse Joronen,29.0,3,1,3,0,0,3,3,100.0,0,0,0,0,6,9,22,0
1258,Willian Jose,22.3,5,2,0,4,1,2,8,25.0,6,10,4,6,1,6,16,0
1259,Joselu,30.9,26,17,4,12,10,4,32,12.5,28,36,5,31,13,39,46,0
1260,Jota,3.7,3,1,2,0,1,2,5,40.0,3,1,0,1,3,6,6,0
1261,Diogo Jota,25.4,28,15,16,10,2,12,48,25.0,36,17,0,17,9,37,10,2
1262,Vukasin Jovanovic,6.4,18,11,12,6,0,14,21,66.7,7,5,3,2,15,33,15,0
1263,Dejan Joveljic,1.7,2,2,1,1,0,0,1,0.0,1,0,0,0,0,2,1,0
1264,Stevan Jovetic,5.3,2,1,0,1,1,1,5,20.0,4,1,0,1,1,3,5,0
1265,Luka Jovic,4.8,2,1,0,0,2,1,2,50.0,1,1,0,1,2,4,0,0
1266,Juanmi,2.9,4,1,1,2,1,1,4,25.0,3,1,0,1,0,4,0,0
1267,David Junca,2.9,6,5,4,1,1,2,3,66.7,1,4,1,3,2,8,3,0
1268,Lago Junior,24.3,32,19,12,11,9,12,29,41.4,17,23,5,18,14,46,25,0
1269,Hamed Junior Traore,17.4,31,15,10,15,6,14,39,35.9,25,22,1,21,11,42,7,0
1270,Vinicius Junior,15.2,26,16,13,8,5,8,32,25.0,24,14,0,14,3,29,2,0
1271,James Justin,11.2,36,17,22,14,0,15,25,60.0,10,15,7,8,11,47,30,0
1272,Musa Juwara,1.7,4,2,1,1,2,1,5,20.0,4,2,1,1,0,4,1,0
1274,Mathias Jorgensen,5.5,4,3,3,1,0,2,4,50.0,2,7,3,4,13,17,33,0
1275,Ozan Kabak,19.7,37,23,28,9,0,14,21,66.7,7,33,19,14,37,74,97,0
1276,Christian Kabasele,25.0,37,24,26,11,0,17,32,53.1,15,31,23,8,36,73,127,0
1277,Abdoul Kader Bamba,16.3,19,15,5,9,5,9,30,30.0,21,8,2,6,16,35,8,0
1278,Pavel Kaderabek,27.5,32,22,17,13,2,13,30,43.3,17,29,7,22,27,59,55,1
1279,Florian Kainz,17.3,21,13,12,6,3,15,33,45.5,18,26,2,24,13,34,11,0
1280,Gael Kakuta,22.2,46,27,13,27,6,17,48,35.4,31,15,1,14,16,62,8,2
1281,Lovre Kalinic,3.4,0,0,0,0,0,0,1,0.0,1,0,0,0,0,0,0,0
1283,Salomon Kalou,1.6,1,0,1,0,0,0,2,0.0,2,2,0,2,0,1,1,0
1284,Samuel Kalu,15.1,33,17,19,12,2,16,36,44.4,20,13,1,12,24,57,10,0
1285,Daichi Kamada,21.9,29,20,7,17,5,8,42,19.0,34,16,1,15,10,39,6,0
1286,Francois Kamano,7.2,12,6,5,4,3,8,15,53.3,7,5,0,5,3,15,2,0
1287,Boubacar Kamara,23.8,67,34,37,27,3,27,57,47.4,30,27,14,13,34,101,53,1
1288,Hassane Kamara,19.0,58,47,40,14,4,24,35,68.6,11,17,2,15,58,116,58,0
1289,Kevin Kampl,7.5,17,11,7,10,0,7,23,30.4,16,7,2,5,16,33,6,0
1290,Harry Kane,28.7,18,12,3,12,3,4,17,23.5,13,17,7,10,6,24,30,0
1291,Lee Kang-in,5.0,3,1,0,2,1,3,6,50.0,3,5,0,5,3,6,0,0
1292,Wilfried Kanga,0.8,0,0,0,0,0,0,1,0.0,1,0,0,0,0,0,0,0
1293,N'Golo Kante,19.2,44,20,22,14,8,17,36,47.2,19,29,5,24,44,88,32,2
1295,Wilfrid Kaptoum,2.2,5,2,3,2,0,3,3,100.0,0,4,1,3,1,6,3,0
1296,Kenan Karaman,15.0,11,5,2,5,4,4,9,44.4,5,9,4,5,2,13,7,0
1297,Yann Karamoh,6.4,10,7,5,4,1,3,9,33.3,6,5,0,5,2,12,3,0
1301,Noah Katterbach,14.6,29,23,21,8,0,11,28,39.3,17,12,1,11,29,58,26,0
1303,Michael Keane,28.4,31,16,18,12,1,14,24,58.3,10,35,28,7,44,75,152,0
1304,Thilo Kehrer,5.3,10,7,4,5,1,5,10,50.0,5,2,0,2,1,11,2,1
1305,Jules Keita,1.8,4,3,2,1,1,1,6,16.7,5,1,0,1,3,7,0,0
1306,Naby Keita,9.1,30,14,8,16,6,11,26,42.3,15,18,0,18,10,40,4,0
1307,Yannik Keitel,1.9,2,1,1,1,0,0,6,0.0,6,3,1,2,4,6,4,0
1308,Lloyd Kelly,7.1,7,3,3,4,0,6,7,85.7,1,9,5,4,6,13,15,1
1309,Martin Kelly,17.2,23,18,19,4,0,14,31,45.2,17,18,10,8,16,39,86,1
1310,Kenedy,6.5,9,5,3,3,3,2,5,40.0,3,10,0,10,11,20,4,0
1311,Jonjoe Kenny,30.2,49,29,24,19,6,26,51,51.0,25,45,10,35,26,75,79,0
1312,Franck Kessie,32.3,54,29,28,18,8,16,52,30.8,36,34,5,29,34,88,32,2
1313,Saif-Eddine Khaoui,1.2,3,1,0,3,0,2,5,40.0,3,2,0,2,1,4,4,0
1314,Wahbi Khazri,12.8,17,9,5,7,5,9,27,33.3,18,11,0,11,4,21,0,0
1315,Rani Khedira,29.4,60,36,21,35,4,18,45,40.0,27,47,12,35,48,108,62,0
1316,Sami Khedira,7.6,14,7,3,8,3,4,19,21.1,15,12,1,11,3,17,13,0
1317,Kike,19.6,13,7,0,5,8,4,12,33.3,8,15,1,14,1,14,9,0
1318,Luca Kilian,14.0,33,24,27,6,0,22,41,53.7,19,20,9,11,12,45,67,0
1319,Max Kilman,2.1,4,2,1,3,0,2,2,100.0,0,1,1,0,4,8,7,0
1320,Joshua Kimmich,31.3,52,29,21,20,11,22,55,40.0,33,38,9,29,29,81,29,0
1321,Presnel Kimpembe,13.6,33,25,25,8,0,14,20,70.0,6,7,3,4,21,54,33,1
1322,Joshua King,22.3,16,6,4,8,4,4,16,25.0,12,20,3,17,8,24,9,0
1323,Simon Kjaer,3.2,9,6,1,8,0,3,4,75.0,1,5,4,1,7,16,10,1
1324,Simon Kjaer,13.8,22,13,17,5,0,10,18,55.6,8,20,16,4,15,37,52,0
1326,Davy Klaassen,32.6,55,43,19,23,13,19,57,33.3,38,46,18,28,38,93,45,2
1327,Felix Klaus,7.4,24,16,4,13,7,7,19,36.8,12,10,2,8,3,27,5,0
1328,Ragnar Klavan,26.2,29,16,20,9,0,14,28,50.0,14,29,19,10,25,54,118,1
1329,Timm Klose,6.5,8,2,5,2,1,7,11,63.6,4,6,6,0,7,15,29,0
1330,Lukas Klostermann,29.4,45,26,24,16,5,18,31,58.1,13,34,16,18,26,71,101,2
1331,Justin Kluivert,16.8,17,11,4,8,5,7,16,43.8,9,15,0,15,6,23,7,0
1332,Lukas Klunter,20.9,44,31,26,16,2,20,30,66.7,10,16,4,12,27,71,61,1
1333,Robin Knoche,17.7,29,14,24,5,0,17,30,56.7,13,19,11,8,27,56,77,1
1334,Robin Koch,30.1,34,20,20,13,1,11,26,42.3,15,30,22,8,45,79,94,4
1336,Jonathan Kodjia,1.3,0,0,0,0,0,0,1,0.0,1,0,0,0,0,0,1,0
1337,Kenan Kodro,4.0,1,0,0,0,1,0,2,0.0,2,1,0,1,0,1,4,0
1338,Dominik Kohr,16.1,44,35,15,25,4,18,53,34.0,35,31,11,20,30,74,16,0
1339,Koke,30.0,70,42,27,30,13,29,89,32.6,60,33,8,25,29,99,28,2
1340,Aleksandar Kolarov,30.4,37,28,16,16,5,20,37,54.1,17,20,9,11,31,68,57,0
1341,Sead Kolasinac,18.9,29,16,18,6,5,12,23,52.2,11,14,4,10,25,54,34,1
1342,Timothee Kolodziejczak,14.5,17,10,13,4,0,9,21,42.9,12,8,3,5,30,47,44,2
1343,Ghislain Konan,14.8,43,26,28,14,1,19,28,67.9,9,13,3,10,24,67,34,0
1344,Ibrahima Konate,6.3,11,6,10,1,0,2,7,28.6,5,9,4,5,5,16,35,1
1345,Moussa Konate,6.8,3,0,0,3,0,0,2,0.0,2,2,0,2,1,4,1,0
1346,Geoffrey Kondogbia,20.1,63,40,40,18,5,19,51,37.3,32,25,6,19,57,120,36,2
1347,Kouadio Kone,9.7,35,20,17,14,4,13,30,43.3,17,15,1,14,19,54,10,1
1348,Lamine Kone,16.4,31,21,20,10,1,12,17,70.6,5,8,5,3,25,56,47,1
1349,Moussa Kone,1.6,2,0,1,1,0,1,3,33.3,2,1,0,1,1,3,0,0
1350,Youssouf Kone,9.1,22,14,17,3,2,12,20,60.0,8,2,1,1,8,30,15,0
1352,Ezri Konsa,22.7,18,9,12,6,0,7,16,43.8,9,34,24,10,25,43,70,2
1354,Laurent Koscielny,24.3,28,13,24,4,0,10,20,50.0,10,23,19,4,26,54,104,0
1355,Filip Kostic,32.9,59,38,30,20,9,22,59,37.3,37,45,2,43,23,82,16,0
1356,Christian Kouame,3.3,3,2,0,3,0,0,1,0.0,1,5,1,4,1,4,1,0
1357,Christian Kouame,10.2,2,1,0,1,1,0,8,0.0,8,8,2,6,1,3,13,0
1358,Tomas Koubek,24.0,3,2,3,0,0,3,11,27.3,8,1,0,1,1,4,23,3
1359,Kalidou Koulibaly,23.4,51,33,30,17,4,17,28,60.7,11,28,16,12,31,82,61,1
1360,Efthimis Koulouris,17.1,13,8,5,5,3,3,13,23.1,10,8,4,4,3,16,16,0
1361,Jules Kounde,25.7,23,12,14,5,4,10,18,55.6,8,16,12,4,23,46,91,2
1362,Leonardo Koutris,1.0,1,1,0,0,1,1,2,50.0,1,1,1,0,1,2,6,0
1363,Cheikhou Kouyate,28.1,67,32,43,20,4,26,48,54.2,22,35,11,24,43,110,58,1
1364,Mateo Kovacic,23.0,63,38,29,32,2,26,65,40.0,39,15,1,14,22,85,16,1
1365,Dawid Kownacki,12.1,13,8,5,7,1,9,20,45.0,11,13,2,11,6,19,8,0
1366,Ismail Koybasi,2.6,4,4,3,1,0,0,2,0.0,2,4,0,4,5,9,2,0
1368,Emil Krafth,11.3,18,12,15,2,1,9,20,45.0,11,11,8,3,8,26,45,0
1369,Andrej Kramaric,15.8,2,1,1,0,1,1,7,14.3,6,6,0,6,3,5,4,0
1370,Christoph Kramer,16.3,45,29,19,21,5,19,49,38.8,30,22,3,19,14,59,19,0
1371,Tom Krauss,0.0,1,1,0,1,0,1,2,50.0,1,0,0,0,0,1,0,0
1372,Ladislav Krejci,11.7,15,10,6,7,2,9,19,47.4,10,7,4,3,10,25,23,0
1373,Rene Krhin,3.6,4,3,1,3,0,2,2,100.0,0,1,0,1,6,10,17,0
1374,Felix Kroos,4.2,17,9,9,6,2,8,15,53.3,7,6,3,3,3,20,13,1
1375,Toni Kroos,29.5,56,28,18,29,9,18,70,25.7,52,27,0,27,23,79,15,0
1376,Tim Krul,36.0,0,0,0,0,0,0,1,0.0,1,2,0,2,1,1,13,1
1378,Rade Krunic,6.0,16,8,8,5,3,9,16,56.3,7,5,0,5,9,25,5,0
1379,Lukas Kubler,2.3,1,1,0,1,0,1,5,20.0,4,2,0,2,1,2,6,0
1380,Takefusa Kubo,25.7,34,22,16,12,6,15,44,34.1,29,19,1,18,23,57,10,0
1381,Juraj Kucka,21.5,43,22,21,16,6,14,61,23.0,47,21,4,17,29,72,36,0
1382,Dejan Kulusevski,32.6,41,21,10,24,7,19,64,29.7,45,25,1,24,23,64,17,0
1383,Marash Kumbulla,21.7,40,24,21,17,2,19,36,52.8,17,33,24,9,50,90,86,3
1384,Pierre Kunde,20.7,34,17,15,18,1,12,30,40.0,18,16,4,12,26,60,55,0
1385,Jasmin Kurtic,15.7,20,7,8,8,4,6,27,22.2,21,14,2,12,10,30,20,1
1386,Jasmin Kurtic,18.5,32,23,19,10,3,13,35,37.1,22,19,5,14,15,47,27,2
1387,Layvin Kurzawa,9.5,23,16,5,14,4,11,23,47.8,12,12,1,11,18,41,24,1
1388,Dereck Kutesa,5.9,6,5,3,2,1,3,9,33.3,6,5,0,5,1,7,1,0
1389,Ahmed Kutucu,7.5,11,7,3,6,2,4,15,26.7,11,5,0,5,2,13,5,0
1390,Enock Kwateng,10.9,36,22,17,17,2,22,47,46.8,25,16,6,10,22,58,41,0
1391,Giorgos Kyriakopoulos,18.3,35,18,22,7,6,18,32,56.3,14,19,6,13,18,53,41,0
1393,Andrea La Mantia,6.1,1,0,1,0,0,1,5,20.0,4,3,0,3,7,8,11,0
1394,Gaetan Laborde,24.9,21,12,4,10,7,9,38,23.7,29,21,0,21,7,28,32,1
1395,Alexandre Lacazette,20.8,31,16,8,21,2,9,24,37.5,15,14,0,14,7,38,15,0
1396,Riccardo Ladinetti,1.4,2,2,0,2,0,1,1,100.0,0,0,0,0,4,6,0,1
1397,Alban Lafont,27.0,1,1,1,0,0,1,1,100.0,0,0,0,0,0,1,12,0
1398,Victor Laguardia,29.5,21,15,15,6,0,16,30,53.3,14,24,18,6,37,58,131,1
1400,Konrad Laimer,23.5,91,45,30,46,15,43,102,42.2,59,51,8,43,34,125,14,0
1401,Stefan Lainer,30.1,51,30,25,19,7,24,54,44.4,30,38,7,31,29,80,71,0
1402,Diego Lainez,3.9,6,5,2,4,0,5,8,62.5,3,6,0,6,1,7,1,0
1404,Kenny Lala,22.7,29,16,17,11,1,11,27,40.7,16,14,5,9,20,49,40,1
1405,Adam Lallana,4.2,19,9,7,9,3,6,21,28.6,15,7,0,7,5,24,3,0
1406,Erik Lamela,13.5,24,20,9,13,2,2,21,9.5,19,12,3,9,8,32,10,0
1407,Tariq Lamptey,0.4,2,2,1,1,0,2,2,100.0,0,0,0,0,0,2,0,0
1408,Tariq Lamptey,6.5,7,6,6,1,0,2,9,22.2,7,6,0,6,16,23,17,0
1409,Loick Landre,10.3,16,9,12,3,1,7,11,63.6,4,12,9,3,17,33,34,0
1410,Michael Lang,6.0,8,5,3,5,0,6,12,50.0,6,5,1,4,7,15,22,0
1411,Sebastian Langkamp,3.5,3,2,3,0,0,2,4,50.0,2,5,3,2,3,6,11,1
1412,Henri Lansbury,2.2,6,2,3,1,2,2,8,25.0,6,4,0,4,0,6,3,0
1413,Manuel Lanzini,15.3,14,9,6,6,2,7,39,17.9,32,9,1,8,10,24,3,0
1414,Gianluca Lapadula,19.8,15,8,6,8,1,5,16,31.3,11,2,0,2,1,16,14,0
1415,Aymeric Laporte,12.2,13,6,6,7,0,4,9,44.4,5,6,5,1,20,33,26,1
1416,Danilo Larangeira,29.3,34,17,19,15,0,16,28,57.1,12,54,39,15,30,64,99,0
1418,Gautier Larsonneur,26.6,2,1,2,0,0,2,4,50.0,2,1,0,1,4,6,14,3
1419,Kevin Lasagna,28.5,27,14,7,13,7,6,31,19.4,25,23,1,22,10,37,18,1
1420,Jamaal Lascelles,23.1,14,3,10,4,0,4,9,44.4,5,23,20,3,28,42,116,1
1421,Paul Lasne,13.6,25,13,13,11,1,6,20,30.0,14,7,2,5,7,32,5,0
1422,Toni Lato,5.2,22,15,11,8,3,9,10,90.0,1,9,1,8,8,30,13,1
1423,Danny Latza,15.3,33,19,15,17,1,16,49,32.7,33,22,5,17,17,50,24,0
1424,Vincent Laurini,9.8,26,22,11,11,4,14,18,77.8,4,10,3,7,11,37,29,0
1425,Wesley Lautoa,20.8,54,29,24,28,2,28,63,44.4,35,31,16,15,42,96,48,2
1426,Diego Laxalt,6.6,19,10,10,6,3,6,20,30.0,14,12,4,8,6,25,20,0
1427,Diego Laxalt,1.9,3,3,3,0,0,1,3,33.3,2,4,0,4,0,3,3,0
1428,Valentino Lazaro,5.3,13,9,11,2,0,11,18,61.1,7,2,0,2,3,16,4,0
1430,Valentino Lazaro,3.6,6,5,3,2,1,4,8,50.0,4,5,0,5,1,7,8,1
1431,Darko Lazovic,36.0,26,16,14,8,4,14,27,51.9,13,15,4,11,23,49,53,0
1432,Manuel Lazzari,28.3,20,11,10,7,3,10,31,32.3,21,11,1,10,8,28,34,0
1433,Mickael Le Bihan,1.1,0,0,0,0,0,0,2,0.0,2,0,0,0,0,0,2,0
1434,Robin Le Normand,26.6,48,27,33,15,0,26,35,74.3,9,20,7,13,20,68,99,0
1435,Damien Le Tallec,27.3,52,27,20,28,4,24,69,34.8,45,38,18,20,38,90,59,0
1436,James Lea Siliki,12.0,28,16,19,9,0,16,29,55.2,13,15,4,11,12,40,12,0
1437,Rafael Leao,15.6,7,4,2,5,0,3,9,33.3,6,4,0,4,0,7,5,0
1438,Adrien Lebeau,0.1,1,1,1,0,0,0,1,0.0,1,1,0,1,0,1,0,0
1439,Mathew Leckie,2.2,3,1,1,2,0,2,3,66.7,1,6,0,6,2,5,2,1
1440,Benjamin Lecomte,28.0,0,0,0,0,0,0,1,0.0,1,1,0,1,0,0,10,5
1441,Pierre Lees-Melou,25.0,63,27,34,21,8,31,88,35.2,57,38,12,26,32,95,43,0
1442,Jordan Lefort,9.4,3,2,2,1,0,3,5,60.0,2,4,1,3,9,12,29,0
1443,Wu Lei,19.1,13,8,5,6,2,4,38,10.5,34,32,1,31,15,28,19,1
1444,Toni Leistner,11.2,19,12,10,9,0,5,13,38.5,8,16,7,9,32,51,57,0
1445,Moritz Leitner,7.6,16,9,8,7,1,9,25,36.0,16,14,4,10,9,25,10,1
1446,Lucas Leiva,20.1,60,35,25,31,4,28,72,38.9,44,29,6,23,47,107,34,1
1447,Florian Lejeune,4.9,8,2,6,2,0,4,7,57.1,3,6,2,4,10,18,15,2
1448,Inigo Lekue,6.9,22,12,14,6,2,11,14,78.6,3,7,0,7,3,25,11,0
1449,Nicolas Lemaitre,1.0,0,0,0,0,0,0,1,0.0,1,0,0,0,1,1,1,1
1450,Thomas Lemar,10.3,12,8,4,5,3,2,11,18.2,9,14,1,13,6,18,6,0
1452,Clement Lenglet,26.9,44,31,29,15,0,16,32,50.0,16,29,15,14,35,79,79,1
1453,Aaron Lennon,5.5,14,8,7,4,3,7,10,70.0,3,6,1,5,8,22,3,0
1454,Bernd Leno,29.4,0,0,0,0,0,0,2,0.0,2,0,0,0,0,0,9,2
1456,Christopher Lenz,25.2,63,37,37,20,6,26,49,53.1,23,46,11,35,43,106,65,0
1458,Pedro Leon,21.1,28,20,8,9,11,12,25,48.0,13,18,1,17,19,47,7,0
1459,Sergio Leon,7.5,3,3,0,3,0,2,4,50.0,2,3,0,3,1,4,2,0
1460,Lukas Lerager,15.4,29,19,13,12,4,10,34,29.4,24,20,5,15,8,37,15,1
1461,Mehdi Leris,5.7,13,11,4,2,7,7,19,36.8,12,12,4,8,6,19,6,0
1462,Jefferson Lerma,30.0,54,32,17,31,6,22,48,45.8,26,28,12,16,57,111,54,1
1463,Karlo Letica,10.0,0,0,0,0,0,0,2,0.0,2,0,0,0,0,0,4,3
1464,Robert Lewandowski,30.7,18,9,3,9,6,3,15,20.0,12,13,1,12,7,25,13,0
1465,Jamal Lewis,25.6,51,35,42,6,3,22,36,61.1,14,27,12,15,25,76,68,0
1466,Aaron Leya Iseka,8.6,2,0,0,2,0,0,3,0.0,3,5,0,5,1,3,7,0
1467,Stephan Lichtsteiner,14.9,23,14,16,5,2,10,22,45.5,12,15,7,8,16,39,35,0
1468,Dimitri Lienard,16.5,37,24,10,22,5,18,39,46.2,21,18,4,14,17,54,25,0
1469,Philipp Lienhart,20.2,11,4,10,1,0,6,13,46.2,7,24,17,7,28,39,86,0
1470,Matthijs de Ligt,27.2,25,15,14,10,1,13,23,56.5,10,30,23,7,25,50,101,2
1472,Lillo,2.2,4,2,2,2,0,1,1,100.0,0,2,1,1,2,6,8,0
1473,Anderson Lima,0.7,4,0,3,1,0,1,1,100.0,0,4,0,4,0,4,0,0
1474,Lucas Lima,3.0,7,2,4,3,0,2,5,40.0,3,2,0,2,1,8,3,0
1475,Anthony Limbombe,1.7,3,2,1,2,0,1,1,100.0,0,1,0,1,0,3,3,0
1476,Victor Lindelof,34.4,29,15,16,12,1,17,20,85.0,3,25,16,9,26,55,129,0
1477,Karol Linetty,22.4,61,32,24,25,12,21,65,32.3,44,26,3,23,26,87,17,0
1478,Jesse Lingard,10.4,15,8,6,4,5,5,18,27.8,13,5,0,5,3,18,0,0
1479,Pol Lirola,29.4,34,20,18,10,6,21,38,55.3,17,16,4,12,26,60,52,0
1480,Diego Llorente,25.9,30,14,20,9,1,16,28,57.1,12,14,7,7,28,58,101,5
1482,Fernando Llorente,5.6,0,0,0,0,0,0,1,0.0,1,4,0,4,1,1,3,0
1483,Marcos Llorente,15.2,29,15,7,16,6,7,21,33.3,14,24,4,20,14,43,9,0
1484,Gautier Lloris,3.0,5,3,5,0,0,4,5,80.0,1,3,3,0,2,7,11,0
1486,Giovani Lo Celso,16.6,51,29,12,33,6,12,59,20.3,47,20,4,16,9,60,19,0
1487,Stanislav Lobotka,8.4,11,9,3,5,3,5,12,41.7,7,3,1,2,9,20,2,0
1488,Stanislav Lobotka,15.4,19,11,13,5,1,4,19,21.1,15,8,2,6,8,27,7,0
1490,Jurgen Locadia,5.9,5,4,0,4,1,1,4,25.0,3,1,0,1,0,5,3,0
1491,Manuel Locatelli,28.7,76,50,35,37,4,33,69,47.8,36,42,14,28,33,109,36,0
1492,Renan Lodi,26.6,73,46,28,35,10,40,65,61.5,25,28,7,21,38,111,56,0
1493,Ruben Loftus-Cheek,2.3,0,0,0,0,0,0,2,0.0,2,1,1,0,2,2,2,0
1494,Enzo Loiodice,2.1,6,4,1,4,1,1,3,33.3,2,2,0,2,2,8,1,0
1495,Kevin Long,6.3,7,5,6,1,0,4,9,44.4,5,9,7,2,4,11,31,0
1496,Shane Long,15.5,19,10,5,8,6,7,19,36.8,12,12,0,12,4,23,16,0
1497,Matthew Longstaff,6.4,3,1,2,1,0,3,14,21.4,11,4,1,3,5,8,3,0
1498,Sean Longstaff,15.3,35,19,17,16,2,20,50,40.0,30,23,5,18,19,54,20,2
1499,Ademola Lookman,3.4,6,4,3,1,2,1,1,100.0,0,3,0,3,1,7,0,1
1503,Adrian Lopez,16.0,7,5,1,5,1,2,19,10.5,17,6,2,4,4,11,8,0
1504,David Lopez,27.3,38,20,15,20,3,13,41,31.7,28,28,13,15,35,73,63,3
1505,Diego Lopez,35.9,2,2,2,0,0,1,2,50.0,1,0,0,0,2,4,8,1
1506,Javi Lopez,1.0,6,5,4,2,0,4,5,80.0,1,1,1,0,1,7,5,0
1508,Javi Lopez,15.4,47,34,23,18,6,19,40,47.5,21,12,6,6,21,68,38,2
1509,Lluis Lopez,3.3,4,2,3,1,0,2,2,100.0,0,4,0,4,1,5,6,1
1510,Maxime Lopez,12.3,16,10,5,8,3,4,26,15.4,22,8,2,6,8,24,1,0
1511,Pau Lopez,32.0,1,0,1,0,0,1,5,20.0,4,0,0,0,1,2,10,3
1512,Roberto Lopez,0.6,4,2,1,1,2,2,2,100.0,0,0,0,0,0,4,0,0
1513,Unai Lopez,19.9,30,22,8,18,4,10,41,24.4,31,13,2,11,18,48,12,1
1515,Albert Lottin,0.5,2,0,2,0,0,1,4,25.0,3,0,0,0,2,4,2,0
1516,Imran Louza,22.3,53,27,18,27,8,19,46,41.3,27,18,2,16,17,70,7,0
1518,Dejan Lovren,8.6,13,8,10,3,0,7,12,58.3,5,9,6,3,10,23,42,0
1519,Eduard Lowen,7.5,10,8,6,2,2,6,18,33.3,12,11,2,9,5,15,7,0
1520,Eduard Lowen,3.5,9,6,3,6,0,5,11,45.5,6,2,1,1,7,16,2,0
1521,Matthew Lowton,17.0,41,22,20,18,3,22,33,66.7,11,20,6,14,27,68,57,1
1522,Hirving Lozano,11.4,6,4,1,5,0,2,15,13.3,13,13,0,13,5,11,5,0
1523,Pol Lozano,1.9,5,3,3,2,0,3,7,42.9,4,3,0,3,1,6,2,0
1525,Jean Lucas,2.2,16,7,8,5,3,2,9,22.2,7,2,2,0,2,18,0,0
1526,Fabio Lucioni,34.8,29,13,20,9,0,14,32,43.8,18,48,38,10,36,65,169,5
1527,Jose Luis Gaya,22.1,44,30,29,12,3,28,41,68.3,13,22,9,13,18,62,48,1
1528,Jose Luis Morales,28.0,17,8,5,9,3,6,34,17.6,28,14,1,13,6,23,5,1
1529,Jose Luis Palomino,27.6,81,44,46,33,2,28,54,51.9,26,39,14,25,61,142,74,2
1530,Jose Luis Rodriguez,0.2,0,0,0,0,0,0,2,0.0,2,0,0,0,0,0,0,0
1531,David Luiz,31.2,28,16,14,14,0,13,24,54.2,11,42,37,5,32,60,133,2
1532,Douglas Luiz,29.0,46,24,25,17,4,19,65,29.2,46,42,15,27,36,82,54,1
1534,Jordan Lukaku,4.4,4,2,1,1,2,2,4,50.0,2,2,1,1,0,4,9,0
1535,Romelu Lukaku,33.1,13,7,4,7,2,3,10,30.0,7,14,6,8,1,14,28,0
1536,Dodi Lukebakio,22.6,25,18,13,8,4,10,28,35.7,18,22,4,18,10,35,14,0
1537,Sasa Lukic,20.7,29,17,8,19,2,10,35,28.6,25,21,7,14,29,58,15,0
1538,Senad Lulic,17.5,21,13,10,7,4,11,41,26.8,30,20,4,16,21,42,28,1
1539,John Lundstram,27.3,46,30,18,21,7,21,65,32.3,44,18,4,14,33,79,46,1
1540,Sebastiano Luperto,5.9,12,9,7,3,2,6,9,66.7,3,5,3,2,6,18,16,0
1541,Arnaud Lusamba,10.9,20,11,8,10,2,7,23,30.4,16,9,0,9,5,25,6,1
1542,Andreas Luthe,10.0,1,0,1,0,0,1,2,50.0,1,0,0,0,0,1,5,1
1543,Lyanco,13.1,23,13,9,12,2,7,13,53.8,6,29,19,10,23,46,54,2
1544,Charalambos Lykogiannis,14.9,14,9,9,3,2,7,18,38.9,11,25,9,16,23,37,71,0
1545,Yann M'Vila,21.6,29,14,12,16,1,12,43,27.9,31,14,4,10,40,69,47,1
1546,Alexis Mac Allister,3.9,9,5,4,3,2,5,9,55.6,4,12,0,12,1,10,2,0
1547,Darwin Machis,23.7,23,13,11,8,4,8,23,34.8,15,22,4,18,31,54,9,0
1548,Yvann Macon,1.1,0,0,0,0,0,0,1,0.0,1,2,0,2,3,3,4,0
1549,James Maddison,29.2,59,30,13,31,15,23,68,33.8,45,16,0,16,9,68,7,1
1550,Lisandro Magallan,13.3,22,15,10,12,0,8,14,57.1,6,17,6,11,16,38,43,1
1551,Francesco Magnanelli,15.5,25,13,9,12,4,11,35,31.4,24,12,6,6,19,44,23,1
1552,Giangiacomo Magnani,1.3,0,0,0,0,0,0,1,0.0,1,2,2,0,2,2,6,0
1554,Hugo Magnetti,2.6,16,10,7,7,2,5,9,55.6,4,4,0,4,7,23,4,0
1555,Harry Maguire,38.0,37,23,23,14,0,18,34,52.9,16,31,22,9,72,109,159,0
1556,Abdallahi Mahmoud,1.7,4,4,2,1,1,1,6,16.7,5,0,0,0,5,9,2,0
1557,Riyad Mahrez,21.6,28,14,11,9,8,11,38,28.9,27,31,1,30,18,46,8,2
1558,Thiago Maia,0.5,4,4,1,3,0,0,1,0.0,1,0,0,0,1,5,1,0
1560,Arne Maier,5.9,9,7,6,1,2,1,10,10.0,9,5,0,5,7,16,2,1
1561,Habib Maiga,25.2,84,50,36,38,10,24,64,37.5,40,39,4,35,34,118,39,2
1563,Ainsley Maitland-Niles,15.4,41,23,34,5,2,22,43,51.2,21,12,3,9,28,69,38,0
1564,Josh Maja,8.2,5,2,0,2,3,1,10,10.0,9,8,4,4,1,6,3,0
1565,Abdul Majeed Waris,4.1,6,4,4,2,0,3,8,37.5,5,2,0,2,4,10,0,0
1566,Zan Majer,18.5,39,18,19,12,8,17,56,30.4,39,27,6,21,26,65,18,1
1567,Jean-Victor Makengo,11.0,14,11,3,10,1,4,13,30.8,9,7,1,6,3,17,5,1
1568,Nemanja Maksimovic,32.2,49,28,12,31,6,10,44,22.7,34,37,7,30,56,105,30,1
1569,Nikola Maksimovic,20.0,35,24,21,14,0,10,21,47.6,11,19,11,8,30,65,64,1
1570,Kevin Malcuit,2.8,8,6,4,3,1,5,6,83.3,1,4,1,3,3,11,2,0
1571,Daniel Maldini,0.3,0,0,0,0,0,0,2,0.0,2,1,0,1,1,1,0,0
1572,Ruslan Malinovskyi,17.1,22,14,2,17,3,9,31,29.0,22,13,2,11,5,27,5,0
1573,Yunus Malli,7.5,8,3,1,5,2,5,10,50.0,5,2,0,2,7,15,7,0
1574,Hugo Mallo,21.8,62,42,44,16,2,27,48,56.3,21,24,8,16,22,84,97,1
1575,Streli Mamba,16.9,15,9,0,9,6,1,13,7.7,12,12,2,10,6,21,2,0
1577,Vincent Manceau,22.0,34,22,18,13,3,16,36,44.4,20,16,3,13,22,56,51,0
1578,Gianluca Mancini,30.4,49,26,26,18,5,22,44,50.0,22,32,15,17,60,109,98,1
1579,Marco Mancosu,27.1,32,18,11,16,5,10,46,21.7,36,34,9,25,16,48,15,1
1580,Steve Mandanda,26.3,3,1,3,0,0,3,4,75.0,1,0,0,0,1,4,2,4
1581,Reinildo Mandava,12.3,37,21,23,11,3,25,41,61.0,16,16,1,15,19,56,20,0
1582,Aissa Mandi,28.6,33,15,22,8,3,18,28,64.3,10,29,15,14,38,71,93,0
1583,Rolando Mandragora,22.8,47,24,15,25,7,15,55,27.3,40,30,5,25,26,73,25,0
1584,Sadio Mane,30.5,44,32,9,20,15,13,40,32.5,27,19,0,19,13,57,11,2
1586,Eliaquim Mangala,7.5,4,4,3,1,0,1,2,50.0,1,7,6,1,7,11,40,0
1587,Thomas Mangani,20.8,33,23,15,16,2,14,47,29.8,33,17,2,15,12,45,20,1
1588,Massimiliano Mangraviti,10.8,8,6,1,6,1,3,6,50.0,3,11,6,5,8,16,43,0
1589,Kostas Manolas,24.2,23,15,13,10,0,10,17,58.8,7,19,14,5,25,48,76,1
1590,Javier Manquillo,17.8,39,26,27,8,4,24,38,63.2,14,14,2,12,18,57,56,0
1592,Myziane Maolida,7.5,14,10,5,6,3,5,12,41.7,7,8,0,8,3,17,3,0
1593,Faitout Maouassa,20.0,51,33,27,20,4,14,26,53.8,12,13,5,8,23,74,59,0
1594,Fernando Marcal,9.2,28,18,18,7,3,13,26,50.0,13,7,3,4,26,54,32,0
1595,Marcelo,14.4,19,11,8,8,3,9,28,32.1,19,19,2,17,18,37,21,0
1596,Marcelo,16.7,27,18,18,8,1,16,23,69.6,7,12,11,1,22,49,77,0
1597,Solly March,12.7,25,12,16,6,3,9,19,47.4,10,16,4,12,20,45,14,2
1598,Gian Marco Ferrari,21.1,9,5,6,3,0,4,8,50.0,4,25,22,3,26,35,41,1
1599,Oscar de Marcos,6.0,5,3,2,1,2,3,6,50.0,3,6,0,6,8,13,8,0
1603,Jose Maria Gimenez,19.5,20,16,18,1,1,7,11,63.6,4,14,7,7,23,43,75,1
1604,Mariano,0.5,0,0,0,0,0,0,1,0.0,1,0,0,0,0,0,0,0
1605,Adrian Mariappa,16.8,20,14,15,4,1,11,30,36.7,19,22,7,15,11,31,73,0
1606,Jordan Marie,2.2,7,5,4,3,0,4,9,44.4,5,3,1,2,4,11,2,0
1608,Adrian Marin,9.5,22,15,14,6,2,13,15,86.7,2,13,4,9,13,35,32,0
1609,Guillermo Maripan,1.0,1,1,1,0,0,1,2,50.0,1,0,0,0,2,3,10,0
1610,Guillermo Maripan,19.5,42,26,28,13,1,24,41,58.5,17,30,13,17,25,67,69,2
1612,Marlon,20.2,40,23,24,15,1,17,27,63.0,10,20,13,7,35,75,69,0
1614,Gonzalo Maroni,2.0,3,1,1,1,1,3,7,42.9,4,1,0,1,3,6,0,0
1615,Marquinhos,16.4,39,20,17,18,4,11,26,42.3,15,25,8,17,25,64,31,1
1616,Bruno Martella,14.1,18,9,14,3,1,9,16,56.3,7,13,7,6,17,35,48,1
1617,Roger Marti,25.2,18,11,8,7,3,7,29,24.1,22,14,0,14,6,24,17,0
1618,Anthony Martial,29.2,15,12,1,4,10,1,16,6.3,15,18,1,17,5,20,17,0
1619,Aaron Martin,19.9,29,15,17,8,4,9,22,40.9,13,11,5,6,30,59,36,0
1622,Jonas Martin,1.3,6,2,4,0,2,1,1,100.0,0,2,2,0,0,6,0,0
1623,Jonas Martin,2.7,5,3,4,0,1,1,3,33.3,2,3,0,3,1,6,3,0
1625,Gabriel Martinelli,7.4,20,15,10,6,4,7,20,35.0,13,15,1,14,3,23,8,0
1628,Inigo Martinez,33.0,48,30,33,13,2,27,47,57.4,20,28,13,15,39,87,140,0
1630,Javi Martinez,7.5,16,12,9,7,0,9,11,81.8,2,9,8,1,18,34,30,0
1631,Jose Martinez,13.2,21,16,12,8,1,14,25,56.0,11,6,4,2,18,39,46,0
1632,Lautaro Martinez,27.2,22,7,2,8,12,4,34,11.8,30,30,2,28,15,37,11,0
1633,Pablo Martinez,0.4,2,0,1,1,0,0,1,0.0,1,0,0,0,0,2,2,0
1634,Pablo Martinez,26.0,42,21,26,15,1,21,40,52.5,19,34,22,12,58,100,97,0
1635,Gelson Martins,18.6,30,22,11,15,4,17,42,40.5,25,9,2,7,19,49,10,1
1636,Adam Marusic,10.5,11,6,7,4,0,4,11,36.4,7,14,2,12,14,25,16,0
1638,Omar Mascarell,22.5,42,23,17,22,3,21,57,36.8,36,46,14,32,62,104,40,0
1639,Andrea Masiello,14.7,26,15,17,8,1,16,32,50.0,16,8,2,6,26,52,55,2
1640,Andrea Masiello,6.0,11,4,6,4,1,7,14,50.0,7,6,4,2,10,21,13,0
1641,Adam Masina,20.2,38,22,24,11,3,14,37,37.8,23,26,12,14,28,66,66,0
1642,Jordi Masip,35.0,1,1,1,0,0,0,2,0.0,2,0,0,0,1,2,7,3
1643,Arthur Masuaku,10.4,41,23,24,13,4,23,39,59.0,16,19,5,14,14,55,23,0
1644,Jaime Mata,30.5,21,13,3,11,7,3,20,15.0,17,16,1,15,7,28,15,0
1645,Juan Mata,8.4,7,3,1,5,1,2,7,28.6,5,5,1,4,0,7,2,0
1646,Ales Mateju,28.3,48,27,33,9,6,23,45,51.1,22,41,24,17,37,85,109,3
1647,Jean-Philippe Mateta,11.7,2,2,0,2,0,0,6,0.0,6,3,2,1,1,3,11,0
1648,Nemanja Matic,17.6,46,24,23,19,4,20,43,46.5,23,21,8,13,22,68,28,1
1649,Joel Matip,7.8,13,9,4,7,2,4,11,36.4,7,8,4,4,12,25,38,0
1650,Rabbi Matondo,12.9,10,3,3,2,5,3,13,23.1,10,4,0,4,5,15,1,0
1652,Federico Mattiello,10.3,30,21,19,7,4,11,27,40.7,16,20,7,13,18,48,22,0
1653,Blaise Matuidi,24.9,48,27,13,27,8,13,34,38.2,21,35,6,29,22,70,16,0
1654,Neal Maupay,30.7,20,12,1,13,6,9,29,31.0,20,24,0,24,4,24,10,0
1655,Stephy Mavididi,15.5,18,11,7,8,3,10,26,38.5,16,11,0,11,7,25,5,0
1656,Philipp Max,30.1,42,29,22,16,4,20,45,44.4,25,19,4,15,26,68,50,0
1657,Alexandru Maxim,1.3,4,2,1,2,1,1,3,33.3,2,0,0,0,1,5,1,0
1658,Eric Maxim Choupo-Moting,5.0,12,9,3,4,5,4,8,50.0,4,3,0,3,1,13,3,0
1660,Borja Mayoral,23.8,12,3,4,6,2,2,13,15.4,11,11,0,11,4,16,6,0
1661,Luca Mazzitelli,0.1,1,1,0,1,0,1,1,100.0,0,0,0,0,0,1,0,0
1662,Kevin Mbabu,18.8,69,48,39,24,6,35,54,64.8,19,33,10,23,23,92,53,0
1664,Kylian Mbappe,16.8,7,2,1,5,1,3,10,30.0,7,4,0,4,3,10,0,0
1665,Ibrahima Mbaye,16.7,19,10,13,4,2,7,17,41.2,10,22,11,11,15,34,42,0
1666,Loic Mbe Soh,0.6,2,2,2,0,0,2,2,100.0,0,0,0,0,1,3,0,0
1667,Isaac Mbenza,0.9,0,0,0,0,0,0,1,0.0,1,0,0,0,0,0,0,0
1668,Nathanael Mbuku,4.4,4,2,2,2,0,0,3,0.0,3,0,0,0,2,6,1,0
1669,James McArthur,34.3,88,51,43,34,11,37,106,34.9,69,69,19,50,60,148,56,0
1670,Oliver McBurnie,23.5,37,22,6,27,4,11,40,27.5,29,25,3,22,15,52,43,0
1671,Alex McCarthy,28.0,1,1,1,0,0,1,1,100.0,0,1,0,1,0,1,11,3
1672,James McCarthy,18.7,82,47,36,36,10,40,76,52.6,36,24,5,19,24,106,11,0
1673,John McGinn,25.7,53,35,19,23,11,18,62,29.0,44,25,1,24,25,78,18,0
1674,David McGoldrick,20.2,41,26,9,24,8,5,20,25.0,15,14,2,12,3,44,23,0
1676,Weston McKennie,23.0,38,20,17,16,5,13,40,32.5,27,38,12,26,46,84,39,0
1677,Kenny McLean,33.0,44,29,20,18,6,14,42,33.3,28,32,7,25,38,82,67,2
1678,Dwight McNeil,37.1,47,33,18,22,7,23,71,32.4,48,60,8,52,30,77,34,0
1679,Scott McTominay,19.7,43,22,14,25,4,17,32,53.1,15,25,5,20,31,74,34,2
1680,Biagio Meccariello,8.5,23,13,15,6,2,12,29,41.4,17,14,2,12,10,33,25,0
1681,Gary Medel,19.8,43,22,15,24,4,16,43,37.2,27,24,8,16,34,77,31,2
1682,Ben Mee,32.0,41,22,25,16,0,17,29,58.6,12,42,31,11,42,83,165,2
1683,Joshua Mees,3.6,8,5,3,4,1,4,12,33.3,8,3,0,3,2,10,4,0
1684,Admir Mehmedi,13.3,14,6,2,9,3,4,15,26.7,11,10,0,10,5,19,4,0
1685,Soualiho Meite,24.5,32,18,14,13,5,12,35,34.3,23,31,6,25,24,56,36,0
1686,Farid El Melali,3.4,7,5,2,2,3,4,14,28.6,10,5,0,5,2,9,4,0
1687,Oscar Melendo,12.4,10,4,4,4,2,4,12,33.3,8,7,2,5,2,12,3,0
1688,Gonzalo Melero,13.7,20,13,9,9,2,7,27,25.9,20,12,3,9,9,29,15,1
1690,Arthur Melo,13.1,15,10,4,7,4,4,12,33.3,8,9,0,9,4,19,5,2
1691,Memphis,11.3,4,3,2,0,2,0,5,0.0,5,0,0,0,2,6,2,0
1692,Pedro Mendes,15.3,28,17,15,13,0,15,24,62.5,9,19,12,7,28,56,42,1
1693,Thiago Mendes,20.1,43,29,20,19,4,21,45,46.7,24,21,7,14,46,89,36,0
1694,Brais Mendez,16.4,26,11,14,9,3,12,39,30.8,27,20,0,20,12,38,23,1
1695,Edgar Mendez,9.6,11,7,4,6,1,5,13,38.5,8,10,2,8,5,16,7,0
1696,Stiven Mendoza,12.2,12,7,4,5,3,4,22,18.2,18,13,2,11,9,21,3,1
1697,Alexandre Mendy,10.0,5,1,1,0,4,1,4,25.0,3,4,1,3,0,5,10,0
1698,Benjamin Mendy,16.6,18,15,7,7,4,9,27,33.3,18,10,2,8,16,34,21,3
1700,Ferland Mendy,20.1,32,26,20,9,3,14,18,77.8,4,19,5,14,22,54,30,1
1701,Nampalys Mendy,3.2,7,5,4,1,2,4,5,80.0,1,4,1,3,6,13,6,0
1702,Hamza Mendyl,16.0,49,32,31,14,4,29,46,63.0,17,16,4,12,23,72,47,0
1703,Chris Mepham,10.1,20,9,13,7,0,11,14,78.6,3,17,11,6,17,37,62,1
1705,Jorge Mere,6.9,6,5,2,4,0,1,2,50.0,1,13,11,2,14,20,30,0
1706,Alex Meret,21.7,0,0,0,0,0,0,2,0.0,2,1,0,1,1,1,7,2
1707,Fran Merida,12.9,27,15,11,10,6,9,27,33.3,18,15,4,11,25,52,10,0
1708,Mikel Merino,34.9,79,52,20,44,15,28,86,32.6,58,46,8,38,51,130,52,0
1710,Yildirim Mert Cetin,2.9,5,1,4,1,0,3,5,60.0,2,4,3,1,4,9,8,1
1711,Dries Mertens,18.8,13,9,1,8,4,2,27,7.4,25,10,1,9,7,20,4,0
1712,Roque Mesa,22.4,40,21,17,18,5,13,44,29.5,31,13,4,9,11,51,8,0
1713,Lionel Messi,32.0,21,10,4,7,10,3,21,14.3,18,9,0,9,7,28,1,0
1714,Thomas Meunier,13.8,27,21,9,12,6,16,26,61.5,10,17,5,12,18,45,19,1
1716,Mexer,16.5,16,11,14,1,1,10,30,33.3,20,14,13,1,15,31,47,0
1717,Max Meyer,7.3,19,11,10,9,0,8,18,44.4,10,6,1,5,7,26,4,0
1719,Michel,24.2,50,28,26,19,5,22,75,29.3,53,22,4,18,33,83,41,1
1720,Sven Michel,15.3,14,12,3,5,6,3,20,15.0,17,13,2,11,7,21,7,0
1721,Miguel,2.6,2,1,1,0,1,1,2,50.0,1,3,1,2,0,2,1,0
1722,Florian Miguel,22.8,51,25,27,20,4,31,52,59.6,21,19,4,15,33,84,32,0
1724,Nikola Milenkovic,36.2,46,25,30,16,0,11,31,35.5,20,39,21,18,29,75,129,1
1725,Arkadiusz Milik,19.4,12,5,4,1,7,3,11,27.3,8,11,1,10,2,14,12,0
1726,Sergej Milinkovic-Savic,33.7,60,35,25,24,11,15,79,19.0,64,67,16,51,37,97,60,1
1727,Eder Militao,11.4,25,15,15,9,1,10,17,58.8,7,12,6,6,20,45,42,0
1728,Luka Milivojevic,27.9,61,32,32,25,4,35,84,41.7,49,30,7,23,42,103,39,4
1729,Vincenzo Millico,2.4,1,0,1,0,0,1,3,33.3,2,2,0,2,0,1,1,0
1730,James Milner,10.4,16,10,3,10,3,6,26,23.1,20,12,3,9,7,23,17,1
1731,Santi Mina,21.6,13,8,8,5,0,5,38,13.2,33,19,2,17,10,23,27,0
1732,Yerry Mina,25.4,39,22,25,12,2,18,24,75.0,6,20,14,6,28,67,102,1
1733,Takumi Minamino,2.8,3,3,0,2,1,2,10,20.0,8,3,0,3,0,3,3,0
1734,Tyrone Mings,32.2,15,11,11,3,1,10,13,76.9,3,56,48,8,30,45,190,4
1735,Jorge Miramon,27.0,52,27,35,13,4,26,45,57.8,19,30,8,22,46,98,61,1
1736,Juan Miranda,8.7,14,10,8,6,0,6,18,33.3,12,12,4,8,10,24,27,1
1737,Antonio Mirante,5.0,0,0,0,0,0,0,1,0.0,1,0,0,0,0,0,2,1
1738,Simone Missiroli,31.1,42,27,18,20,4,13,43,30.2,30,42,27,15,54,96,62,1
1739,Tyrick Mitchell,2.2,5,2,2,2,1,1,7,14.3,6,2,0,2,2,7,3,0
1740,Stefan Mitrovic,22.8,15,9,10,5,0,6,14,42.9,8,14,9,5,23,38,90,3
1742,Maximilian Mittelstadt,21.0,61,38,31,25,5,26,54,48.1,28,38,6,32,53,114,64,0
1743,Henrikh Mkhitaryan,1.2,0,0,0,0,0,0,2,0.0,2,3,0,3,0,0,1,0
1744,Henrikh Mkhitaryan,17.0,32,22,10,17,5,19,45,42.2,26,27,3,24,11,43,6,0
1745,Anthony Modeste,12.6,10,5,1,5,4,1,10,10.0,9,5,3,2,0,10,19,0
1746,Luka Modric,22.2,37,18,9,15,13,16,41,39.0,25,10,2,8,22,59,12,0
1747,Kevin Mohwald,0.8,2,1,1,1,0,1,2,50.0,1,0,0,0,0,2,1,0
1748,Niklas Moisander,22.0,27,15,19,6,2,11,26,42.3,15,37,19,18,49,76,85,0
1749,Jorge Molina,21.0,8,2,0,4,4,0,12,0.0,12,13,2,11,4,12,18,0
1750,Florent Mollet,18.7,13,11,3,8,2,7,28,25.0,21,9,1,8,9,22,2,0
1751,Jon Moncayola,16.6,52,30,26,22,4,27,54,50.0,27,29,5,24,16,68,23,1
1753,Thomas Monconduit,15.2,26,12,6,18,2,9,26,34.6,17,11,4,7,10,36,25,3
1754,Nacho Monreal,3.0,1,1,1,0,0,1,3,33.3,2,3,1,2,3,4,10,0
1755,Nacho Monreal,26.6,38,16,26,9,3,22,42,52.4,20,20,4,16,43,81,66,0
1758,Angel Montoro,10.8,19,8,8,9,2,3,13,23.1,10,10,1,9,13,32,15,0
1759,Martin Montoya,21.1,57,29,31,20,6,30,56,53.6,26,19,5,14,24,81,40,0
1760,Simon Moore,2.0,1,0,1,0,0,1,1,100.0,0,0,0,0,0,1,0,1
1761,Aaron Mooy,23.2,37,24,9,18,10,6,40,15.0,34,36,7,29,23,60,32,1
1762,Wesley Moraes,19.8,15,8,3,8,4,0,5,0.0,5,10,2,8,4,19,23,0
1763,Alfredo Morales,19.2,31,15,11,16,4,11,35,31.4,24,17,6,11,18,49,37,0
1764,Alvaro Morata,23.3,17,8,4,9,4,1,13,7.7,12,12,2,10,5,22,23,0
1765,Jan Moravek,5.3,23,12,9,14,0,11,24,45.8,13,4,1,3,8,31,11,0
1766,Steven Moreira,15.4,37,25,21,15,1,19,31,61.3,12,16,3,13,16,53,29,0
1768,Jeremy Morel,20.1,15,9,13,1,1,9,20,45.0,11,21,17,4,17,32,59,1
1769,Alberto Moreno,16.3,27,16,15,11,1,9,25,36.0,16,15,3,12,25,52,36,0
1770,Alex Moreno,25.2,37,20,27,8,2,12,32,37.5,20,21,8,13,23,60,47,1
1771,Gerard Moreno,30.5,19,8,4,10,5,5,46,10.9,41,19,3,16,10,29,51,0
1773,Wes Morgan,4.8,4,1,3,1,0,0,3,0.0,3,5,3,2,7,11,19,0
1774,Manu Morlanes,2.8,7,3,3,4,0,2,9,22.2,7,1,1,0,2,9,2,0
1776,Loren Moron,22.6,18,12,6,7,5,9,23,39.1,14,25,6,19,9,27,13,0
1779,Victor Moses,4.7,4,3,1,2,1,2,8,25.0,6,4,0,4,0,4,4,0
1780,Lebo Mothiba,11.6,4,3,1,1,2,1,6,16.7,5,5,0,5,3,7,1,0
1781,Harold Moukoudi,11.0,28,19,20,7,1,11,14,78.6,3,16,10,6,16,44,42,2
1783,Mason Mount,31.9,37,17,8,19,10,9,42,21.4,33,25,3,22,16,53,18,0
1784,Lucas Moura,24.9,57,33,25,22,10,16,58,27.6,42,29,2,27,15,72,27,0
1785,Lys Mousset,13.8,9,5,0,5,4,3,7,42.9,4,3,0,3,4,13,2,0
1787,Joao Moutinho,34.5,93,50,43,41,9,46,139,33.1,93,43,13,30,50,143,18,1
1788,Samuel Moutoussamy,5.8,4,1,2,1,1,2,7,28.6,5,2,0,2,4,8,7,0
1790,Javi Moyano,24.7,19,8,11,8,0,8,20,40.0,12,18,5,13,27,46,63,0
1791,Nordi Mukiele,19.8,61,39,39,12,10,25,38,65.8,13,26,4,22,47,108,57,0
1792,Mert Muldur,14.1,47,27,33,8,6,27,42,64.3,15,10,0,10,22,69,42,0
1795,Thomas Muller,25.1,45,27,7,26,12,22,69,31.9,47,27,3,24,12,57,8,0
1796,Marshall Munetsi,9.3,27,19,12,12,3,6,12,50.0,6,13,7,6,12,39,20,1
1797,Iker Muniain,26.5,26,19,11,10,5,4,24,16.7,20,9,0,9,12,38,7,0
1798,Aihen Munoz,10.9,28,18,13,12,3,18,27,66.7,9,13,2,11,2,30,19,0
1800,Simone Muratore,1.8,2,0,0,1,1,1,3,33.3,2,1,0,1,3,5,0,0
1801,Alessandro Murgia,19.4,27,17,16,8,3,14,34,41.2,20,10,3,7,18,45,15,0
1802,Luis Muriel,14.0,15,9,3,8,4,3,14,21.4,11,12,0,12,4,19,0,0
1803,Jeison Murillo,7.4,18,6,14,4,0,10,19,52.6,9,8,4,4,10,28,28,0
1804,Jeison Murillo,17.0,37,20,30,6,1,18,27,66.7,9,13,9,4,20,57,74,2
1805,Glenn Murray,8.9,5,2,0,3,2,2,9,22.2,7,6,2,4,1,6,12,0
1806,Nicola Murru,25.1,40,22,24,8,8,21,41,51.2,20,22,4,18,27,67,58,0
1807,Mateo Musacchio,16.3,15,8,11,4,0,7,20,35.0,13,10,7,3,22,37,50,0
1810,Juan Musso,38.0,0,0,0,0,0,0,1,0.0,1,0,0,0,1,1,18,2
1811,Shkodran Mustafi,13.4,17,10,11,5,1,6,12,50.0,6,10,6,4,18,35,72,0
1812,Yoshinori Muto,2.4,3,2,1,2,0,1,2,50.0,1,0,0,0,0,3,0,0
1814,Phillipp Mwene,3.5,11,5,9,2,0,7,12,58.3,5,10,1,9,3,14,11,0
1815,Obite N'Dicka,19.1,27,13,13,11,3,15,28,53.6,13,28,6,22,29,56,57,0
1816,Kevin N'Doram,18.3,43,28,19,21,3,17,40,42.5,23,20,8,12,26,69,23,0
1817,Abdallah N'dour,4.1,5,4,2,3,0,5,10,50.0,5,4,1,3,4,9,5,1
1821,Georges-Kevin N'Koudou,0.0,0,0,0,0,0,0,1,0.0,1,0,0,0,0,0,0,0
1822,Stanley N'Soki,14.1,40,29,24,16,0,23,42,54.8,19,14,6,8,32,72,37,0
1823,Nacho,21.0,43,22,24,15,4,17,48,35.4,31,36,8,28,25,68,61,0
1824,Nacho,4.9,11,6,6,3,2,6,10,60.0,4,5,3,2,12,23,18,1
1825,Radja Nainggolan,23.0,30,18,9,12,9,9,29,31.0,20,25,6,19,13,43,30,0
1826,Marvelous Nakamba,20.4,55,28,28,20,7,24,67,35.8,43,50,11,39,39,94,38,3
1827,Naldo,14.8,24,13,15,9,0,7,15,46.7,8,11,7,4,21,45,50,1
1828,Nahitan Nandez,32.2,58,38,37,17,4,25,69,36.2,44,30,1,29,25,83,26,0
1829,Matija Nastasic,15.2,26,16,17,9,0,14,17,82.4,3,28,16,12,22,48,79,0
1830,Marc Navarro,2.4,3,3,2,1,0,1,1,100.0,0,2,1,1,0,3,3,0
1831,Ximo Navarro,21.1,34,19,17,15,2,16,28,57.1,12,20,7,13,52,86,76,2
1832,Jesus Navas,37.4,27,15,16,7,4,15,32,46.9,17,20,7,13,31,58,70,0
1834,Raul Navas,7.9,10,5,4,6,0,4,13,30.8,9,10,4,6,18,28,30,0
1837,Wilfred Ndidi,29.7,128,67,56,61,11,45,91,49.5,46,52,6,46,80,208,69,3
1838,Emanuele Ndoj,6.2,9,6,2,6,1,3,13,23.1,10,7,0,7,5,14,5,0
1839,Tanguy Ndombele,11.2,24,16,10,13,1,9,22,40.9,13,20,3,17,14,38,7,0
1840,Reiss Nelson,7.0,11,8,5,4,2,7,17,41.2,10,13,2,11,3,14,3,0
1841,Ilija Nestorovski,13.9,10,7,5,5,0,6,21,28.6,15,13,2,11,4,14,12,0
1843,Pedro Neto,10.4,9,4,3,6,0,4,15,26.7,11,2,0,2,6,15,4,0
1844,Manuel Neuer,33.0,2,1,1,0,1,2,4,50.0,2,0,0,0,0,2,15,4
1846,Florian Neuhaus,26.2,42,23,13,22,7,12,54,22.2,42,24,4,20,27,69,8,0
1847,Carlos Neva,24.5,16,11,12,3,1,9,21,42.9,12,15,2,13,28,44,60,0
1848,Ruben Neves,34.0,62,33,27,32,3,34,86,39.5,52,38,9,29,56,118,34,1
1849,Neymar,14.6,12,7,1,9,2,3,21,14.3,18,10,0,10,4,16,1,0
1850,Jeremy Ngakia,4.9,15,7,10,5,0,9,21,42.9,12,6,1,5,7,22,16,0
1851,Jessic Ngankam,0.9,2,2,1,1,0,2,2,100.0,0,2,0,2,0,2,1,0
1852,Muzinga Ngonda,6.0,15,6,10,3,2,7,10,70.0,3,5,4,1,11,26,23,0
1853,Ahmad Ngouyamsa,0.6,1,0,1,0,0,0,3,0.0,3,1,1,0,1,2,5,0
1854,Opa Nguette,20.3,44,28,23,15,6,11,39,28.2,28,17,3,14,12,56,12,0
1855,Moussa Niakhate,33.0,35,22,29,6,0,16,29,55.2,13,40,26,14,40,75,124,4
1856,Ibrahima Niane,10.6,8,7,2,5,1,5,16,31.3,11,5,1,4,10,18,11,1
1857,M'Baye Niang,23.6,17,10,3,11,3,6,21,28.6,15,10,1,9,5,22,20,0
1858,Tanguy Nianzou,5.0,2,1,0,1,1,1,3,33.3,2,4,2,2,3,5,6,0
1862,Florian Niederlechner,30.2,21,13,7,9,5,4,21,19.0,17,21,5,16,8,29,38,0
1863,Saul Niguez,34.1,95,59,44,42,9,39,88,44.3,49,58,13,45,55,150,68,1
1864,Casimir Ninga,7.6,5,5,4,0,1,1,5,20.0,4,5,0,5,3,8,2,0
1865,Fernando Nino,0.9,1,0,0,1,0,1,2,50.0,1,0,0,0,0,1,2,0
1866,Timothee Nkada,1.6,1,0,1,0,0,0,1,0.0,1,0,0,0,0,1,1,0
1867,Eddie Nketiah,7.0,7,5,3,4,0,2,6,33.3,4,9,0,9,2,9,5,0
1868,Nicolas Nkoulou,29.9,34,24,21,11,2,16,22,72.7,6,40,18,22,70,104,138,2
1869,Christopher Nkunku,21.4,21,13,4,11,6,9,33,27.3,24,25,2,23,20,41,8,0
1872,Mark Noble,29.7,52,30,19,28,5,22,64,34.4,42,20,6,14,20,72,10,1
1873,Nolito,10.0,21,12,5,11,5,7,20,35.0,13,7,0,7,1,22,1,0
1874,Nolito,3.6,7,5,5,2,0,3,8,37.5,5,4,1,3,1,8,4,0
1875,Arnaud Nordin,10.1,7,3,3,3,1,4,13,30.8,9,11,1,10,4,11,6,0
1876,Havard Nordtveit,7.8,4,1,3,1,0,3,7,42.9,4,17,12,5,13,17,45,0
1877,Oliver Norwood,34.3,66,37,35,24,7,28,97,28.9,69,34,12,22,47,113,40,1
1879,Kasim Nuhu,11.1,14,7,12,1,1,9,19,47.4,10,16,12,4,25,39,54,0
1880,Unai Nunez,17.5,13,10,10,2,1,6,16,37.5,10,25,17,8,23,36,71,0
1881,Bram Nuytinck,24.7,46,32,30,13,3,17,27,63.0,10,50,32,18,27,73,96,1
1884,Allan Nyom,26.9,45,25,26,15,4,20,37,54.1,17,24,5,19,14,59,50,1
1885,Steven Nzonzi,4.3,5,4,3,1,1,1,2,50.0,1,2,2,0,4,9,18,0
1886,Jack O'Connell,32.4,23,14,15,6,2,10,20,50.0,10,38,17,21,42,65,154,1
1887,Michael Obafemi,7.4,7,3,1,3,3,2,14,14.3,12,3,0,3,6,13,0,0
1888,Pedro Obiang,18.6,46,31,21,19,6,19,40,47.5,21,24,10,14,21,67,31,1
1890,Rafel Obrador,0.0,0,0,0,0,0,0,1,0.0,1,0,0,0,0,0,1,0
1891,Lucas Ocampos,30.5,54,31,30,19,5,30,72,41.7,42,33,2,31,22,76,27,0
1892,Bastian Oczipka,33.5,72,50,42,21,9,36,62,58.1,26,35,6,29,37,109,68,0
1893,Alvaro Odriozola,3.8,5,2,4,0,1,5,8,62.5,3,4,0,4,2,7,8,0
1894,Alvaro Odriozola,1.7,2,2,1,0,1,2,3,66.7,1,1,0,1,1,3,2,0
1896,Angelo Ogbonna,31.0,38,24,20,14,4,18,32,56.3,14,50,32,18,27,65,134,1
1898,Stefano Okaka,26.8,19,11,6,8,5,7,27,25.9,20,23,2,21,8,27,28,0
1900,Lucas Olaza,34.9,56,39,36,17,3,39,59,66.1,20,37,10,27,31,87,60,1
1902,Christian Oliva,5.2,13,7,9,4,0,5,15,33.3,10,5,0,5,7,20,14,0
1903,Kiko Olivas,32.7,33,16,25,7,1,13,35,37.1,22,30,16,14,61,94,112,2
1904,Paulo Oliveira,23.2,31,19,22,8,1,18,30,60.0,12,23,13,10,42,73,107,1
1905,Cauly Oliveira Souza,8.0,11,7,5,5,1,3,11,27.3,8,9,0,9,6,17,1,0
1906,Mathias Olivera,20.8,64,40,34,16,14,27,45,60.0,18,32,3,29,23,87,44,0
1908,Marco Olivieri,0.3,1,1,1,0,0,1,2,50.0,1,0,0,0,0,1,0,0
1909,Dani Olmo,8.3,20,14,5,10,5,1,13,7.7,12,7,1,6,4,24,6,0
1910,Robin Olsen,16.9,0,0,0,0,0,0,1,0.0,1,0,0,0,0,0,8,0
1911,Kenneth Omeruo,20.8,28,17,25,3,0,11,18,61.1,7,21,12,9,36,64,112,2
1912,Jean Onana,0.9,0,0,0,0,0,0,2,0.0,2,1,0,1,1,1,0,0
1913,Karim Onisiwo,19.2,27,19,6,10,11,5,13,38.5,8,20,3,17,7,34,11,0
1914,Javier Ontiveros,9.9,29,14,13,14,2,8,35,22.9,27,13,1,12,5,34,7,0
1916,Nicholas Opoku,5.3,13,8,8,3,2,6,11,54.5,5,6,4,2,4,17,19,0
1917,Nicholas Opoku,7.0,7,5,6,1,0,7,14,50.0,7,6,2,4,7,14,32,0
1918,Willi Orban,9.5,20,12,13,7,0,12,20,60.0,8,14,3,11,16,36,52,1
1919,Fabian Orellana,26.6,29,18,10,6,13,14,52,26.9,38,9,0,9,20,49,2,0
1920,Divock Origi,8.0,12,9,2,5,5,4,9,44.4,5,2,0,2,4,16,5,0
1922,Riccardo Orsolini,29.8,36,22,21,10,5,12,47,25.5,35,23,1,22,16,52,20,0
1924,Yuya Osako,20.5,29,16,5,19,5,3,29,10.3,26,10,1,9,6,35,13,1
1925,Ben Osborn,6.6,15,10,11,3,1,3,16,18.8,13,6,1,5,6,21,7,0
1926,Victor Osimhen,25.4,8,4,1,0,7,1,11,9.1,10,8,0,8,11,19,32,0
1928,Nicolas Otamendi,19.1,28,14,21,6,1,16,33,48.5,17,15,9,6,21,49,76,2
1929,Otavio,24.6,80,45,23,52,5,35,82,42.7,47,26,9,17,41,121,40,6
1930,Paulo Otavio,4.2,21,16,11,9,1,10,13,76.9,3,12,2,10,9,30,11,0
1932,Remi Oudin,6.2,9,6,4,4,1,4,14,28.6,10,7,1,6,9,18,5,0
1933,Remi Oudin,15.5,15,7,8,5,2,6,19,31.6,13,16,1,15,18,33,18,1
1934,Alexandre Oukidja,26.5,0,0,0,0,0,0,1,0.0,1,1,0,1,0,0,15,1
1935,Zinedine Ould Khaled,0.7,2,1,0,2,0,2,4,50.0,2,0,0,0,4,6,0,0
1936,Adam Ounas,12.5,10,5,2,6,2,5,13,38.5,8,9,1,8,11,21,8,1
1937,Reece Oxford,4.2,7,4,2,4,1,2,8,25.0,6,8,5,3,5,12,10,1
1938,Alex Oxlade-Chamberlain,16.5,18,9,4,6,8,5,21,23.8,16,26,1,25,22,40,10,0
1939,Mikel Oyarzabal,33.9,36,15,13,15,8,16,46,34.8,30,32,2,30,13,49,19,1
1940,Ambroise Oyongo,20.2,25,10,16,6,3,16,28,57.1,12,8,0,8,17,42,35,0
1941,Mesut Ozil,16.0,17,8,9,7,1,4,23,17.4,19,4,0,4,5,22,1,0
1942,Levin Oztunali,19.8,28,19,13,12,3,12,35,34.3,23,27,1,26,9,37,14,2
1943,Pablo,24.1,27,15,22,5,0,16,31,51.6,15,25,14,11,40,67,130,2
1944,Fernando Pacheco,26.2,1,0,1,0,0,1,3,33.3,2,0,0,0,0,1,10,0
1946,Goncalo Paciencia,14.3,9,5,1,4,4,3,13,23.1,10,9,1,8,1,10,11,0
1948,Marko Pajac,8.4,8,4,4,3,1,7,16,43.8,9,6,0,6,8,16,9,0
1950,Vincent Pajot,1.3,2,2,1,1,0,1,1,100.0,0,3,0,3,5,7,0,0
1951,Vincent Pajot,5.8,16,11,8,7,1,2,4,50.0,2,5,1,4,9,25,13,0
1952,Rodrigo Palacio,28.0,19,11,0,9,10,4,27,14.8,23,17,3,14,5,24,38,2
1953,Exequiel Palacios,2.0,8,7,4,4,0,2,5,40.0,3,2,0,2,1,9,0,0
1954,Sergi Palencia,5.2,16,10,6,10,0,5,7,71.4,2,6,1,5,8,24,4,0
1955,Nicolas Pallois,21.0,47,36,28,17,2,31,55,56.4,24,18,13,5,40,87,77,1
1956,Emerson Palmieri,11.4,23,12,8,11,4,10,15,66.7,5,13,1,12,18,41,19,0
1957,Alberto Paloschi,4.9,3,0,3,0,0,2,8,25.0,6,3,0,3,0,3,2,0
1958,Alberto Paloschi,2.3,0,0,0,0,0,0,1,0.0,1,1,0,1,1,1,3,0
1960,Goran Pandev,18.7,12,8,2,7,3,3,25,12.0,22,4,1,3,0,12,5,1
1961,Jonathan Panzo,1.2,2,2,2,0,0,1,1,100.0,0,3,1,2,3,5,7,0
1962,Sokratis Papastathopoulos,18.8,25,16,17,7,1,10,21,47.6,11,30,24,6,17,42,68,1
1963,Andrea Papetti,10.2,9,7,8,1,0,4,14,28.6,10,15,11,4,15,24,39,0
1964,Lucas Paqueta,12.3,33,19,12,17,4,14,37,37.8,23,17,2,15,8,41,9,0
1965,Gaetan Paquiez,17.0,36,25,14,13,9,17,47,36.2,30,18,5,13,33,69,43,0
1966,Ruben Pardo,2.1,3,2,2,1,0,2,3,66.7,1,0,0,0,1,4,2,1
1967,Leandro Paredes,9.0,22,14,7,14,1,13,29,44.8,16,7,1,6,15,37,7,0
1968,Daniel Parejo,33.6,67,41,29,32,6,32,101,31.7,69,38,11,27,22,89,20,2
1969,Michael Parensen,7.0,11,6,5,6,0,5,10,50.0,5,14,8,6,12,23,17,0
1971,Marco Parolo,18.9,54,26,19,27,8,18,46,39.1,28,44,15,29,26,80,49,0
1973,Thomas Partey,28.3,70,41,34,30,6,26,58,44.8,32,32,8,24,48,118,41,7
1974,Mario Pasalic,26.9,47,21,17,18,12,16,52,30.8,36,27,7,20,27,74,22,2
1976,Javier Pastore,5.7,14,10,3,5,6,5,12,41.7,7,4,0,4,5,19,5,0
1977,Patric,18.6,34,20,24,7,3,18,25,72.0,7,19,9,10,15,49,45,0
1978,Rui Patricio,38.0,0,0,0,0,0,0,2,0.0,2,2,0,2,2,2,5,2
1979,Paulinho,3.4,4,3,3,1,0,1,2,50.0,1,5,1,4,1,5,0,0
1980,Paulino,0.8,0,0,0,0,0,0,1,0.0,1,1,0,1,1,1,0,0
1981,Gabriel Paulista,31.1,22,14,17,2,3,15,25,60.0,10,36,29,7,48,70,151,3
1982,Benjamin Pavard,31.0,34,22,15,10,9,16,28,57.1,12,28,10,18,52,86,60,0
1983,Jiri Pavlenka,33.0,1,0,1,0,0,1,2,50.0,1,1,0,1,5,6,11,3
1984,Mateo Pavlovic,9.0,8,2,6,2,0,5,7,71.4,2,4,2,2,5,13,38,1
1986,Dimitri Payet,21.4,22,12,8,8,6,10,26,38.5,16,8,1,7,8,30,12,0
1987,Nehuen Paz,1.3,1,1,0,1,0,0,2,0.0,2,3,3,0,5,6,12,0
1988,Nehuen Paz,9.4,14,5,11,3,0,10,12,83.3,2,12,6,6,20,34,38,1
1989,Giampaolo Pazzini,3.4,1,0,0,1,0,0,4,0.0,4,2,0,2,1,2,4,0
1990,Mads Pedersen,1.1,4,2,3,0,1,2,6,33.3,4,3,1,2,2,6,0,0
1991,Alfonso Pedraza,15.0,30,19,16,11,3,19,33,57.6,14,18,6,12,16,46,26,1
1992,Marc Pedraza,1.4,1,1,1,0,0,1,5,20.0,4,0,0,0,4,5,1,0
1993,Pedro,7.3,15,7,5,9,1,3,15,20.0,12,9,0,9,9,24,1,0
1995,Joao Pedro,35.0,17,11,5,7,5,4,24,16.7,20,35,8,27,9,26,39,0
1996,Adria Pedrosa,12.1,19,13,8,9,2,7,25,28.0,18,12,1,11,11,30,32,0
1997,Daouda Peeters,0.2,1,0,0,1,0,1,1,100.0,0,0,0,0,0,1,0,0
1998,Jordan Pefok,4.9,7,6,1,4,2,0,2,0.0,2,3,0,3,1,8,2,0
2000,Peter Pekarik,8.5,14,7,7,3,4,8,20,40.0,12,11,4,7,7,21,31,0
2003,Lorenzo Pellegrini,23.3,30,13,9,13,8,12,33,36.4,21,28,0,28,15,45,18,0
2004,Luca Pellegrini,21.2,31,15,20,7,4,15,38,39.5,23,19,2,17,21,52,45,2
2005,Theo Pellenard,5.1,11,8,6,3,2,6,13,46.2,7,4,0,4,5,16,8,0
2006,Andy Pelmard,8.5,22,14,13,9,0,9,11,81.8,2,12,4,8,15,37,28,1
2007,Federico Peluso,16.8,19,16,8,8,3,8,9,88.9,1,14,9,5,22,41,58,1
2008,Ruben Pena,21.2,42,24,23,19,0,17,50,34.0,33,25,8,17,35,77,58,2
2010,Nicolas Pepe,22.3,32,17,15,13,4,8,16,50.0,8,15,2,13,8,40,5,0
2012,Andreas Pereira,16.5,24,13,8,9,7,10,39,25.6,29,13,0,13,7,31,7,0
2013,Mathias Pereira Lage,17.1,30,18,16,13,1,12,37,32.4,25,19,0,19,17,47,9,0
2014,Ricardo Pereira,28.0,119,68,65,36,18,53,106,50.0,53,38,6,32,49,168,86,0
2015,Gaston Pereiro,3.9,2,2,2,0,0,1,4,25.0,3,1,0,1,0,2,1,1
2016,Bruno Peres,11.7,14,10,10,3,1,8,21,38.1,13,12,3,9,15,29,19,2
2017,Roberto Pereyra,18.3,20,8,11,7,2,9,28,32.1,19,21,0,21,14,34,12,1
2018,Ayoze Perez,22.3,45,28,14,26,5,8,54,14.8,46,33,1,32,14,59,9,1
2019,Carles Perez,6.3,12,8,4,6,2,3,10,30.0,7,6,1,5,3,15,1,0
2020,Carles Perez,5.3,7,4,2,2,3,3,15,20.0,12,5,2,3,1,8,1,0
2021,Inigo Perez,12.0,15,11,3,7,5,8,22,36.4,14,7,1,6,12,27,6,0
2022,Juan Perez,2.0,1,1,1,0,0,1,2,50.0,1,0,0,0,0,1,0,0
2023,Kike Perez,2.4,6,1,1,3,2,3,7,42.9,4,1,0,1,10,16,4,0
2024,Lucas Perez,27.7,12,6,2,8,2,3,13,23.1,10,13,2,11,2,14,0,0
2025,Ruben Perez,24.4,50,27,21,23,6,16,47,34.0,31,21,4,17,38,88,33,0
2028,Mattia Perin,21.0,1,1,1,0,0,1,1,100.0,0,1,0,1,0,1,5,1
2029,Ivan Perisic,13.4,16,12,5,6,5,8,33,24.2,25,14,3,11,4,20,8,0
2030,Diego Perotti,9.7,16,13,5,8,3,5,20,25.0,15,14,0,14,3,19,6,0
2031,Romain Perraud,18.6,29,14,18,9,2,14,28,50.0,14,24,9,15,27,56,50,0
2032,Loic Perrin,19.0,27,20,16,11,0,11,14,78.6,3,23,17,6,39,66,59,0
2033,Lucas Perrin,4.0,5,2,3,2,0,2,7,28.6,5,3,2,1,10,15,17,0
2034,Pavao Pervan,8.0,0,0,0,0,0,0,1,0.0,1,0,0,0,0,0,4,0
2035,Matteo Pessina,27.7,35,21,9,20,6,12,33,36.4,21,28,8,20,25,60,40,2
2036,Andrea Petagna,33.7,9,4,2,7,0,3,17,17.6,14,11,5,6,1,10,27,0
2037,Nils Petersen,27.1,19,14,7,9,3,10,28,35.7,18,32,6,26,10,29,67,0
2039,Denis Petric,1.0,1,1,1,0,0,1,1,100.0,0,0,0,0,0,1,0,0
2040,Jacopo Petriccione,23.8,38,20,29,9,0,15,57,26.3,42,20,7,13,28,66,25,2
2041,German Pezzella,31.4,36,18,26,9,1,14,32,43.8,18,31,20,11,55,91,134,1
2043,Giuseppe Pezzella,10.5,20,12,17,3,0,11,19,57.9,8,13,9,4,6,26,30,0
2044,Rayan Philippe,0.3,0,0,0,0,0,0,1,0.0,1,0,0,0,1,1,1,1
2045,Romain Philippoteaux,22.2,23,12,11,11,1,9,43,20.9,34,22,1,21,13,36,10,0
2046,Krzysztof Piatek,13.1,9,4,0,7,2,3,11,27.3,8,5,2,3,3,12,10,0
2047,Krzysztof Piatek,10.1,5,4,1,1,3,0,11,0.0,11,7,0,7,5,10,3,0
2048,Pablo Piatti,0.6,2,2,1,1,0,1,2,50.0,1,1,0,1,0,2,1,0
2049,Cristiano Piccini,0.8,5,4,1,0,4,4,4,100.0,0,0,0,0,2,7,1,0
2052,Jordan Pickford,38.0,0,0,0,0,0,0,4,0.0,4,0,0,0,3,3,12,6
2054,Jeremy Pied,5.0,18,10,6,11,1,11,16,68.8,5,8,0,8,7,25,10,0
2055,Ronael Pierre-Gabriel,6.4,16,10,9,6,1,7,13,53.8,6,7,0,7,8,24,31,1
2057,Erik Pieters,20.9,54,32,18,29,7,28,69,40.6,41,30,4,26,28,82,60,1
2058,Tomas Pina Isla,14.9,37,22,13,21,3,12,24,50.0,12,15,5,10,16,53,31,0
2059,Andrea Pinamonti,24.8,19,12,1,7,11,5,25,20.0,20,19,2,17,9,28,25,0
2062,Pipa,5.3,9,8,5,4,0,4,6,66.7,2,8,0,8,6,15,17,0
2063,Gerard Pique,34.4,32,23,20,11,1,16,26,61.5,10,39,24,15,36,68,157,0
2065,Fabio Pisacane,27.1,32,21,22,10,0,21,37,56.8,16,36,28,8,27,59,110,2
2066,Lukasz Piszczek,23.4,45,32,27,16,2,28,50,56.0,22,27,11,16,26,71,47,1
2067,Claudio Pizarro,2.6,2,1,0,1,1,0,1,0.0,1,2,0,2,2,4,2,0
2068,Miralem Pjanic,25.3,46,21,16,23,7,21,63,33.3,42,29,12,17,32,78,30,0
2069,Oscar Plano,27.8,48,30,25,19,4,20,61,32.8,41,36,3,33,35,83,29,0
2070,Marvin Plattenhardt,15.5,18,12,13,4,1,12,17,70.6,5,18,7,11,11,29,47,0
2071,Alassane Plea,23.8,16,7,5,6,5,8,28,28.6,20,21,2,19,9,25,7,0
2072,Thomas Pledl,1.0,4,2,2,2,0,0,1,0.0,1,0,0,0,0,4,1,0
2073,Daniel Podence,3.2,3,3,2,0,1,0,2,0.0,2,4,1,3,2,5,1,0
2074,Paul Pogba,13.4,20,9,8,8,4,8,16,50.0,8,12,4,8,7,27,10,2
2076,Andrea Poli,21.3,44,24,19,21,4,16,52,30.8,36,19,3,16,40,84,11,0
2077,Matteo Politano,8.3,12,6,8,2,2,5,14,35.7,9,6,0,6,5,17,3,0
2078,Matteo Politano,2.9,0,0,0,0,0,0,2,0.0,2,1,0,1,0,0,1,0
2080,Sebastian Polter,3.7,2,2,0,1,1,1,3,33.3,2,2,0,2,1,3,1,0
2081,Marin Pongracic,10.3,14,9,11,2,1,9,10,90.0,1,11,7,4,19,33,21,1
2082,Pere Pons,12.1,28,16,14,12,2,12,26,46.2,14,16,3,13,12,40,8,1
2083,Nick Pope,38.0,1,1,1,0,0,1,2,50.0,1,0,0,0,3,4,15,3
2084,Pedro Porro,8.2,18,10,11,7,0,10,18,55.6,8,3,0,3,7,25,19,1
2085,Francisco Portillo,4.2,11,6,3,6,2,4,12,33.3,8,2,0,2,2,13,3,0
2086,Portu,26.6,32,21,10,15,7,13,33,39.4,20,28,3,25,13,45,5,0
2087,Stefan Posch,25.6,63,34,35,27,1,35,63,55.6,28,57,25,32,40,103,101,1
2088,Sergio Postigo,26.4,32,15,23,7,2,11,18,61.1,7,24,15,9,34,66,132,1
2090,Yussuf Poulsen,13.6,14,10,2,10,2,4,21,19.0,17,12,0,12,4,18,15,0
2093,Alejandro Pozo Pozo,16.6,38,24,30,6,2,19,38,50.0,19,23,2,21,23,61,29,1
2094,Alejandro Pozo Pozo,0.4,1,1,1,0,0,1,1,100.0,0,0,0,0,0,1,1,0
2095,Percy Prado,2.1,6,5,3,2,1,5,9,55.6,4,1,0,1,1,7,5,0
2096,Dennis Praet,12.6,33,18,8,21,4,9,29,31.0,20,19,1,18,17,50,12,0
2097,Abdon Prats,3.1,1,1,0,0,1,0,1,0.0,1,1,0,1,0,1,1,0
2098,Sanjin Prcic,0.9,1,0,0,0,1,1,2,50.0,1,1,1,0,1,2,0,0
2099,Nicolas de Preville,22.2,35,21,9,22,4,18,56,32.1,38,15,3,12,6,41,19,0
2101,Kai Proger,23.1,43,22,21,17,5,17,58,29.3,41,34,6,28,14,57,20,1
2102,Grischa Promel,10.3,14,11,6,6,2,7,19,36.8,12,10,2,8,14,28,9,0
2103,Davy Propper,31.4,64,35,28,28,8,23,74,31.1,51,27,8,19,38,102,36,4
2104,Antonio Puertas,28.5,37,24,8,18,11,16,53,30.2,37,21,3,18,12,49,21,0
2106,Riqui Puig,5.7,11,7,1,9,1,5,17,29.4,12,2,0,2,5,16,1,0
2107,Teemu Pukki,32.1,12,6,3,5,4,1,23,4.3,22,13,0,13,6,18,7,0
2108,Erick Pulgar,32.8,73,46,25,41,7,22,96,22.9,74,45,15,30,49,122,53,1
2109,Christian Pulisic,19.1,23,11,13,4,6,7,24,29.2,17,15,0,15,6,29,11,0
2110,Ignacio Pussetto,0.8,7,4,4,2,1,3,8,37.5,5,2,1,1,3,10,4,0
2111,Ignacio Pussetto,3.8,8,4,4,3,1,1,4,25.0,3,3,0,3,4,12,7,0
2112,Fabio Quagliarella,25.3,9,5,0,6,3,2,30,6.7,28,13,0,13,8,17,15,0
2113,Robin Quaison,28.9,25,17,15,7,3,11,32,34.4,21,27,5,22,11,36,8,0
2114,Domingos Quina,0.2,2,0,1,1,0,1,2,50.0,1,3,0,3,0,2,0,0
2115,Quini,8.0,25,14,16,7,2,13,22,59.1,9,5,1,4,10,35,14,0
2116,Xavi Quintilla,17.5,22,12,14,4,4,10,20,50.0,10,11,4,7,12,34,35,0
2118,Adrien Rabiot,21.2,47,31,16,19,12,15,41,36.6,26,36,6,30,32,79,19,0
2119,Nemanja Radoja,22.1,43,19,27,16,0,15,46,32.6,31,21,4,17,23,66,24,0
2120,Nemanja Radonjic,9.8,10,3,4,3,3,6,17,35.3,11,7,0,7,2,12,7,0
2121,Ivan Radovanovic,14.6,27,14,18,9,0,10,26,38.5,16,17,3,14,8,35,39,0
2122,Ionut Radu,17.0,0,0,0,0,0,0,2,0.0,2,0,0,0,1,1,7,1
2123,Stefan Radu,25.6,43,25,24,15,4,28,43,65.1,15,19,9,10,34,77,85,0
2126,Rafael,7.8,24,16,12,8,4,10,18,55.6,8,6,3,3,10,34,14,0
2127,Raffael,0.7,0,0,0,0,0,0,2,0.0,2,2,0,2,0,0,0,0
2128,Rafinha,2.1,3,2,1,1,1,1,2,50.0,1,0,0,0,1,4,0,0
2129,Rafinha,23.5,71,37,29,37,5,20,62,32.3,42,37,4,33,33,104,25,0
2130,Daniele Ragatzu,3.5,3,2,0,2,1,1,3,33.3,2,1,0,1,1,4,5,0
2133,Antonio Raillo,30.8,31,21,24,7,0,13,19,68.4,6,31,26,5,22,53,112,1
2134,Predrag Rajkovic,27.0,1,1,1,0,0,1,1,100.0,0,0,0,0,1,2,9,0
2135,Ivan Rakitic,17.7,27,14,8,15,4,10,28,35.7,18,19,6,13,15,42,18,1
2136,Benito Raman,17.8,18,9,4,9,5,7,24,29.2,17,11,1,10,7,25,1,0
2137,Gaston Ramirez,15.5,32,21,7,16,9,8,30,26.7,22,28,2,26,11,43,10,0
2138,Sandro Ramirez,14.5,12,10,2,6,4,2,20,10.0,18,11,1,10,7,19,2,0
2139,Ivan Ramis,5.1,3,2,2,1,0,1,4,25.0,3,2,0,2,4,7,23,2
2140,Adrian Ramos,2.5,6,2,0,2,4,2,3,66.7,1,2,0,2,1,7,1,0
2141,Sergio Ramos,33.5,46,31,26,17,3,20,42,47.6,22,22,9,13,49,95,102,4
2142,Aaron Ramsdale,37.0,4,3,4,0,0,3,3,100.0,0,0,0,0,0,4,25,1
2143,Aaron Ramsey,11.7,20,15,6,8,6,6,24,25.0,18,18,3,15,11,31,12,0
2145,Luca Ranieri,2.6,2,2,2,0,0,2,3,66.7,1,1,0,1,2,4,7,0
2146,Andrea Ranocchia,5.8,17,10,10,7,0,5,8,62.5,3,11,6,5,8,25,18,0
2147,Raphinha,18.8,22,18,5,12,5,10,32,31.3,22,23,1,22,17,39,14,1
2148,Tobias Raschl,0.3,0,0,0,0,0,0,1,0.0,1,1,0,1,0,0,0,0
2149,Marcus Rashford,29.4,13,9,1,6,6,9,23,39.1,14,23,0,23,10,23,19,0
2150,Milot Rashica,25.2,21,14,13,6,2,9,33,27.3,24,15,2,13,6,27,16,1
2151,Giacomo Raspadori,2.9,8,6,5,2,1,3,4,75.0,1,5,0,5,1,9,0,0
2152,Raul,0.2,0,0,0,0,0,0,2,0.0,2,0,0,0,0,0,0,0
2153,Ante Rebic,15.5,16,11,4,9,3,7,34,20.6,27,14,1,13,3,19,12,0
2155,Arkadiusz Reca,21.4,38,23,22,10,6,13,39,33.3,26,15,2,13,32,70,48,1
2156,Recio,17.4,30,19,13,12,5,10,40,25.0,30,14,3,11,22,52,9,0
2158,Daishawn Redan,0.2,0,0,0,0,0,0,1,0.0,1,0,0,0,0,0,0,0
2159,Nathan Redmond,30.7,49,29,17,23,9,21,57,36.8,36,39,2,37,16,65,16,0
2163,Sergio Reguilon,27.9,57,30,28,25,4,27,64,42.2,37,25,5,20,33,90,53,0
2164,Ken Reichel,5.9,6,3,2,3,1,3,13,23.1,10,8,1,7,9,15,12,0
2165,Manolo Reina,36.0,0,0,0,0,0,0,1,0.0,1,2,0,2,5,5,9,1
2166,Pepe Reina,12.0,0,0,0,0,0,0,2,0.0,2,0,0,0,0,0,9,1
2168,Jeff Reine-Adelaide,0.9,3,1,1,2,0,1,1,100.0,0,1,0,1,0,3,1,0
2169,Jeff Reine-Adelaide,8.7,10,8,3,3,4,5,13,38.5,8,3,1,2,7,17,4,0
2170,Karim Rekik,14.0,16,10,10,6,0,3,6,50.0,3,23,15,8,18,34,44,0
2171,Alex Remiro,25.0,0,0,0,0,0,0,1,0.0,1,0,0,0,0,0,25,1
2172,Loic Remy,10.7,4,1,0,3,1,0,4,0.0,4,1,1,0,0,4,7,0
2173,Panagiotis Retsos,1.3,6,3,4,2,0,1,4,25.0,3,2,0,2,2,8,2,0
2174,Marco Reus,16.6,26,16,5,11,10,3,19,15.8,16,17,2,15,9,35,11,0
2175,Elvis Rexhbecaj,6.9,16,12,9,5,2,5,13,38.5,8,7,0,7,3,19,4,0
2176,Gio Reyna,3.9,6,2,1,5,0,1,4,25.0,3,3,0,3,0,6,2,0
2177,Baptiste Reynet,22.6,1,1,1,0,0,1,3,33.3,2,0,0,0,0,1,12,0
2178,Nico Ribaudo,2.0,3,1,1,0,2,2,6,33.3,4,1,0,1,1,4,0,0
2179,Lucas Ribeiro,0.7,1,0,1,0,0,0,3,0.0,3,1,0,1,1,2,1,0
2180,Franck Ribery,15.7,20,14,7,10,3,4,20,20.0,16,9,0,9,3,23,3,0
2181,Davide Riccardi,0.2,0,0,0,0,0,0,1,0.0,1,0,0,0,0,0,1,0
2182,Declan Rice,38.0,116,60,64,48,4,47,98,48.0,51,41,9,32,77,193,55,0
2185,Richarlison,34.1,70,47,28,28,14,27,56,48.2,29,34,4,30,12,82,42,0
2186,Marco Richter,25.3,21,16,7,9,5,14,51,27.5,37,15,0,15,24,45,17,0
2187,Diego Rico,25.9,61,39,32,24,5,29,59,49.2,30,31,7,24,84,145,91,0
2189,Jairo Riedewald,8.5,14,10,4,10,0,7,11,63.6,4,7,2,5,17,31,23,1
2190,Emiliano Rigoni,4.8,5,4,2,1,2,3,10,30.0,7,5,1,4,3,8,1,0
2191,Tomas Rincon,30.0,56,25,23,25,8,23,65,35.4,42,20,3,17,36,92,62,0
2192,Luis Rioja,18.2,18,12,11,6,1,8,25,32.0,17,21,0,21,16,34,6,0
2193,Renaud Ripart,22.5,39,23,17,20,2,18,46,39.1,28,17,2,15,12,51,37,0
2195,Andrea Rispoli,21.2,24,18,14,9,1,15,30,50.0,15,28,7,21,32,56,62,1
2196,Marcel Risse,1.5,3,2,3,0,0,1,1,100.0,0,1,0,1,1,4,1,0
2197,Mihailo Ristic,9.0,18,14,7,11,0,9,20,45.0,11,7,2,5,7,25,18,0
2198,Matt Ritchie,14.6,22,15,9,10,3,3,15,20.0,12,20,5,15,14,36,31,1
2199,Marlon Ritter,4.8,7,5,5,2,0,4,9,44.4,5,7,0,7,8,15,3,0
2200,Cristian Rivera,3.5,6,4,3,2,1,2,4,50.0,2,4,3,1,4,10,7,0
2201,Maxence Rivera,0.3,0,0,0,0,0,0,1,0.0,1,1,0,1,0,0,0,0
2202,Rober,2.1,3,1,2,0,1,2,2,100.0,0,0,0,0,3,6,2,0
2204,Roberto,8.8,1,1,1,0,0,1,1,100.0,0,0,0,0,0,1,2,0
2205,Sergi Roberto,26.0,35,22,16,11,8,15,25,60.0,10,12,3,9,33,68,36,0
2207,Andrew Robertson,34.6,54,31,17,25,12,27,61,44.3,34,29,7,22,38,92,72,1
2208,Callum Robinson,7.5,6,3,2,2,2,2,7,28.6,5,3,0,3,7,13,3,0
2210,Jack Robinson,5.6,10,5,5,5,0,1,6,16.7,5,12,5,7,8,18,24,0
2211,Joel Robles,32.1,0,0,0,0,0,0,2,0.0,2,0,0,0,0,0,13,2
2212,Marc Roca,33.4,82,52,29,44,9,29,82,35.4,53,28,10,18,31,113,53,2
2213,Ruben Rochina,20.8,41,26,22,9,10,19,52,36.5,33,16,0,16,12,53,19,1
2214,Sebastian Rode,21.5,58,33,27,27,4,17,59,28.8,42,32,5,27,34,92,13,0
2215,Rodri,27.6,50,30,17,25,8,23,63,36.5,40,19,5,14,26,76,35,0
2216,Rodrigo,20.9,10,6,4,5,1,2,23,8.7,21,9,1,8,9,19,13,0
2217,Kevin Rodrigues,21.5,56,31,31,17,8,25,46,54.3,21,30,3,27,31,87,26,1
2218,Kevin Rodrigues,0.1,1,0,1,0,0,1,1,100.0,0,0,0,0,0,1,0,0
2219,Angel Rodriguez,15.6,14,8,2,8,4,2,18,11.1,16,10,1,9,3,17,10,0
2220,Oscar Rodriguez Arnaiz,21.3,23,10,11,7,5,13,41,31.7,28,19,0,19,14,37,13,0
2221,Dani Rodriguez,33.8,59,32,24,28,7,18,61,29.5,43,35,3,32,38,97,27,1
2222,Guido Rodriguez,10.4,24,16,11,11,2,15,25,60.0,10,13,4,9,10,34,21,0
2223,James Rodriguez,4.7,17,13,6,8,3,6,12,50.0,6,3,0,3,3,20,1,0
2224,Jay Rodriguez,22.4,29,19,4,13,12,8,33,24.2,25,33,6,27,5,34,12,0
2226,Ricardo Rodriguez,4.3,6,1,2,2,2,2,6,33.3,4,3,2,1,5,11,17,0
2227,Rodrygo,11.3,6,1,2,3,1,2,21,9.5,19,13,0,13,10,16,5,0
2229,Marko Rog,25.7,69,47,31,29,9,22,84,26.2,62,40,12,28,22,91,23,0
2230,Agustin Rogel,9.5,15,8,12,3,0,7,13,53.8,6,13,10,3,11,26,35,2
2231,Rogerio,11.3,22,14,12,8,2,16,23,69.6,7,13,3,10,9,31,34,0
2232,Marcos Rojo,1.4,3,1,2,1,0,1,2,50.0,1,2,1,1,0,3,6,0
2233,Filippo Romagna,16.4,7,6,2,5,0,5,6,83.3,1,24,17,7,10,17,69,0
2234,Alessio Romagnoli,34.3,46,25,28,15,3,16,27,59.3,11,32,18,14,56,102,157,1
2236,Alaixys Romao,19.8,46,29,31,14,1,17,57,29.8,40,12,3,9,26,72,38,3
2237,Cristian Romero,28.6,52,35,36,12,4,12,41,29.3,29,59,33,26,75,127,116,2
2239,Oriol Romeu,20.7,55,35,23,30,2,27,75,36.0,48,35,13,22,34,89,32,0
2240,Romulo,19.1,30,19,12,14,4,12,34,35.3,22,18,1,17,8,38,12,1
2242,Cristiano Ronaldo,32.4,14,10,3,3,8,4,20,20.0,16,10,3,7,6,20,21,1
2243,Facundo Roncaglia,14.2,24,20,12,10,2,11,20,55.0,9,18,3,15,22,46,46,0
2244,Valentin Rongier,19.9,76,51,25,41,10,22,63,34.9,41,30,4,26,36,112,16,2
2245,Valentin Rongier,3.0,5,4,0,2,3,3,5,60.0,2,4,0,4,2,7,0,0
2246,Marten de Roon,30.2,77,43,36,29,12,34,75,45.3,41,32,8,24,46,123,45,0
2247,Roberto Rosales,20.8,42,23,23,17,2,19,43,44.2,24,17,4,13,30,72,48,0
2249,Danny Rose,9.9,18,11,6,10,2,9,20,45.0,11,14,6,8,8,26,34,2
2250,Danny Rose,9.6,21,12,11,8,2,12,21,57.1,9,11,4,7,10,31,14,1
2251,Luca Rossettini,25.1,25,14,18,7,0,17,34,50.0,17,31,22,9,35,60,126,1
2253,Jerome Roussillon,26.3,48,29,26,18,4,15,29,51.7,14,33,5,28,30,78,58,0
2254,Nolan Roux,6.5,5,2,1,3,1,1,3,33.3,2,2,0,2,4,9,5,0
2255,Nicolo Rovella,1.2,0,0,0,0,0,0,1,0.0,1,0,0,0,4,4,0,0
2256,Amir Rrahmani,35.9,50,31,26,19,5,26,46,56.5,20,50,31,19,30,80,151,1
2257,Ruben,17.6,1,1,1,0,0,1,1,100.0,0,0,0,0,0,1,9,1
2258,Waldo Rubio,9.8,13,8,10,3,0,5,31,16.1,26,12,0,12,7,20,7,0
2259,Antonio Rudiger,19.0,28,18,19,7,2,16,25,64.0,9,15,9,6,16,44,59,1
2260,Sebastian Rudy,30.4,73,49,31,29,13,28,75,37.3,47,26,5,21,27,100,38,0
2264,Daniele Rugani,7.7,8,6,4,4,0,4,5,80.0,1,4,4,0,11,19,18,0
2265,Mario Rui,21.8,31,17,12,12,7,11,29,37.9,18,24,5,19,21,52,43,0
2266,Aitor Ruibal,13.6,27,17,14,11,2,16,39,41.0,23,18,1,17,8,35,11,0
2267,Fabian Ruiz Pena,29.8,43,26,19,18,6,24,65,36.9,41,32,4,28,32,75,18,2
2268,Geronimo Rulli,25.0,3,1,3,0,0,3,4,75.0,1,1,0,1,2,5,9,1
2269,Lukas Rupp,7.7,15,9,7,5,3,5,17,29.4,12,11,0,11,15,30,4,0
2270,Lukas Rupp,3.8,9,4,3,5,1,3,6,50.0,3,5,0,5,5,14,3,0
2271,Mathew Ryan,38.0,1,1,1,0,0,1,4,25.0,3,0,0,0,2,3,13,2
2272,Julian Ryerson,4.1,7,5,2,1,4,3,6,50.0,3,5,3,2,5,12,9,0
2273,Frederik Ronnow,9.0,0,0,0,0,0,0,1,0.0,1,0,0,0,0,0,1,0
2274,Joao Victor Santos Sa,18.1,35,22,12,17,6,10,38,26.3,28,31,1,30,9,44,9,0
2276,Youssouf Sabaly,10.1,18,11,9,4,5,6,22,27.3,16,8,1,7,18,36,23,0
2277,Stefano Sabelli,35.2,83,44,51,28,4,50,106,47.2,56,40,13,27,58,141,107,0
2278,Abdelhamid Sabiri,11.6,20,16,6,11,3,9,27,33.3,18,9,2,7,8,28,18,1
2279,Marcel Sabitzer,27.8,39,25,15,18,6,19,56,33.9,37,27,4,23,23,62,25,0
2280,Ihsan Sacko,1.6,1,1,1,0,0,0,1,0.0,1,0,0,0,0,1,0,0
2281,Alexis Saelemaekers,7.6,14,8,5,7,2,6,20,30.0,14,13,1,12,8,22,1,0
2282,Jorge Saenz,4.1,6,1,4,2,0,3,5,60.0,2,5,2,3,10,16,15,0
2283,Nuri Sahin,13.9,27,16,10,14,3,11,35,31.4,24,15,7,8,37,64,38,0
2284,Wesley Said,12.9,20,9,8,10,2,2,13,15.4,11,6,0,6,9,29,8,0
2285,Allan Saint-Maximin,20.7,13,8,7,4,2,4,18,22.2,14,5,2,3,9,22,6,0
2288,Borja Sainz,6.4,16,9,4,9,3,8,26,30.8,18,14,0,14,3,19,0,0
2289,Romain Saiss,30.1,55,38,37,15,3,32,46,69.6,14,31,16,15,55,110,127,3
2290,Bukayo Saka,19.5,36,21,21,8,7,19,37,51.4,18,12,3,9,12,48,19,0
2291,Hiroki Sakai,18.0,57,36,26,24,7,25,40,62.5,15,20,5,15,23,80,34,1
2292,Mamadou Sakho,10.3,7,5,5,1,1,2,5,40.0,3,12,5,7,20,27,46,2
2293,Jacopo Sala,9.5,29,24,17,11,1,17,31,54.8,14,4,0,4,13,42,15,1
2294,Mohamed Salah,32.0,16,6,1,4,11,5,22,22.7,17,3,1,2,8,24,2,1
2295,Bartosz Salamon,3.8,2,1,2,0,0,1,2,50.0,1,4,4,0,6,8,14,0
2296,Eddie Salcedo,7.6,3,1,2,0,1,0,5,0.0,5,4,0,4,1,4,2,0
2297,William Saliba,11.0,19,9,15,3,1,5,10,50.0,5,13,4,9,21,40,36,1
2298,Yannis Salibur,0.9,0,0,0,0,0,0,4,0.0,4,0,0,0,1,1,1,0
2299,Romain Salin,4.0,0,0,0,0,0,0,1,0.0,1,0,0,0,0,0,3,0
2300,Mohammed Salisu,30.3,41,24,28,13,0,21,34,61.8,13,32,26,6,35,76,158,3
2301,Roland Sallai,12.9,17,10,4,9,4,7,20,35.0,13,12,2,10,7,24,4,0
2302,Lazar Samardzic,0.4,4,4,2,2,0,1,4,25.0,3,2,1,1,0,4,0,0
2303,Diadie Samassekou,14.6,37,18,14,17,6,12,34,35.3,22,25,8,17,40,77,27,1
2304,Mbwana Samatta,10.5,6,4,0,3,3,1,8,12.5,7,7,0,7,1,7,6,0
2305,Mama Samba Balde,18.6,24,13,9,8,7,7,30,23.3,23,17,0,17,7,31,24,0
2306,Junior Sambia,6.5,8,6,4,2,2,3,13,23.1,10,4,0,4,8,16,6,0
2307,Frederic Sammaritano,5.8,9,7,4,4,1,4,11,36.4,7,6,1,5,2,11,3,1
2308,Fede San Emeterio,19.5,26,13,18,6,2,7,29,24.1,22,20,8,12,28,54,13,1
2309,Mikel San Jose,4.0,9,4,2,4,3,2,10,20.0,8,3,1,2,9,18,12,0
2310,Antonio Sanabria,15.4,14,11,2,7,5,3,14,21.4,11,13,1,12,5,19,12,1
2311,Oihan Sancet,8.2,11,7,5,4,2,4,11,36.4,7,6,0,6,2,13,2,0
2312,Renato Sanches,16.5,28,15,9,15,4,8,33,24.2,25,19,1,18,15,43,10,1
2315,Alexis Sanchez,10.3,9,7,1,4,4,5,13,38.5,8,7,0,7,3,12,1,0
2316,Carlos Sanchez,1.3,1,0,0,1,0,1,1,100.0,0,1,0,1,2,3,1,0
2317,Davinson Sanchez,27.0,44,27,32,12,0,22,44,50.0,22,40,28,12,34,78,128,5
2318,German Sanchez,25.5,16,10,12,4,0,6,16,37.5,10,29,23,6,33,49,115,2
2319,Javi Sanchez,5.5,5,4,3,2,0,1,3,33.3,2,4,2,2,4,9,24,0
2320,Manu Sanchez,3.6,13,7,2,7,4,8,15,53.3,7,3,0,3,7,20,1,0
2321,Victor Sanchez,18.8,66,36,36,23,7,30,71,42.3,41,31,8,23,27,93,23,1
2322,Jadon Sancho,25.4,14,11,6,6,2,8,24,33.3,16,8,0,8,14,28,6,0
2323,Alex Sandro,26.5,44,26,23,14,7,12,33,36.4,21,26,6,20,47,91,46,3
2325,Salif Sane,12.5,16,9,12,4,0,11,19,57.9,8,19,7,12,21,37,50,0
2326,Luca Sangalli,4.1,1,0,0,1,0,1,8,12.5,7,3,0,3,1,2,0,0
2327,Ibrahim Sangare,24.2,84,54,37,42,5,33,74,44.6,41,28,10,18,39,123,49,4
2328,Oier Sanjurjo,25.8,65,34,21,34,10,28,64,43.8,36,33,8,25,35,100,39,1
2329,Yaya Sanogo,10.1,6,3,2,3,1,1,2,50.0,1,4,1,3,7,13,14,0
2330,Morgan Sanson,24.1,60,28,20,29,11,13,52,25.0,39,39,5,34,23,83,9,0
2331,Nicola Sansone,25.2,34,20,12,18,4,15,59,25.4,44,21,0,21,11,45,9,0
2332,Baptiste Santamaria,27.8,91,53,39,43,9,35,79,44.3,44,27,5,22,43,134,36,0
2333,Federico Santander,8.6,13,8,3,0,10,1,4,25.0,3,3,0,3,7,20,12,0
2334,Davide Santon,6.9,11,6,6,5,0,6,17,35.3,11,2,1,1,11,22,13,0
2335,Samir Santos,17.2,35,27,24,8,3,12,23,52.2,11,16,6,10,33,68,64,1
2336,Riccardo Saponara,1.9,4,3,2,2,0,0,2,0.0,2,2,1,1,0,4,2,0
2337,Riccardo Saponara,10.5,12,8,4,8,0,6,13,46.2,7,2,0,2,5,17,7,0
2340,Pablo Sarabia,12.9,12,7,3,6,3,4,25,16.0,21,19,1,18,10,22,5,0
2341,Marcelo Saracchi,2.0,8,6,2,5,1,5,6,83.3,1,3,1,2,1,9,5,0
2342,Josh Sargent,15.7,11,6,5,4,2,2,12,16.7,10,17,1,16,14,25,21,0
2343,Bouna Sarr,24.0,60,37,30,19,11,30,53,56.6,23,17,1,16,32,92,38,0
2344,Ismaila Sarr,22.5,11,10,5,2,4,5,23,21.7,18,9,1,8,18,29,10,0
2345,Malang Sarr,16.2,19,11,13,6,0,9,22,40.9,13,10,4,6,38,57,31,4
2346,Sidy Sarr,12.9,35,18,15,16,4,11,34,32.4,23,13,3,10,15,50,18,0
2347,Joan Sastre Vanrell,15.1,30,17,26,3,1,17,39,43.6,22,8,2,6,23,53,27,1
2348,Teji Savanier,16.9,52,39,16,30,6,25,77,32.5,52,10,0,10,35,87,21,1
2349,Stefan Savic,22.0,22,17,11,10,1,11,18,61.1,7,16,9,7,24,46,91,1
2350,Fabian Schar,18.6,39,21,25,14,0,19,40,47.5,21,35,18,17,47,86,74,2
2351,Louis Schaub,6.9,15,12,2,9,4,5,14,35.7,9,10,1,9,3,18,2,0
2352,Ezequiel Schelotto,4.0,4,3,1,2,1,2,8,25.0,6,3,0,3,7,11,14,0
2353,Patrik Schick,14.4,7,3,1,3,3,2,9,22.2,7,8,2,6,2,9,17,0
2355,Kingsley Schindler,9.4,8,5,3,5,0,4,12,33.3,8,6,1,5,6,14,17,0
2356,Xaver Schlager,19.1,47,29,13,30,4,14,44,31.8,30,16,2,14,17,64,12,0
2357,Keven Schlotterbeck,21.5,52,27,36,15,1,17,29,58.6,12,40,21,19,40,92,113,1
2358,Nico Schlotterbeck,4.1,6,3,4,2,0,2,5,40.0,3,7,5,2,3,9,20,1
2359,Jeffrey Schlupp,11.5,18,9,10,7,1,6,16,37.5,10,11,3,8,13,31,15,0
2360,Kasper Schmeichel,38.0,1,1,1,0,0,1,2,50.0,1,0,0,0,1,2,4,2
2361,Marcel Schmelzer,0.7,2,1,1,1,0,1,1,100.0,0,0,0,0,1,3,2,0
2362,Jonathan Schmid,31.5,42,27,19,19,4,19,37,51.4,18,23,8,15,35,77,84,0
2363,Manuel Schmiedebach,2.0,4,1,0,3,1,1,7,14.3,6,1,1,0,3,7,3,0
2364,Benno Schmitz,12.9,28,17,13,11,4,16,36,44.4,20,11,1,10,16,44,27,0
2366,Morgan Schneiderlin,11.1,31,22,13,16,2,8,24,33.3,16,13,3,10,21,52,20,1
2367,Lasse Schone,27.0,42,26,16,22,4,15,48,31.3,33,22,6,16,37,79,25,2
2368,Sebastian Schonlau,23.0,64,43,50,14,0,41,66,62.1,25,36,15,21,40,104,138,1
2369,Alessandro Schopf,15.9,29,16,11,10,8,12,33,36.4,21,17,1,16,26,55,8,0
2370,Jerdy Schouten,12.0,26,16,13,11,2,10,26,38.5,16,19,7,12,26,52,22,0
2371,Markus Schubert,8.2,0,0,0,0,0,0,1,0.0,1,0,0,0,0,0,9,4
2372,Nico Schulz,6.6,11,7,3,6,2,8,13,61.5,5,14,4,10,9,20,9,0
2374,Matteo Scozzarella,10.2,23,15,8,13,2,14,29,48.3,15,19,14,5,27,50,28,0
2375,Aleksandar Sedlar,9.0,13,6,10,2,1,7,11,63.6,4,17,11,6,16,29,31,0
2376,Davie Selke,10.7,6,3,2,2,2,4,7,57.1,3,7,1,6,1,7,11,0
2377,Davie Selke,5.1,2,0,1,1,0,0,2,0.0,2,1,0,1,0,2,2,0
2378,Matz Sels,27.0,0,0,0,0,0,0,1,0.0,1,0,0,0,1,1,6,0
2379,Ken Sema,27.3,59,41,43,15,1,36,68,52.9,32,26,6,20,17,76,41,1
2380,Nelson Semedo,23.3,51,30,27,18,6,21,36,58.3,15,18,3,15,22,73,30,0
2381,Alessandro Semprini,7.0,10,4,7,3,0,7,9,77.8,2,10,3,7,9,19,16,0
2382,Josep Sene,1.7,2,1,2,0,0,2,5,40.0,3,2,1,1,0,2,2,0
2383,Stefano Sensi,8.0,18,10,10,7,1,6,22,27.3,16,15,1,14,9,27,4,0
2384,Luigi Sepe,34.0,1,0,1,0,0,1,2,50.0,1,0,0,0,0,1,6,2
2385,Suat Serdar,17.8,56,37,16,33,7,18,61,29.5,43,39,7,32,24,80,7,0
2386,Ryan Sessegnon,3.8,6,4,2,4,0,3,6,50.0,3,0,0,0,3,9,12,0
2387,Salva Sevilla,28.5,27,21,11,16,0,9,30,30.0,21,17,5,12,29,56,17,1
2388,Yevhen Shakhov,12.1,28,16,12,13,3,8,27,29.6,19,11,3,8,14,42,9,1
2389,Xherdan Shaqiri,2.1,1,0,0,1,0,0,1,0.0,1,0,0,0,0,1,0,0
2390,Billy Sharp,11.7,6,5,2,1,3,1,6,16.7,5,2,0,2,1,7,2,0
2392,Luke Shaw,19.3,34,18,19,11,4,19,33,57.6,14,26,6,20,24,58,56,1
2394,Jonjo Shelvey,23.5,29,19,17,12,0,11,42,26.2,31,14,5,9,23,52,38,0
2395,Gen Shoji,0.5,2,2,2,0,0,1,1,100.0,0,0,0,0,0,2,2,0
2396,Djibril Sidibe,20.3,83,44,48,25,10,43,72,59.7,29,19,3,16,40,123,41,0
2397,Kalidou Sidibe,1.0,3,3,0,3,0,2,5,40.0,3,0,0,0,1,4,0,0
2398,Sidnei,13.1,23,19,17,6,0,9,14,64.3,5,15,12,3,21,44,57,0
2400,Gylfi Sigurdsson,28.4,50,26,15,24,11,19,70,27.1,51,30,4,26,37,87,17,1
2401,Luca Siligardi,3.7,6,2,3,2,1,4,8,50.0,4,3,0,3,3,9,5,0
2402,Adrien Silva,13.6,37,22,14,19,4,10,37,27.0,27,19,6,13,12,49,14,2
2403,Andre Silva,0.7,2,1,0,0,2,0,1,0.0,1,0,0,0,0,2,0,0
2404,Andre Silva,17.5,7,2,0,5,2,2,14,14.3,12,9,0,9,8,15,4,0
2405,Bernardo Silva,22.6,36,18,8,21,7,13,44,29.5,31,25,1,24,24,60,13,0
2406,David Silva,20.3,26,14,3,15,8,10,28,35.7,18,18,3,15,13,39,5,0
2407,Gabriel Silva,2.6,4,1,1,2,1,2,3,66.7,1,2,0,2,4,8,8,0
2408,Jonathan Silva,30.9,60,34,32,22,6,27,52,51.9,25,12,4,8,34,94,46,0
2409,Matheus Pereira da Silva,5.2,10,6,1,6,3,4,10,40.0,6,11,0,11,6,16,5,0
2410,Rui Silva,35.0,2,1,2,0,0,2,2,100.0,0,0,0,0,2,4,22,3
2411,Thiago Silva,17.5,28,16,15,13,0,13,16,81.3,3,18,15,3,26,54,54,0
2412,Marco Silvestri,35.0,1,0,1,0,0,1,2,50.0,1,0,0,0,4,5,11,1
2413,Mohamed Simakan,16.7,54,32,35,16,3,22,34,64.7,12,14,3,11,31,85,25,0
2414,Giovanni Simeone,32.5,24,13,9,10,5,5,32,15.6,27,24,7,17,11,35,16,1
2415,Moses Simon,24.2,15,7,5,4,6,6,21,28.6,15,6,0,6,8,23,6,0
2416,Unai Simon,33.2,0,0,0,0,0,0,1,0.0,1,1,0,1,1,1,10,1
2418,Jack Simpson,2.7,5,2,4,1,0,2,8,25.0,6,1,0,1,2,7,12,1
2419,Sarpreet Singh,0.8,1,0,0,1,0,0,1,0.0,1,0,0,0,0,1,0,0
2421,Daley Sinkgraven,10.1,20,16,11,6,3,8,24,33.3,16,12,3,9,10,30,16,0
2422,Dimitris Siovas,21.3,42,31,24,15,3,19,28,67.9,9,14,1,13,46,88,69,0
2424,Ibrahima Sissoko,17.8,46,27,21,21,4,16,48,33.3,32,14,5,9,20,66,25,0
2425,Moussa Sissoko,27.2,39,25,25,12,2,20,48,41.7,28,19,4,15,27,66,43,2
2427,Pione Sisto,9.9,17,8,5,6,6,4,19,21.1,15,18,0,18,6,23,4,1
2429,Ellyes Skhiri,29.7,74,52,30,37,7,29,77,37.7,48,47,9,38,67,141,33,0
2430,Oliver Skipp,0.9,2,2,0,2,0,1,4,25.0,3,3,2,1,0,2,0,0
2431,Lukasz Skorupski,37.0,1,0,1,0,0,0,1,0.0,1,0,0,0,2,3,15,5
2432,Andreas Skov Olsen,8.4,11,8,5,5,1,4,12,33.3,8,10,1,9,8,19,5,0
2433,Robert Skov,29.0,41,28,30,9,2,26,50,52.0,24,26,6,20,20,61,40,0
2434,Simon Skrabb,2.9,7,6,2,4,1,6,12,50.0,6,4,1,3,0,7,3,0
2435,Milan Skriniar,29.2,39,20,24,14,1,14,33,42.4,19,19,11,8,28,67,85,1
2436,Steven Skrzybski,5.9,4,4,2,1,1,0,16,0.0,16,10,0,10,10,14,4,0
2437,Petar Skuletic,1.2,6,4,2,2,2,2,4,50.0,2,0,0,0,0,6,1,0
2438,Islam Slimani,14.3,8,4,0,2,6,4,15,26.7,11,5,0,5,1,9,11,1
2439,William Smallbone,4.4,10,5,2,8,0,5,10,50.0,5,7,1,6,1,11,2,0
2440,Chris Smalling,28.5,25,16,15,9,1,10,13,76.9,3,44,35,9,56,81,126,2
2442,Adam Smith,22.8,47,32,29,16,2,23,50,46.0,27,27,6,21,25,72,64,1
2444,Emile Smith Rowe,1.1,1,1,1,0,0,1,3,33.3,2,0,0,0,1,2,2,0
2445,Fyodor Smolov,8.3,2,1,0,2,0,1,9,11.1,8,6,0,6,7,9,9,0
2446,Robert Snodgrass,16.8,29,16,17,10,2,13,44,29.5,31,12,1,11,4,33,11,0
2447,Cedric Soares,2.8,8,6,2,6,0,1,3,33.3,2,3,0,3,3,11,4,0
2448,Cedric Soares,14.5,45,26,19,24,2,25,41,61.0,16,18,4,14,19,64,51,0
2449,Rafa Soares,4.8,6,5,5,0,1,5,11,45.5,6,1,0,1,2,8,6,0
2451,Marcel Sobottka,7.8,15,10,6,8,1,4,13,30.8,9,9,1,8,9,24,12,0
2452,Ruben Sobrino,1.9,7,5,3,2,2,2,3,66.7,1,1,0,1,0,7,1,0
2453,Dominic Solanke,18.3,8,4,2,5,1,5,33,15.2,28,9,1,8,8,16,18,1
2454,Roberto Soldado,26.1,16,9,2,7,7,7,24,29.2,17,16,4,12,4,20,16,0
2455,Carlos Soler,23.0,21,10,10,10,1,9,39,23.1,30,16,6,10,9,30,14,0
2457,Yann Sommer,34.0,0,0,0,0,0,0,1,0.0,1,0,0,0,1,1,11,6
2459,David Soria,38.0,2,1,2,0,0,2,4,50.0,2,0,0,0,3,5,17,5
2460,Bruno Soriano,2.9,4,0,1,2,1,1,1,100.0,0,4,0,4,1,5,7,0
2462,Roberto Soriano,27.4,43,25,15,21,7,10,46,21.7,36,19,0,19,17,60,23,1
2463,Riccardo Sottil,5.7,6,4,4,2,0,3,10,30.0,7,4,0,4,0,6,0,0
2464,Tomas Soucek,11.6,29,15,13,15,1,10,23,43.5,13,7,1,6,22,51,35,0
2465,Adama Soumaoro,7.1,3,2,3,0,0,1,3,33.3,2,12,12,0,11,14,32,0
2467,Boubakary Soumare,13.5,19,12,6,13,0,9,19,47.4,10,6,0,6,16,35,9,0
2468,Bryan Soumare,4.3,12,1,6,5,1,6,9,66.7,3,1,0,1,2,14,1,0
2470,Arnaud Souquet,22.4,62,40,45,13,4,30,67,44.8,37,20,6,14,17,79,44,0
2471,Djibril Sow,19.4,56,33,26,17,13,16,47,34.0,31,15,3,12,30,86,9,0
2472,Caglar Soyuncu,33.7,60,40,41,18,1,27,46,58.7,19,35,19,16,43,103,156,1
2473,Nikolas Spalek,17.5,24,10,6,11,7,7,31,22.6,24,15,1,14,6,30,10,0
2474,Leonardo Spinazzola,17.2,24,12,11,8,5,12,21,57.1,9,13,5,8,20,44,41,0
2476,Mattia Sprocati,6.6,4,2,3,1,0,0,1,0.0,1,5,1,4,2,6,2,0
2477,Bassem Srarfi,1.5,0,0,0,0,0,0,2,0.0,2,0,0,0,2,2,0,0
2478,Dennis Srbeny,0.5,5,5,3,2,0,1,3,33.3,2,1,0,1,0,5,1,0
2479,Dennis Srbeny,12.4,11,6,4,4,3,5,18,27.8,13,11,1,10,3,14,9,0
2480,Jerry St. Juste,23.5,46,25,34,10,2,14,34,41.2,20,35,19,16,52,98,86,1
2481,Jack Stacey,17.2,21,11,9,11,1,8,22,36.4,14,27,11,16,18,39,64,1
2482,Kostas Stafylidis,4.4,10,3,7,2,1,4,10,40.0,6,10,3,7,2,12,17,0
2483,Benjamin Stambouli,9.0,31,19,14,15,2,11,21,52.4,10,16,6,10,12,43,28,1
2484,Junior Stanislas,7.9,10,7,2,3,5,3,8,37.5,5,6,0,6,4,14,6,0
2485,Niklas Stark,19.2,36,20,24,10,2,9,21,42.9,12,27,12,15,21,57,97,2
2487,Renato Steffen,17.6,25,18,4,14,7,14,39,35.9,25,25,2,23,23,48,10,0
2489,Dale Stephens,28.1,73,44,30,37,6,25,75,33.3,50,31,11,20,58,131,42,2
2490,Jack Stephens,27.2,44,27,30,13,1,24,46,52.2,22,38,22,16,31,75,120,2
2491,Mariusz Stepinski,7.8,5,3,2,1,2,1,2,50.0,1,3,1,2,1,6,7,0
2492,Raheem Sterling,29.5,27,15,8,10,9,6,28,21.4,22,16,2,14,15,42,4,0
2493,Enda Stevens,37.2,81,46,48,26,7,42,96,43.8,54,27,8,19,35,116,71,3
2494,Marco Stiepermann,13.1,20,8,8,9,3,5,21,23.8,16,11,3,8,5,25,16,0
2496,Lars Stindl,15.9,27,16,4,15,8,10,28,35.7,18,18,2,16,10,37,7,0
2497,Kevin Stoger,14.1,21,15,10,7,4,6,24,25.0,18,24,2,22,26,47,7,1
2498,Vlatko Stojanovski,1.4,3,3,0,3,0,1,1,100.0,0,0,0,0,0,3,1,0
2499,John Stones,12.5,16,10,8,7,1,3,5,60.0,2,5,3,2,9,25,32,2
2500,Thomas Strakosha,38.0,0,0,0,0,0,0,1,0.0,1,0,0,0,0,0,7,2
2502,Tobias Strobl,6.8,9,6,5,4,0,3,8,37.5,5,8,4,4,11,20,5,0
2503,Christian Strohdiek,15.1,26,22,21,5,0,20,42,47.6,22,16,10,6,25,51,92,0
2504,Kevin Strootman,15.7,39,27,13,23,3,20,49,40.8,29,16,1,15,17,56,24,0
2505,Jens Stryger Larsen,31.0,27,19,15,9,3,17,30,56.7,13,20,5,15,20,47,52,0
2506,Stefano Sturaro,13.9,38,22,14,19,5,15,39,38.5,24,16,4,12,10,48,26,1
2507,Damian Suarez,28.8,62,32,32,21,9,38,72,52.8,34,25,2,23,27,89,41,0
2508,Denis Suarez,18.1,22,15,14,7,1,10,37,27.0,27,9,1,8,14,36,12,1
2509,Luis Suarez,22.2,4,0,0,1,3,2,12,16.7,10,6,1,5,1,5,11,0
2510,Mathias Suarez,0.7,2,2,2,0,0,2,3,66.7,1,0,0,0,1,3,3,0
2511,Neven Subotic,21.8,30,18,12,16,2,8,32,25.0,24,21,8,13,34,64,89,0
2513,Marek Suchy,4.4,7,5,7,0,0,4,6,66.7,2,4,1,3,6,13,15,0
2514,Niklas Sule,7.1,10,6,8,2,0,4,5,80.0,1,8,6,2,8,18,22,1
2515,Ki Sung-yueng,1.5,1,1,0,1,0,1,3,33.3,2,1,0,1,3,4,2,0
2516,Ki Sung-yueng,0.1,0,0,0,0,0,0,1,0.0,1,0,0,0,0,0,0,0
2517,Stoppila Sunzu,15.0,16,8,12,4,0,10,15,66.7,5,22,15,7,24,40,63,0
2518,Andrew Surman,2.6,4,2,2,2,0,1,3,33.3,2,1,0,1,1,5,5,1
2520,Suso,15.1,7,3,2,3,2,2,10,20.0,8,5,0,5,8,15,3,0
2522,Suso,8.7,9,4,4,4,1,7,16,43.8,9,6,0,6,2,11,0,0
2523,Bosko Sutalo,3.1,3,2,2,1,0,0,2,0.0,2,4,0,4,6,9,6,1
2524,Markus Suttner,14.9,21,16,11,9,1,11,24,45.8,13,22,7,15,13,34,33,0
2525,Mattias Svanberg,11.7,13,8,9,4,0,6,31,19.4,25,15,4,11,13,26,10,0
2526,Issiaga Sylla,28.0,73,49,44,21,8,40,69,58.0,29,31,7,24,67,140,90,2
2528,Eddy Sylvestre,0.4,0,0,0,0,0,0,1,0.0,1,0,0,0,0,0,0,0
2529,Adam Szalai,12.7,8,4,0,6,2,1,11,9.1,10,9,0,9,2,10,14,0
2531,Andrea Tabanelli,10.7,22,13,10,9,3,8,28,28.6,20,13,2,11,11,33,19,0
2532,Tachi,2.6,2,1,2,0,0,1,4,25.0,3,5,4,1,4,6,12,0
2533,Panagiotis Tachtsidis,22.3,52,27,26,20,6,20,56,35.7,36,27,11,16,35,87,32,2
2534,Jonathan Tah,23.2,36,26,23,11,2,18,29,62.1,11,25,13,12,27,63,98,2
2535,Flavien Tait,9.8,20,13,12,6,2,9,28,32.1,19,7,0,7,9,29,5,1
2536,Mahdi Talal,0.2,0,0,0,0,0,0,1,0.0,1,1,0,1,0,0,2,0
2537,Adrien Tameze,2.3,4,3,1,1,2,1,2,50.0,1,3,1,2,3,7,4,1
2538,Adrien Tameze,5.8,6,2,2,3,1,4,16,25.0,12,7,2,5,7,13,1,1
2539,Japhet Tanganga,5.8,17,9,10,6,1,10,17,58.8,7,7,6,1,11,28,31,2
2540,Adil Taoui,0.3,2,2,0,2,0,0,2,0.0,2,0,0,0,2,4,0,0
2541,Edmond Tapsoba,11.8,24,15,17,5,2,15,25,60.0,10,9,5,4,9,33,44,0
2542,Matt Targett,25.5,52,29,37,11,4,22,53,41.5,31,28,8,20,56,108,82,0
2543,Rodrigo Tarin,10.6,10,7,8,2,0,9,14,64.3,5,7,3,4,9,19,51,0
2544,James Tarkowski,38.0,66,43,47,19,0,31,54,57.4,23,63,47,16,63,129,204,4
2546,Julio Tavares,22.2,12,8,1,6,5,4,17,23.5,13,9,2,7,8,20,29,0
2548,Charlie Taylor,21.6,39,24,26,9,4,19,39,48.7,20,29,9,20,29,68,78,1
2549,Neil Taylor,12.1,16,11,12,4,0,11,20,55.0,9,15,5,10,20,36,43,0
2550,Aurelien Tchouameni,12.3,30,14,15,13,2,11,27,40.7,16,11,3,8,13,43,19,1
2551,Aurelien Tchouameni,0.7,0,0,0,0,0,0,2,0.0,2,0,0,0,0,0,2,1
2552,Georg Teigl,1.2,3,1,1,2,0,2,4,50.0,2,0,0,0,3,6,1,0
2553,Alvaro Tejero,16.1,30,18,17,10,3,14,23,60.9,9,17,4,13,28,58,38,0
2554,Bernard Tekpetey,5.0,4,4,1,2,1,0,2,0.0,2,5,0,5,2,6,0,0
2556,Cristian Tello,8.7,8,5,2,2,4,4,8,50.0,4,5,0,5,4,12,0,0
2557,Lino Tempelmann,0.4,1,0,1,0,0,1,1,100.0,0,1,1,0,0,1,0,0
2558,Lukasz Teodorczyk,2.5,7,5,1,5,1,3,7,42.9,4,2,0,2,0,7,1,0
2559,Hidde ter Avest,7.6,18,9,13,3,2,14,17,82.4,3,6,1,5,9,27,27,0
2560,Marc-Andre ter Stegen,36.0,2,2,2,0,0,2,3,66.7,1,0,0,0,2,4,17,6
2561,Simon Terodde,9.0,8,5,4,3,1,3,13,23.1,10,14,3,11,2,10,14,0
2563,Martin Terrier,13.3,20,15,7,10,3,3,14,21.4,11,14,1,13,10,30,11,0
2565,Kenny Tete,11.9,33,21,12,16,5,15,23,65.2,8,12,3,9,19,52,34,0
2566,Alexander Tettey,26.0,23,18,7,16,0,11,39,28.2,28,20,9,11,43,66,72,1
2567,Florian Thauvin,0.2,1,0,0,1,0,0,1,0.0,1,0,0,0,0,1,0,0
2569,Malick Thiaw,0.8,2,0,1,1,0,1,2,50.0,1,2,2,0,2,4,4,1
2571,Jan Thielmann,6.2,9,6,2,6,1,5,12,41.7,7,8,0,8,8,17,6,0
2572,Sada Thioub,16.8,20,12,8,9,3,5,18,27.8,13,9,1,8,4,24,5,0
2575,Luke Thomas,3.0,1,0,0,1,0,0,3,0.0,3,2,0,2,3,4,7,0
2576,Romain Thomas,26.0,24,17,16,7,1,8,18,44.4,10,35,18,17,39,63,118,1
2577,Adrien Thomasson,23.0,36,21,11,16,9,15,47,31.9,32,21,1,20,9,45,9,0
2578,Erik Thommy,25.1,40,23,16,16,8,15,39,38.5,24,23,2,21,16,56,20,1
2580,Morten Thorsby,20.7,53,34,17,23,13,27,52,51.9,25,24,6,18,17,70,34,0
2581,Khephren Thuram,6.6,22,7,14,8,0,6,17,35.3,11,12,2,10,7,29,13,0
2582,Marcus Thuram,24.5,26,18,7,8,11,11,29,37.9,18,20,1,19,12,38,18,0
2583,Youri Tielemans,31.4,52,29,17,30,5,24,74,32.4,50,43,4,39,22,74,18,0
2584,Kieran Tierney,11.0,20,16,13,6,1,11,15,73.3,4,10,4,6,9,29,37,1
2585,Cheick Timite,1.3,1,0,0,1,0,0,1,0.0,1,0,0,0,2,3,1,0
2586,David Timor,10.5,9,6,4,5,0,5,16,31.3,11,8,3,5,18,27,23,0
2587,Marcel Tisserand,13.4,21,10,14,5,2,7,12,58.3,5,13,4,9,32,53,49,2
2588,Jean-Clair Todibo,0.9,1,0,1,0,0,0,1,0.0,1,0,0,0,0,1,6,0
2589,Jean-Clair Todibo,4.1,15,10,10,5,0,8,9,88.9,1,2,0,2,15,30,24,0
2590,Karl Toko Ekambi,11.0,5,3,0,3,2,1,4,25.0,3,2,0,2,3,8,2,0
2591,Karl Toko Ekambi,6.0,5,2,0,1,4,3,5,60.0,2,2,0,2,5,10,1,0
2592,Corentin Tolisso,7.1,9,4,4,3,2,1,9,11.1,8,9,3,6,4,13,2,1
2593,Jeremy Toljan,24.3,37,21,24,10,3,18,35,51.4,17,23,12,11,18,55,58,1
2594,Rafael Toloi,29.0,56,29,28,23,5,33,76,43.4,43,31,17,14,45,101,80,0
2595,Raul de Tomas,11.9,9,7,3,4,2,4,13,30.8,9,8,1,7,10,19,4,0
2596,Takehiro Tomiyasu,28.1,42,24,25,13,4,22,41,53.7,19,34,9,25,49,91,78,1
2597,James Tomkins,17.6,29,17,21,8,0,18,25,72.0,7,17,15,2,21,50,103,0
2598,Fikayo Tomori,14.3,29,16,21,8,0,10,15,66.7,5,13,7,6,22,51,48,2
2600,Nenad Tomovic,19.5,26,19,18,6,2,10,21,47.6,11,32,23,9,30,56,65,1
2601,Sandro Tonali,33.5,39,25,16,20,3,16,55,29.1,39,36,14,22,41,80,42,0
2602,Lorenzo Tonelli,7.8,13,9,13,0,0,4,10,40.0,6,10,7,3,4,17,23,0
2603,Tono,17.7,26,19,18,7,1,15,28,53.6,13,11,3,8,13,39,34,1
2604,Omer Toprak,7.9,7,2,4,2,1,3,6,50.0,3,6,4,2,12,19,41,0
2605,Ernesto Torregrossa,20.5,17,7,5,10,2,6,22,27.3,16,10,2,8,5,22,22,0
2606,Lucas Torreira,16.8,31,16,11,15,5,16,39,41.0,23,24,8,16,34,65,24,0
2607,Ferran Torres,25.0,23,15,6,16,1,8,30,26.7,22,20,3,17,14,37,12,0
2608,Oliver Torres,17.7,45,27,12,26,7,23,60,38.3,37,23,1,22,13,58,9,1
2609,Pau Torres,33.0,34,21,24,10,0,16,24,66.7,8,39,23,16,27,61,153,1
2610,Roberto Torres,30.2,33,16,12,18,3,21,49,42.9,28,41,2,39,31,64,37,0
2611,Lucas Torro,3.7,12,7,6,6,0,8,16,50.0,8,2,1,1,8,20,3,0
2612,Jordan Torunarigha,16.2,32,19,21,11,0,18,27,66.7,9,33,18,15,31,63,75,0
2613,Cenk Tosun,2.0,2,2,2,0,0,0,2,0.0,2,0,0,0,0,2,1,0
2614,Cenk Tosun,3.2,2,0,0,0,2,0,1,0.0,1,1,0,1,0,2,1,0
2615,Abdoulaye Toure,24.7,32,21,10,21,1,10,30,33.3,20,31,11,20,29,61,18,1
2616,Almamy Toure,16.6,32,19,18,11,3,11,22,50.0,11,18,7,11,23,55,54,1
2617,Lucas Tousart,19.6,58,32,19,34,5,17,56,30.4,39,19,7,12,31,89,27,1
2618,Andros Townsend,14.4,34,21,12,17,5,15,37,40.5,22,18,0,18,15,49,10,1
2619,Aleksandar Trajkovski,3.7,2,0,1,1,0,1,7,14.3,6,2,0,2,3,5,1,0
2620,Adama Traore,28.9,33,21,6,14,13,8,23,34.8,15,19,3,16,13,46,14,2
2621,Adama Traore,11.2,3,1,1,2,0,3,12,25.0,9,7,2,5,3,6,5,0
2623,Bertrand Traore,13.9,27,14,8,12,7,8,19,42.1,11,17,2,15,21,48,16,0
2624,Charles Traore,19.3,48,35,27,19,2,36,61,59.0,25,21,4,17,39,87,64,0
2626,Hamari Traore,26.8,55,26,34,18,3,32,64,50.0,32,22,5,17,48,103,59,1
2627,Ibrahima Traore,1.7,4,3,1,1,2,1,7,14.3,6,1,0,1,1,5,3,0
2628,Ismael Traore,22.8,23,12,14,7,2,10,17,58.8,7,23,13,10,27,50,85,1
2629,Kevin Trapp,22.0,0,0,0,0,0,0,1,0.0,1,0,0,0,3,3,5,0
2630,Miguel Trauco,16.4,32,20,16,12,4,19,44,43.2,25,8,1,7,23,55,25,0
2633,Trezeguet,21.7,38,16,18,15,5,9,44,20.5,35,23,2,21,25,63,18,0
2634,Manu Trigueros,17.2,34,21,10,17,7,12,45,26.7,33,23,12,11,4,38,21,0
2635,Christopher Trimmel,31.8,71,41,35,32,4,32,54,59.3,22,31,10,21,51,122,88,1
2636,Alessandro Tripaldelli,1.5,4,4,1,3,0,1,3,33.3,2,1,0,1,3,7,3,0
2637,Kieran Trippier,22.0,52,34,24,21,7,34,53,64.2,19,33,7,26,24,76,46,0
2638,William Troost-Ekong,28.6,37,19,25,12,0,10,18,55.6,8,41,29,12,31,68,135,2
2639,Leandro Trossard,22.3,22,17,7,12,3,6,38,15.8,32,16,1,15,9,31,8,0
2640,Tom Trybull,12.6,39,25,15,18,6,16,60,26.7,44,20,5,15,16,55,35,0
2641,Axel Tuanzebe,2.1,2,2,0,2,0,1,2,50.0,1,1,0,1,5,7,5,1
2642,Georgi Tunjov,3.2,4,4,3,1,0,1,11,9.1,10,3,1,2,1,5,0,0
2645,Matthieu Udol,12.2,29,19,19,8,2,13,24,54.2,11,21,4,17,23,52,43,0
2646,Hwang Ui-jo,18.1,9,7,2,5,2,4,20,20.0,16,7,0,7,5,14,5,0
2647,Anthony Ujah,10.5,8,6,4,2,2,1,6,16.7,5,0,0,0,3,11,10,0
2650,Samuel Umtiti,10.5,11,5,5,5,1,5,8,62.5,3,4,2,2,22,33,32,0
2652,Enes Unal,26.0,20,12,6,11,3,6,28,21.4,22,17,5,12,6,26,13,0
2653,Cengiz Under,9.7,10,6,4,4,2,2,9,22.2,7,7,2,5,8,18,7,0
2654,Dayot Upamecano,26.2,52,31,37,15,0,23,43,53.5,20,31,17,14,43,95,88,1
2655,Mark Uth,12.9,19,12,4,10,5,9,32,28.1,23,15,0,15,7,26,3,0
2656,Mark Uth,3.9,3,2,1,1,1,0,3,0.0,3,4,0,4,1,4,0,0
2657,Tomas Vaclik,32.5,0,0,0,0,0,0,1,0.0,1,0,0,0,0,0,7,0
2658,Alvaro Vadillo,13.5,16,11,6,8,2,9,16,56.3,7,12,0,12,7,23,2,0
2659,William Vainqueur,19.1,68,36,30,32,6,22,60,36.7,38,21,5,16,29,97,23,0
2660,Mirko Valdifiori,15.6,31,15,14,17,0,16,33,48.5,17,8,3,5,4,35,25,0
2661,Pierrick Valdivia,0.8,1,1,0,0,1,0,1,0.0,1,0,0,0,0,1,0,0
2663,Antoine Valerio,1.0,1,1,0,1,0,0,2,0.0,2,2,0,2,3,4,1,0
2664,Borja Valero,10.3,18,7,9,3,6,6,24,25.0,18,12,3,9,8,26,9,0
2665,Yan Valery,8.7,20,7,9,7,4,11,19,57.9,8,9,1,8,13,33,32,2
2666,Martin Valjent,35.4,25,17,14,10,1,13,25,52.0,12,39,27,12,37,62,146,1
2667,Jesus Vallejo,1.8,1,1,1,0,0,1,2,50.0,1,4,3,1,2,3,8,1
2668,Jesus Vallejo,7.0,6,5,4,2,0,3,4,75.0,1,7,4,3,5,11,28,0
2669,Manu Vallejo,4.6,7,3,0,3,4,5,9,55.6,4,4,0,4,2,9,2,0
2670,Luca Valls,0.1,1,0,1,0,0,1,1,100.0,0,1,0,1,0,1,0,0
2671,Theo Valls,18.1,39,16,12,26,1,16,50,32.0,34,17,0,17,13,52,6,0
2672,Mattia Valoti,17.0,48,30,21,25,2,16,43,37.2,27,27,6,21,16,64,18,0
2673,Federico Valverde,21.2,38,19,9,19,10,12,36,33.3,24,38,4,34,21,59,12,2
2674,Virgil van Dijk,38.0,23,12,18,5,0,6,13,46.2,7,20,15,5,40,63,166,2
2675,Raphael Varane,31.4,30,17,15,14,1,12,23,52.2,11,32,16,16,31,61,124,0
2676,Jamie Vardy,33.7,15,12,0,9,6,2,4,50.0,2,22,4,18,2,17,22,0
2678,Matias Vargas,11.4,13,5,7,3,3,4,23,17.4,19,12,2,10,3,16,5,0
2679,Ruben Vargas,28.1,32,16,18,7,7,8,36,22.2,28,26,1,25,26,58,35,0
2680,Thibaut Vargas,1.7,3,1,3,0,0,2,5,40.0,3,1,1,0,0,3,3,0
2681,Sebastian Vasiliadis,31.2,73,45,34,31,8,28,81,34.6,53,47,6,41,34,107,50,0
2683,Denis Vavro,3.6,3,3,2,1,0,1,3,33.3,2,8,6,2,5,8,10,0
2684,Franco Vazquez,12.2,25,17,9,14,2,6,36,16.7,30,13,0,13,10,35,10,0
2685,Kevin Vazquez,14.7,26,15,16,6,4,15,28,53.6,13,18,1,17,26,52,28,0
2686,Lucas Vazquez,9.4,23,17,10,13,0,11,26,42.3,15,10,0,10,10,33,8,1
2687,Matias Vecino,14.2,31,20,14,11,6,9,36,25.0,27,20,3,17,15,46,26,0
2688,Koke Vegas,2.0,0,0,0,0,0,0,1,0.0,1,0,0,0,0,0,3,0
2689,Milos Veljkovic,22.8,55,33,36,18,1,33,53,62.3,20,25,11,14,26,81,92,1
2690,Miguel Veloso,31.2,52,29,20,28,4,18,60,30.0,42,36,12,24,32,84,46,1
2692,Lorenzo Venuti,9.5,20,10,12,6,2,13,19,68.4,6,5,1,4,11,31,15,0
2693,Brayan Vera,1.7,4,1,2,1,1,3,7,42.9,4,1,0,1,1,5,4,0
2694,Simone Verdi,23.0,19,10,4,12,3,9,38,23.7,29,14,0,14,7,26,1,0
2695,Jordan Veretout,29.2,36,18,13,16,7,14,43,32.6,29,35,5,30,18,54,31,1
2696,Marco Verratti,16.5,54,32,22,22,10,20,56,35.7,36,23,3,20,19,73,9,0
2697,Valerio Verre,19.7,25,15,4,11,10,9,23,39.1,14,5,0,5,13,38,9,0
2698,Birger Verstraete,7.4,20,11,9,10,1,11,21,52.4,10,8,1,7,4,24,10,1
2699,Jan Vertonghen,18.3,40,24,25,14,1,20,31,64.5,11,18,10,8,33,73,68,0
2700,Mikel Vesga,14.1,25,17,7,12,6,9,45,20.0,36,18,7,11,31,56,24,1
2701,Jannik Vestergaard,16.6,19,12,14,5,0,11,28,39.3,17,15,9,6,26,45,99,2
2702,Ruben Vezo,29.0,41,24,28,13,0,19,35,54.3,16,37,29,8,42,83,144,2
2704,Francesco Vicari,32.2,27,13,20,6,1,12,25,48.0,13,48,37,11,38,65,145,1
2705,Fede Vico,9.7,5,1,2,3,0,2,11,18.2,9,12,1,11,5,10,2,0
2706,Aleix Vidal,24.1,21,14,8,11,2,8,37,21.6,29,14,1,13,23,44,18,0
2707,Arturo Vidal,18.6,63,38,22,30,11,24,58,41.4,34,31,7,24,17,80,16,1
2708,Clement Vidal,1.0,0,0,0,0,0,0,2,0.0,2,1,1,0,0,0,6,0
2709,Nacho Vidal,25.9,45,29,26,13,6,21,38,55.3,17,24,6,18,44,89,70,1
2710,Ronaldo Vieira,20.2,33,19,13,17,3,6,28,21.4,22,14,2,12,21,54,31,0
2712,Didac Vila,27.7,73,42,44,23,6,25,61,41.0,36,31,5,26,40,113,63,0
2713,Toni Villa,15.0,31,16,13,14,4,13,50,26.0,37,16,1,15,8,39,11,0
2714,Asier Villalibre,5.9,0,0,0,0,0,0,3,0.0,3,3,0,3,1,1,4,0
2715,Gonzalo Villar,3.3,5,3,4,0,1,2,4,50.0,2,2,0,2,2,7,3,0
2717,Juan Villar,2.7,1,0,0,1,0,0,2,0.0,2,4,1,3,1,2,0,0
2718,Ruben Vinagre,7.2,23,13,15,6,2,12,15,80.0,3,7,2,5,11,34,22,0
2720,Vitolo,13.6,15,12,7,7,1,5,17,29.4,12,9,0,9,10,25,9,0
2721,Mattia Viviani,3.8,3,1,0,3,0,1,8,12.5,7,3,3,0,9,12,2,1
2722,Dusan Vlahovic,16.7,6,2,1,4,1,4,13,30.8,9,5,2,3,7,13,6,0
2723,Kevin Vogt,10.7,7,5,4,3,0,3,9,33.3,6,12,6,6,8,15,52,1
2724,Kevin Vogt,12.3,14,10,8,6,0,8,16,50.0,8,15,12,3,25,39,37,1
2725,Jake Vokins,1.0,2,2,0,0,2,1,1,100.0,0,0,0,0,0,2,1,0
2726,Kevin Volland,22.7,16,6,5,6,5,5,16,31.3,11,14,2,12,5,21,7,0
2727,Mario Vrancic,7.1,27,16,14,11,2,16,27,59.3,11,9,0,9,10,37,4,2
2728,Stefan de Vrij,31.4,33,18,20,12,1,14,27,51.9,13,34,24,10,52,85,121,1
2731,Sime Vrsaljko,4.0,6,5,6,0,0,5,6,83.3,1,5,3,2,8,14,11,0
2732,Nikola Vukcevic,17.4,41,26,17,17,7,15,40,37.5,25,19,7,12,12,53,16,0
2733,Matej Vydra,9.1,4,3,0,3,1,3,6,50.0,3,7,3,4,1,5,6,0
2734,Molla Wague,7.6,15,12,11,4,0,7,7,100.0,0,10,8,2,15,30,42,0
2735,Moussa Wague,1.0,2,1,1,0,1,1,1,100.0,0,0,0,0,1,3,0,0
2736,Moussa Wague,2.2,6,4,3,3,0,2,3,66.7,1,2,1,1,2,8,2,0
2737,Wakaso,14.3,54,31,25,24,5,16,33,48.5,17,23,5,18,17,71,17,1
2738,Walace,12.7,28,9,19,6,3,13,42,31.0,29,14,6,8,33,61,19,0
2739,Theo Walcott,14.3,13,8,6,5,2,3,15,20.0,12,13,0,13,8,21,1,0
2740,Luca Waldschmidt,14.1,10,7,3,5,2,2,18,11.1,16,11,2,9,4,14,4,0
2741,Kyle Walker,26.6,28,18,12,15,1,12,29,41.4,17,15,6,9,28,56,42,1
2742,Kyle Walker-Peters,7.8,13,8,5,6,2,6,16,37.5,10,10,3,7,14,27,21,1
2743,Kyle Walker-Peters,2.7,8,5,8,0,0,5,9,55.6,4,4,2,2,3,11,5,1
2744,Remi Walter,0.6,1,1,0,1,0,1,1,100.0,0,0,0,0,0,1,0,0
2745,Sebastian Walukiewicz,12.9,25,11,17,8,0,14,22,63.6,8,21,14,7,14,39,41,0
2746,Aaron Wan-Bissaka,34.1,129,80,71,50,8,64,86,74.4,22,46,13,33,66,195,83,0
2748,Joel Ward,26.5,69,42,48,16,5,39,56,69.6,17,13,6,7,48,117,93,1
2749,James Ward-Prowse,38.0,92,48,39,39,14,39,94,41.5,55,48,14,34,60,152,75,1
2750,Daniel Wass,30.4,44,25,25,13,6,25,57,43.9,32,22,5,17,31,75,91,1
2751,Kelland Watts,0.2,1,0,1,0,0,1,1,100.0,0,0,0,0,0,1,0,0
2752,Timothy Weah,0.9,0,0,0,0,0,0,1,0.0,1,0,0,0,0,0,1,0
2753,Adam Webster,29.6,30,17,21,8,1,14,32,43.8,18,43,26,17,45,75,110,2
2754,Wout Weghorst,30.4,15,8,4,5,6,1,17,5.9,16,17,4,13,2,17,30,0
2756,Julian Weigl,11.3,16,9,12,3,1,9,16,56.3,7,10,0,10,8,24,21,0
2757,Mitchell Weiser,13.0,41,29,20,17,4,18,30,60.0,12,19,2,17,24,65,22,1
2758,Danny Welbeck,9.1,14,6,6,5,3,3,11,27.3,8,12,1,11,5,19,7,0
2759,Wendell,21.1,64,42,26,26,12,41,66,62.1,25,30,4,26,36,100,36,0
2760,Oscar Wendt,18.7,26,14,16,8,2,12,31,38.7,19,27,6,21,20,46,45,0
2761,Timo Werner,31.1,20,9,6,7,7,3,16,18.8,13,16,0,16,5,25,2,0
2762,Ashley Westwood,35.0,54,33,15,32,7,17,48,35.4,31,23,11,12,32,86,32,3
2765,Georginio Wijnaldum,32.6,38,20,12,21,5,10,40,25.0,30,18,4,14,17,55,34,3
2766,Jetro Willems,16.6,37,19,29,6,2,18,39,46.2,21,20,5,15,17,54,42,1
2767,William,15.2,55,26,34,14,7,27,59,45.8,32,10,3,7,24,79,38,1
2768,Brandon Williams,11.2,21,15,11,6,4,9,29,31.0,20,9,4,5,16,37,27,0
2769,Inaki Williams,32.7,15,5,0,7,8,5,18,27.8,13,18,2,16,5,20,29,0
2770,Neco Williams,2.6,5,3,1,3,1,4,5,80.0,1,3,1,2,9,14,6,0
2771,Willian,28.9,45,27,14,24,7,14,43,32.6,29,15,0,15,20,65,7,0
2772,Joe Willock,9.5,25,16,9,12,4,8,21,38.1,13,16,2,14,4,29,11,2
2773,Jack Wilshere,2.4,1,0,1,0,0,0,4,0.0,4,3,0,3,1,2,0,0
2774,Callum Wilson,32.3,12,9,3,6,3,2,17,11.8,15,16,2,14,4,16,16,0
2775,Harry Wilson,18.3,23,13,8,10,5,11,34,32.4,23,26,2,24,11,34,15,1
2776,Harry Winks,24.7,40,24,18,20,2,17,54,31.5,37,27,8,19,36,76,32,1
2777,Florian Wirtz,4.1,4,2,0,4,0,2,4,50.0,2,4,0,4,2,6,1,0
2778,Axel Witsel,24.9,28,20,10,17,1,14,33,42.4,19,26,7,19,31,59,19,1
2779,Hannes Wolf,0.6,3,0,0,1,2,1,4,25.0,3,0,0,0,0,3,0,0
2780,Marius Wolf,15.7,19,11,9,7,3,10,27,37.0,17,14,1,13,17,36,13,0
2782,Nick Woltemade,1.0,2,1,0,2,0,0,1,0.0,1,1,0,1,0,2,2,0
2783,Chris Wood,27.1,7,4,2,4,1,5,15,33.3,10,15,2,13,4,11,18,0
2784,Xeka,7.9,18,10,3,13,2,9,29,31.0,20,11,1,10,4,22,7,1
2785,Granit Xhaka,28.7,45,25,20,19,6,25,55,45.5,30,32,16,16,21,66,59,3
2786,Jawad El Yamiq,2.2,3,2,3,0,0,1,4,25.0,3,3,2,1,1,4,3,0
2787,Andriy Yarmolenko,11.0,13,8,5,6,2,5,20,25.0,15,3,1,2,6,19,4,0
2788,Yusuf Yazici,9.4,17,8,2,11,4,5,13,38.5,8,6,1,5,5,22,1,1
2789,DeAndre Yedlin,10.4,18,13,10,6,2,8,16,50.0,8,13,7,6,10,28,20,0
2791,Okay Yokuslu,21.9,41,27,18,21,2,20,42,47.6,22,12,5,7,28,69,71,1
2792,Maya Yoshida,6.2,8,5,4,1,3,3,7,42.9,4,6,2,4,4,12,27,1
2793,Maya Yoshida,13.2,4,3,2,2,0,2,6,33.3,4,15,12,3,27,31,72,0
2794,Elie Youan,1.8,0,0,0,0,0,0,7,0.0,7,2,0,2,0,0,3,0
2795,Amin Younes,2.0,3,2,1,2,0,2,4,50.0,2,2,0,2,0,3,1,0
2796,Ashley Young,10.6,14,7,7,4,3,5,17,29.4,12,8,2,6,11,25,29,0
2797,Ashley Young,13.2,11,5,3,5,3,6,19,31.6,13,11,3,8,14,25,24,0
2798,Zaydou Youssouf,12.0,40,22,12,26,2,15,35,42.9,20,7,1,6,16,56,13,0
2799,Pablo Zabaleta,6.6,18,10,12,5,1,6,13,46.2,7,5,3,2,14,32,21,0
2800,Mattia Zaccagni,23.5,20,11,10,5,5,3,15,20.0,12,14,3,11,20,40,21,0
2801,Dan-Axel Zagadou,10.9,16,10,12,4,0,6,8,75.0,2,12,8,4,15,31,38,0
2803,Wilfried Zaha,36.4,43,19,18,12,13,12,49,24.5,37,22,2,20,18,61,4,0
2804,Denis Zakaria,21.6,49,30,23,23,3,20,39,51.3,19,39,12,27,37,86,31,1
2805,Joseba Zaldua,28.3,62,43,39,18,5,31,59,52.5,28,31,7,24,37,99,71,0
2806,Andre-Frank Zambo Anguissa,28.7,76,49,29,40,7,26,78,33.3,52,42,6,36,44,120,30,0
2808,Luca Zanimacchia,1.3,5,1,1,2,2,1,2,50.0,1,1,0,1,0,5,0,0
2809,Nicolo Zaniolo,16.7,15,11,4,7,4,3,24,12.5,21,14,0,14,5,20,5,0
2810,Cristian Zapata,19.1,23,17,16,7,0,8,16,50.0,8,29,17,12,24,47,75,0
2811,Duvan Zapata,22.5,7,3,1,2,4,1,6,16.7,5,18,7,11,2,9,11,0
2812,Davide Zappacosta,5.0,7,3,2,3,2,4,8,50.0,4,3,1,2,6,13,8,1
2813,Simone Zaza,18.2,15,10,6,4,5,3,10,30.0,7,11,0,11,9,24,13,1
2814,Marvin Zeegelaar,6.6,15,9,8,4,3,6,11,54.5,5,9,2,7,5,20,10,0
2817,Robin Zentner,21.5,1,1,1,0,0,1,1,100.0,0,0,0,0,0,1,11,0
2818,Piotr Zielinski,32.5,26,16,10,11,5,12,30,40.0,18,28,5,23,21,47,15,0
2819,Jean Zimmer,8.0,11,6,5,5,1,5,10,50.0,5,3,1,2,3,14,0,0
2820,Christoph Zimmermann,15.9,32,21,26,6,0,21,30,70.0,9,22,18,4,19,51,87,2
2821,Matthias Zimmermann,32.5,62,47,26,27,9,31,64,48.4,33,41,15,26,43,105,59,0
2822,Oleksandr Zinchenko,14.2,31,19,16,11,4,17,32,53.1,15,9,0,9,17,48,21,1
2823,Leopold Zingerle,28.0,3,1,3,0,0,2,4,50.0,2,0,0,0,0,3,7,2
2824,Joshua Zirkzee,3.3,5,2,0,2,3,2,4,50.0,2,2,0,2,1,6,0,0
2825,Richairo Zivkovic,1.2,2,2,0,2,0,1,2,50.0,1,1,0,1,0,2,0,0
2826,Jaromir Zmrhal,12.5,10,4,2,5,3,5,18,27.8,13,8,1,7,4,14,11,0
2827,Kevin Zohi,5.9,8,6,3,3,2,3,6,50.0,3,1,0,1,4,12,2,0
2828,Ben Zolinski,13.4,17,9,7,9,1,7,27,25.9,20,12,0,12,8,25,4,0
2829,Kurt Zouma,26.0,23,14,17,6,0,9,16,56.3,7,22,14,8,58,81,116,2
2830,Igor Zubeldia,29.3,42,21,18,19,5,17,35,48.6,18,38,21,17,26,68,82,2
2831,Steven Zuber,8.3,11,10,7,2,2,9,19,47.4,10,4,1,3,9,20,12,0
2832,Martin Zubimendi,5.8,16,12,9,7,0,6,12,50.0,6,7,0,7,9,25,2,0
2834,Ervin Zukanovic,2.3,1,0,0,0,1,1,1,100.0,0,3,1,2,3,4,15,0
2835,Bongani Zungu,11.0,27,11,10,13,4,18,31,58.1,13,8,2,6,16,43,21,0
2836,Szymon Zurkowski,0.1,1,0,0,0,1,0,2,0.0,2,0,0,0,0,1,1,0
2837,David Zurutuza,1.7,4,3,0,3,1,1,2,50.0,1,1,0,1,4,8,3,0
2838,Martin Odegaard,28.1,27,19,5,14,8,7,34,20.6,27,13,0,13,17,44,5,0
2839,Filip Duricic,18.1,23,14,2,10,11,3,19,15.8,16,20,3,17,8,31,14,0
