,Player,Squad,90s,Tackles - Tkl,Tackles - TklW,Tackles - Def 3rd,Tackles - Mid 3rd,Tackles - Att 3rd,Challenges - Tkl,Challenges - Att,Challenges - Tkl%,Challenges - Lost,Blocks - Blocks,Blocks - Sh,Blocks - Pass,Int,Tkl+Int,Clr,Err
0,Ismael Aaneba,Strasbourg,0.1,0,0,0,0,0,0,0,0.0,0,0,0,0,1,1,1,0
1,Patrick van Aanholt,Crystal Palace,19.7,35,22,18,17,0,19,43,44.2,24,18,6,12,30,65,40,2
2,Issah Abbas,Mainz 05,0.2,0,0,0,0,0,0,0,0.0,0,0,0,0,0,0,0,0
3,Yunis Abdelhamid,Reims,32.1,59,37,36,23,0,26,42,61.9,16,34,15,19,61,120,132,0
4,Sabit Abdulai,Getafe,0.7,2,0,1,1,0,1,3,33.3,2,0,0,0,0,2,0,0
5,Mehdi Abeid,Nantes,14.7,34,19,16,14,4,15,30,50.0,15,9,2,7,20,54,10,0
6,Laurent Abergel,Lorient,32.9,145,84,64,69,12,54,162,33.3,108,64,6,58,46,191,12,0
7,Charles Abi,Saint-Étienne,10.1,8,2,5,0,3,3,12,25.0,9,6,2,4,4,12,5,0
8,Matthis Abline,Rennes,0.0,0,0,0,0,0,0,0,0.0,0,0,0,0,0,0,0,0
9,Pape Abou Cisse,Saint-Étienne,14.0,15,13,10,5,0,6,10,60.0,4,7,4,3,27,42,87,0
10,David Abraham,Eint Frankfurt,13.6,18,12,13,3,2,11,17,64.7,6,13,4,9,17,35,34,0
11,Tammy Abraham,Chelsea,11.6,7,5,3,3,1,1,7,14.3,6,6,0,6,5,12,17,0
12,Amir Abrashi,Freiburg,0.7,1,1,1,0,0,0,0,0.0,0,1,1,0,2,3,1,0
13,Gennaro Acampora,Spezia,4.9,6,4,1,4,1,2,7,28.6,5,4,1,3,4,10,4,0
14,Francesco Acerbi,Lazio,31.3,51,32,34,13,4,18,40,45.0,22,24,15,9,76,127,121,2
15,Ragnar Ache,Eint Frankfurt,1.1,2,0,0,1,1,0,0,0.0,0,1,0,1,1,3,1,0
16,Marcos Acuna,Sevilla,25.9,62,42,34,20,8,23,41,56.1,18,23,2,21,23,85,30,1
17,Che Adams,Southampton,29.6,25,16,4,15,6,6,17,35.3,11,20,2,18,4,29,19,1
18,Tyler Adams,RB Leipzig,20.6,35,24,12,15,8,17,31,54.8,14,22,5,17,29,64,30,0
19,Sargis Adamyan,Hoffenheim,5.3,9,4,4,3,2,7,14,50.0,7,2,0,2,6,15,1,0
20,Tosin Adarabioyo,Fulham,32.8,37,19,30,6,1,19,40,47.5,21,26,20,6,42,79,197,2
21,Bobby Adekanye,Cádiz,0.4,0,0,0,0,0,0,1,0.0,1,0,0,0,0,0,1,0
22,Yacine Adli,Bordeaux,26.9,74,37,30,33,11,35,92,38.0,57,27,2,25,39,113,17,2
23,Andrea Adorante,Parma,0.1,0,0,0,0,0,0,0,0.0,0,0,0,0,0,0,0,0
24,Adrian,Liverpool,3.0,0,0,0,0,0,0,0,0.0,0,0,0,0,0,0,3,1
26,Martin Agirregabiria,Alavés,17.3,32,18,17,12,3,17,33,51.5,16,9,3,6,27,59,36,0
27,Lucien Agoume,Spezia,8.9,18,10,11,7,0,6,19,31.6,13,10,5,5,15,33,10,0
28,Felix Agu,Werder Bremen,7.8,20,9,10,9,1,10,18,55.6,8,14,3,11,12,32,18,0
29,Kevin Agudelo,Spezia,15.1,39,28,9,15,15,12,34,35.3,22,30,0,30,10,49,2,0
30,Nayef Aguerd,Rennes,35.0,37,30,28,9,0,21,33,63.6,12,34,22,12,47,84,102,0
31,Sergio Aguero,Manchester City,6.2,4,1,0,2,2,2,11,18.2,9,2,0,2,2,6,0,0
32,Ruben Aguilar,Monaco,24.7,63,37,32,21,10,32,52,61.5,20,30,3,27,47,110,43,1
33,Naouirou Ahamada,Stuttgart,2.8,4,1,3,1,0,1,1,100.0,0,2,0,2,1,5,1,0
34,Matteo Ahlinvi,Nîmes,10.0,26,20,10,14,2,11,39,28.2,28,6,0,6,2,28,8,0
35,Jean-Eudes Aholou,Strasbourg,23.8,46,25,18,25,3,19,48,39.6,29,17,5,12,53,99,32,0
36,Jean-Eudes Aholou,Monaco,0.4,1,0,0,1,0,1,3,33.3,2,0,0,0,1,2,1,0
37,Joseph Aidoo,Celta Vigo,14.3,26,17,17,9,0,12,21,57.1,9,7,4,3,25,51,88,1
38,Ola Aina,Fulham,29.6,37,20,22,7,8,21,43,48.8,22,22,6,16,45,82,94,2
39,Rayan Ait Nouri,Wolves,15.6,29,16,18,10,1,13,27,48.1,14,14,1,13,15,44,25,0
40,Rayan Ait Nouri,Angers,2.1,3,2,1,2,0,3,5,60.0,2,2,1,1,4,7,1,0
41,Semi Ajayi,West Brom,30.9,40,14,34,6,0,23,41,56.1,18,51,32,19,42,82,122,2
42,Ludovic Ajorque,Strasbourg,33.0,30,18,6,18,6,7,31,22.6,24,14,5,9,11,41,54,0
43,Manuel Akanji,Dortmund,26.1,41,22,23,12,6,19,31,61.3,12,23,10,13,49,90,70,1
44,Carlos Akapo,Cádiz,9.6,18,14,14,4,0,10,18,55.6,8,16,3,13,19,37,33,0
45,Marley Ake,Marseille,1.6,3,3,1,0,2,0,1,0.0,1,2,0,2,0,3,1,0
46,Nathan Ake,Manchester City,8.9,10,5,3,6,1,3,4,75.0,1,2,1,1,9,19,23,0
47,Paul Akouokou,Betis,4.2,11,8,2,8,1,5,8,62.5,3,3,1,2,6,17,7,0
48,Jean-Daniel Akpa-Akpro,Lazio,11.7,38,25,13,22,3,8,27,29.6,19,24,6,18,18,56,13,0
49,Kevin Akpoguma,Hoffenheim,13.2,18,12,11,6,1,8,14,57.1,6,28,15,13,13,31,32,2
50,David Alaba,Bayern Munich,29.7,37,21,14,19,4,17,32,53.1,15,29,13,16,43,80,60,0
52,Sofiane Alakouch,Nîmes,16.7,53,33,30,16,7,29,45,64.4,16,17,2,15,21,74,38,0
53,Jony Alamo,Elche,0.8,2,1,1,0,1,0,1,0.0,1,0,0,0,1,3,0,0
54,Lucas Alario,Leverkusen,13.8,8,2,2,5,1,2,4,50.0,2,9,1,8,2,10,10,0
55,Jordi Alba,Barcelona,33.6,45,30,22,16,7,24,52,46.2,28,21,2,19,49,94,48,0
56,Luis Alberto,Lazio,29.1,43,24,15,19,9,15,73,20.5,58,41,2,39,13,56,11,1
57,Raul Albiol,Villarreal,34.6,22,15,19,3,0,13,18,72.2,5,32,22,10,22,44,146,2
58,Marc Albrighton,Leicester City,19.4,33,19,14,15,4,16,45,35.6,29,29,3,26,17,50,27,1
59,Paco Alcacer,Villarreal,17.2,6,3,1,2,3,3,7,42.9,4,8,0,8,9,15,6,0
60,Pedro Alcala,Cádiz,10.1,8,4,6,2,0,3,5,60.0,2,19,13,6,16,24,50,0
61,Thiago Alcantara,Liverpool,20.6,61,36,20,30,11,17,49,34.7,32,26,0,26,30,91,14,0
62,Ruben Alcaraz,Valladolid,24.1,54,29,32,21,1,30,80,37.5,50,35,8,27,31,85,28,0
63,Omar Alderete,Hertha BSC,14.4,16,10,11,5,0,7,16,43.8,9,14,10,4,21,37,61,1
64,Toby Alderweireld,Tottenham,24.9,35,22,22,11,2,18,30,60.0,12,40,28,12,10,45,121,0
65,Ivan Alejo,Cádiz,9.2,14,10,8,4,2,4,23,17.4,19,14,1,13,3,17,10,0
66,Carles Alena,Barcelona,0.5,1,0,1,0,0,0,0,0.0,0,0,0,0,0,1,0,0
67,Carles Alena,Getafe,15.2,15,10,3,9,3,7,25,28.0,18,14,1,13,2,17,2,0
68,Runar Alex Runarsson,Arsenal,0.2,0,0,0,0,0,0,0,0.0,0,0,0,0,0,0,0,0
69,Trent Alexander-Arnold,Liverpool,33.7,56,33,31,18,7,36,56,64.3,20,24,3,21,49,105,50,3
70,Alfon,Celta Vigo,0.4,0,0,0,0,0,0,0,0.0,0,0,0,0,0,0,0,0
71,Mohamed Ali Cho,Angers,3.9,9,7,2,6,1,4,9,44.4,5,4,0,4,3,12,0,0
72,Ezgjan Alioski,Leeds United,27.3,74,31,38,28,8,32,74,43.2,42,17,2,15,23,97,50,2
73,Rachid Alioui,Angers,0.2,0,0,0,0,0,0,1,0.0,1,0,0,0,0,0,0,0
74,Alisson,Liverpool,33.0,3,2,3,0,0,3,4,75.0,1,0,0,0,2,5,26,7
75,Saturnin Allagbe,Dijon,12.0,0,0,0,0,0,0,1,0.0,1,0,0,0,0,0,9,3
76,Allan,Everton,22.8,80,45,39,37,4,28,95,29.5,67,31,12,19,19,99,25,1
78,Dele Alli,Tottenham,6.9,18,11,8,6,4,7,19,36.8,12,9,0,9,7,25,3,0
79,Miguel Almiron,Newcastle Utd,27.0,49,29,21,25,3,14,56,25.0,42,23,4,19,25,74,20,1
80,Marcos Alonso,Chelsea,10.7,13,3,6,4,3,7,14,50.0,7,12,1,11,12,25,30,0
81,Sergio Alvarez,Eibar,17.4,42,25,13,26,3,8,22,36.4,14,22,5,17,22,64,24,2
82,Yeray Alvarez,Athletic Club,21.6,19,12,11,8,0,9,21,42.9,12,12,5,7,53,72,73,0
83,Bruno Alves,Parma,18.1,13,10,10,3,0,7,9,77.8,2,17,12,5,26,39,81,0
84,Steven Alzate,Brighton,10.0,17,8,10,4,3,6,15,40.0,9,8,1,7,8,25,10,0
85,Ibrahim Amadou,Angers,16.7,39,26,18,19,2,15,38,39.5,23,14,4,10,23,62,25,0
86,Romain Amalfitano,Dijon,1.3,4,2,3,1,0,1,3,33.3,2,2,1,1,1,5,1,0
87,Emmanuel Amankwaa Akurugu,Getafe,0.5,0,0,0,0,0,0,1,0.0,1,1,0,1,2,2,1,0
88,Daniel Amartey,Leicester City,8.0,11,7,6,4,1,8,12,66.7,4,8,4,4,12,23,26,0
89,Jordan Amavi,Marseille,9.0,11,9,9,1,1,9,12,75.0,3,12,2,10,27,38,33,1
90,Thierry Ambrose,Metz,8.4,7,4,1,1,5,2,12,16.7,10,2,0,2,2,9,4,0
91,Wisdom Amey,Bologna,0.0,0,0,0,0,0,0,0,0.0,0,0,0,0,0,0,0,0
92,Nadiem Amiri,Leverkusen,21.0,12,7,4,8,0,7,33,21.2,26,18,3,15,12,24,7,0
93,Ethan Ampadu,Sheffield Utd,23.2,57,36,31,24,2,20,46,43.5,26,40,19,21,49,106,87,3
94,Sofyan Amrabat,Fiorentina,27.1,39,22,11,24,4,18,48,37.5,30,30,5,25,23,62,12,0
95,Jon Ander Garrido,Cádiz,8.9,18,10,8,7,3,10,26,38.5,16,12,4,8,14,32,13,0
96,Joachim Andersen,Fulham,30.3,33,19,18,11,4,15,28,53.6,13,24,13,11,44,77,151,1
97,Joachim Andersen,Lyon,2.1,2,1,1,1,0,2,2,100.0,0,1,1,0,2,4,6,0
98,Djavan Anderson,Lazio,0.8,0,0,0,0,0,0,1,0.0,1,1,0,1,1,1,0,0
99,Elliot Anderson,Newcastle Utd,0.0,0,0,0,0,0,0,0,0.0,0,0,0,0,0,0,0,0
100,Felipe Anderson,West Ham,0.0,1,1,0,1,0,0,0,0.0,0,0,0,0,0,1,0,0
101,Sebastian Andersson,Köln,12.5,3,2,0,3,0,1,8,12.5,7,10,3,7,2,5,9,0
102,Nicolas Andrade,Udinese,2.0,0,0,0,0,0,0,0,0.0,0,0,0,0,0,0,0,0
104,Benjamin Andre,Lille,32.1,114,68,47,61,6,53,122,43.4,69,39,10,29,76,190,49,0
105,Marcos Andre,Valladolid,13.1,8,2,2,2,4,0,8,0.0,8,15,2,13,2,10,9,0
106,Robert Andrich,Union Berlin,28.1,51,24,22,27,2,24,53,45.3,29,40,6,34,51,102,31,2
107,Victorien Angban,Metz,18.6,36,24,17,15,4,17,42,40.5,25,17,4,13,19,55,9,1
108,Angel,Granada,1.0,0,0,0,0,0,0,0,0.0,0,0,0,0,0,0,1,0
109,Jose Angel,Eibar,10.0,15,8,9,4,2,8,12,66.7,4,7,0,7,13,28,17,1
110,Miguel Angel Rubio,Valladolid,1.5,0,0,0,0,0,0,0,0.0,0,2,2,0,3,3,11,0
111,Angelino,RB Leipzig,24.0,31,19,10,18,3,13,24,54.2,11,22,1,21,30,61,40,0
112,Davide Angelo Ghislandi,Atalanta,0.1,0,0,0,0,0,0,0,0.0,0,0,0,0,0,0,1,0
113,Philip Ankhrah,Hellas Verona,0.1,0,0,0,0,0,0,0,0.0,0,1,0,1,0,0,0,0
114,Cristian Ansaldi,Torino,21.6,48,33,25,14,9,24,38,63.2,14,21,7,14,16,64,38,0
115,Waldemar Anton,Stuttgart,30.1,31,20,17,14,0,12,31,38.7,19,28,18,10,47,78,114,0
116,Michail Antonio,West Ham,21.9,7,4,1,5,1,1,7,14.3,6,20,3,17,7,14,7,0
117,Jose Antonio Miranda,Getafe,0.3,0,0,0,0,0,0,1,0.0,1,1,0,1,0,0,0,0
118,Valentin Antov,Bologna,2.6,4,2,3,1,0,3,10,30.0,7,6,5,1,4,8,13,0
119,Houssem Aouar,Lyon,19.8,17,12,0,13,4,8,25,32.0,17,17,1,16,17,34,4,0
120,Adil Aouchiche,Saint-Étienne,19.2,38,20,12,17,9,13,49,26.5,36,15,1,14,10,48,6,0
121,Dennis Appiah,Nantes,17.3,55,34,33,15,7,32,59,54.2,27,23,6,17,25,80,43,0
122,Aritz Arambarri,Real Sociedad,0.3,1,1,0,1,0,1,2,50.0,1,0,0,0,0,1,0,0
123,Mauro Arambarri,Getafe,33.1,64,39,22,35,7,23,80,28.8,57,40,5,35,42,106,28,0
124,Charles Aranguiz,Leverkusen,18.5,41,23,16,21,4,17,43,39.5,26,32,4,28,33,74,17,0
125,Luiz Araujo,Lille,16.6,38,25,12,18,8,8,28,28.6,20,23,1,22,11,49,3,0
126,Nestor Araujo,Celta Vigo,27.0,24,16,14,9,1,7,15,46.7,8,23,18,5,43,67,89,2
127,Ronald Araujo,Barcelona,16.8,22,11,12,8,2,9,9,100.0,0,24,15,9,20,42,47,1
128,Anaitz Arbilla,Eibar,31.2,45,26,31,11,3,27,54,50.0,27,36,11,25,69,114,73,1
130,Alphonse Areola,Fulham,36.0,1,0,1,0,0,1,5,20.0,4,0,0,0,1,2,13,3
131,Santiago Arias,Leverkusen,1.0,2,1,0,1,1,1,1,100.0,0,0,0,0,1,3,4,0
132,Karim Aribi,Nîmes,3.3,2,2,0,1,1,0,5,0.0,5,1,0,1,0,2,3,0
133,Unai Arietaleanizbeaskoa,Eibar,0.5,1,0,0,0,1,0,0,0.0,0,0,0,0,0,1,0,0
134,Nicolo Armini,Lazio,0.1,0,0,0,0,0,0,0,0.0,0,0,0,0,0,0,0,0
135,Stuart Armstrong,Southampton,30.7,60,41,19,32,9,27,75,36.0,48,26,1,25,24,84,19,0
136,Maximilian Arnold,Wolfsburg,28.7,47,32,20,26,1,18,49,36.7,31,24,3,21,49,96,57,0
137,Toluwalase Arokodare,Köln,1.2,1,1,0,0,1,0,0,0.0,0,1,0,1,1,2,0,0
138,Sergio Arribas,Real Madrid,1.5,3,1,2,1,0,1,3,33.3,2,2,0,2,4,7,2,0
139,Kepa Arrizabalaga,Chelsea,6.5,0,0,0,0,0,0,1,0.0,1,0,0,0,0,0,0,3
140,Tolgay Arslan,Udinese,20.2,52,32,24,24,4,25,54,46.3,29,22,2,20,22,74,15,1
141,Kwadwo Asamoah,Cagliari,2.5,4,3,2,2,0,2,3,66.7,1,5,1,4,4,8,2,1
142,Santiago Ascacibar,Hertha BSC,8.5,30,15,15,14,1,15,28,53.6,13,23,2,21,13,43,14,0
143,Sergio Asenjo,Villarreal,36.0,0,0,0,0,0,0,1,0.0,1,0,0,0,0,0,13,2
144,Marco Asensio,Real Madrid,20.8,12,6,7,4,1,3,24,12.5,21,15,0,15,11,23,10,0
145,Kristoffer Askildsen,Sampdoria,1.1,0,0,0,0,0,0,0,0.0,0,2,0,2,3,3,3,0
146,Iago Aspas,Celta Vigo,31.8,11,3,2,7,2,2,23,8.7,21,25,2,23,16,27,21,0
147,Roger Assale,Dijon,9.2,10,8,3,5,2,4,12,33.3,8,7,3,4,2,12,2,0
148,Youcef Atal,Nice,10.6,25,12,11,14,0,13,26,50.0,13,10,2,8,26,51,12,0
149,Miguel Atienza,Eibar,9.3,20,9,5,15,0,8,23,34.8,15,14,1,13,9,29,12,0
150,Pierre-Emerick Aubameyang,Arsenal,25.9,12,8,7,4,1,3,20,15.0,17,18,0,18,7,19,17,0
151,Emil Audero,Sampdoria,37.0,1,1,1,0,0,1,2,50.0,1,0,0,0,1,2,16,0
152,Tommaso Augello,Sampdoria,35.7,42,30,27,10,5,23,39,59.0,16,22,2,20,32,74,76,1
153,Jean-Kevin Augustin,Nantes,0.4,2,0,0,2,0,2,2,100.0,0,0,0,0,0,2,0,0
154,Ludwig Augustinsson,Werder Bremen,21.7,37,20,19,14,4,17,29,58.6,12,21,7,14,20,57,62,0
156,Serge Aurier,Tottenham,17.8,55,33,33,17,5,15,40,37.5,25,28,5,23,19,74,44,3
157,Charlie Austin,West Brom,1.5,4,2,1,2,1,1,3,33.3,2,0,0,0,3,7,4,0
158,Ezequiel Avila,Osasuna,2.2,6,2,3,1,2,2,4,50.0,2,1,0,1,1,7,0,0
159,Taiwo Awoniyi,Union Berlin,15.1,5,3,2,3,0,1,14,7.1,13,9,0,9,3,8,4,0
160,Mehmet Aydin,Schalke 04,5.6,15,7,9,6,0,4,10,40.0,6,6,1,5,6,21,16,0
161,Jordan Ayew,Crystal Palace,23.3,38,26,8,16,14,16,44,36.4,28,28,2,26,16,54,12,0
162,Kaan Ayhan,Sassuolo,8.8,15,9,8,5,2,8,13,61.5,5,9,5,4,16,31,33,0
163,Luke Ayling,Leeds United,37.8,108,61,69,30,9,49,87,56.3,38,53,36,17,36,144,96,5
164,Ramon Azeez,Granada,1.1,1,1,0,1,0,0,0,0.0,0,0,0,0,1,2,1,0
165,Cesar Azpilicueta,Chelsea,24.3,53,28,22,24,7,19,37,51.4,18,30,5,25,28,81,62,2
166,Ludovic Baal,Brest,3.3,6,5,4,1,1,2,5,40.0,3,4,1,3,5,11,5,0
167,Carlos Bacca,Villarreal,8.7,9,5,5,3,1,3,5,60.0,2,5,0,5,3,12,2,0
168,Loic Bade,Lens,29.0,57,34,47,10,0,30,55,54.5,25,43,17,26,74,131,135,2
169,Milan Badelj,Genoa,26.8,56,27,27,22,7,26,84,31.0,58,51,10,41,87,143,45,1
170,Edgar Badia,Elche,30.0,1,0,1,0,0,1,3,33.3,2,0,0,0,0,1,17,3
171,Benoit Badiashile,Monaco,31.9,24,17,15,9,0,13,28,46.4,15,21,12,9,58,82,102,4
172,Alex Baena,Villarreal,1.5,4,3,1,2,1,1,3,33.3,2,1,1,0,1,5,1,0
173,Miguel Baeza,Celta Vigo,6.0,7,6,5,2,0,5,13,38.5,8,3,0,3,3,10,2,0
174,Stephane Bahoken,Angers,18.0,9,6,1,7,1,4,12,33.3,8,9,0,9,9,18,9,0
175,Leon Bailey,Leverkusen,23.8,14,8,3,7,4,4,15,26.7,11,13,0,13,9,23,3,0
176,Eric Bailly,Manchester Utd,10.2,5,5,3,1,1,0,1,0.0,1,13,11,2,13,18,36,2
177,Stefan Bajic,Saint-Étienne,1.0,0,0,0,0,0,0,0,0.0,0,0,0,0,0,0,1,0
178,Tiemoue Bakayoko,Napoli,21.8,69,41,21,41,7,23,40,57.5,17,24,2,22,36,105,13,2
179,Mitchel Bakker,Paris S-G,18.8,38,30,15,14,9,17,26,65.4,9,22,2,20,22,60,20,0
180,Ridle Baku,Wolfsburg,29.8,50,31,20,20,10,22,53,41.5,31,54,4,50,40,90,33,1
182,Ridle Baku,Mainz 05,2.0,4,2,3,1,0,2,6,33.3,4,3,1,2,3,7,6,0
183,Dilane Bakwa,Bordeaux,0.6,2,2,1,1,0,0,1,0.0,1,2,0,2,1,3,0,0
184,Fabian Balbuena,West Ham,13.3,24,12,23,1,0,14,23,60.9,9,23,6,17,25,49,63,0
185,Keita Balde,Sampdoria,13.3,9,6,2,6,1,4,10,40.0,6,10,1,9,0,9,3,0
186,George Baldock,Sheffield Utd,31.0,47,34,28,14,5,21,50,42.0,29,26,7,19,25,72,70,1
187,Gareth Bale,Tottenham,10.2,17,10,4,9,4,7,14,50.0,7,13,2,11,8,25,16,0
188,Mikel Balenziaga,Athletic Club,18.8,26,15,11,12,3,9,18,50.0,9,22,7,15,7,33,46,0
189,Leonardo Balerdi,Marseille,18.2,29,18,19,7,3,14,31,45.2,17,17,9,8,28,57,65,3
190,Fode Ballo-Toure,Monaco,7.4,21,17,9,11,1,6,13,46.2,7,7,0,7,6,27,11,1
191,Botond Balogh,Parma,1.8,9,7,9,0,0,2,5,40.0,3,4,3,1,2,11,8,0
192,Abdoulaye Bamba,Angers,15.0,27,17,19,7,1,19,28,67.9,9,7,1,6,19,46,34,0
193,Jonathan Bamba,Lille,33.2,45,23,15,19,11,24,84,28.6,60,24,2,22,24,69,15,0
194,Robson Bambu,Nice,11.6,16,11,14,2,0,11,14,78.6,3,8,7,1,10,26,57,0
195,Patrick Bamford,Leeds United,33.9,21,9,2,11,8,8,27,29.6,19,14,4,10,10,31,37,0
196,Mattia Bani,Genoa,10.2,10,5,5,5,0,5,12,41.7,7,16,11,5,27,37,44,0
197,Mattia Bani,Parma,12.7,20,11,15,4,1,4,8,50.0,4,10,6,4,33,53,50,0
198,Simon Banza,Lens,15.2,13,6,0,4,9,1,14,7.1,13,16,1,15,7,20,15,0
199,Antonin Barak,Hellas Verona,30.7,30,19,8,16,6,14,47,29.8,33,26,7,19,12,42,38,1
200,Federico Barba,Benevento,29.5,31,16,22,8,1,21,35,60.0,14,39,18,21,48,79,94,4
201,Danilo Barbosa,Nice,2.8,6,3,5,1,0,4,6,66.7,2,2,1,1,2,8,11,2
202,Barcia,Granada,1.0,1,1,1,0,0,0,0,0.0,0,1,1,0,3,4,9,0
203,Melvin Bard,Lyon,4.8,12,8,7,4,1,6,11,54.5,5,10,2,8,6,18,14,0
204,Enis Bardhi,Levante,18.7,28,12,8,16,4,10,36,27.8,26,8,2,6,21,49,14,0
205,Phil Bardsley,Burnley,3.0,6,5,4,2,0,3,6,50.0,3,3,1,2,6,12,12,0
206,Nicolo Barella,Inter,32.2,58,31,23,29,6,23,72,31.9,49,29,4,25,26,84,14,0
208,Philipp Bargfrede,Werder Bremen,0.3,0,0,0,0,0,0,0,0.0,0,0,0,0,0,0,3,0
209,Kike Barja,Osasuna,15.9,10,5,6,1,3,5,24,20.8,19,10,1,9,16,26,8,0
210,Ross Barkley,Aston Villa,17.0,6,2,2,4,0,3,15,20.0,12,9,1,8,5,11,6,1
211,Ross Barkley,Chelsea,0.5,0,0,0,0,0,0,0,0.0,0,0,0,0,0,0,0,0
212,Aymen Barkok,Eint Frankfurt,10.9,29,15,11,9,9,10,31,32.3,21,15,1,14,10,39,9,1
213,Ashley Barnes,Burnley,14.8,12,6,2,6,4,3,13,23.1,10,14,2,12,5,17,11,0
214,Harvey Barnes,Leicester City,21.6,19,9,11,3,5,5,22,22.7,17,16,3,13,8,27,11,0
215,Marc Baro,Cádiz,1.0,2,1,2,0,0,0,2,0.0,2,1,0,1,2,4,2,1
216,Antonio Barragan,Elche,24.8,28,14,21,5,2,12,21,57.1,9,22,8,14,33,61,67,1
217,Antonio Barreca,Fiorentina,0.9,1,0,0,1,0,1,1,100.0,0,0,0,0,0,1,1,0
218,Leandro Barreiro Martins,Mainz 05,25.6,58,32,19,26,13,20,50,40.0,30,34,9,25,57,115,55,0
219,Ander Barrenetxea,Real Sociedad,14.5,29,19,5,18,6,9,24,37.5,15,20,0,20,6,35,8,0
220,Jacob Barrett Laursen,Arminia,12.3,23,12,13,8,2,10,16,62.5,6,14,4,10,24,47,37,0
221,Musa Barrow,Bologna,32.5,26,10,8,10,8,10,25,40.0,15,37,2,35,11,37,15,0
222,Kyle Bartley,West Brom,28.7,27,16,14,10,3,11,23,47.8,12,50,35,15,38,65,159,1
223,Paolo Bartolomei,Spezia,3.6,6,2,3,1,2,4,7,57.1,3,1,0,1,1,7,2,0
224,Marc Bartra,Betis,18.8,27,16,18,8,1,12,22,54.5,10,19,5,14,40,67,74,3
225,Daniele Baselli,Torino,4.4,12,7,3,6,3,6,10,60.0,4,2,0,2,9,21,5,0
226,Chris Basham,Sheffield Utd,28.6,69,42,41,23,5,41,67,61.2,26,36,15,21,49,118,105,1
227,Toma Basic,Bordeaux,28.9,33,22,15,16,2,16,58,27.6,42,21,5,16,32,65,42,1
228,Alvaro Bastida,Cádiz,0.4,0,0,0,0,0,0,0,0.0,0,0,0,0,0,0,0,0
229,Alessandro Bastoni,Inter,32.5,36,22,13,21,2,17,27,63.0,10,34,16,18,40,76,75,0
230,Simone Bastoni,Spezia,16.9,50,29,26,22,2,27,52,51.9,25,19,1,18,16,66,31,0
231,Bastos,Lazio,0.7,3,1,2,0,1,3,5,60.0,2,1,0,1,0,3,3,0
232,Michy Batshuayi,Crystal Palace,8.1,5,3,1,2,2,1,9,11.1,8,5,1,4,4,9,5,0
234,Rodrigo Battaglia,Alavés,27.7,38,16,21,14,3,16,50,32.0,34,30,14,16,29,67,40,1
235,Cristian Battocchio,Brest,3.9,5,2,1,4,0,2,9,22.2,7,0,0,0,4,9,5,0
236,Oliver Baumann,Hoffenheim,31.0,0,0,0,0,0,0,1,0.0,1,0,0,0,2,2,14,0
237,Julian Baumgartlinger,Leverkusen,11.9,43,20,14,26,3,16,31,51.6,15,12,0,12,12,55,10,1
238,Christoph Baumgartner,Hoffenheim,26.3,44,31,13,24,7,14,51,27.5,37,40,8,32,24,68,24,0
239,Jon Bautista,Real Sociedad,4.1,5,3,0,2,3,0,3,0.0,3,3,1,2,2,7,4,0
240,Paul Baysse,Bordeaux,29.0,35,18,21,13,1,16,21,76.2,5,33,24,9,52,87,123,1
241,Noah Joel Sarenren Bazee,Augsburg,0.4,0,0,0,0,0,0,1,0.0,1,0,0,0,1,1,0,0
242,Ihlas Bebou,Hoffenheim,24.4,24,9,5,10,9,8,14,57.1,6,18,4,14,17,41,16,0
243,Rodrigo Becao,Udinese,30.9,59,33,36,20,3,27,49,55.1,22,48,27,21,68,127,94,2
244,Sheraldo Becker,Union Berlin,12.3,5,4,2,2,1,3,5,60.0,2,4,0,4,6,11,7,0
245,Timo Becker,Schalke 04,18.2,34,23,28,6,0,16,25,64.0,9,18,4,14,22,56,58,0
246,Jan Bednarek,Southampton,34.4,37,19,25,11,1,25,49,51.0,24,44,27,17,84,121,132,0
247,Donny van de Beek,Manchester Utd,5.8,15,10,2,11,2,7,15,46.7,8,10,1,9,6,21,7,0
248,Valon Behrami,Genoa,9.9,21,9,9,10,2,9,26,34.6,17,13,5,8,9,30,13,0
249,Brian Behrendt,Arminia,0.9,0,0,0,0,0,0,1,0.0,1,0,0,0,0,0,1,0
250,Maximilian Beier,Hoffenheim,0.1,0,0,0,0,0,0,1,0.0,1,0,0,0,0,0,0,0
251,Ishak Belfodil,Hoffenheim,6.6,3,2,0,0,3,0,2,0.0,2,1,0,1,1,4,3,0
252,Erwan Belhadji,Dijon,0.3,3,0,3,0,0,3,5,60.0,2,1,0,1,0,3,0,0
253,Haris Belkebla,Brest,30.3,69,39,32,28,9,31,66,47.0,35,26,5,21,57,126,34,0
254,Stefan Bell,Mainz 05,14.1,24,18,15,9,0,14,23,60.9,9,19,11,8,27,51,76,1
255,Karim Bellarabi,Leverkusen,8.9,12,10,3,4,5,4,17,23.5,13,12,0,12,12,24,4,0
256,Jean-Ricner Bellegarde,Strasbourg,23.2,56,39,22,25,9,14,23,60.9,9,20,2,18,19,75,16,0
257,Hector Bellerin,Arsenal,23.2,29,19,14,12,3,12,41,29.3,29,26,8,18,33,62,33,0
258,Jude Bellingham,Dortmund,18.9,49,31,11,29,9,19,46,41.3,27,37,5,32,24,73,13,0
260,Andrea Belotti,Torino,32.1,30,18,4,16,10,11,35,31.4,24,27,4,23,12,42,21,0
261,Fran Beltran,Celta Vigo,15.5,30,22,15,12,3,8,24,33.3,16,14,1,13,16,46,24,0
262,Sami Ben Amar,Nîmes,0.1,0,0,0,0,0,0,0,0.0,0,1,0,1,0,0,0,0
263,Hatem Ben Arfa,Bordeaux,18.9,11,7,1,7,3,2,9,22.2,7,3,0,3,2,13,0,0
264,Salim Ben Seghir,Nice,0.1,0,0,0,0,0,0,0,0.0,0,0,0,0,0,0,0,0
265,Wissam Ben Yedder,Monaco,29.0,18,9,2,10,6,3,13,23.1,10,16,0,16,13,31,3,0
266,Ahmad Benali,Crotone,13.5,19,11,10,9,0,11,38,28.9,27,15,2,13,6,25,15,0
267,Samy Benchamma,Montpellier,0.5,1,1,1,0,0,0,0,0.0,0,0,0,0,0,1,1,0
268,Lars Bender,Leverkusen,10.4,19,13,12,6,1,9,21,42.9,12,19,5,14,16,35,19,0
269,Sven Bender,Leverkusen,13.0,17,9,8,8,1,7,20,35.0,13,20,9,11,21,38,41,1
270,Dario Benedetto,Marseille,17.5,6,4,1,4,1,5,13,38.5,8,9,2,7,3,9,17,0
271,Laszlo Benes,Augsburg,7.3,8,6,4,4,0,2,8,25.0,6,6,2,4,7,15,1,1
272,Laszlo Benes,M'Gladbach,1.7,6,2,5,1,0,2,4,50.0,2,0,0,0,2,8,1,0
273,Walter Benitez,Nice,38.0,1,1,1,0,0,1,3,33.3,2,1,0,1,1,2,7,2
274,Loris Benito,Bordeaux,29.5,42,26,27,12,3,22,48,45.8,26,33,10,23,42,84,70,0
275,Sergio Benito,Valladolid,0.0,0,0,0,0,0,0,0,0.0,0,0,0,0,0,0,0,0
276,Bilal Benkhedim,Saint-Étienne,0.8,0,0,0,0,0,0,1,0.0,1,1,0,1,0,0,0,0
277,Djamel Benlamri,Lyon,1.7,5,3,5,0,0,3,6,50.0,3,3,2,1,6,11,11,0
278,Ismael Bennacer,Milan,14.7,39,18,17,21,1,15,32,46.9,17,10,1,9,20,59,12,0
279,Said Benrahma,West Ham,15.5,24,15,8,11,5,8,28,28.6,20,10,0,10,8,32,8,0
280,Yassine Benrahou,Nîmes,13.8,16,9,8,6,2,7,25,28.0,18,9,0,9,4,20,5,1
281,Ramy Bensebaini,M'Gladbach,20.1,43,24,27,13,3,26,42,61.9,16,39,7,32,47,90,66,0
282,Josh Benson,Burnley,2.9,5,1,3,0,2,1,6,16.7,5,3,0,3,3,8,2,0
283,Nabil Bentaleb,Schalke 04,6.1,14,8,7,6,1,4,15,26.7,11,5,2,3,6,20,8,0
284,Rodrigo Bentancur,Juventus,25.8,63,33,21,37,5,20,59,33.9,39,35,12,23,47,110,46,1
286,Christian Benteke,Crystal Palace,20.2,15,7,1,7,7,2,9,22.2,7,17,6,11,4,19,39,0
287,Karim Benzema,Real Madrid,32.2,8,6,4,2,2,5,15,33.3,10,9,2,7,8,16,24,0
288,Yassine Benzia,Dijon,4.5,10,5,5,3,2,2,10,20.0,8,3,0,3,6,16,2,0
289,Alessandro Berardi,Hellas Verona,0.3,0,0,0,0,0,0,0,0.0,0,0,0,0,0,0,0,0
290,Domenico Berardi,Sassuolo,27.5,42,22,17,11,14,21,62,33.9,41,23,1,22,26,68,34,0
291,Gaetano Berardi,Leeds United,1.3,2,2,1,0,1,0,0,0.0,0,2,1,1,1,3,2,0
292,Yuri Berchiche,Athletic Club,18.7,24,19,14,5,5,10,24,41.7,14,14,0,14,11,35,29,0
293,Alex Berenguer,Torino,1.5,2,0,0,0,2,2,5,40.0,3,2,0,2,0,2,1,0
294,Alex Berenguer,Athletic Club,25.3,47,31,21,20,6,9,51,17.6,42,48,3,45,18,65,27,0
295,Bartosz Bereszynski,Sampdoria,29.0,66,44,37,22,7,41,73,56.2,32,40,20,20,42,108,88,0
296,Johann Berg Gudmundsson,Burnley,15.1,19,11,6,9,4,11,23,47.8,12,11,2,9,17,36,19,0
297,Sander Berge,Sheffield Utd,12.4,16,7,8,5,3,7,15,46.7,8,11,2,9,4,20,18,0
298,Steven Bergwijn,Tottenham,13.4,15,7,8,3,4,7,20,35.0,13,7,1,6,5,20,9,0
299,Valon Berisha,Reims,18.3,40,23,19,17,4,11,47,23.4,36,14,2,12,25,65,21,1
300,Bernard,Everton,5.1,8,3,3,3,2,7,15,46.7,8,5,0,5,8,16,6,0
301,Federico Bernardeschi,Juventus,10.8,9,4,3,5,1,4,20,20.0,16,6,2,4,14,23,7,1
302,Bernardo,Brighton,2.3,10,8,8,1,1,4,6,66.7,2,2,0,2,1,11,1,0
303,Paul Bernardoni,Angers,38.0,1,1,1,0,0,1,2,50.0,1,0,0,0,2,3,23,1
304,Juan Bernat,Paris S-G,2.2,5,3,0,4,1,3,5,60.0,2,4,0,4,1,6,6,0
305,Dimitry Bertaud,Montpellier,8.3,0,0,0,0,0,0,0,0.0,0,0,0,0,1,1,2,0
306,Marco Bertini,Lazio,0.1,1,0,1,0,0,0,0,0.0,0,0,0,0,0,1,0,0
307,Ryan Bertrand,Southampton,28.9,60,32,26,27,7,30,48,62.5,18,19,1,18,30,90,41,1
308,Daniel Bessa,Hellas Verona,6.8,15,8,3,11,1,6,14,42.9,8,5,1,4,2,17,0,0
309,Loic Bessile,Bordeaux,1.0,0,0,0,0,0,0,0,0.0,0,2,1,1,1,1,3,0
310,Jordan Beyer,M'Gladbach,2.1,2,1,2,0,0,1,2,50.0,1,5,4,1,5,7,5,0
312,Giulian Biancone,Monaco,1.0,3,3,1,1,1,2,3,66.7,1,1,0,1,1,4,4,0
313,Bartosz Bialek,Wolfsburg,3.0,6,5,1,4,1,4,4,100.0,0,5,1,4,3,9,4,0
314,Ermin Bicakcic,Hoffenheim,1.4,1,1,0,1,0,1,1,100.0,0,1,1,0,3,4,9,0
315,Pedro Bigas,Eibar,17.0,11,9,7,4,0,7,14,50.0,7,12,6,6,23,34,54,0
316,El Bilal Toure,Reims,13.8,22,12,3,16,3,8,18,44.4,10,8,3,5,6,28,10,1
317,Cristiano Biraghi,Fiorentina,31.1,42,23,19,15,8,27,45,60.0,18,23,9,14,27,69,56,3
318,Davide Biraschi,Genoa,10.2,17,9,12,5,0,5,10,50.0,5,12,6,6,21,38,26,0
319,Yves Bissouma,Brighton,34.6,104,68,50,48,6,33,67,49.3,34,42,6,36,64,168,67,0
320,Leonardo Bittencourt,Werder Bremen,16.8,58,32,24,28,6,16,51,31.4,35,29,2,27,13,71,10,0
321,Alejandro Blanco,Valencia,6.4,8,4,4,4,0,3,18,16.7,15,5,0,5,8,16,9,0
322,Ruben Blanco,Celta Vigo,18.2,0,0,0,0,0,0,0,0.0,0,0,0,0,0,0,7,3
323,Ludovic Blas,Nantes,31.0,58,30,18,37,3,23,54,42.6,31,33,4,29,21,79,19,0
324,Alejandro Blesa,Levante,0.1,0,0,0,0,0,0,0,0.0,0,0,0,0,0,0,0,0
325,Jerome Boateng,Bayern Munich,26.3,26,16,17,8,1,14,32,43.8,18,24,17,7,40,66,63,1
326,Antonin Bobichon,Angers,10.1,23,14,10,8,5,9,15,60.0,6,4,1,3,2,25,1,0
327,Yann Bodiger,Cádiz,2.8,2,2,1,1,0,1,6,16.7,5,7,3,4,8,10,4,0
328,Jean-Paul Boetius,Mainz 05,22.9,42,28,13,15,14,17,47,36.2,30,37,3,34,33,75,14,0
329,Sacha Boey,Dijon,20.7,54,40,30,23,1,27,55,49.1,28,25,5,20,41,95,62,0
330,Sacha Boey,Rennes,1.4,3,3,2,1,0,3,4,75.0,1,0,0,0,2,5,2,0
331,Jeremie Boga,Sassuolo,19.8,11,9,5,0,6,3,11,27.3,8,10,0,10,8,19,7,0
332,Melayro Bogarde,Hoffenheim,3.1,7,3,3,3,1,5,9,55.6,4,0,0,0,5,12,1,0
333,Jayden Bogle,Sheffield Utd,12.3,33,23,21,10,2,20,39,51.3,19,14,4,10,14,47,22,0
334,Quentin Boisgard,Lorient,14.6,24,17,3,15,6,11,24,45.8,13,17,2,15,15,39,1,0
335,Willy Boly,Wolves,20.9,33,20,26,7,0,13,24,54.2,11,18,12,6,32,65,84,1
336,Giacomo Bonaventura,Fiorentina,25.1,34,19,16,13,5,16,53,30.2,37,26,2,24,39,73,12,0
338,Federico Bonazzoli,Torino,6.3,6,4,0,4,2,2,13,15.4,11,3,0,3,2,8,3,0
339,Federico Bonazzoli,Sampdoria,1.5,0,0,0,0,0,0,0,0.0,0,1,0,1,0,0,0,0
340,Kevin Bonifazi,Udinese,27.4,32,21,24,6,2,8,23,34.8,15,33,20,13,50,82,85,1
341,Leonardo Bonucci,Juventus,22.5,19,14,10,8,1,6,14,42.9,8,24,13,11,33,52,67,0
342,Elias Bordner,Eint Frankfurt,1.0,1,0,1,0,0,1,1,100.0,0,0,0,0,2,3,1,0
343,Dennis Borkowski,RB Leipzig,0.1,0,0,0,0,0,0,0,0.0,0,1,0,1,0,0,0,0
344,Sebastiaan Bornauw,Köln,23.1,29,20,25,4,0,14,25,56.0,11,33,26,7,40,69,104,0
345,Sven Botman,Lille,36.8,31,21,18,12,1,14,26,53.8,12,31,21,10,57,88,126,2
346,Denis Bouanga,Saint-Étienne,30.2,52,28,22,24,6,16,58,27.6,42,32,3,29,20,72,36,0
347,Hicham Boudaoui,Nice,19.3,52,35,20,24,8,26,68,38.2,42,14,4,10,23,75,26,1
348,Ryad Boudebouz,Saint-Étienne,7.2,9,4,1,7,1,4,8,50.0,4,3,0,3,5,14,5,0
349,Sofiane Boufal,Angers,8.1,17,11,8,6,3,8,28,28.6,20,8,0,8,3,20,1,0
350,Nassim Boujellab,Schalke 04,6.7,13,9,2,10,1,2,12,16.7,10,10,3,7,7,20,9,0
351,Farid Boulaya,Metz,31.3,24,16,4,17,3,13,51,25.5,38,19,3,16,12,36,7,0
352,Yassine Bounou,Sevilla,33.0,1,1,1,0,0,0,2,0.0,2,0,0,0,0,1,12,2
353,Ismaelben Boura,Lens,9.1,11,7,8,2,1,3,9,33.3,6,7,2,5,21,32,12,0
354,Mehdi Bourabia,Sassuolo,5.9,6,5,1,4,1,2,7,28.6,5,14,6,8,12,18,8,0
355,Benjamin Bourigeaud,Rennes,28.4,40,23,17,16,7,21,71,29.6,50,37,1,36,19,59,25,0
356,Edoardo Bove,Roma,0.1,0,0,0,0,0,0,1,0.0,1,0,0,0,0,0,0,0
357,Jarrod Bowen,West Ham,28.5,26,15,12,7,7,10,29,34.5,19,19,1,18,22,48,10,0
358,Dedryck Boyata,Hertha BSC,17.2,14,7,10,3,1,7,15,46.7,8,23,20,3,26,40,68,1
359,John Boye,Metz,33.8,58,34,43,13,2,31,54,57.4,23,36,20,16,80,138,146,1
360,Lucas Boye,Elche,29.9,47,31,13,27,7,10,49,20.4,39,37,2,35,19,66,21,0
361,Can Bozdogan,Schalke 04,7.2,13,5,6,6,1,4,15,26.7,11,10,2,8,7,20,5,0
362,Umut Bozok,Lorient,0.7,0,0,0,0,0,0,2,0.0,2,0,0,0,0,0,0,0
364,Jayden Braaf,Udinese,1.3,0,0,0,0,0,0,1,0.0,1,0,0,0,0,0,0,0
365,Domagoj Bradaric,Lille,14.0,28,18,11,13,4,12,27,44.4,15,14,4,10,26,54,21,0
366,Robbie Brady,Burnley,11.7,22,15,12,6,4,12,35,34.3,23,16,0,16,9,31,29,1
367,Martin Braithwaite,Barcelona,13.1,8,4,2,3,3,1,6,16.7,5,2,0,2,6,14,7,0
368,Julian Brandt,Dortmund,16.6,27,14,13,9,5,12,43,27.9,31,25,1,24,17,44,7,1
369,Darko Brasanac,Osasuna,10.1,10,6,6,4,0,5,16,31.3,11,8,1,7,7,17,10,0
370,Lilian Brassier,Brest,10.7,19,10,12,4,3,7,11,63.6,4,13,6,7,23,42,38,1
371,Alvaro Bravo,Granada,0.2,1,1,1,0,0,1,2,50.0,1,0,0,0,1,2,0,0
372,Claudio Bravo,Betis,20.0,0,0,0,0,0,0,1,0.0,1,0,0,0,0,0,11,0
373,Fabian Bredlow,Stuttgart,1.0,0,0,0,0,0,0,0,0.0,0,0,0,0,0,0,0,0
374,Josip Brekalo,Wolfsburg,20.2,22,10,10,7,5,8,29,27.6,21,18,0,18,17,39,3,1
375,Gleison Bremer,Torino,32.6,51,34,36,14,1,21,36,58.3,15,54,21,33,70,121,142,1
376,Joshua Brenet,Hoffenheim,0.0,0,0,0,0,0,0,0,0.0,0,0,0,0,0,0,0,0
377,Rhian Brewster,Sheffield Utd,12.5,8,5,1,4,3,1,13,7.7,12,15,2,13,5,13,5,0
378,Anthony Briancon,Nîmes,13.6,12,7,9,3,0,9,19,47.4,10,19,12,7,33,45,57,2
379,Jimmy Briand,Bordeaux,6.3,7,3,3,2,2,1,1,100.0,0,2,0,2,1,8,3,0
380,Yan Brice Eteki,Granada,14.7,23,15,10,12,1,8,19,42.1,11,13,3,10,13,36,16,1
381,Nathan Broadhead,Everton,0.0,1,1,0,1,0,0,0,0.0,0,0,0,0,0,1,0,0
382,Dylan Bronn,Metz,37.9,57,37,38,19,0,24,44,54.5,20,31,14,17,44,101,112,0
383,John Brooks,Wolfsburg,30.8,47,29,33,14,0,30,54,55.6,24,35,10,25,55,102,134,0
384,Daniel Brosinski,Mainz 05,15.9,19,14,10,7,2,12,31,38.7,19,18,1,17,14,33,33,0
385,Josh Brownhill,Burnley,31.3,45,27,9,29,7,15,44,34.1,29,33,11,22,69,114,39,0
386,Marcelo Brozovic,Inter,28.7,54,29,23,24,7,20,61,32.8,41,43,17,26,40,94,38,0
387,Gaston Brugman,Parma,18.0,35,19,18,15,2,11,44,25.0,33,33,4,29,45,80,34,0
388,Juan Brunet,Granada,0.3,0,0,0,0,0,0,0,0.0,0,0,0,0,0,0,1,0
390,Juan Brunetta,Parma,5.3,2,2,0,2,0,1,6,16.7,5,5,0,5,1,3,2,0
391,Cedric Brunner,Arminia,29.5,42,22,24,15,3,27,40,67.5,13,30,10,20,42,84,96,0
392,Jacob Bruun Larsen,Hoffenheim,1.0,0,0,0,0,0,0,0,0.0,0,0,0,0,0,0,0,0
393,Joe Bryan,Fulham,7.4,15,8,7,5,3,7,12,58.3,5,8,2,6,14,29,16,0
394,Kean Bryan,Sheffield Utd,11.2,20,10,9,11,0,9,19,47.4,10,16,10,6,13,33,39,1
395,Lucas Buades,Nîmes,0.2,1,0,0,1,0,0,0,0.0,0,0,0,0,0,1,0,0
396,Ante Budimir,Osasuna,18.1,20,12,2,11,7,4,15,26.7,11,17,4,13,2,22,17,1
397,Gianluigi Buffon,Juventus,8.0,0,0,0,0,0,0,0,0.0,0,0,0,0,0,0,3,1
398,Marius Bulter,Union Berlin,10.9,15,8,6,6,3,5,17,29.4,12,17,2,15,12,27,11,0
399,Alessandro Buongiorno,Torino,9.5,12,5,8,4,0,7,12,58.3,5,15,9,6,11,23,44,1
400,Esteban Burgos,Eibar,12.3,7,6,4,3,0,1,5,20.0,4,8,7,1,23,30,54,2
401,Burgui,Alavés,0.2,3,1,2,1,0,1,1,100.0,0,0,0,0,0,3,0,0
402,Jonathan Burkardt,Mainz 05,15.3,27,13,15,10,2,11,19,57.9,8,20,3,17,8,35,15,0
403,Nishan Burkart,Freiburg,0.2,0,0,0,0,0,0,1,0.0,1,0,0,0,0,0,0,0
404,Oliver Burke,Sheffield Utd,14.1,16,8,6,9,1,5,24,20.8,19,24,0,24,2,18,6,0
405,Roman Burki,Dortmund,18.5,0,0,0,0,0,0,0,0.0,0,0,0,0,0,0,5,1
406,Dan Burn,Brighton,22.9,50,26,33,14,3,27,53,50.9,26,30,7,23,31,81,75,0
407,Patrick Burner,Nice,0.0,0,0,0,0,0,0,0,0.0,0,0,0,0,0,0,0,0
408,Patrick Burner,Nîmes,14.6,25,11,14,10,1,13,26,50.0,13,10,3,7,24,49,41,1
409,Maxime Busi,Parma,13.3,23,13,19,3,1,11,28,39.3,17,14,1,13,16,39,32,0
410,Sergio Busquets,Barcelona,28.0,63,35,21,29,13,27,76,35.5,49,27,4,23,53,116,18,2
411,Jack Butland,Crystal Palace,1.0,0,0,0,0,0,0,0,0.0,0,0,0,0,0,0,0,0
412,David Button,West Brom,1.0,0,0,0,0,0,0,0,0.0,0,0,0,0,0,0,0,0
413,Oskar Buur,Wolves,0.2,0,0,0,0,0,0,2,0.0,2,0,0,0,0,0,0,0
414,Marcin Bulka,Paris S-G,1.0,0,0,0,0,0,0,0,0.0,0,0,0,0,0,0,0,1
416,Erick Cabaco,Getafe,14.7,24,14,11,12,1,12,22,54.5,10,8,6,2,13,37,51,1
417,Willy Caballero,Chelsea,1.0,0,0,0,0,0,0,0,0.0,0,0,0,0,0,0,0,0
418,Jimmy Cabot,Angers,10.5,26,13,8,14,4,11,36,30.6,25,8,0,8,12,38,6,0
419,Martin Caceres,Fiorentina,24.9,28,12,16,11,1,15,35,42.9,20,20,14,6,14,42,52,1
420,Anthony Caci,Strasbourg,31.1,80,46,47,27,6,35,69,50.7,34,30,4,26,55,135,65,1
421,Mathieu Cafaro,Reims,23.0,40,17,15,19,6,13,43,30.2,30,11,0,11,17,57,12,0
422,Gary Cahill,Crystal Palace,20.0,13,9,10,3,0,7,11,63.6,4,27,22,5,13,26,88,0
423,Yannick Cahuzac,Lens,25.0,26,12,12,10,4,9,27,33.3,18,18,5,13,33,59,72,0
424,Felipe Caicedo,Lazio,10.3,10,7,4,4,2,1,8,12.5,7,7,0,7,4,14,2,0
425,Marc-Aurele Caillard,Metz,4.0,0,0,0,0,0,0,0,0.0,0,0,0,0,0,0,2,0
426,Tom Cairney,Fulham,8.4,9,3,1,4,4,1,4,25.0,3,6,0,6,0,9,3,0
427,Cala,Cádiz,25.2,21,12,15,6,0,11,21,52.4,10,18,8,10,35,56,91,0
428,Arturo Calabresi,Bologna,0.2,0,0,0,0,0,0,0,0.0,0,0,0,0,0,0,2,0
429,Arturo Calabresi,Cagliari,0.2,0,0,0,0,0,0,1,0.0,1,0,0,0,0,0,0,0
430,Davide Calabria,Milan,29.4,101,64,61,32,8,54,90,60.0,36,42,9,33,37,138,82,1
431,Riccardo Calafiori,Roma,0.7,1,0,1,0,0,1,4,25.0,3,1,0,1,0,1,0,0
432,Mattia Caldara,Atalanta,1.2,1,0,0,1,0,1,1,100.0,0,3,2,1,4,5,3,0
433,Luca Caldirola,Benevento,17.5,21,13,13,6,2,10,22,45.5,12,20,15,5,20,41,56,0
434,Duje Caleta-Car,Marseille,31.3,29,17,19,9,1,17,30,56.7,13,29,22,7,44,73,130,0
435,Hakan Calhanoglu,Milan,29.0,26,7,3,17,6,7,28,25.0,21,21,6,15,15,41,24,1
436,Kerim Calhanoglu,Schalke 04,3.3,3,3,1,1,1,0,3,0.0,3,4,0,4,7,10,6,0
437,Fabrizio Caligara,Cagliari,2.0,6,4,2,2,2,6,9,66.7,3,9,2,7,3,9,3,0
438,Daniel Caligiuri,Augsburg,29.6,71,46,29,31,11,29,92,31.5,63,45,6,39,38,109,41,0
439,Jose Callejon,Fiorentina,7.4,10,7,0,6,4,5,9,55.6,4,4,1,3,4,14,5,0
440,Jonathan Calleri,Osasuna,17.2,15,6,2,4,9,3,17,17.6,14,18,2,16,1,16,10,1
442,Dominic Calvert-Lewin,Everton,31.9,17,8,1,8,8,6,12,50.0,6,22,6,16,6,23,33,0
443,Dani Calvo,Elche,19.8,20,13,13,7,0,7,10,70.0,3,18,12,6,11,31,71,0
444,Drissa Camara,Parma,0.2,0,0,0,0,0,0,0,0.0,0,0,0,0,0,0,0,0
445,Mahdi Camara,Saint-Étienne,36.6,99,67,43,46,10,33,60,55.0,27,50,12,38,78,177,51,0
446,Eduardo Camavinga,Rennes,26.7,98,58,39,48,11,38,77,49.4,39,36,2,34,23,121,15,1
447,Jose Campana,Levante,8.3,14,6,3,6,5,5,14,35.7,9,2,0,2,13,27,4,0
448,Emre Can,Dortmund,23.7,43,34,20,20,3,20,37,54.1,17,35,10,25,48,91,52,0
449,Sergio Canales,Betis,27.8,16,9,9,6,1,3,21,14.3,18,18,0,18,13,29,5,0
450,Joao Cancelo,Manchester City,25.5,68,41,42,19,7,43,83,51.8,40,23,2,21,41,109,33,2
451,Antonio Candreva,Sampdoria,27.8,28,19,17,9,2,21,53,39.6,32,24,3,21,9,37,27,1
452,Alex Cantero,Levante,2.6,2,1,0,2,0,1,2,50.0,1,1,0,1,0,2,3,0
453,Ander Capa,Athletic Club,23.7,37,18,22,13,2,18,37,48.6,19,21,8,13,25,62,57,0
454,Pierrick Capelle,Angers,22.8,53,28,24,17,12,31,79,39.2,48,25,1,24,47,100,32,0
455,Etienne Capoue,Villarreal,13.2,20,10,14,6,0,8,18,44.4,10,7,1,6,20,40,23,0
456,Elio Capradossi,Spezia,1.0,2,1,2,0,0,2,2,100.0,0,0,0,0,1,3,5,0
457,Gianluca Caprari,Benevento,20.7,16,11,5,5,6,6,31,19.4,25,19,1,18,18,34,8,0
458,Francesco Caputo,Sassuolo,18.9,0,0,0,0,0,0,2,0.0,2,4,0,4,1,1,3,0
459,Maxence Caqueret,Lyon,19.6,72,45,17,39,16,35,106,33.0,71,35,3,32,23,95,5,2
460,Andrea Carboni,Cagliari,12.1,34,23,23,11,0,15,28,53.6,13,15,4,11,14,48,52,0
461,Isaac Carcelen,Cádiz,28.7,68,43,36,25,7,33,60,55.0,27,37,12,25,49,117,89,0
462,Cardenas,Levante,8.0,0,0,0,0,0,0,1,0.0,1,0,0,0,3,3,5,1
463,Irvin Cardona,Brest,22.5,10,5,3,6,1,4,22,18.2,18,17,3,14,9,19,23,2
464,Marc Cardona,Osasuna,0.6,1,0,1,0,0,1,1,100.0,0,0,0,0,0,1,0,0
465,Ian Carlo Poveda,Leeds United,3.9,5,4,3,0,2,1,7,14.3,6,5,1,4,1,6,2,0
466,Diego Carlos,Sevilla,31.0,22,13,17,4,1,8,16,50.0,8,35,27,8,31,53,114,1
468,Juan Carlos,Huesca,3.2,5,3,4,1,0,2,15,13.3,13,7,0,7,1,6,1,0
469,Lionel Carole,Strasbourg,14.9,37,25,18,14,5,16,29,55.2,13,3,1,2,38,75,28,0
470,Yannick Carrasco,Atlético Madrid,24.2,27,15,14,6,7,15,34,44.1,19,24,0,24,17,44,16,1
471,Sergio Carreira,Celta Vigo,2.9,3,0,2,1,0,1,1,100.0,0,2,0,2,1,4,7,0
472,Guido Carrillo,Elche,11.1,9,8,1,7,1,2,8,25.0,6,2,1,1,4,13,14,0
473,Andy Carroll,Newcastle Utd,4.4,3,1,1,1,1,1,8,12.5,7,1,0,1,0,3,14,0
474,Scott Carson,Manchester City,1.0,0,0,0,0,0,0,0,0.0,0,0,0,0,0,0,0,0
475,Dani Carvajal,Real Madrid,10.6,27,20,12,10,5,11,20,55.0,9,19,1,18,13,40,27,0
476,Fabio Carvalho,Fulham,2.8,9,6,4,4,1,5,9,55.6,4,2,0,2,1,10,1,1
477,William Carvalho,Betis,13.6,19,12,7,11,1,5,21,23.8,16,11,3,8,11,30,14,1
478,Casemiro,Real Madrid,32.2,84,49,50,30,4,33,73,45.2,40,50,17,33,70,154,62,0
479,Matty Cash,Aston Villa,26.4,71,40,43,22,6,41,74,55.4,33,50,11,39,60,131,95,0
480,Kiko Casilla,Leeds United,3.0,0,0,0,0,0,0,0,0.0,0,0,0,0,0,0,0,0
481,Giuseppe Caso,Genoa,0.6,0,0,0,0,0,0,0,0.0,0,0,0,0,0,0,0,0
482,Moreto Cassama,Reims,22.6,49,36,24,23,2,27,49,55.1,22,19,6,13,36,85,33,4
483,Francesco Cassata,Genoa,2.5,7,6,7,0,0,4,7,57.1,3,0,0,0,3,10,1,0
484,Timothy Castagne,Leicester City,26.1,52,32,29,18,5,24,44,54.5,20,29,5,24,29,81,62,1
485,Koen Casteels,Wolfsburg,32.0,0,0,0,0,0,0,1,0.0,1,1,0,1,2,2,9,2
486,Jean-Charles Castelletto,Nantes,21.6,32,18,20,11,1,18,31,58.1,13,25,19,6,42,74,79,0
487,Samu Castillejo,Milan,13.1,24,12,9,14,1,14,40,35.0,26,21,0,21,6,30,9,0
488,Gonzalo Castro,Stuttgart,19.2,21,7,6,9,6,8,23,34.8,15,16,3,13,8,29,12,0
489,Jonny Castro,Wolves,5.5,11,5,6,4,1,6,13,46.2,7,9,3,6,9,20,7,0
490,Gaetano Castrovilli,Fiorentina,25.9,33,19,15,11,7,11,42,26.2,31,25,2,23,34,67,14,0
491,Danilo Cataldi,Lazio,6.3,7,2,1,5,1,4,18,22.2,14,3,1,2,9,16,7,0
492,Ivan Cavaleiro,Fulham,27.5,23,14,9,11,3,12,34,35.3,22,25,1,24,19,42,14,0
494,Edinson Cavani,Manchester Utd,15.3,12,8,1,8,3,2,13,15.4,11,2,0,2,6,18,11,0
495,Dani Ceballos,Arsenal,17.9,37,22,20,11,6,21,51,41.2,30,23,6,17,35,72,14,1
496,Federico Ceccherini,Hellas Verona,19.3,16,12,10,6,0,2,7,28.6,5,15,8,7,40,56,60,0
497,Federico Ceccherini,Fiorentina,3.0,4,1,1,3,0,1,1,100.0,0,6,5,1,7,11,15,0
498,Zeki Celik,Lille,26.5,72,33,30,30,12,44,81,54.3,37,32,6,26,38,110,52,0
499,Bersant Celina,Dijon,25.5,20,12,8,8,4,7,38,18.4,31,20,2,18,8,28,10,0
500,Fabien Centonze,Metz,35.8,104,68,64,30,10,43,73,58.9,30,62,17,45,112,216,119,1
501,Luca Ceppitelli,Cagliari,16.3,25,19,13,10,2,14,26,53.8,12,23,12,11,25,50,58,1
502,Alberto Cerri,Cagliari,4.1,3,2,0,2,1,0,5,0.0,5,4,2,2,2,5,6,0
503,Sava Cestic,Köln,10.0,20,9,12,6,2,8,17,47.1,9,13,4,9,18,38,40,0
504,Julian Chabot,Spezia,18.4,48,34,28,16,4,23,37,62.2,14,25,13,12,37,85,43,1
505,Nassim Chadli,Nîmes,0.3,2,1,2,0,0,0,1,0.0,1,1,0,1,0,2,0,0
506,Fouad Chafik,Dijon,18.0,39,24,29,8,2,16,35,45.7,19,19,10,9,21,60,41,0
507,Mehdi Chahiri,Strasbourg,8.9,18,8,7,5,6,8,20,40.0,12,9,0,9,6,24,5,0
508,Sofian Chakla,Villarreal,0.1,0,0,0,0,0,0,0,0.0,0,0,0,0,0,0,0,0
509,Sofian Chakla,Getafe,10.0,12,8,10,1,1,5,7,71.4,2,3,2,1,14,26,48,1
510,Anibal Chala,Dijon,8.3,10,7,6,3,1,6,12,50.0,6,5,3,2,14,24,15,1
511,Trevoh Chalobah,Lorient,24.9,45,26,32,13,0,24,50,48.0,26,20,7,13,69,114,56,0
512,Calum Chambers,Arsenal,8.4,7,3,3,2,2,3,8,37.5,5,6,2,4,10,17,37,0
513,Timothy Chandler,Eint Frankfurt,4.8,4,0,2,1,1,1,4,25.0,3,5,2,3,3,7,5,0
514,Kwon Chang-hoon,Freiburg,2.4,3,1,1,0,2,1,3,33.3,2,3,1,2,7,10,2,1
515,Gaetan Charbonnier,Brest,17.4,24,15,6,11,7,12,32,37.5,20,15,1,14,9,33,19,0
516,Brendan Chardonnet,Brest,30.2,51,29,31,19,1,27,41,65.9,14,54,41,13,64,115,151,0
517,Xavier Chavalerin,Reims,28.3,92,50,47,38,7,26,74,35.1,48,43,9,34,43,135,29,1
518,Pape Cheikh Diop,Dijon,12.1,24,14,15,6,3,13,33,39.4,20,14,2,12,6,30,6,0
520,Chema,Getafe,6.2,11,5,6,5,0,5,7,71.4,2,1,0,1,10,21,23,0
521,Rayan Cherki,Lyon,7.8,5,3,0,3,2,1,11,9.1,10,3,0,3,4,9,0,0
522,Denis Cheryshev,Valencia,12.2,19,15,6,7,6,6,26,23.1,20,15,1,14,12,31,15,0
523,Giorgio Chiellini,Juventus,15.4,12,9,9,3,0,5,11,45.5,6,18,13,5,27,39,56,0
524,Federico Chiesa,Fiorentina,2.7,6,2,2,2,2,3,8,37.5,5,3,1,2,1,7,3,0
525,Federico Chiesa,Juventus,24.6,47,26,21,14,12,19,50,38.0,31,23,1,22,12,59,16,0
526,Ben Chilwell,Chelsea,25.4,42,22,16,22,4,15,33,45.5,18,28,3,25,24,66,58,0
527,Vlad Chiriches,Sassuolo,20.4,38,23,34,3,1,21,35,60.0,14,31,21,10,50,88,59,2
528,Pedro Chirivella,Nantes,25.3,26,8,7,13,6,14,49,28.6,35,23,4,19,41,67,19,0
529,Tahith Chong,Werder Bremen,4.3,11,6,1,9,1,4,8,50.0,4,4,0,4,5,16,1,0
530,Joris Chotard,Montpellier,12.9,12,8,5,6,1,6,31,19.4,25,12,3,9,11,23,15,0
531,Hamza Choudhury,Leicester City,3.5,8,7,3,5,0,4,10,40.0,6,4,1,3,4,12,9,1
532,Mounir Chouiar,Dijon,14.3,22,12,10,9,3,6,18,33.3,12,10,0,10,11,33,8,0
533,Andreas Christensen,Chelsea,15.2,11,6,8,3,0,0,8,0.0,8,19,14,5,20,31,51,1
534,Carney Chukwuemeka,Aston Villa,0.2,2,2,1,0,1,1,3,33.3,2,0,0,0,0,2,0,0
535,Samuel Chukwueze,Villarreal,15.2,12,7,4,4,4,3,17,17.6,14,8,0,8,10,22,3,0
536,Darko Churlinov,Stuttgart,2.4,2,2,2,0,0,1,3,33.3,2,5,1,4,0,2,2,0
537,Victor Chust,Real Madrid,1.1,1,1,0,1,0,0,2,0.0,2,2,2,0,1,2,5,0
538,Sebastien Cibois,Brest,3.0,0,0,0,0,0,0,0,0.0,0,0,0,0,0,0,0,1
539,Cifu,Elche,5.0,10,7,7,3,0,7,13,53.8,6,5,1,4,8,18,10,0
540,Alberto Cifuentes,Cádiz,2.0,0,0,0,0,0,0,0,0.0,0,0,0,0,0,0,0,0
541,Luca Cigarini,Crotone,10.3,26,14,11,12,3,12,28,42.9,16,10,1,9,12,38,9,0
542,Jasper Cillessen,Valencia,10.0,0,0,0,0,0,0,0,0.0,0,0,0,0,0,0,0,0
543,Antonio Cioffi,Napoli,0.1,0,0,0,0,0,0,0,0.0,0,1,0,1,1,1,0,0
544,Tim Civeja,Augsburg,0.4,0,0,0,0,0,0,1,0.0,1,0,0,0,3,3,0,0
546,Ciaran Clark,Newcastle Utd,21.0,24,14,15,6,3,6,13,46.2,7,27,20,7,29,53,104,1
547,Alexis Claude-Maurice,Nice,21.2,40,19,17,14,9,14,48,29.2,34,16,2,14,14,54,3,0
548,Jonathan Clauss,Lens,28.0,43,20,12,20,11,17,38,44.7,21,24,1,23,45,88,46,0
549,Carlos Clerc,Levante,30.9,56,29,33,16,7,22,39,56.4,17,26,4,22,37,93,55,1
550,Nathaniel Clyne,Crystal Palace,12.7,17,10,8,8,1,9,16,56.3,7,7,2,5,18,35,25,1
551,Conor Coady,Wolves,36.7,35,23,25,10,0,19,35,54.3,16,40,32,8,27,62,134,2
552,Marcus Coco,Nantes,16.4,36,21,17,15,4,16,36,44.4,20,16,3,13,20,56,17,0
553,Coke,Levante,9.3,24,10,14,7,3,14,27,51.9,13,13,1,12,14,38,27,0
554,Seamus Coleman,Everton,17.9,39,26,21,14,4,21,30,70.0,9,22,6,16,13,52,37,2
555,Ebrima Colley,Hellas Verona,8.2,11,4,2,6,3,3,11,27.3,8,6,0,6,6,17,1,0
556,Omar Colley,Sampdoria,28.8,28,16,19,8,1,13,23,56.5,10,43,29,14,68,96,133,1
557,Simone Colombi,Parma,2.0,0,0,0,0,0,0,0,0.0,0,0,0,0,0,0,2,0
558,Lorenzo Colombo,Milan,1.0,2,1,1,1,0,0,3,0.0,3,0,0,0,0,2,3,0
559,Racine Coly,Nice,0.2,0,0,0,0,0,0,0,0.0,0,0,0,0,0,0,0,0
560,Kingsley Coman,Bayern Munich,19.5,14,8,6,7,1,2,21,9.5,19,22,0,22,4,18,3,0
561,Daniel Congre,Montpellier,36.6,59,35,45,12,2,36,70,51.4,34,50,33,17,69,128,144,3
562,Aaron Connolly,Brighton,8.8,6,3,1,3,2,0,2,0.0,2,4,0,4,0,6,2,0
563,Andrea Consigli,Sassuolo,37.0,2,2,2,0,0,2,2,100.0,0,0,0,0,0,2,14,4
564,Andrea Conti,Milan,0.3,1,1,1,0,0,0,1,0.0,1,0,0,0,1,2,0,0
565,Andrea Conti,Parma,9.0,21,10,16,4,1,13,26,50.0,13,13,4,9,16,37,23,0
566,Liam Cooper,Leeds United,24.3,68,45,39,27,2,37,59,62.7,22,39,32,7,61,129,70,1
567,Francis Coquelin,Villarreal,8.2,19,14,4,12,3,8,19,42.1,11,8,2,6,21,40,11,1
568,Theo Corbeanu,Wolves,0.1,2,1,0,2,0,1,1,100.0,0,0,0,0,1,3,0,0
569,Sebastien Corchia,Nantes,23.0,55,30,29,17,9,33,60,55.0,27,28,10,18,38,93,40,1
570,Alex Cordaz,Crotone,36.0,0,0,0,0,0,0,0,0.0,0,0,0,0,1,1,7,2
572,Inigo Cordoba,Athletic Club,1.1,0,0,0,0,0,0,3,0.0,3,4,0,4,2,2,1,0
573,Inigo Cordoba,Alavés,2.4,6,4,1,3,2,2,10,20.0,8,7,0,7,3,9,2,0
574,Jhon Cordoba,Hertha BSC,17.1,9,4,1,5,3,2,4,50.0,2,13,2,11,6,15,4,0
575,Sergio Cordova,Arminia,12.1,16,8,0,10,6,2,15,13.3,13,14,3,11,9,25,9,0
576,Jack Cork,Burnley,15.0,26,10,5,17,4,11,31,35.5,20,15,4,11,16,42,20,0
577,Andreas Cornelius,Parma,21.1,11,4,1,5,5,2,12,16.7,10,9,2,7,1,12,25,1
578,Maxwel Cornet,Lyon,27.2,70,41,39,24,7,33,58,56.9,25,23,5,18,43,113,47,2
579,Angel Correa,Atlético Madrid,26.6,38,21,10,23,5,15,45,33.3,30,18,1,17,22,60,16,0
580,Joaquin Correa,Lazio,21.5,21,12,6,11,4,7,25,28.0,18,14,0,14,7,28,12,0
581,Rober Correa,Eibar,12.6,16,9,8,6,2,8,12,66.7,4,9,1,8,20,36,31,0
582,Felix Correia,Juventus,0.1,0,0,0,0,0,0,0,0.0,0,0,0,0,0,0,1,0
583,Thierry Correia,Valencia,23.7,47,27,32,10,5,21,43,48.8,22,24,6,18,42,89,63,1
584,Danny da Costa,Mainz 05,13.4,22,16,6,9,7,13,27,48.1,14,17,2,15,17,39,27,0
585,Danny da Costa,Eint Frankfurt,1.2,0,0,0,0,0,0,1,0.0,1,3,1,2,0,0,4,0
586,David Pereira da Costa,Lens,1.8,4,4,1,2,1,2,3,66.7,1,2,0,2,0,4,4,0
587,Diego Costa,Atlético Madrid,2.3,1,0,1,0,0,1,3,33.3,2,0,0,0,0,1,2,0
588,Douglas Costa,Juventus,0.5,1,0,1,0,0,1,3,33.3,2,0,0,0,0,1,0,0
589,Douglas Costa,Bayern Munich,3.6,2,1,1,1,0,1,3,33.3,2,7,0,7,2,4,1,0
590,Helder Costa,Leeds United,12.8,25,11,12,5,8,11,32,34.4,21,11,0,11,3,28,5,1
591,Jaume Costa,Villarreal,3.9,10,6,4,6,0,7,9,77.8,2,7,1,6,6,16,8,0
592,Angelo da Costa Junior,Bologna,6.0,0,0,0,0,0,0,0,0.0,0,0,0,0,0,0,2,3
593,Charles Costes,Dijon,0.0,0,0,0,0,0,0,0,0.0,0,0,0,0,0,0,0,0
594,Benoit Costil,Bordeaux,38.0,1,1,1,0,0,1,3,33.3,2,1,0,1,1,2,17,0
595,Vladimir Coufal,West Ham,33.9,73,36,50,15,8,52,89,58.4,37,41,7,34,41,114,102,1
596,Kalifa Coulibaly,Nantes,10.9,3,1,0,1,2,2,8,25.0,6,3,1,2,2,5,12,0
598,Lassana Coulibaly,Angers,18.7,78,41,33,34,11,39,75,52.0,36,29,4,25,33,111,17,0
599,Mamadou Coulibaly,Udinese,2.0,10,8,5,5,0,0,0,0.0,0,2,0,2,1,11,0,0
600,Senou Coulibaly,Dijon,21.5,33,21,23,10,0,12,24,50.0,12,18,12,6,30,63,89,0
601,Tanguy Coulibaly,Stuttgart,16.7,26,15,10,7,9,11,23,47.8,12,20,0,20,10,36,11,0
602,Thibaut Courtois,Real Madrid,38.0,0,0,0,0,0,0,1,0.0,1,1,0,1,1,1,17,2
603,Philippe Coutinho,Barcelona,7.3,8,6,2,5,1,3,9,33.3,6,7,0,7,2,10,1,0
604,Nicolas Cozza,Montpellier,15.2,39,30,27,11,1,20,40,50.0,20,20,11,9,26,65,62,0
605,Alessio Cragno,Cagliari,34.0,0,0,0,0,0,0,1,0.0,1,0,0,0,1,1,10,0
606,Gian Crespi,Crotone,1.0,0,0,0,0,0,0,0,0.0,0,0,0,0,0,0,0,0
607,Aaron Cresswell,West Ham,35.2,32,13,15,15,2,18,32,56.3,14,29,14,15,32,64,79,2
608,Domenico Criscito,Genoa,19.2,43,22,29,11,3,22,39,56.4,17,27,14,13,44,87,51,0
609,Bryan Cristante,Roma,23.9,27,20,10,14,3,10,28,35.7,18,21,7,14,40,67,61,1
610,Giovanni Crociata,Crotone,0.3,1,0,0,1,0,0,1,0.0,1,1,0,1,0,1,0,0
611,Juan Cruz Armada,Osasuna,21.8,36,22,17,16,3,19,35,54.3,16,19,5,14,15,51,50,0
612,Juan Cuadrado,Juventus,24.2,43,25,22,15,6,29,60,48.3,31,16,2,14,43,86,22,2
613,Andres Cubas,Nîmes,24.9,80,47,30,44,6,33,74,44.6,41,37,10,27,50,130,29,3
614,Sergio Cubero Ezcurra,Eibar,0.0,0,0,0,0,0,0,0,0.0,0,0,0,0,0,0,0,0
615,Cucho,Getafe,16.3,19,10,1,14,4,2,23,8.7,21,18,1,17,6,25,8,0
616,Marc Cucurella,Getafe,36.0,64,51,19,40,5,25,66,37.9,41,45,4,41,40,104,27,0
617,Mickael Cuisance,Marseille,11.4,24,11,2,15,7,10,33,30.3,23,13,1,12,3,27,4,0
618,Mickael Cuisance,Bayern Munich,0.2,0,0,0,0,0,0,0,0.0,0,1,0,1,0,0,0,0
619,Matheus Cunha,Hertha BSC,23.9,36,16,10,19,7,13,49,26.5,36,29,2,27,31,67,9,0
620,Giuseppe Cuomo,Crotone,8.9,26,19,17,9,0,9,14,64.3,5,10,2,8,18,44,19,1
621,Patrick Cutrone,Wolves,0.3,0,0,0,0,0,0,0,0.0,0,0,0,0,0,0,0,0
622,Patrick Cutrone,Fiorentina,2.2,4,3,1,2,1,1,2,50.0,1,1,0,1,1,5,0,0
624,Patrick Cutrone,Valencia,1.2,0,0,0,0,0,0,1,0.0,1,0,0,0,1,1,0,0
625,Wylan Cyprien,Parma,4.6,9,4,5,3,1,2,4,50.0,2,13,8,5,5,14,6,1
626,Rafael Czichos,Köln,25.1,48,24,33,13,2,23,42,54.8,19,25,9,16,53,101,109,0
627,Lennart-Marten Czyborra,Genoa,13.0,19,10,7,7,5,11,19,57.9,8,6,1,5,17,36,27,0
628,Danilo D'Ambrosio,Inter,7.8,15,9,6,7,2,6,15,40.0,9,9,7,2,4,19,15,0
629,Damien Da Silva,Rennes,29.6,22,13,13,8,1,12,18,66.7,6,17,13,4,44,66,99,1
630,Moanes Dabbur,Hoffenheim,11.1,6,3,3,1,2,1,13,7.7,12,6,0,6,9,15,7,0
631,Bryan Dabo,Benevento,12.4,11,8,5,3,3,5,16,31.3,11,7,1,6,13,24,16,0
632,Colin Dagba,Paris S-G,15.1,23,11,4,17,2,14,19,73.7,5,18,5,13,16,39,18,1
633,Finn Dahmen,Mainz 05,3.0,0,0,0,0,0,0,1,0.0,1,0,0,0,0,0,1,0
634,Mahmoud Dahoud,Dortmund,14.0,30,18,9,20,1,14,38,36.8,24,23,5,18,18,48,11,1
635,Leon Dajaku,Union Berlin,0.4,0,0,0,0,0,0,0,0.0,0,0,0,0,0,0,0,0
636,Stuart Dallas,Leeds United,37.9,74,45,46,22,6,30,88,34.1,58,41,3,38,44,118,52,1
637,Diogo Dalot,Milan,12.1,32,17,23,6,3,17,34,50.0,17,18,5,13,25,57,42,0
638,Mikkel Damsgaard,Sampdoria,19.7,42,21,14,20,8,22,70,31.4,48,40,4,36,24,66,17,0
639,Flavius Daniliuc,Nice,16.4,23,15,15,5,3,10,21,47.6,11,17,6,11,14,37,32,0
640,Danilo,Juventus,32.4,62,31,37,16,9,35,66,53.0,31,32,12,20,66,128,68,2
641,Scott Dann,Crystal Palace,15.0,6,4,5,1,0,4,11,36.4,7,16,14,2,18,24,59,1
642,Tiago Dantas,Bayern Munich,0.8,1,1,0,0,1,0,0,0.0,0,0,0,0,0,1,0,0
643,Dante,Nice,8.6,10,5,6,4,0,3,7,42.9,4,6,4,2,10,20,20,0
644,Andrea Danzi,Hellas Verona,1.2,0,0,0,0,0,0,1,0.0,1,0,0,0,3,3,1,0
645,Ebrima Darboe,Roma,3.6,5,2,3,1,1,3,10,30.0,7,3,0,3,8,13,0,1
646,Marton Dardai,Hertha BSC,9.1,17,10,10,6,1,9,16,56.3,7,7,3,4,16,33,31,0
647,Vladimir Darida,Hertha BSC,21.1,34,19,11,19,4,9,31,29.0,22,34,2,32,27,61,18,0
648,Karl Darlow,Newcastle Utd,25.0,0,0,0,0,0,0,0,0.0,0,0,0,0,0,0,17,0
650,Matteo Darmian,Parma,2.3,6,5,3,3,0,4,7,57.1,3,2,0,2,6,12,7,0
651,Matteo Darmian,Inter,12.9,30,16,12,7,11,16,28,57.1,12,9,2,7,17,47,35,0
652,Jonathan David,Lille,26.2,17,10,5,5,7,9,24,37.5,15,19,1,18,3,20,9,0
653,Alphonso Davies,Bayern Munich,19.6,39,27,16,17,6,28,40,70.0,12,21,1,20,28,67,33,1
654,Ben Davies,Tottenham,15.0,27,17,10,11,6,13,30,43.3,17,10,5,5,18,45,49,2
655,Tom Davies,Everton,15.8,31,18,17,12,2,16,39,41.0,23,15,9,6,34,65,21,2
656,Keinan Davis,Aston Villa,3.1,2,1,1,0,1,0,1,0.0,1,1,0,1,0,2,2,0
657,Leif Davis,Leeds United,0.4,0,0,0,0,0,0,3,0.0,3,1,0,1,1,1,0,0
658,Pawel Dawidowicz,Hellas Verona,20.7,42,28,30,10,2,14,24,58.3,10,28,19,9,27,69,62,1
659,Craig Dawson,West Ham,21.4,11,8,7,4,0,5,12,41.7,7,26,22,4,32,43,88,3
660,Kevin De Bruyne,Manchester City,22.2,34,21,6,18,10,13,48,27.1,35,26,1,25,9,43,10,0
661,Sebastien De Maio,Udinese,9.5,15,10,6,9,0,4,5,80.0,1,16,9,7,18,33,41,0
662,Rodrigo De Paul,Udinese,35.6,41,24,17,22,2,15,60,25.0,45,32,1,31,17,58,20,1
663,Mattia De Sciglio,Juventus,0.3,0,0,0,0,0,0,0,0.0,0,0,0,0,0,0,1,0
664,Mattia De Sciglio,Lyon,16.3,29,17,15,11,3,18,27,66.7,9,13,4,9,27,56,44,0
665,Lorenzo De Silvestri,Bologna,23.8,34,24,18,13,3,16,37,43.2,21,37,10,27,30,64,62,3
666,Thibault De Smet,Reims,5.5,11,6,8,3,0,6,15,40.0,9,8,1,7,6,17,16,0
667,Lucas Deaux,Nîmes,19.5,47,32,20,22,5,16,49,32.7,33,20,3,17,20,67,30,4
668,Mathieu Debuchy,Saint-Étienne,23.4,58,33,37,17,4,40,62,64.5,22,27,9,18,45,103,61,0
669,Gregoire Defrel,Sassuolo,14.8,13,8,5,5,3,5,13,38.5,8,9,0,9,7,20,5,0
670,Alessandro Deiola,Spezia,4.0,6,3,2,3,1,5,13,38.5,8,3,1,2,3,9,1,0
671,Alessandro Deiola,Cagliari,6.8,13,5,5,4,4,8,23,34.8,15,7,2,5,11,24,11,0
672,Romain Del Castillo,Rennes,7.2,30,11,5,14,11,5,25,20.0,20,6,0,6,3,33,4,1
673,Lorenzo Del Pinto,Benevento,0.1,0,0,0,0,0,0,2,0.0,2,0,0,0,0,0,0,0
674,Thomas Delaine,Metz,19.8,32,18,19,11,2,20,35,57.1,15,22,5,17,24,56,30,1
676,Thomas Delaney,Dortmund,14.3,40,30,15,20,5,11,31,35.5,20,28,10,18,22,62,15,1
677,Liam Delap,Manchester City,0.4,0,0,0,0,0,0,0,0.0,0,0,0,0,0,0,0,0
678,Jonathan Delaplace,Lorient,10.1,8,5,5,1,2,7,13,53.8,6,12,5,7,17,25,19,1
679,Sacha Delaye,Montpellier,0.1,0,0,0,0,0,0,1,0.0,1,0,0,0,1,1,1,0
680,Cristian Dell'Orco,Spezia,2.9,1,0,1,0,0,1,3,33.3,2,8,5,3,7,8,9,1
681,Andy Delort,Montpellier,27.6,12,7,1,9,2,8,18,44.4,10,11,1,10,4,16,34,0
682,Fabian Delph,Everton,3.0,5,2,3,2,0,1,3,33.3,2,2,0,2,4,9,8,1
683,Moussa Dembele,Atlético Madrid,1.1,0,0,0,0,0,0,1,0.0,1,0,0,0,1,1,0,0
684,Moussa Dembele,Lyon,7.5,2,2,0,1,1,0,4,0.0,4,4,2,2,5,7,9,0
685,Ousmane Dembele,Barcelona,19.7,14,9,4,9,1,6,17,35.3,11,10,0,10,9,23,3,1
686,Merih Demiral,Juventus,10.4,12,9,8,4,0,5,13,38.5,8,16,9,7,21,33,40,0
687,Kerem Demirbay,Leverkusen,19.4,46,31,15,26,5,19,38,50.0,19,21,4,17,8,54,6,1
688,Ermedin Demirovic,Freiburg,16.6,15,9,4,6,5,2,16,12.5,14,29,5,24,0,15,27,0
689,Diego Demme,Napoli,17.7,56,32,26,22,8,23,63,36.5,40,14,1,13,11,67,15,1
690,Jason Denayer,Lyon,29.0,25,16,16,9,0,6,13,46.2,7,36,25,11,27,52,91,1
691,Leander Dendoncker,Wolves,27.8,54,29,29,22,3,31,60,51.7,29,38,15,23,27,81,52,2
692,Kevin Denkey,Nîmes,5.8,4,2,0,3,1,0,3,0.0,3,2,0,2,1,5,2,0
693,Emmanuel Dennis,Köln,5.3,13,7,6,5,2,1,6,16.7,5,6,0,6,0,13,0,1
694,Stefano Denswil,Bologna,1.3,2,1,1,1,0,0,1,0.0,1,1,0,1,1,3,1,0
695,Fabio Depaoli,Benevento,12.4,25,13,15,6,4,15,32,46.9,17,16,4,12,12,37,38,0
696,Fabio Depaoli,Sampdoria,0.9,1,0,0,1,0,0,2,0.0,2,0,0,0,1,2,1,0
697,Fabio Depaoli,Atalanta,2.1,3,2,0,1,2,1,2,50.0,1,4,0,4,3,6,2,0
698,Clement Depres,Nîmes,0.2,0,0,0,0,0,0,0,0.0,0,0,0,0,0,0,0,0
699,Mike van der Hoorn,Arminia,15.1,8,4,3,5,0,1,3,33.3,2,12,8,4,27,35,73,0
700,Kastriot Dermaku,Parma,1.1,1,1,1,0,0,0,0,0.0,0,2,1,1,2,3,8,0
702,Kiril Despodov,Cagliari,0.1,1,1,0,1,0,1,1,100.0,0,0,0,0,0,1,0,0
703,Sergino Dest,Barcelona,21.2,31,16,23,6,2,18,32,56.3,14,25,4,21,10,41,24,1
704,Mattia Destro,Genoa,17.8,6,3,0,3,3,2,9,22.2,7,11,0,11,4,10,8,0
705,Gerard Deulofeu,Udinese,6.6,2,2,1,1,0,2,12,16.7,10,2,0,2,3,5,0,0
706,Deyverson,Alavés,9.7,6,4,3,1,2,2,13,15.4,11,9,0,9,9,15,13,0
707,Jacopo Dezi,Parma,0.9,4,3,0,2,2,3,6,50.0,3,2,0,2,0,4,0,0
708,Samuel Di Carmine,Hellas Verona,5.6,1,2,0,1,0,0,3,0.0,3,1,0,1,0,1,5,0
709,Samuel Di Carmine,Crotone,5.3,2,2,1,0,1,1,3,33.3,2,2,0,2,0,2,5,0
710,Giovanni Di Lorenzo,Napoli,36.0,79,50,54,21,4,43,75,57.3,32,37,13,24,35,114,64,1
711,Angel Di Maria,Paris S-G,20.6,26,17,6,8,12,11,45,24.4,34,14,1,13,6,32,7,0
712,Alessandro Di Pardo,Juventus,0.2,0,0,0,0,0,0,0,0.0,0,1,1,0,0,0,0,0
713,Giuseppe Di Serio,Benevento,3.2,2,2,1,1,0,0,4,0.0,4,5,0,5,0,2,4,0
714,Boulaye Dia,Reims,32.6,23,12,3,11,9,4,22,18.2,18,19,5,14,12,35,37,1
715,Abdoulay Diaby,Getafe,0.2,2,0,0,2,0,0,0,0.0,0,2,0,2,0,2,0,0
716,Moussa Diaby,Leverkusen,26.5,10,6,4,5,1,6,20,30.0,14,11,0,11,12,22,5,0
717,Mbaye Diagne,West Brom,13.2,4,3,3,0,1,1,4,25.0,3,2,1,1,1,5,16,0
718,Mouctar Diakhaby,Valencia,23.1,16,8,10,6,0,8,12,66.7,4,28,21,7,27,43,102,1
719,Abdou Diallo,Paris S-G,16.6,16,11,9,5,2,8,13,61.5,5,15,8,7,25,41,36,0
720,Amad Diallo,Manchester Utd,1.8,3,3,1,2,0,0,0,0.0,0,2,1,1,0,3,1,0
721,Amad Diallo,Atalanta,0.2,0,0,0,0,0,0,0,0.0,0,0,0,0,0,0,0,0
722,Habib Diallo,Strasbourg,25.8,11,6,3,6,2,7,18,38.9,11,12,2,10,13,24,12,0
723,Habib Diallo,Metz,1.6,1,1,0,1,0,1,1,100.0,0,0,0,0,0,1,5,0
724,Ibrahima Diallo,Southampton,11.3,29,16,11,17,1,9,16,56.3,7,10,1,9,10,39,12,2
725,Ibrahima Diallo,Brest,4.9,14,9,2,9,3,4,8,50.0,4,4,0,4,3,17,3,0
726,Amadou Diambo,Benevento,0.0,0,0,0,0,0,0,0,0.0,0,0,0,0,0,0,0,0
728,Grady Diangana,West Brom,13.7,35,19,19,9,7,19,43,44.2,24,16,2,14,16,51,9,0
729,Stephane Diarra,Lorient,2.2,0,0,0,0,0,0,7,0.0,7,6,1,5,4,4,1,0
730,Ruben Dias,Manchester City,31.6,24,13,13,8,3,4,16,25.0,12,31,23,8,35,59,92,0
731,Krepin Diatta,Monaco,4.3,4,3,1,1,2,1,3,33.3,2,5,1,4,4,8,1,0
732,Amadou Diawara,Roma,7.3,10,8,4,6,0,2,8,25.0,6,11,2,9,12,22,4,0
733,Brahim Diaz,Milan,13.6,18,10,7,7,4,10,23,43.5,13,10,0,10,2,20,2,0
734,Victor Diaz,Granada,9.2,21,10,13,6,2,10,19,52.6,9,14,8,6,16,37,39,0
735,Daniel Didavi,Stuttgart,10.8,16,6,2,9,5,7,12,58.3,5,10,0,10,3,19,8,0
736,Bamba Dieng,Marseille,1.4,5,3,3,2,0,2,4,50.0,2,2,0,2,0,5,0,0
737,Eric Dier,Tottenham,28.0,23,14,13,10,0,11,18,61.1,7,37,31,6,23,46,123,3
738,Daan Dierckx,Parma,5.2,5,4,5,0,0,3,5,60.0,2,10,6,4,13,18,21,0
739,Lucas Digne,Everton,29.8,63,38,40,16,7,29,54,53.7,25,42,4,38,31,94,87,0
740,Mitchell Dijks,Bologna,16.5,21,14,15,5,1,12,21,57.1,9,17,2,15,17,38,35,0
741,Javairo Dilrosun,Hertha BSC,5.9,5,3,2,2,1,1,6,16.7,5,5,0,5,4,9,3,0
742,Federico Dimarco,Hellas Verona,29.0,32,19,23,7,2,13,28,46.4,15,18,9,9,47,79,50,1
743,Junior Dina Ebimbe,Dijon,23.8,38,25,14,19,5,15,45,33.3,30,17,1,16,14,52,9,0
744,Tristan Dingome,Reims,0.2,0,0,0,0,0,0,1,0.0,1,0,0,0,0,0,0,0
745,Eren Dinkci,Werder Bremen,1.2,1,1,1,0,0,0,1,0.0,1,4,0,4,2,3,1,0
746,Sinaly Diomande,Lyon,12.6,10,7,8,1,1,5,14,35.7,9,19,15,4,33,43,53,1
747,Lois Diony,Angers,19.4,15,10,3,9,3,4,18,22.2,14,6,3,3,5,20,16,0
748,Issa Diop,West Ham,15.3,20,14,12,8,0,7,18,38.9,11,32,22,10,22,42,59,0
749,Papakouli Diop,Eibar,25.8,43,29,15,22,6,12,41,29.3,29,23,5,18,39,82,34,1
750,Sofiane Diop,Monaco,22.5,49,34,17,25,7,18,53,34.0,35,25,1,24,31,80,15,0
751,Andy Diouf,Rennes,0.1,0,0,0,0,0,0,0,0.0,0,0,0,0,0,0,0,0
752,Yehvann Diouf,Reims,1.5,0,0,0,0,0,0,0,0.0,0,0,0,0,0,0,0,0
754,Assane Diousse,Saint-Étienne,0.0,0,0,0,0,0,0,0,0.0,0,0,0,0,0,0,0,0
755,Jonas Dirkner,Hertha BSC,0.2,0,0,0,0,0,0,0,0.0,0,0,0,0,0,0,0,0
756,Axel Disasi,Monaco,22.3,29,20,17,12,0,20,35,57.1,15,18,11,7,26,55,66,1
757,Tiago Djalo,Lille,9.7,22,13,14,5,3,15,23,65.2,8,10,4,6,9,31,23,0
758,Djene,Getafe,32.7,61,39,31,26,4,26,34,76.5,8,24,11,13,42,103,96,0
759,Moussa Djenepo,Southampton,13.8,52,27,27,17,8,28,63,44.4,35,24,2,22,10,62,14,0
760,Koffi Djidji,Crotone,16.9,39,28,30,8,1,10,20,50.0,10,35,20,15,28,67,73,0
761,Alexander Djiku,Strasbourg,28.4,60,41,45,13,2,32,52,61.5,20,28,10,18,91,151,104,0
762,Berat Djimsiti,Atalanta,29.2,41,29,27,12,2,17,34,50.0,17,34,20,14,62,103,89,1
763,Marko Dmitrovic,Eibar,34.7,4,3,4,0,0,2,4,50.0,2,0,0,0,0,4,16,2
764,Ritsu Doan,Arminia,30.8,53,31,22,19,12,19,52,36.5,33,42,1,41,31,84,11,0
765,Mihai Dobre,Dijon,5.9,12,5,6,2,4,7,14,50.0,7,5,0,5,10,22,3,0
766,Matt Doherty,Tottenham,13.8,29,15,15,10,4,13,33,39.4,20,20,5,15,23,52,46,0
767,Jeremy Doku,Rennes,25.7,44,25,9,24,11,11,26,42.3,15,18,1,17,11,55,1,0
768,Kasper Dolberg,Nice,21.4,6,2,1,3,2,2,11,18.2,9,11,2,9,6,12,19,1
769,Keagan Dolly,Montpellier,5.0,7,2,6,0,1,4,8,50.0,4,3,0,3,5,12,2,0
770,Jaume Domenech,Valencia,28.0,1,1,1,0,0,1,2,50.0,1,1,0,1,0,1,16,2
771,Carlos Dominguez,Celta Vigo,4.0,5,4,4,1,0,3,6,50.0,3,5,3,2,6,11,24,0
772,Nicolas Dominguez,Bologna,13.9,48,28,26,17,5,15,37,40.5,22,26,7,19,24,72,20,0
773,John Donald,Elche,0.6,0,0,0,0,0,0,0,0.0,0,0,0,0,0,0,1,0
774,Ji Dong-won,Mainz 05,0.7,1,1,1,0,0,0,0,0.0,0,1,0,1,2,3,0,0
775,Anastasios Donis,Reims,1.1,4,1,2,0,2,1,1,100.0,0,0,0,0,0,4,0,0
776,Gianluigi Donnarumma,Milan,37.0,0,0,0,0,0,0,1,0.0,1,1,0,1,1,1,23,2
777,Gabriel Dos Santos,Arsenal,22.2,25,15,19,5,1,13,19,68.4,6,27,19,8,26,51,74,2
778,Bas Dost,Eint Frankfurt,9.1,3,2,1,1,1,2,5,40.0,3,5,1,4,2,5,8,0
780,Abdoulaye Doucoure,Everton,27.1,52,32,25,19,8,14,43,32.6,29,24,7,17,39,91,31,1
781,Cheick Doucoure,Lens,29.2,87,47,40,42,5,32,65,49.2,33,20,4,16,52,139,26,1
782,Fode Doucoure,Reims,3.7,11,8,7,4,0,4,9,44.4,5,2,0,2,4,15,11,0
783,Mahamadou Doucoure,Nîmes,0.5,1,1,1,0,0,1,1,100.0,0,0,0,0,0,1,0,0
784,Cheick Doukoure,Levante,1.1,5,4,2,1,2,3,4,75.0,1,2,0,2,3,8,0,0
785,Idrissa Doumbia,Huesca,8.7,15,8,6,7,2,5,13,38.5,8,6,3,3,7,22,9,0
786,Moussa Doumbia,Reims,10.0,10,6,4,4,2,4,22,18.2,18,5,1,4,10,20,4,0
787,Souleyman Doumbia,Angers,24.7,48,33,25,19,4,22,36,61.1,14,18,4,14,42,90,50,0
788,Aleksandar Dragovic,Leverkusen,12.6,11,7,5,5,1,9,13,69.2,4,17,5,12,13,24,33,0
789,Bartlomiej Dragowski,Fiorentina,35.0,1,0,1,0,0,1,1,100.0,0,0,0,0,1,2,13,1
790,Denis Dragus,Crotone,2.0,3,1,0,0,3,0,4,0.0,4,4,0,4,1,4,0,0
791,Radu Dragusin,Juventus,0.0,0,0,0,0,0,0,0,0.0,0,0,0,0,0,0,0,0
792,Mouhamadou Drammeh,Reims,1.9,0,0,0,0,0,0,2,0.0,2,0,0,0,2,2,7,0
793,Julian Draxler,Paris S-G,11.8,13,6,5,6,2,5,20,25.0,15,4,0,4,14,27,0,0
794,Dominick Drexler,Köln,13.7,36,26,15,18,3,12,30,40.0,18,5,1,4,14,50,15,0
795,Matthieu Dreyer,Lorient,15.0,0,0,0,0,0,0,0,0.0,0,0,0,0,0,0,4,2
796,Domingos Duarte,Granada,26.3,32,20,18,12,2,14,21,66.7,7,29,20,9,29,61,86,0
797,Leo Duarte,Milan,0.2,1,1,0,1,0,0,0,0.0,0,0,0,0,1,2,0,0
798,Oscar Duarte,Levante,22.9,22,13,17,5,0,10,18,55.6,8,23,15,8,36,58,97,1
799,Ruben Duarte,Alavés,28.3,55,30,28,21,6,23,52,44.2,29,44,6,38,66,121,72,0
800,Leo Dubois,Lyon,32.3,38,26,19,16,3,18,36,50.0,18,27,9,18,31,69,69,2
801,Martin Dubravka,Newcastle Utd,13.0,0,0,0,0,0,0,0,0.0,0,0,0,0,0,0,3,0
802,Ondrej Duda,Köln,28.2,36,14,13,18,5,8,39,20.5,31,28,2,26,19,55,20,0
803,Unai Dufur,Eibar,0.7,2,2,2,0,0,2,4,50.0,2,0,0,0,1,3,0,0
804,Haris Duljevic,Nîmes,8.6,15,9,4,7,4,6,22,27.3,16,3,0,3,8,23,1,0
806,Paul Dummett,Newcastle Utd,13.9,16,7,11,5,0,13,21,61.9,8,12,7,5,16,32,74,0
807,Alfred Duncan,Fiorentina,1.8,3,0,1,1,1,0,2,0.0,2,2,0,2,2,5,0,0
808,Alfred Duncan,Cagliari,11.9,18,10,8,9,1,4,21,19.0,17,8,0,8,16,34,8,1
809,Lewis Dunk,Brighton,32.6,30,15,20,8,2,16,23,69.6,7,29,20,9,32,62,106,0
810,Jimmy Dunne,Burnley,3.0,3,3,2,1,0,1,2,50.0,1,3,2,1,6,9,16,1
811,Erik Durm,Eint Frankfurt,16.4,17,13,7,9,1,8,21,38.1,13,19,5,14,29,46,26,0
812,Hugo Duro,Real Madrid,0.6,0,0,0,0,0,0,0,0.0,0,1,0,1,0,0,0,0
813,Jean-Kevin Duverne,Brest,22.5,38,21,24,14,0,15,32,46.9,17,24,16,8,30,68,70,0
814,Paulo Dybala,Juventus,12.6,14,8,3,4,7,2,14,14.3,12,15,0,15,1,15,1,0
815,Edin Dzeko,Roma,20.3,8,6,2,3,3,3,9,33.3,6,9,4,5,1,9,11,0
816,Steeve-Mike Ebongue,Genoa,0.6,2,1,1,0,1,0,3,0.0,3,1,0,1,0,2,0,0
817,Enzo Ebosse,Angers,2.9,5,3,5,0,0,3,4,75.0,1,1,1,0,2,7,13,0
818,Bruno Ecuele Manga,Dijon,38.0,52,38,46,6,0,29,40,72.5,11,50,33,17,57,109,165,3
819,Simone Edera,Torino,0.6,3,1,2,1,0,3,4,75.0,1,0,0,0,1,4,1,0
820,Ederson,Manchester City,36.0,3,1,3,0,0,3,4,75.0,1,0,0,0,0,3,11,4
821,Kyle Edwards,West Brom,1.3,3,2,1,1,1,0,0,0.0,0,2,0,2,1,4,0,0
822,John Egan,Sheffield Utd,29.2,41,21,29,12,0,22,39,56.4,17,43,31,12,41,82,131,0
823,Johannes Eggestein,Werder Bremen,0.4,0,0,0,0,0,0,1,0.0,1,0,0,0,1,1,2,0
824,Maximilian Eggestein,Werder Bremen,32.7,57,42,22,29,6,21,46,45.7,25,30,5,25,43,100,36,0
825,Lilian Egloff,Stuttgart,0.2,0,0,0,0,0,0,0,0.0,0,0,0,0,0,0,0,0
826,Kingsley Ehizibue,Köln,12.6,32,19,22,9,1,10,17,58.8,7,19,5,14,18,50,42,0
827,Albin Ekdal,Sampdoria,25.5,56,29,21,32,3,23,65,35.4,42,31,12,19,49,105,35,0
828,Hugo Ekitike,Reims,1.0,1,1,0,0,1,0,1,0.0,1,0,0,0,0,1,0,0
829,Anthony Elanga,Manchester Utd,1.7,4,2,3,1,0,4,5,80.0,1,1,1,0,1,5,1,0
830,Niclas Eliasson,Nîmes,20.0,28,14,9,12,7,11,24,45.8,13,20,1,19,23,51,16,0
832,Elif Elmas,Napoli,8.2,15,4,3,6,6,7,12,58.3,5,11,1,10,2,17,10,0
833,Ahmed Elmohamady,Aston Villa,9.3,17,13,12,4,1,9,14,64.3,5,6,3,3,17,34,26,0
834,Mohamed Elneny,Arsenal,17.2,14,6,7,7,0,7,28,25.0,21,11,4,7,24,38,20,2
835,Aritz Elustondo,Real Sociedad,20.9,30,16,21,7,2,18,22,81.8,4,12,5,7,15,45,63,0
836,Nico Elvedi,M'Gladbach,28.2,49,35,36,12,1,25,37,67.6,12,38,22,16,65,114,123,0
837,Rodrigo Ely,Alavés,5.2,5,2,3,2,0,3,4,75.0,1,2,1,1,7,12,23,1
838,Breel Embolo,M'Gladbach,16.0,15,10,1,13,1,0,6,0.0,6,16,1,15,8,23,8,0
839,Emerson,Betis,33.2,91,52,62,25,4,43,78,55.1,35,33,6,27,61,152,102,2
840,Renaud Emond,Nantes,3.9,0,0,0,0,0,0,1,0.0,1,2,0,2,0,0,1,0
841,Alan Empereur,Hellas Verona,2.4,0,0,0,0,0,0,0,0.0,0,1,1,0,6,6,7,1
842,Youssef En-Nesyri,Sevilla,25.7,17,11,2,9,6,4,21,19.0,17,15,0,15,8,25,23,0
843,Keita Endo,Union Berlin,5.1,8,3,1,5,2,3,9,33.3,6,5,2,3,6,14,4,0
844,Wataru Endo,Stuttgart,32.8,65,44,25,34,6,29,71,40.8,42,53,14,39,51,116,59,0
845,Sergi Enrich,Eibar,15.6,21,15,6,7,8,9,22,40.9,13,11,0,11,6,27,5,0
846,Christian Eriksen,Inter,15.4,12,6,6,4,2,7,20,35.0,13,16,1,15,9,21,13,1
847,Martin Erlic,Spezia,20.0,23,14,16,6,1,11,20,55.0,9,22,16,6,41,64,71,2
848,Patrick Erras,Werder Bremen,0.3,0,0,0,0,0,0,1,0.0,1,0,0,0,0,0,0,0
849,Gonzalo Escalante,Lazio,8.1,26,13,11,14,1,8,28,28.6,20,10,3,7,19,45,13,0
850,Aaron Escandell,Granada,5.0,1,1,1,0,0,1,1,100.0,0,0,0,0,0,1,6,0
851,Dani Escriche,Huesca,9.5,9,7,5,2,2,3,10,30.0,7,11,0,11,8,17,5,0
852,Sergio Escudero,Sevilla,6.3,12,8,6,5,1,6,12,50.0,6,5,2,3,9,21,7,0
853,Alfonso Espino,Cádiz,28.9,92,48,63,28,1,43,85,50.6,42,30,5,25,41,133,74,0
854,Vicente Esquerdo,Valencia,2.6,7,4,5,2,0,4,6,66.7,2,4,2,2,8,15,1,0
855,Nahuel Estevez,Spezia,19.6,13,5,4,6,3,5,32,15.6,27,23,5,18,20,33,22,1
856,Pervis Estupinan,Villarreal,13.0,37,17,23,12,2,14,23,60.9,9,10,2,8,35,72,14,2
858,Yoann Etienne,Lorient,1.0,2,0,1,1,0,1,1,100.0,0,1,0,1,1,3,2,0
859,Xabier Etxeita,Getafe,9.8,8,4,5,3,0,7,14,50.0,7,6,3,3,13,21,38,0
860,Jonny Evans,Leicester City,27.5,25,12,22,2,1,14,20,70.0,6,8,3,5,46,71,98,1
861,Edu Exposito,Eibar,27.3,51,30,16,31,4,20,66,30.3,46,25,4,21,22,73,17,0
862,Valentin Eysseric,Fiorentina,8.1,14,8,6,7,1,5,11,45.5,6,11,0,11,7,21,8,0
863,Eberechi Eze,Crystal Palace,28.4,27,14,11,13,3,16,35,45.7,19,19,3,16,24,51,9,1
864,Jokin Ezkieta,Athletic Club,1.0,0,0,0,0,0,0,0,0.0,0,0,0,0,0,0,0,0
865,Lukasz Fabianski,West Ham,35.0,1,0,1,0,0,1,1,100.0,0,1,0,1,1,2,12,3
866,Fabinho,Liverpool,28.5,58,31,21,29,8,27,54,50.0,27,28,10,18,44,102,66,1
867,Fabio,Nantes,16.7,62,37,37,23,2,35,61,57.4,26,29,8,21,37,99,49,0
868,Cesc Fabregas,Monaco,9.7,20,12,6,9,5,9,22,40.9,13,11,1,10,13,33,3,0
869,Bandiougou Fadiga,Paris S-G,0.7,1,0,1,0,0,0,0,0.0,0,0,0,0,0,1,0,0
870,Bandiougou Fadiga,Brest,0.5,0,0,0,0,0,0,2,0.0,2,0,0,0,0,0,0,0
871,Wout Faes,Reims,32.2,35,22,26,9,0,20,39,51.3,19,40,31,9,68,103,144,1
872,Nicolo Fagioli,Juventus,0.2,0,0,0,0,0,0,0,0.0,0,0,0,0,0,0,1,0
873,Ralf Fahrmann,Schalke 04,20.8,2,1,2,0,0,1,2,50.0,1,0,0,0,1,3,9,3
874,Romain Faivre,Brest,32.1,54,27,26,23,5,21,54,38.9,33,30,0,30,30,84,18,0
875,Fali,Cádiz,29.3,42,25,24,15,3,16,37,43.2,21,28,15,13,32,74,119,0
876,Iago Falque,Benevento,4.0,4,2,2,2,0,1,6,16.7,5,4,1,3,0,4,1,0
877,Andri Fannar Baldursson,Bologna,2.4,6,6,1,2,3,1,3,33.3,2,3,1,2,3,9,7,0
878,Paolo Farago,Bologna,0.3,1,1,1,0,0,1,2,50.0,1,1,0,1,0,1,0,0
879,Paolo Farago,Cagliari,4.1,13,9,10,3,0,9,20,45.0,11,3,2,1,6,19,15,0
880,Davide Faraoni,Hellas Verona,32.1,62,33,36,19,7,28,51,54.9,23,48,17,31,49,111,83,1
881,Mohamed Fares,Lazio,12.7,20,15,9,7,4,11,19,57.9,8,14,1,13,16,36,21,0
882,Diego Farias,Spezia,16.8,9,5,4,1,4,4,21,19.0,17,12,0,12,13,22,3,0
884,Wuilker Farinez,Lens,1.2,0,0,0,0,0,0,0,0.0,0,0,0,0,0,0,1,0
885,Noah Fatar,Angers,0.2,1,0,0,0,1,0,0,0.0,0,0,0,0,0,1,0,0
886,Ansu Fati,Barcelona,4.8,9,4,2,4,3,2,10,20.0,8,4,0,4,3,12,1,0
887,Julien Faussurier,Brest,10.6,16,11,6,8,2,11,25,44.0,14,12,4,8,9,25,10,0
888,Andrea Favilli,Hellas Verona,3.8,3,1,0,1,2,2,3,66.7,1,2,0,2,0,3,2,0
889,Federico Fazio,Roma,4.5,3,2,3,0,0,3,4,75.0,1,3,3,0,7,10,18,1
890,Nabil Fekir,Betis,29.1,45,23,9,22,14,7,43,16.3,36,31,2,29,8,53,2,0
891,Felipe,Atlético Madrid,22.9,29,17,19,10,0,18,23,78.3,5,30,15,15,36,65,128,2
892,Luiz Felipe,Lazio,10.1,32,20,19,11,2,16,24,66.7,8,20,9,11,21,53,29,1
893,Joao Felix,Atlético Madrid,17.5,8,4,1,6,1,4,17,23.5,13,3,0,3,5,13,2,0
894,Ohis Felix Uduokhai,Augsburg,29.0,33,24,19,10,4,18,27,66.7,9,48,25,23,54,87,164,2
895,Zinedine Ferhat,Nîmes,32.9,36,21,18,9,9,18,39,46.2,21,22,0,22,32,68,38,0
896,Bruno Fernandes,Manchester Utd,34.4,57,30,16,29,12,26,100,26.0,74,38,0,38,26,83,29,0
897,Edimilson Fernandes,Mainz 05,9.3,8,4,4,4,0,4,7,57.1,3,12,4,8,29,37,25,0
898,Aitor Fernandez,Levante,29.0,0,0,0,0,0,0,0,0.0,0,0,0,0,2,2,17,1
899,Alex Fernandez,Cádiz,21.6,19,9,8,8,3,8,30,26.7,22,14,1,13,22,41,15,0
900,Alvaro Fernandez,Huesca,22.0,1,1,0,1,0,1,3,33.3,2,0,0,0,2,3,7,0
901,Andres Fernandez,Huesca,16.0,0,0,0,0,0,0,0,0.0,0,0,0,0,0,0,3,2
902,Augusto Fernandez,Cádiz,4.1,11,3,5,6,0,2,13,15.4,11,5,1,4,9,20,5,0
903,Carlos Fernandez,Sevilla,1.6,1,0,1,0,0,0,2,0.0,2,3,1,2,1,2,0,0
904,Carlos Fernandez,Real Sociedad,4.3,3,2,0,2,1,1,8,12.5,7,6,1,5,0,3,6,0
905,Federico Fernandez,Newcastle Utd,23.1,29,22,23,5,1,17,21,81.0,4,41,31,10,17,46,147,0
906,Joaquin Fernandez,Valladolid,23.0,30,16,21,8,1,12,21,57.1,9,24,15,9,43,73,113,0
907,Fernandinho,Manchester City,13.2,31,17,8,14,9,20,43,46.5,23,11,2,9,23,54,17,0
908,Fernando,Sevilla,28.3,54,28,24,25,5,23,43,53.5,20,25,11,14,41,95,70,0
910,Alex Ferrari,Sampdoria,9.8,27,15,16,9,2,15,24,62.5,9,18,6,12,23,50,26,0
911,David Ferreiro,Huesca,28.1,25,12,12,8,5,8,49,16.3,41,21,1,20,25,50,15,0
912,Salvador Ferrer,Spezia,13.2,20,10,10,8,2,8,22,36.4,14,13,4,9,24,44,37,1
913,Facundo Ferreyra,Celta Vigo,3.3,4,3,1,2,1,0,2,0.0,2,5,0,5,2,6,2,0
914,Jordan Ferri,Montpellier,28.6,58,40,34,22,2,31,103,30.1,72,30,5,25,8,66,18,1
915,Marco Festa,Crotone,1.0,0,0,0,0,0,0,0,0.0,0,0,0,0,0,0,0,0
916,Fidel,Elche,26.6,46,30,28,15,3,25,64,39.1,39,22,2,20,16,62,14,0
917,Sam Field,West Brom,0.7,5,5,3,2,0,0,0,0.0,0,4,1,3,2,7,4,0
918,Alfred Finnbogason,Augsburg,6.0,2,1,0,1,1,0,1,0.0,1,7,1,6,1,3,4,0
919,Roberto Firmino,Liverpool,31.5,33,15,3,17,13,6,32,18.8,26,42,5,37,11,44,12,0
920,Junior Firpo,Barcelona,3.2,1,1,1,0,0,0,1,0.0,1,5,3,2,4,5,7,0
921,John Fleck,Sheffield Utd,28.6,51,33,28,18,5,26,83,31.3,57,26,4,22,28,79,12,1
922,Mark Flekken,Freiburg,3.0,0,0,0,0,0,0,0,0.0,0,0,0,0,0,0,1,0
923,Florian Flick,Schalke 04,4.0,10,7,4,6,0,7,16,43.8,9,4,3,1,7,17,5,1
924,Alexis Flips,Reims,0.5,0,0,0,0,0,0,2,0.0,2,0,0,0,0,0,1,0
925,Alessandro Florenzi,Paris S-G,17.1,24,16,9,9,6,12,29,41.4,17,7,1,6,17,41,25,0
926,Kingsley Fobi,Granada,0.5,0,0,0,0,0,0,0,0.0,0,0,0,0,1,1,1,0
927,Phil Foden,Manchester City,18.0,22,11,12,8,2,9,23,39.1,14,9,0,9,11,33,11,0
928,Mamadou Fofana,Metz,11.9,25,11,17,8,0,7,31,22.6,24,14,2,12,18,43,36,0
929,Seko Fofana,Lens,25.7,16,8,3,10,3,4,26,15.4,22,16,5,11,34,50,23,1
930,Wesley Fofana,Leicester City,25.1,51,37,27,22,2,31,46,67.4,15,28,16,12,61,112,94,0
931,Wesley Fofana,Saint-Étienne,3.5,6,4,6,0,0,3,4,75.0,1,3,3,0,8,14,14,1
932,Youssouf Fofana,Monaco,31.9,90,51,31,51,8,42,82,51.2,40,43,7,36,34,124,14,2
933,Thomas Foket,Reims,36.9,77,43,50,20,7,40,69,58.0,29,28,7,21,69,146,92,2
934,Ramon Folch,Elche,0.0,0,0,0,0,0,0,0,0.0,0,0,0,0,0,0,0,0
936,Lamine Fomba,Nîmes,24.2,66,36,30,25,11,30,65,46.2,35,48,19,29,59,125,39,2
937,Thomas Fontaine,Lorient,3.6,5,2,5,0,0,2,2,100.0,0,3,2,1,5,10,14,0
938,Jose Fontan,Celta Vigo,7.2,12,9,8,4,0,5,11,45.5,6,4,3,1,13,25,27,0
939,Jose Fonte,Lille,35.4,40,29,28,10,2,27,33,81.8,6,36,23,13,36,76,137,1
940,Fernando Forestieri,Udinese,6.1,9,7,4,4,1,3,7,42.9,4,7,0,7,2,11,0,0
941,Pablo Fornals,West Ham,28.6,44,26,14,24,6,11,73,15.1,62,43,1,42,36,80,9,0
942,Emil Forsberg,RB Leipzig,17.1,11,6,1,6,4,5,27,18.5,22,10,1,9,11,22,4,0
943,Fraser Forster,Southampton,8.0,1,0,1,0,0,1,2,50.0,1,0,0,0,0,1,9,0
944,Philipp Forster,Stuttgart,16.8,22,13,7,12,3,6,25,24.0,19,18,1,17,15,37,2,0
945,Steven Fortes,Lens,15.9,33,20,20,10,3,16,22,72.7,6,25,10,15,27,60,52,0
946,Yassin Fortune,Angers,0.2,0,0,0,0,0,0,0,0.0,0,0,0,0,0,0,0,0
947,Timothy Fosu-Mensah,Manchester Utd,0.9,2,0,1,1,0,1,1,100.0,0,0,0,0,3,5,1,0
948,Timothy Fosu-Mensah,Leverkusen,4.5,4,2,1,2,1,2,4,50.0,2,7,3,4,7,11,4,0
949,Daam Foulon,Benevento,11.3,26,15,21,5,0,16,28,57.1,12,12,3,9,14,40,34,0
950,Dimitri Foulquier,Granada,29.6,35,21,20,12,3,15,26,57.7,11,24,7,17,26,61,60,0
951,Juan Foyth,Villarreal,13.0,40,22,22,14,4,12,29,41.4,17,21,6,15,19,59,24,1
952,Gianluca Frabotta,Juventus,7.7,7,4,5,0,2,5,12,41.7,7,9,1,8,14,21,15,0
953,Raphael Framberger,Augsburg,17.1,42,23,26,11,5,19,25,76.0,6,24,2,22,36,78,62,1
954,Tyrese Francois,Fulham,0.2,0,0,0,0,0,0,0,0.0,0,0,0,0,0,0,0,0
955,Ryan Fraser,Newcastle Utd,10.3,4,1,3,1,0,2,5,40.0,3,1,0,1,6,10,7,0
956,Fred,Manchester Utd,26.6,81,39,39,38,4,29,89,32.6,60,49,9,40,45,126,26,1
957,Ryan Fredericks,West Ham,6.3,9,5,5,4,0,3,7,42.9,4,6,2,4,11,20,20,0
958,Remo Freuler,Atalanta,30.1,63,39,17,38,8,32,76,42.1,44,52,4,48,39,102,27,2
959,Marco Friedl,Werder Bremen,30.9,50,34,31,17,2,30,62,48.4,32,38,17,21,55,105,118,1
960,Marvin Friedrich,Union Berlin,34.0,47,29,35,11,1,18,32,56.3,14,38,18,20,52,99,109,0
962,Jeremie Frimpong,Leverkusen,4.8,7,4,4,3,0,4,8,50.0,4,4,0,4,1,8,7,0
963,Jorge de Frutos,Levante,24.3,48,24,21,21,6,11,41,26.8,30,25,2,23,16,64,18,0
964,Christian Fuchs,Leicester City,7.8,18,7,15,2,1,8,15,53.3,7,6,4,2,16,34,34,1
965,Angelo Fulgini,Angers,30.3,22,13,4,12,6,12,34,35.3,22,17,0,17,15,37,9,0
966,Niclas Fullkrug,Werder Bremen,9.7,7,3,2,4,1,1,13,7.7,12,10,4,6,3,10,13,0
967,Ramiro Funes Mori,Villarreal,8.1,12,8,7,5,0,7,11,63.6,4,7,5,2,8,20,42,1
968,Darnell Furlong,West Brom,32.6,45,27,27,12,6,21,44,47.7,23,39,16,23,49,94,90,0
969,Daniel Fuzato,Roma,5.0,0,0,0,0,0,0,0,0.0,0,1,0,1,0,0,1,1
970,Baptiste Gabard,Saint-Étienne,1.5,4,3,1,3,0,1,5,20.0,4,4,0,4,1,5,0,0
971,Matteo Gabbia,Milan,6.2,9,5,3,6,0,2,2,100.0,0,8,6,2,3,12,21,0
972,Manolo Gabbiadini,Sampdoria,9.7,2,2,0,2,0,0,1,0.0,1,3,1,2,3,5,5,0
973,Mijat Gacinovic,Hoffenheim,9.1,18,10,6,11,1,9,24,37.5,15,13,0,13,18,36,15,0
974,Roberto Gagliardini,Inter,13.7,30,17,17,8,5,5,28,17.9,23,15,3,12,19,49,16,0
975,Riccardo Gagliolo,Parma,21.7,45,18,35,8,2,28,45,62.2,17,34,7,27,36,81,64,1
976,Adolfo Gaich,Benevento,8.5,9,4,1,7,1,1,13,7.7,12,4,0,4,2,11,4,0
977,Andrey Galabinov,Spezia,4.8,2,1,1,1,0,1,3,33.3,2,2,0,2,0,2,5,0
978,Javi Galan,Huesca,34.1,88,54,47,35,6,46,72,63.9,26,30,4,26,39,127,61,0
979,Conor Gallagher,West Brom,28.1,81,41,30,39,12,29,97,29.9,68,47,8,39,27,108,31,0
980,Enric Gallego,Osasuna,9.0,6,3,2,2,2,2,14,14.3,12,5,1,4,1,7,9,0
981,Kevin Gameiro,Valencia,12.0,7,4,3,2,2,3,11,27.3,8,10,0,10,0,7,3,0
982,Idrissa Gana Gueye,Paris S-G,17.6,63,35,20,34,9,26,50,52.0,24,26,7,19,20,83,9,3
983,Ignatius Ganago,Lens,14.5,4,3,0,2,2,3,12,25.0,9,7,1,6,6,10,3,0
984,Aleix Garcia,Eibar,4.9,5,4,2,2,1,1,10,10.0,9,5,0,5,8,13,2,0
985,Borja Garcia,Huesca,12.4,13,7,4,6,3,6,12,50.0,6,12,0,12,10,23,4,1
986,Dani Garcia,Athletic Club,21.3,39,19,10,23,6,15,46,32.6,31,20,7,13,33,72,34,0
988,David Garcia,Osasuna,35.0,26,17,13,13,0,13,24,54.2,11,36,19,17,59,85,171,0
989,Eric Garcia,Manchester City,4.3,8,7,5,3,0,5,7,71.4,2,4,1,3,4,12,10,0
990,Manu Garcia,Alavés,12.5,24,13,10,13,1,8,35,22.9,27,16,1,15,12,36,21,0
991,Raul Garcia,Valladolid,5.6,10,8,5,5,0,6,20,30.0,14,5,1,4,9,19,10,0
992,Raul Garcia,Athletic Club,19.4,34,19,9,19,6,7,22,31.8,15,30,1,29,15,49,20,0
993,Ruben Garcia,Osasuna,30.2,50,29,21,22,7,14,45,31.1,31,28,2,26,29,79,20,0
994,Sergi Garcia,Alavés,0.2,1,1,0,1,0,0,1,0.0,1,0,0,0,0,1,0,0
995,Unai Garcia,Osasuna,13.8,19,9,14,4,1,9,15,60.0,6,16,8,8,14,33,40,0
996,Mario Gaspar,Villarreal,20.6,55,34,22,24,9,21,40,52.5,19,26,4,22,30,85,47,1
997,Manuel Gasparini,Udinese,0.0,0,0,0,0,0,0,0,0.0,0,0,0,0,0,0,0,0
998,Dwight Gayle,Newcastle Utd,5.7,2,0,1,1,0,0,7,0.0,7,3,1,2,1,3,2,0
999,Paulo Gazzaniga,Elche,8.0,1,1,1,0,0,0,0,0.0,0,0,0,0,1,2,4,0
1000,Jean-Philippe Gbamin,Everton,0.1,1,0,0,1,0,0,0,0.0,0,1,0,1,0,1,1,0
1001,Yann Gboho,Rennes,3.4,6,3,3,1,2,3,8,37.5,5,1,0,1,1,7,3,1
1002,David de Gea,Manchester Utd,25.5,0,0,0,0,0,0,0,0.0,0,0,0,0,0,0,8,3
1003,Christian Gebauer,Arminia,7.6,9,4,2,5,2,4,11,36.4,7,4,1,3,6,15,14,0
1004,Theodor Gebre Selassie,Werder Bremen,33.7,61,35,39,17,5,28,64,43.8,36,33,11,22,58,119,98,1
1005,Emrehan Gedikli,Leverkusen,0.3,0,0,0,0,0,0,0,0.0,0,0,0,0,0,0,0,0
1006,Dennis Geiger,Hoffenheim,7.3,13,10,3,8,2,5,8,62.5,3,10,0,10,3,16,0,0
1007,Christian Gentner,Union Berlin,11.5,17,8,9,5,3,5,18,27.8,13,13,1,12,17,34,16,0
1008,Yannick Gerhardt,Wolfsburg,21.5,52,32,14,32,6,21,52,40.4,31,34,4,30,21,73,30,0
1009,Valere Germain,Marseille,9.5,8,6,2,4,2,3,11,27.3,8,7,2,5,11,19,22,0
1010,Gervinho,Parma,22.5,5,1,2,2,1,1,14,7.1,13,11,1,10,10,15,3,0
1011,Willem Geubbels,Monaco,3.3,12,8,5,7,0,5,13,38.5,8,9,0,9,3,15,5,0
1012,Hamadi Al Ghaddioui,Stuttgart,0.5,0,0,0,0,0,0,1,0.0,1,0,0,0,0,0,0,0
1014,Anwar El Ghazi,Aston Villa,17.9,16,13,6,7,3,7,23,30.4,16,11,0,11,6,22,11,0
1015,Paolo Ghiglione,Genoa,15.1,27,15,17,8,2,13,28,46.4,15,14,2,12,13,40,25,0
1016,Faouzi Ghoulam,Napoli,3.2,6,5,3,2,1,0,1,0.0,1,4,2,2,3,9,1,0
1017,Kieran Gibbs,West Brom,9.0,15,11,11,3,1,8,10,80.0,2,8,6,2,16,31,30,1
1018,Morgan Gibbs-White,Wolves,4.6,9,7,3,4,2,5,12,41.7,7,6,0,6,3,12,1,0
1019,Niko Giesselmann,Union Berlin,4.8,12,9,7,4,1,5,8,62.5,3,9,3,6,8,20,13,1
1020,Rafal Gikiewicz,Augsburg,34.0,0,0,0,0,0,0,3,0.0,3,0,0,0,3,3,9,1
1021,Bryan Gil,Sevilla,0.1,1,1,0,1,0,0,0,0.0,0,0,0,0,0,1,0,0
1022,Bryan Gil,Eibar,25.2,28,18,12,11,5,6,23,26.1,17,20,0,20,17,45,6,0
1023,David Gil,Cádiz,4.0,0,0,0,0,0,0,1,0.0,1,0,0,0,0,0,2,0
1024,Billy Gilmour,Chelsea,2.9,4,2,1,2,1,2,7,28.6,5,3,2,1,3,7,1,0
1025,Alvaro Gimenez,Cádiz,4.5,4,2,2,2,0,0,3,0.0,3,2,0,2,2,6,3,0
1026,Daniel Ginczek,Wolfsburg,2.4,2,2,1,1,0,2,8,25.0,6,2,0,2,1,3,2,0
1027,Matthias Ginter,M'Gladbach,34.0,26,16,15,10,1,14,24,58.3,10,43,32,11,51,77,121,0
1028,Andrei Girotto,Nantes,29.6,65,41,50,15,0,39,70,55.7,31,34,15,19,59,124,103,0
1029,Olivier Giroud,Chelsea,8.3,4,2,0,1,3,1,7,14.3,6,4,1,3,5,9,10,0
1030,Robert Glatzel,Mainz 05,4.0,1,0,1,0,0,0,2,0.0,2,2,0,2,0,1,2,0
1031,Kamil Glik,Benevento,35.6,44,24,33,10,1,25,53,47.2,28,37,31,6,62,106,153,0
1032,Serge Gnabry,Bayern Munich,18.3,39,19,7,19,13,12,32,37.5,20,17,0,17,26,65,3,0
1033,Ben Godfrey,Everton,29.8,55,33,37,15,3,27,41,65.9,14,56,37,19,33,88,120,0
1034,Diego Godin,Cagliari,27.9,60,32,51,9,0,24,39,61.5,15,41,24,17,56,116,117,0
1035,Akaki Gogia,Union Berlin,1.6,1,0,0,1,0,0,2,0.0,2,0,0,0,1,2,0,0
1036,Amer Gojak,Torino,5.3,1,0,1,0,0,1,7,14.3,6,5,0,5,3,4,1,0
1037,Edoardo Goldaniga,Genoa,20.6,28,18,21,7,0,14,23,60.9,9,17,7,10,38,66,62,1
1038,Vladimir Golemic,Crotone,26.0,33,16,17,13,3,14,19,73.7,5,38,26,12,40,73,97,2
1040,Pierluigi Gollini,Atalanta,24.0,1,0,1,0,0,1,2,50.0,1,1,0,1,1,2,11,0
1041,Aleksandr Golovin,Monaco,11.9,28,16,6,18,4,8,39,20.5,31,21,0,21,11,39,3,0
1042,Tomislav Gomelt,Crotone,0.2,1,1,0,1,0,0,0,0.0,0,0,0,0,1,2,0,0
1043,Andre Gomes,Everton,17.4,35,23,16,16,3,17,58,29.3,41,19,1,18,10,45,12,1
1044,Dani Gomez,Levante,18.5,4,3,2,1,1,0,11,0.0,11,3,0,3,2,6,4,0
1045,Ibai Gomez,Athletic Club,4.7,6,4,2,3,1,4,7,57.1,3,3,0,3,2,8,4,0
1046,Joe Gomez,Liverpool,6.6,3,2,1,1,1,0,4,0.0,4,3,2,1,4,7,29,0
1047,Maxi Gomez,Valencia,29.9,11,9,3,7,1,3,14,21.4,11,13,3,10,2,13,34,0
1048,Moi Gomez,Villarreal,28.5,21,12,6,8,7,14,35,40.0,21,20,3,17,11,32,16,0
1049,Papu Gomez,Atalanta,7.4,3,2,2,1,0,2,8,25.0,6,8,1,7,1,4,1,0
1050,Papu Gomez,Sevilla,10.2,9,6,2,4,3,2,12,16.7,10,13,2,11,7,16,6,0
1051,Sergi Gomez,Sevilla,8.0,4,3,2,2,0,1,1,100.0,0,5,4,1,6,10,34,0
1052,Sergio Gomez,Huesca,8.8,29,10,17,9,3,11,22,50.0,11,15,0,15,14,43,9,0
1053,Alfred Gomis,Dijon,5.0,1,0,1,0,0,1,2,50.0,1,0,0,0,1,2,7,0
1054,Alfred Gomis,Rennes,22.0,1,1,1,0,0,1,1,100.0,0,0,0,0,3,4,10,1
1055,Maxime Gonalons,Granada,16.4,53,37,18,33,2,15,37,40.5,22,17,0,17,25,78,21,1
1056,Vagner Goncalves,Metz,10.7,16,9,5,5,6,2,15,13.3,13,6,0,6,4,20,1,1
1057,Alvaro Gonzalez,Marseille,31.5,26,17,20,6,0,19,31,61.3,12,30,18,12,33,59,119,1
1058,Bruno Gonzalez,Valladolid,25.1,26,17,18,8,0,17,31,54.8,14,22,14,8,37,63,112,1
1059,Diego Gonzalez,Elche,14.2,11,7,7,3,1,5,11,45.5,6,16,9,7,20,31,49,1
1060,Nicolas Gonzalez,Stuttgart,10.4,5,5,1,2,2,0,6,0.0,6,10,3,7,4,9,6,0
1061,Sergio Gonzalez,Cádiz,1.0,1,0,0,1,0,1,2,50.0,1,0,0,0,2,3,0,0
1062,Urko Gonzalez,Real Sociedad,0.5,0,0,0,0,0,0,1,0.0,1,1,1,0,0,0,1,0
1063,Anthony Gordon,Everton,1.0,3,3,3,0,0,0,2,0.0,2,1,0,1,1,4,3,0
1064,Leon Goretzka,Bayern Munich,18.9,37,23,12,21,4,16,39,41.0,23,30,2,28,44,81,11,0
1066,Andoni Gorosabel,Real Sociedad,26.5,76,43,45,20,11,27,64,42.2,37,25,4,21,23,99,42,0
1067,Robin Gosens,Atalanta,28.0,46,35,20,15,11,17,41,41.5,24,50,7,43,41,87,34,0
1068,Amine Gouiri,Nice,30.5,31,18,7,16,8,10,41,24.4,31,22,6,16,17,48,23,0
1069,Lucas Gourna-Douath,Saint-Étienne,14.7,32,22,18,11,3,15,28,53.6,13,10,0,10,24,56,18,0
1070,Jeffrey Gouweleeuw,Augsburg,31.5,36,20,24,11,1,16,33,48.5,17,37,18,19,69,105,149,2
1071,Jonathan Gradit,Lens,31.4,60,39,26,28,6,22,38,57.9,16,37,19,18,56,116,81,1
1072,Karlan Grant,West Brom,12.5,5,3,3,2,0,2,4,50.0,2,7,0,7,5,10,17,0
1073,Alberto Grassi,Parma,13.1,30,11,14,13,3,8,29,27.6,21,22,9,13,26,56,32,0
1074,Andrew Gravillon,Lorient,25.2,26,17,17,9,0,13,28,46.4,15,44,31,13,59,85,118,4
1075,Demarai Gray,Leicester City,0.2,1,1,1,0,0,0,0,0.0,0,0,0,0,0,1,0,0
1076,Demarai Gray,Leverkusen,4.9,3,2,1,2,0,1,1,100.0,0,3,0,3,4,7,3,0
1077,Adrian Grbic,Lorient,10.7,6,4,2,2,2,1,7,14.3,6,6,0,6,5,11,7,0
1078,Jack Grealish,Aston Villa,24.3,31,14,8,16,7,15,24,62.5,9,20,3,17,12,43,5,3
1079,Etienne Green,Saint-Étienne,8.0,0,0,0,0,0,0,0,0.0,0,0,0,0,0,0,3,0
1080,Mason Greenwood,Manchester Utd,20.2,13,10,6,4,3,5,22,22.7,17,9,0,9,5,18,1,0
1081,Michael Gregoritsch,Augsburg,9.3,13,10,6,7,0,3,10,30.0,7,2,0,2,3,16,17,0
1082,Clement Grenier,Rennes,12.0,20,8,9,8,3,7,31,22.6,24,7,0,7,5,25,3,0
1083,Sebastian Griesbeck,Union Berlin,9.9,20,9,8,11,1,8,19,42.1,11,13,3,10,5,25,8,0
1084,Antoine Griezmann,Barcelona,28.9,37,22,10,18,9,12,40,30.0,28,20,1,19,12,49,11,0
1085,Vincenzo Grifo,Freiburg,25.7,18,7,6,7,5,14,34,41.2,20,13,0,13,27,45,18,1
1086,Lennart Grill,Leverkusen,4.0,0,0,0,0,0,0,0,0.0,0,0,0,0,0,0,2,0
1087,Florian Grillitsch,Hoffenheim,20.9,37,21,21,13,3,19,52,36.5,33,38,7,31,51,88,47,1
1088,Christian Gross,Werder Bremen,16.3,44,28,17,25,2,15,37,40.5,22,12,2,10,24,68,37,0
1089,Pascal Gross,Brighton,27.6,45,24,24,15,6,24,53,45.3,29,25,4,21,23,68,18,1
1090,Kamil Grosicki,West Brom,1.6,2,1,2,0,0,2,8,25.0,6,1,0,1,2,4,1,0
1092,Ilia Gruev,Werder Bremen,0.0,0,0,0,0,0,0,0,0.0,0,0,0,0,0,0,0,0
1093,Carlos Gruezo,Augsburg,23.2,57,32,20,32,5,20,52,38.5,32,32,5,27,35,92,29,1
1094,Vicente Guaita,Crystal Palace,37.0,1,1,1,0,0,1,1,100.0,0,0,0,0,1,2,11,1
1095,Andres Guardado,Betis,14.6,25,12,10,11,4,10,25,40.0,15,13,3,10,18,43,19,0
1096,Sergi Guardiola,Valladolid,19.9,11,5,1,5,5,2,27,7.4,25,12,1,11,7,18,16,3
1097,Nemanja Gudelj,Sevilla,11.6,23,12,16,5,2,4,10,40.0,6,10,6,4,24,47,24,2
1098,Goncalo Guedes,Valencia,25.4,18,12,8,7,3,10,45,22.2,35,24,1,23,8,26,7,0
1099,Matteo Guendouzi,Hertha BSC,20.2,24,13,10,12,2,9,25,36.0,16,15,4,11,21,45,24,1
1100,Raphael Guerreiro,Dortmund,24.6,30,13,14,8,8,16,31,51.6,15,21,4,17,28,58,31,1
1101,Evann Guessand,Nice,0.3,0,0,0,0,0,0,1,0.0,1,1,1,0,1,1,1,0
1102,Kelyan Guessoum,Nîmes,12.5,13,7,11,1,1,11,16,68.8,5,8,6,2,24,37,51,0
1103,Ander Guevara,Real Sociedad,23.1,35,23,15,16,4,15,30,50.0,15,19,5,14,25,60,35,1
1104,Lamine Gueye,Metz,16.2,18,9,4,11,3,7,24,29.2,17,7,2,5,21,39,5,0
1105,Pape Gueye,Marseille,22.9,49,21,25,19,5,15,45,33.3,30,25,6,19,47,96,34,0
1106,John Guidetti,Alavés,2.3,2,2,0,2,0,0,2,0.0,2,0,0,0,1,3,2,0
1107,Josuha Guilavogui,Wolfsburg,8.3,17,9,9,8,0,5,12,41.7,7,12,5,7,29,46,25,0
1108,Frederic Guilbert,Strasbourg,12.4,37,19,23,11,3,21,34,61.8,13,14,1,13,33,70,32,0
1109,Bruno Guimaraes,Lyon,19.5,76,34,26,41,9,30,64,46.9,34,24,4,20,14,90,13,0
1110,Serhou Guirassy,Rennes,19.6,4,1,1,3,0,1,3,33.3,2,10,1,9,5,9,17,0
1111,Peter Gulacsi,RB Leipzig,33.0,1,0,1,0,0,1,2,50.0,1,0,0,0,2,3,7,0
1112,Manuel Gulde,Freiburg,21.7,27,15,12,12,3,5,21,23.8,16,25,15,10,37,64,64,0
1113,Robert Gumny,Augsburg,15.3,24,15,12,9,3,15,23,65.2,8,12,2,10,18,42,31,0
1114,Ilkay Gundogan,Manchester City,22.5,25,15,8,12,5,10,39,25.6,29,13,4,9,20,45,9,0
1115,Christian Gunter,Freiburg,34.0,34,19,18,13,3,15,43,34.9,28,38,9,29,29,63,40,0
1116,Koray Gunter,Hellas Verona,19.6,20,10,10,9,1,4,9,44.4,5,27,21,6,70,90,87,0
1118,Jon Guridi,Real Sociedad,9.2,19,9,10,6,3,8,22,36.4,14,8,1,7,10,29,9,0
1119,Malo Gusto,Lyon,0.0,0,0,0,0,0,0,0,0.0,0,0,0,0,0,0,0,0
1120,Raul Guti,Elche,31.8,48,28,21,22,5,16,52,30.8,36,25,3,22,49,97,25,0
1121,Marcos Mauro Lopez Gutierrez,Cádiz,20.3,23,15,15,8,0,15,24,62.5,9,18,12,6,22,45,78,0
1122,Miguel Gutierrez,Real Madrid,3.5,4,0,0,3,1,1,7,14.3,6,3,0,3,5,9,5,0
1123,Manu Gyabuaa,Atalanta,0.0,0,0,0,0,0,0,0,0.0,0,0,0,0,0,0,0,0
1124,Emmanuel Gyasi,Spezia,31.7,30,16,16,10,4,9,31,29.0,22,13,2,11,14,44,8,0
1125,Erling Haaland,Dortmund,26.7,7,2,1,3,3,1,4,25.0,3,19,4,15,4,11,16,0
1126,Janik Haberer,Freiburg,5.4,7,4,4,3,0,3,15,20.0,12,4,1,3,7,14,9,0
1127,Alexander Hack,Mainz 05,15.2,32,21,23,8,1,18,31,58.1,13,26,17,9,41,73,91,2
1128,Antwoine Hackford,Sheffield Utd,0.1,0,0,0,0,0,0,0,0.0,0,0,0,0,0,0,0,0
1129,Munir El Haddadi,Sevilla,9.4,12,8,5,5,2,2,12,16.7,10,6,0,6,5,17,6,0
1130,Andre Hahn,Augsburg,22.6,31,17,14,13,4,9,44,20.5,35,35,3,32,14,45,24,0
1131,Amadou Haidara,RB Leipzig,21.2,50,28,20,21,9,11,36,30.6,25,33,1,32,30,80,24,0
1132,Massadio Haidara,Lens,23.7,48,32,21,21,6,23,37,62.2,14,29,6,23,35,83,60,0
1133,Achraf Hakimi,Inter,29.6,53,32,23,19,11,23,48,47.9,25,31,1,30,22,75,23,1
1134,Sebastien Haller,West Ham,10.4,14,9,1,6,7,4,20,20.0,16,7,1,6,5,19,7,0
1135,Marcel Halstenberg,RB Leipzig,18.3,29,18,20,8,1,19,41,46.3,22,15,3,12,16,45,35,0
1136,Pierre-Yves Hamel,Lorient,9.4,15,8,3,9,3,1,6,16.7,5,12,1,11,10,25,6,0
1137,Romain Hamouma,Saint-Étienne,19.7,12,7,5,6,1,4,24,16.7,20,17,1,16,7,19,11,0
1138,Samir Handanovic,Inter,36.0,1,0,1,0,0,1,1,100.0,0,0,0,0,0,1,6,3
1139,Lukas Haraslin,Sassuolo,3.7,8,4,2,5,1,2,5,40.0,3,1,0,1,0,8,2,0
1140,Amine Harit,Schalke 04,23.3,22,13,8,11,3,10,23,43.5,13,9,1,8,17,39,7,1
1141,Rekeem Harper,West Brom,0.4,0,0,0,0,0,0,0,0.0,0,2,0,2,1,1,0,0
1142,Jack Harrison,Leeds United,31.6,63,38,20,30,13,26,59,44.1,33,30,2,28,15,78,21,0
1144,Marcel Hartel,Arminia,18.7,35,19,15,18,2,20,40,50.0,20,17,4,13,26,61,16,1
1145,Makoto Hasebe,Eint Frankfurt,25.4,43,29,21,20,2,25,51,49.0,26,31,12,19,31,74,68,2
1146,Hans Hateboer,Atalanta,19.6,28,17,12,14,2,13,23,56.5,10,8,1,7,17,45,9,0
1147,Kortney Hause,Aston Villa,7.0,4,2,3,1,0,0,3,0.0,3,4,2,2,8,12,53,0
1148,Kai Havertz,Chelsea,16.9,18,9,6,10,2,6,27,22.2,21,25,0,25,4,22,22,1
1149,Isaac Hayden,Newcastle Utd,21.6,52,29,23,22,7,14,35,40.0,21,32,9,23,43,95,47,0
1150,Eden Hazard,Real Madrid,5.9,3,2,1,2,0,0,3,0.0,3,3,0,3,3,6,0,0
1151,Thorgan Hazard,Dortmund,7.3,8,2,6,1,1,3,13,23.1,10,4,0,4,10,18,1,0
1152,Jonas Hector,Köln,14.3,34,22,8,21,5,15,35,42.9,20,24,5,19,19,53,20,1
1153,Michael Hector,Fulham,2.9,3,2,1,2,0,1,6,16.7,5,4,2,2,0,3,6,0
1154,Hwang Hee-chan,RB Leipzig,5.1,3,2,1,0,2,1,7,14.3,6,4,0,4,1,4,1,0
1155,Ahmed Hegazi,West Brom,1.0,0,0,0,0,0,0,0,0.0,0,2,0,2,1,1,7,0
1156,Dominique Heintz,Freiburg,15.2,22,11,19,3,0,10,19,52.6,9,10,8,2,35,57,49,0
1157,Dean Henderson,Manchester Utd,12.5,1,1,1,0,0,1,2,50.0,1,0,0,0,0,1,3,2
1158,Jordan Henderson,Liverpool,18.9,24,15,12,9,3,10,26,38.5,16,12,1,11,34,58,30,0
1159,Jeff Hendrick,Newcastle Utd,15.8,8,3,5,3,0,1,13,7.7,12,14,9,5,19,27,18,0
1160,Benjamin Henrichs,RB Leipzig,6.0,12,7,4,5,3,2,9,22.2,7,9,1,8,8,20,8,0
1161,Dalbert Henrique,Rennes,4.1,7,6,4,2,1,6,8,75.0,2,8,2,6,5,12,8,0
1162,Eduardo Henrique,Crotone,10.3,5,2,1,4,0,3,12,25.0,9,6,1,5,7,12,7,1
1163,Luis Henrique,Marseille,7.5,5,4,3,1,1,4,9,44.4,5,5,1,4,7,12,4,0
1164,Christophe Herelle,Brest,15.3,19,13,12,6,1,10,12,83.3,2,13,9,4,31,50,41,2
1165,Jerome Hergault,Lorient,18.1,38,23,22,10,6,17,31,54.8,14,16,2,14,22,60,34,0
1166,Mario Hermoso,Atlético Madrid,28.6,55,31,40,11,4,37,61,60.7,24,23,10,13,36,91,73,0
1167,Aridane Hernandez,Osasuna,22.5,20,11,13,6,1,7,12,58.3,5,22,19,3,34,54,127,1
1168,Lucas Hernandez,Bayern Munich,17.7,41,31,16,17,8,17,31,54.8,14,24,6,18,19,60,38,0
1170,Pablo Hernandez,Leeds United,4.7,5,3,2,1,2,5,16,31.3,11,2,0,2,0,5,0,1
1171,Theo Hernandez,Milan,32.6,48,29,22,21,5,19,38,50.0,19,29,6,23,34,82,64,5
1172,Hernani,Parma,24.3,51,25,21,27,3,29,66,43.9,37,35,4,31,31,82,40,1
1173,Ander Herrera,Paris S-G,20.6,53,35,17,26,10,30,77,39.0,47,31,5,26,31,84,22,1
1174,Hector Herrera,Atlético Madrid,7.6,12,7,5,6,1,7,13,53.8,6,7,2,5,14,26,8,0
1175,Sergio Herrera,Osasuna,32.9,0,0,0,0,0,0,2,0.0,2,0,0,0,3,3,29,3
1176,Yangel Herrera,Granada,25.7,59,26,19,32,8,11,41,26.8,30,53,17,36,26,85,32,1
1177,Patrick Herrmann,M'Gladbach,9.7,9,6,4,3,2,2,14,14.3,12,16,0,16,10,19,8,0
1178,Pablo Hervias,Valladolid,13.4,19,12,7,9,3,9,26,34.6,17,6,0,6,11,30,8,0
1179,Perparim Hetemaj,Benevento,24.6,44,27,21,18,5,26,61,42.6,35,41,5,36,22,66,24,1
1180,Son Heung-min,Tottenham,34.6,32,18,11,14,7,18,72,25.0,54,28,3,25,14,46,8,0
1181,Aaron Hickey,Bologna,8.4,12,8,10,2,0,7,17,41.2,10,6,1,5,15,27,15,1
1182,Vitorino Hilton,Montpellier,23.5,15,10,10,4,1,3,14,21.4,11,34,26,8,38,53,104,3
1183,Martin Hinteregger,Eint Frankfurt,28.1,77,49,53,22,2,37,63,58.7,26,31,12,19,44,121,92,0
1184,Marwin Hitz,Dortmund,15.5,1,1,1,0,0,1,1,100.0,0,0,0,0,0,1,7,1
1185,Wesley Hoedt,Lazio,10.6,22,16,18,4,0,10,17,58.8,7,9,5,4,17,39,48,1
1186,Ki-Jana Hoever,Wolves,6.4,14,6,11,2,1,10,22,45.5,12,2,0,2,9,23,23,0
1187,Nicolas Hofler,Freiburg,30.3,54,28,16,31,7,23,59,39.0,36,34,10,24,66,120,41,2
1188,Jonas Hofmann,M'Gladbach,20.2,26,20,12,12,2,10,53,18.9,43,27,2,25,27,53,9,0
1189,Marco Hoger,Köln,0.6,1,0,0,1,0,1,2,50.0,1,2,0,2,2,3,1,0
1190,Rob Holding,Arsenal,28.4,43,20,28,13,2,17,35,48.6,18,37,27,10,24,67,120,0
1191,Lucas Holer,Freiburg,23.2,36,24,13,19,4,12,32,37.5,20,19,2,17,16,52,14,0
1192,Mason Holgate,Everton,25.4,56,36,31,18,7,20,50,40.0,30,37,13,24,35,91,90,3
1193,Jordan Holsgrove,Celta Vigo,1.6,6,4,4,1,1,5,8,62.5,3,2,0,2,2,8,1,0
1194,Franck Honorat,Brest,27.3,28,13,12,10,6,14,37,37.8,23,15,3,12,11,39,24,0
1196,Matthew Hoppe,Schalke 04,14.5,6,6,1,3,2,2,12,16.7,10,8,2,6,4,10,15,0
1197,Jannes Horn,Köln,19.6,35,19,23,11,1,23,31,74.2,8,19,2,17,10,45,45,0
1198,Timo Horn,Köln,33.4,1,0,1,0,0,1,4,25.0,3,1,0,1,0,1,11,2
1199,Fraser Hornby,Reims,0.4,0,0,0,0,0,0,0,0.0,0,0,0,0,1,1,0,0
1200,Conor Hourihane,Aston Villa,2.5,0,0,0,0,0,0,2,0.0,2,3,0,3,0,0,2,0
1201,Lukas Hradecky,Leverkusen,28.5,0,0,0,0,0,0,1,0.0,1,0,0,0,1,1,11,3
1202,Ajdin Hrustic,Eint Frankfurt,3.0,6,5,2,3,1,3,10,30.0,7,2,0,2,4,10,3,0
1203,Florian Hubner,Union Berlin,5.8,10,5,7,3,0,7,15,46.7,8,7,3,4,13,23,21,0
1204,Callum Hudson-Odoi,Chelsea,11.8,23,15,11,7,5,8,21,38.1,13,15,1,14,6,29,6,0
1205,Niall Huggins,Leeds United,0.4,0,0,0,0,0,0,1,0.0,1,0,0,0,0,0,1,0
1206,Mats Hummels,Dortmund,31.3,58,40,34,18,6,26,42,61.9,16,31,22,9,73,131,122,2
1207,Adrien Hunou,Rennes,6.5,6,3,2,2,2,2,8,25.0,6,7,0,7,1,7,2,0
1208,Klaas-Jan Huntelaar,Schalke 04,6.5,4,2,0,2,2,0,2,0.0,2,3,1,2,2,6,3,0
1209,Elseid Hysaj,Napoli,19.6,29,17,16,11,2,17,33,51.5,16,18,4,14,30,59,52,0
1210,Pierre Hojbjerg,Tottenham,38.0,98,51,45,42,11,54,129,41.9,75,51,9,42,48,146,66,0
1211,Simone Iacoponi,Parma,13.3,22,12,16,5,1,13,26,50.0,13,9,4,5,11,33,42,1
1212,Iago,Augsburg,17.3,37,27,21,13,3,17,29,58.6,12,17,5,12,22,59,55,0
1213,Roger Ibanez,Roma,26.6,59,37,28,25,6,25,45,55.6,20,38,17,21,68,127,78,3
1214,Vedad Ibisevic,Schalke 04,1.7,0,0,0,0,0,0,0,0.0,0,1,0,1,1,1,1,0
1215,Vicente Iborra,Villarreal,10.3,18,8,8,7,3,8,24,33.3,16,14,7,7,14,32,25,1
1216,Didier Ibrahim Ndong,Dijon,29.0,53,32,22,30,1,25,70,35.7,45,35,7,28,37,90,40,0
1217,Zlatan Ibrahimovic,Milan,16.6,5,4,0,4,1,3,6,50.0,3,5,3,2,6,11,27,1
1218,Mauro Icardi,Paris S-G,12.0,6,2,1,2,3,4,13,30.8,9,3,1,2,3,9,7,0
1219,Oussama Idrissi,Sevilla,0.3,1,1,0,1,0,1,2,50.0,1,2,0,2,1,2,0,0
1220,Blendi Idrizi,Schalke 04,2.6,8,4,1,6,1,1,1,100.0,0,6,2,4,3,11,1,0
1222,Odion Ighalo,Manchester Utd,0.1,0,0,0,0,0,0,1,0.0,1,0,0,0,0,0,0,0
1223,Iglesias,Getafe,6.7,27,15,14,10,3,11,19,57.9,8,11,1,10,17,44,19,0
1224,Borja Iglesias,Betis,15.7,1,1,0,0,1,1,8,12.5,7,7,2,5,3,4,9,0
1225,Igor,Fiorentina,13.0,15,9,9,6,0,7,12,58.3,5,17,9,8,23,38,34,0
1226,Kelechi Iheanacho,Leicester City,16.2,12,5,2,4,6,4,17,23.5,13,14,0,14,2,14,1,1
1227,Jonathan Ikone,Lille,24.2,18,12,3,8,7,9,22,40.9,13,16,1,15,7,25,9,0
1228,Yun Il-lok,Montpellier,3.5,0,0,0,0,0,0,4,0.0,4,0,0,0,5,5,1,0
1229,Ivan Ilic,Hellas Verona,20.4,26,14,11,11,4,7,21,33.3,14,17,5,12,27,53,26,0
1230,Josip Ilicic,Atalanta,17.0,9,4,1,5,3,5,21,23.8,16,12,0,12,2,11,0,1
1231,Asier Illarramendi,Real Sociedad,3.7,5,2,1,4,0,1,5,20.0,4,2,0,2,5,10,7,0
1232,Stefan Ilsanker,Eint Frankfurt,17.5,33,20,17,15,1,21,42,50.0,21,30,8,22,30,63,51,2
1233,Ciro Immobile,Lazio,31.7,14,13,4,6,4,7,22,31.8,15,13,1,12,6,20,9,0
1234,Riccardo Improta,Benevento,25.9,39,23,25,8,6,21,45,46.7,24,23,4,19,28,67,47,0
1235,Roberto Inglese,Parma,6.4,5,2,1,2,2,2,11,18.2,9,10,0,10,0,5,3,0
1236,Danny Ings,Southampton,24.1,22,13,3,16,3,12,28,42.9,16,39,2,37,3,25,27,1
1237,Marcus Ingvartsen,Union Berlin,21.8,17,11,5,6,6,8,26,30.8,18,22,0,22,18,35,10,0
1238,Lorenzo Insigne,Napoli,31.8,26,18,8,12,6,13,72,18.1,59,30,1,29,37,63,6,1
1239,Roberto Insigne,Benevento,17.8,16,10,8,3,5,7,27,25.9,20,10,0,10,7,23,9,0
1240,Pablo Insua,Huesca,17.6,37,18,26,9,2,14,31,45.2,17,14,8,6,24,61,68,0
1241,Takashi Inui,Eibar,20.2,13,8,6,3,4,3,12,25.0,9,19,0,19,12,25,7,0
1242,Artur Ionita,Benevento,31.5,47,22,11,31,5,17,63,27.0,46,38,14,24,19,66,28,0
1243,Alexander Isak,Real Sociedad,26.0,9,5,0,3,6,3,8,37.5,5,17,1,16,3,12,7,0
1244,Isco,Real Madrid,10.1,13,9,5,5,3,2,14,14.3,12,7,1,6,2,15,2,0
1245,Ardian Ismajli,Spezia,14.4,19,9,10,8,1,8,13,61.5,5,10,7,3,23,42,52,1
1246,Branislav Ivanovic,West Brom,8.5,14,5,11,3,0,7,13,53.8,6,11,5,6,8,22,25,0
1248,Alex Iwobi,Everton,17.1,27,10,10,14,3,13,25,52.0,12,20,1,19,16,43,14,0
1249,Jairo Izquierdo,Cádiz,14.2,21,13,13,8,0,12,31,38.7,19,7,1,6,14,35,12,0
1250,Jose Izquierdo,Brighton,0.1,0,0,0,0,0,0,0,0.0,0,0,0,0,0,0,0,0
1251,Armando Izzo,Torino,22.3,30,16,13,13,4,13,33,39.4,20,22,9,13,53,83,62,0
1252,Phil Jagielka,Sheffield Utd,5.8,5,4,4,0,1,2,7,28.6,5,11,5,6,10,15,26,2
1253,Alireza Jahanbakhsh,Brighton,5.9,9,7,3,5,1,2,12,16.7,10,8,0,8,8,17,1,0
1254,Mato Jajalo,Udinese,0.4,1,1,1,0,0,1,1,100.0,0,1,0,1,2,3,0,0
1255,Ismail Jakobs,Köln,19.2,25,10,17,4,4,11,21,52.4,10,18,1,17,16,41,36,0
1256,Daniel James,Manchester Utd,10.1,15,9,4,7,4,3,18,16.7,15,10,1,9,0,15,6,0
1257,Reece James,Chelsea,26.4,55,35,24,22,9,21,44,47.7,23,36,7,29,17,72,52,0
1258,Alexandre Jankewitz,Southampton,0.0,2,1,2,0,0,1,1,100.0,0,0,0,0,0,2,0,0
1259,Saidy Janko,Valladolid,13.6,19,10,12,5,2,8,14,57.1,6,9,1,8,18,37,47,0
1260,Jakub Jankto,Sampdoria,26.8,28,17,14,7,7,11,35,31.4,24,16,1,15,24,52,34,0
1261,Tony Jantschke,M'Gladbach,3.0,2,2,1,1,0,1,3,33.3,2,6,4,2,4,6,7,0
1262,Adnan Januzaj,Real Sociedad,11.3,9,8,0,6,3,3,8,37.5,5,7,2,5,3,12,4,0
1263,Rune Jarstein,Hertha BSC,8.0,0,0,0,0,0,0,0,0.0,0,0,0,0,0,0,7,1
1264,Jason,Valencia,4.9,9,3,5,2,2,4,16,25.0,12,6,1,5,10,19,4,0
1265,Luis Javier Suarez,Granada,18.5,19,11,5,7,7,6,17,35.3,11,10,1,9,8,27,11,0
1266,Corentin Jean,Lens,6.4,4,3,1,1,2,0,5,0.0,5,4,0,4,2,6,2,0
1267,Daniel Jebbison,Sheffield Utd,3.2,6,2,1,3,2,3,7,42.9,4,6,1,5,1,7,0,0
1268,Tin Jedvaj,Leverkusen,1.7,5,2,2,3,0,1,3,33.3,2,2,1,1,2,7,9,0
1269,Fredrik Jensen,Augsburg,4.2,3,2,1,2,0,3,6,50.0,3,4,1,3,2,5,6,0
1270,Jese,Paris S-G,0.3,0,0,0,0,0,0,1,0.0,1,0,0,0,0,0,0,0
1271,Gabriel Jesus,Manchester City,22.9,17,6,5,5,7,11,28,39.3,17,16,0,16,15,32,5,0
1272,Juan Jesus,Roma,1.7,3,1,2,1,0,2,4,50.0,2,1,0,1,2,5,5,0
1274,Raul Jimenez,Wolves,9.1,3,2,1,2,0,0,7,0.0,7,2,0,2,8,11,12,0
1275,Joaquin,Betis,14.3,9,3,1,5,3,4,12,33.3,8,8,0,8,17,26,11,0
1276,John Joe,Getafe,0.7,2,0,0,2,0,0,0,0.0,0,0,0,0,0,2,0,0
1277,Joelinton,Newcastle Utd,22.0,33,21,7,21,5,14,37,37.8,23,30,2,28,9,42,24,0
1278,Marco John,Hoffenheim,11.1,21,15,9,5,7,10,22,45.5,12,18,1,17,16,37,21,0
1279,Ben Johnson,West Ham,5.8,11,5,5,3,3,7,9,77.8,2,5,1,4,11,22,9,0
1280,Sam Johnstone,West Brom,37.0,0,0,0,0,0,0,0,0.0,0,0,0,0,2,2,15,2
1281,Curtis Jones,Liverpool,13.1,16,6,6,7,3,12,25,48.0,13,13,0,13,19,35,11,1
1282,Frenkie de Jong,Barcelona,35.0,44,27,21,19,4,15,35,42.9,20,20,4,16,38,82,29,2
1283,Luuk de Jong,Sevilla,14.1,9,5,3,2,4,1,7,14.3,6,11,3,8,5,14,15,0
1284,Jony,Osasuna,9.7,7,3,1,2,4,5,20,25.0,15,5,0,5,14,21,3,0
1285,Joan Jordan,Sevilla,26.7,52,28,17,29,6,17,76,22.4,59,22,3,19,27,79,25,0
1286,Jorginho,Chelsea,22.3,57,30,22,31,4,31,76,40.8,45,33,5,28,40,97,21,3
1287,Josan,Elche,21.4,34,18,23,11,0,13,39,33.3,26,24,1,23,21,55,26,1
1288,Willian Jose,Wolves,12.3,2,1,1,1,0,1,4,25.0,3,6,1,5,1,3,12,0
1289,Willian Jose,Real Sociedad,7.7,3,1,0,3,0,1,3,33.3,2,3,1,2,0,3,8,0
1290,Joselu,Alavés,33.6,27,14,6,15,6,8,28,28.6,20,26,3,23,15,42,58,1
1291,Josema,Elche,21.8,43,28,33,10,0,10,18,55.6,8,17,7,10,37,80,92,0
1292,Jota,Valladolid,7.4,7,3,1,4,2,5,10,50.0,5,4,0,4,6,13,5,1
1293,Jota,Alavés,15.5,19,14,6,7,6,3,29,10.3,26,12,0,12,9,28,9,0
1294,Diogo Jota,Liverpool,12.4,12,6,4,7,1,2,29,6.9,27,9,0,9,5,17,3,0
1295,Stevan Jovetic,Monaco,8.9,8,4,2,3,3,3,13,23.1,10,1,0,1,3,11,3,0
1296,Luka Jovic,Real Madrid,1.7,0,0,0,0,0,0,0,0.0,0,0,0,0,0,0,0,0
1297,Luka Jovic,Eint Frankfurt,9.9,2,0,0,2,0,0,4,0.0,4,3,0,3,1,3,7,0
1298,Juanmi,Betis,6.7,13,9,3,5,5,4,18,22.2,14,4,0,4,2,15,4,0
1300,Hamed Junior Traore,Sassuolo,19.9,29,17,10,10,9,14,35,40.0,21,27,3,24,18,47,9,0
1301,Vinicius Junior,Real Madrid,21.9,32,22,14,10,8,11,43,25.6,32,28,0,28,7,39,4,0
1302,James Justin,Leicester City,23.0,61,37,38,18,5,20,41,48.8,21,36,10,26,30,91,58,1
1303,Musa Juwara,Bologna,0.5,2,2,2,0,0,1,3,33.3,2,1,0,1,0,2,0,0
1304,Jens Jonsson,Cádiz,29.1,55,29,25,25,5,22,52,42.3,30,39,7,32,51,106,45,0
1305,Ozan Kabak,Liverpool,8.9,19,10,11,4,4,6,9,66.7,3,2,2,0,12,31,28,1
1306,Ozan Kabak,Schalke 04,13.8,17,9,11,5,1,6,13,46.2,7,20,11,9,13,30,57,0
1307,Abdoul Kader Bamba,Nantes,10.2,18,3,7,8,3,11,18,61.1,7,10,0,10,7,25,4,1
1308,Pavel Kaderabek,Hoffenheim,17.6,15,12,7,6,2,6,15,40.0,9,12,3,9,18,33,31,0
1309,Tino Kadewere,Lyon,22.3,35,22,12,16,7,17,49,34.7,32,16,3,13,21,56,31,0
1310,Damian Kadzior,Eibar,2.2,1,0,0,1,0,1,5,20.0,4,1,0,1,0,1,0,0
1311,Florian Kainz,Köln,5.0,4,2,0,4,0,2,8,25.0,6,7,0,7,3,7,3,0
1312,Gael Kakuta,Lens,26.6,38,23,10,18,10,8,44,18.2,36,24,3,21,17,55,4,0
1313,Sasa Kalajdzic,Stuttgart,23.7,16,12,4,5,7,2,17,11.8,15,10,1,9,9,25,21,0
1314,Arnaud Kalimuendo,Paris S-G,0.8,0,0,0,0,0,0,0,0.0,0,0,0,0,0,0,0,0
1315,Arnaud Kalimuendo,Lens,13.5,8,2,2,2,4,1,7,14.3,6,11,0,11,2,10,2,0
1316,Nikola Kalinic,Hellas Verona,11.8,5,1,2,2,1,0,3,0.0,3,6,0,6,1,6,7,0
1317,Yayah Kallon,Genoa,0.5,0,0,0,0,0,0,0,0.0,0,0,0,0,0,0,0,0
1318,Samuel Kalu,Bordeaux,10.7,21,12,11,8,2,4,13,30.8,9,14,0,14,9,30,2,0
1319,Pierre Kalulu,Milan,8.1,18,14,11,6,1,10,14,71.4,4,9,3,6,19,37,20,0
1320,Daichi Kamada,Eint Frankfurt,26.2,48,28,21,16,11,16,49,32.7,33,18,1,17,14,62,22,0
1321,Aboubakar Kamara,Fulham,3.5,2,2,1,1,0,0,5,0.0,5,6,0,6,1,3,0,0
1322,Aboubakar Kamara,Dijon,6.2,3,1,0,2,1,1,7,14.3,6,1,0,1,0,3,2,0
1323,Bingourou Kamara,Strasbourg,8.0,1,1,1,0,0,1,3,33.3,2,0,0,0,1,2,2,1
1324,Boubacar Kamara,Marseille,32.2,88,51,31,49,8,40,74,54.1,34,36,13,23,34,122,51,0
1326,Hassane Kamara,Nice,32.9,65,39,40,16,9,27,49,55.1,22,39,12,27,55,120,61,1
1327,Marcin Kaminski,Stuttgart,2.4,1,1,0,0,1,0,0,0.0,0,2,1,1,1,2,10,0
1328,Kevin Kampl,RB Leipzig,21.5,38,26,9,24,5,18,35,51.4,17,20,2,18,29,67,14,0
1329,Harry Kane,Tottenham,34.2,22,12,1,17,4,8,26,30.8,18,28,11,17,11,33,40,0
1330,Lee Kang-in,Valencia,14.0,15,11,8,4,3,3,31,9.7,28,12,0,12,2,17,0,0
1331,Wilfried Kanga,Angers,1.5,0,0,0,0,0,0,1,0.0,1,1,0,1,0,0,2,0
1332,N'Golo Kante,Chelsea,23.8,79,42,39,35,5,27,56,48.2,29,42,4,38,59,138,34,0
1333,Jimmy Kaparos,Schalke 04,0.2,0,0,0,0,0,0,1,0.0,1,0,0,0,0,0,0,0
1334,Yann Karamoh,Parma,14.4,27,17,8,12,7,11,31,35.5,20,6,0,6,4,31,11,0
1335,Isaac Karamoko,Sassuolo,0.0,1,0,0,0,1,1,1,100.0,0,0,0,0,0,1,0,0
1336,Atakan Karazor,Stuttgart,11.5,20,12,12,7,1,13,22,59.1,9,18,8,10,21,41,50,2
1337,Augustus Kargbo,Crotone,0.4,0,0,0,0,0,0,0,0.0,0,0,0,0,0,0,0,0
1338,Loris Karius,Union Berlin,3.2,0,0,0,0,0,0,0,0.0,0,0,0,0,0,0,2,0
1339,Rick Karsdorp,Roma,28.3,36,23,19,12,5,21,48,43.8,27,18,1,17,30,66,32,0
1340,Silas Katompa,Stuttgart,21.3,48,29,19,19,10,21,44,47.7,23,29,1,28,22,70,11,2
1341,Noah Katterbach,Köln,12.3,18,11,11,6,1,13,21,61.9,8,7,3,4,23,41,22,0
1342,Eiji Kawashima,Strasbourg,24.0,1,0,1,0,0,1,1,100.0,0,0,0,0,0,1,4,2
1343,Moise Kean,Everton,0.2,0,0,0,0,0,0,0,0.0,0,0,0,0,0,0,0,0
1344,Moise Kean,Paris S-G,18.9,11,8,2,6,3,3,12,25.0,9,7,1,6,8,19,10,0
1345,Michael Keane,Everton,33.2,28,15,20,8,0,14,31,45.2,17,46,33,13,51,79,161,0
1346,Neeskens Kebano,Fulham,1.3,0,0,0,0,0,0,1,0.0,1,3,0,3,0,0,0,0
1347,Thilo Kehrer,Paris S-G,18.0,31,26,17,11,3,10,26,38.5,16,16,4,12,15,46,37,1
1348,Habib Keita,Lyon,0.1,0,0,0,0,0,0,0,0.0,0,0,0,0,0,0,0,0
1349,Naby Keita,Liverpool,5.8,11,5,1,8,2,7,17,41.2,10,10,0,10,9,20,6,0
1350,Yannik Keitel,Freiburg,5.5,12,8,7,4,1,7,9,77.8,2,9,3,6,10,22,8,0
1352,Caoimhin Kelleher,Liverpool,2.0,0,0,0,0,0,0,0,0.0,0,0,0,0,0,0,2,0
1353,Stephane Keller,Alavés,0.2,1,0,1,0,0,1,1,100.0,0,0,0,0,0,1,0,0
1354,Martin Kelly,Crystal Palace,0.0,1,0,1,0,0,1,1,100.0,0,0,0,0,0,1,0,0
1355,Marc-Oliver Kempf,Stuttgart,30.3,49,26,28,18,3,29,49,59.2,20,40,25,15,68,117,103,1
1356,Kenedy,Granada,16.3,22,12,10,7,5,5,25,20.0,20,21,4,17,26,48,15,1
1357,Jonjoe Kenny,Everton,0.9,2,1,1,0,1,2,2,100.0,0,0,0,0,1,3,3,0
1358,Franck Kessie,Milan,35.8,53,30,28,19,6,20,38,52.6,18,47,15,32,46,99,51,0
1359,Reda Khadra,Brighton,0.1,0,0,0,0,0,0,0,0.0,0,0,0,0,0,0,0,0
1360,Omar Khailoti,Bologna,0.3,0,0,0,0,0,0,0,0.0,0,2,0,2,1,1,0,0
1361,Saif-Eddine Khaoui,Marseille,6.7,19,11,7,6,6,7,16,43.8,9,8,0,8,12,31,1,0
1362,Wahbi Khazri,Saint-Étienne,13.1,24,15,12,7,5,12,24,50.0,12,10,1,9,4,28,11,0
1363,Rani Khedira,Augsburg,20.2,29,10,13,15,1,10,20,50.0,10,14,5,9,31,60,47,0
1364,Sami Khedira,Hertha BSC,4.4,11,6,3,7,1,6,12,50.0,6,4,0,4,9,20,7,0
1365,Kike,Eibar,34.3,24,18,5,7,12,6,22,27.3,16,24,1,23,7,31,29,0
1366,Luca Kilian,Mainz 05,4.2,14,7,10,4,0,9,17,52.9,8,3,1,2,13,27,12,0
1367,Max Kilman,Wolves,14.6,21,14,13,4,4,8,14,57.1,6,17,8,9,19,40,46,0
1368,Joshua Kimmich,Bayern Munich,24.4,40,28,16,19,5,10,53,18.9,43,25,5,20,36,76,19,0
1369,Presnel Kimpembe,Paris S-G,25.6,46,28,23,19,4,24,34,70.6,10,19,11,8,30,76,61,4
1370,Joshua King,Everton,1.6,4,1,2,1,1,0,0,0.0,0,3,0,3,1,5,1,0
1371,Simon Kjaer,Milan,26.6,45,26,23,20,2,18,30,60.0,12,42,26,16,42,87,125,0
1372,Davy Klaassen,Werder Bremen,2.5,3,1,0,1,2,0,5,0.0,5,5,1,4,3,6,4,0
1373,Felix Klaus,Wolfsburg,1.5,7,4,3,4,0,4,5,80.0,1,4,0,4,2,9,4,0
1374,Klauss,Hoffenheim,0.6,1,0,0,0,1,0,1,0.0,1,0,0,0,0,1,0,0
1375,Ragnar Klavan,Cagliari,8.6,15,9,9,5,1,7,11,63.6,4,9,4,5,8,23,34,0
1376,Philipp Klement,Stuttgart,4.7,7,3,6,0,1,3,7,42.9,4,9,2,7,6,13,7,0
1378,Mateusz Klich,Leeds United,26.6,38,20,14,20,4,14,61,23.0,47,13,4,9,11,49,16,0
1379,Mateo Klimowicz,Stuttgart,13.3,20,15,6,10,4,5,18,27.8,13,5,1,4,2,22,2,0
1380,Fabian Klos,Arminia,30.1,24,13,9,11,4,7,26,26.9,19,20,6,14,4,28,29,0
1381,Lukas Klostermann,RB Leipzig,16.1,23,19,8,12,3,11,18,61.1,7,16,6,10,18,41,44,1
1382,Justin Kluivert,Roma,0.2,0,0,0,0,0,0,0,0.0,0,0,0,0,0,0,0,0
1383,Justin Kluivert,RB Leipzig,9.0,2,1,1,1,0,0,2,0.0,2,4,0,4,5,7,3,0
1384,Lukas Klunter,Hertha BSC,11.0,10,5,6,4,0,5,10,50.0,5,3,1,2,11,21,29,1
1385,Ansgar Knauff,Dortmund,0.8,0,0,0,0,0,0,1,0.0,1,3,1,2,0,0,0,0
1386,Robin Knoche,Union Berlin,33.8,44,29,30,12,2,23,39,59.0,16,43,27,16,49,93,118,2
1387,Gregor Kobel,Stuttgart,33.0,2,2,2,0,0,2,2,100.0,0,0,0,0,2,4,8,1
1388,Robin Koch,Leeds United,12.6,27,16,17,10,0,10,19,52.6,9,18,12,6,27,54,34,2
1389,Giorgi Kochorashvili,Levante,0.3,1,0,1,0,0,0,0,0.0,0,0,0,0,0,1,0,0
1390,Kenan Kodro,Valladolid,5.1,0,0,0,0,0,0,2,0.0,2,2,1,1,2,2,6,0
1391,Kenan Kodro,Athletic Club,0.5,0,0,0,0,0,0,1,0.0,1,0,0,0,0,0,0,0
1392,Dominik Kohr,Mainz 05,14.1,47,31,14,26,7,20,39,51.3,19,18,5,13,27,74,15,0
1393,Dominik Kohr,Eint Frankfurt,2.9,11,7,0,7,4,4,9,44.4,5,5,1,4,9,20,9,0
1394,Koba Koindredi,Valencia,0.2,1,1,1,0,0,0,1,0.0,1,0,0,0,0,1,0,0
1395,Koke,Atlético Madrid,33.6,64,42,22,31,11,28,98,28.6,70,35,6,29,36,100,40,0
1396,Aleksandr Kokorin,Fiorentina,1.0,1,0,0,1,0,0,1,0.0,1,1,0,1,0,1,0,0
1397,Aleksandar Kolarov,Inter,4.3,4,4,0,4,0,1,2,50.0,1,2,0,2,7,11,8,0
1398,Sead Kolasinac,Arsenal,1.0,0,0,0,0,0,0,0,0.0,0,0,0,0,1,1,0,0
1399,Sead Kolasinac,Schalke 04,15.8,20,17,10,7,3,8,18,44.4,10,17,5,12,20,40,17,0
1400,Randal Kolo Muani,Nantes,33.7,22,14,1,13,8,7,27,25.9,20,15,2,13,8,30,26,0
1401,Timothee Kolodziejczak,Saint-Étienne,22.6,28,15,23,5,0,19,27,70.4,8,24,15,9,36,64,80,1
1402,Ghislain Konan,Reims,29.0,57,32,35,17,5,32,56,57.1,24,25,11,14,30,87,67,0
1404,Ibrahima Konate,RB Leipzig,7.7,6,4,2,3,1,2,8,25.0,6,6,3,3,8,14,24,0
1405,Moussa Konate,Dijon,13.3,5,3,1,2,2,2,11,18.2,9,4,1,3,5,10,8,0
1406,Geoffrey Kondogbia,Valencia,4.9,16,9,9,4,3,7,19,36.8,12,6,1,5,8,24,8,0
1407,Geoffrey Kondogbia,Atlético Madrid,6.8,30,20,12,16,2,11,20,55.0,9,11,5,6,11,41,8,1
1408,Lamine Kone,Strasbourg,11.6,9,6,5,4,0,5,8,62.5,3,4,3,1,15,24,36,0
1409,Moussa Kone,Nîmes,19.5,13,6,1,8,4,2,9,22.2,7,7,1,6,2,15,7,0
1410,Youssouf Kone,Elche,0.8,2,0,1,0,1,0,1,0.0,1,0,0,0,0,2,0,0
1411,Terence Kongolo,Fulham,1.0,3,2,1,2,0,1,1,100.0,0,0,0,0,2,5,3,0
1412,Ezri Konsa,Aston Villa,35.5,25,13,18,6,1,9,13,69.2,4,53,47,6,29,54,162,1
1413,Laurent Koscielny,Bordeaux,24.6,29,17,18,11,0,16,24,66.7,8,44,34,10,54,83,115,1
1414,Filip Kostic,Eint Frankfurt,28.2,54,31,22,23,9,22,54,40.7,32,43,6,37,26,80,28,2
1415,Mark Kosznovszky,Parma,1.0,2,2,1,1,0,1,4,25.0,3,2,0,2,1,3,1,0
1416,Christian Kouame,Fiorentina,11.1,9,4,2,4,3,4,12,33.3,8,9,1,8,5,14,4,0
1417,Kalidou Koulibaly,Napoli,24.5,36,24,25,7,4,19,32,59.4,13,46,26,20,29,65,64,2
1418,Jules Kounde,Sevilla,33.1,27,15,14,11,2,10,24,41.7,14,24,16,8,40,67,104,0
1419,Boubakar Kouyate,Metz,21.8,60,35,45,15,0,32,58,55.2,26,44,27,17,60,120,132,1
1420,Cheikhou Kouyate,Crystal Palace,34.7,58,37,44,12,2,25,43,58.1,18,42,26,16,32,90,125,2
1421,Mateo Kovacic,Chelsea,20.2,46,28,19,24,3,17,32,53.1,15,18,1,17,15,61,11,2
1422,Viktor Kovalenko,Atalanta,0.0,0,0,0,0,0,0,0,0.0,0,0,0,0,0,0,1,0
1423,Emil Krafth,Newcastle Utd,14.3,19,8,9,9,1,12,25,48.0,13,15,9,6,15,34,52,2
1424,Andrej Kramaric,Hoffenheim,26.4,7,4,4,0,3,3,8,37.5,5,8,1,7,7,14,5,1
1425,Christoph Kramer,M'Gladbach,22.6,55,37,22,28,5,28,58,48.3,30,32,11,21,34,89,39,0
1426,Jean-Philippe Krasso,Saint-Étienne,2.5,5,3,1,4,0,2,4,50.0,2,5,0,5,1,6,3,0
1427,Toni Kroos,Real Madrid,23.5,42,22,15,15,12,11,44,25.0,33,26,6,20,15,57,10,3
1428,Filip Krovinovic,West Brom,6.1,13,10,6,5,2,6,18,33.3,12,2,0,2,4,17,2,0
1430,Rade Krunic,Milan,8.0,15,12,6,6,3,7,17,41.2,10,12,2,10,10,25,9,0
1431,Max Kruse,Union Berlin,18.1,7,3,1,5,1,2,9,22.2,7,11,0,11,3,10,3,0
1432,Lukas Kubler,Freiburg,9.8,15,8,9,5,1,9,14,64.3,5,9,3,6,21,36,31,0
1433,Takefusa Kubo,Villarreal,3.3,1,1,0,0,1,1,5,20.0,4,2,0,2,1,2,2,0
1434,Takefusa Kubo,Getafe,8.9,7,4,2,3,2,1,14,7.1,13,14,0,14,14,21,4,0
1435,Juraj Kucka,Parma,25.9,67,36,21,37,9,26,74,35.1,48,25,3,22,28,95,25,0
1436,Kuki,Valladolid,0.3,1,1,0,0,1,0,1,0.0,1,0,0,0,0,1,0,0
1437,Dejan Kulusevski,Juventus,21.4,33,19,12,10,11,14,43,32.6,29,22,0,22,9,42,2,1
1438,Marash Kumbulla,Roma,15.1,16,11,8,7,1,5,17,29.4,12,12,5,7,24,40,38,1
1439,Pierre Kunde,Mainz 05,5.7,8,4,1,5,2,2,9,22.2,7,6,0,6,10,18,9,0
1440,Fabian Kunze,Arminia,14.1,38,26,19,15,4,19,42,45.2,23,19,3,16,18,56,22,1
1441,Jasmin Kurtic,Parma,30.4,46,28,22,21,3,21,70,30.0,49,22,2,20,33,79,57,1
1442,Layvin Kurzawa,Paris S-G,14.2,26,19,10,10,6,9,28,32.1,19,20,5,15,28,54,26,1
1443,Dereck Kutesa,Reims,7.6,15,7,7,3,5,5,14,35.7,9,7,1,6,7,22,3,0
1444,Ahmed Kutucu,Schalke 04,1.2,1,0,0,0,1,1,2,50.0,1,1,0,1,0,1,0,0
1445,Enock Kwateng,Bordeaux,11.5,21,12,15,4,2,14,27,51.9,13,15,3,12,26,47,27,0
1446,Giorgos Kyriakopoulos,Sassuolo,16.2,35,18,17,12,6,8,28,28.6,20,16,5,11,15,50,42,0
1447,Antonino La Gumina,Sampdoria,3.8,3,2,0,1,2,0,3,0.0,3,5,1,4,3,6,5,0
1448,Gaetan Laborde,Montpellier,36.2,43,22,21,17,5,16,60,26.7,44,29,3,26,16,59,25,1
1449,Alexandre Lacazette,Arsenal,21.4,18,10,4,11,3,4,22,18.2,18,20,1,19,12,30,13,0
1450,Tom Lacoux,Bordeaux,5.8,22,14,10,11,1,9,21,42.9,12,12,3,9,12,34,7,0
1451,Maxence Lacroix,Wolfsburg,28.8,49,29,37,12,0,24,45,53.3,21,51,21,30,65,114,140,1
1452,Alban Lafont,Nantes,38.0,1,0,1,0,0,1,1,100.0,0,1,0,1,0,1,14,0
1453,Victor Laguardia,Alavés,29.2,20,12,13,6,1,14,31,45.2,17,25,13,12,37,57,104,0
1454,Konrad Laimer,RB Leipzig,0.9,2,0,0,1,1,0,4,0.0,4,2,0,2,1,3,0,0
1456,Stefan Lainer,M'Gladbach,30.8,62,37,30,22,10,27,60,45.0,33,34,5,29,35,97,85,1
1457,Diego Lainez,Betis,9.6,9,4,3,5,1,6,16,37.5,10,15,0,15,11,20,6,0
1458,Kenny Lala,Strasbourg,20.4,22,13,13,8,1,11,22,50.0,11,12,6,6,23,45,33,1
1459,Adam Lallana,Brighton,17.7,28,13,11,13,4,8,39,20.5,31,18,3,15,15,43,13,0
1460,Erik Lamela,Tottenham,8.0,17,9,1,11,5,8,21,38.1,13,11,1,10,6,23,2,0
1461,Sam Lammers,Atalanta,3.2,2,0,0,2,0,0,6,0.0,6,0,0,0,0,2,3,0
1462,Tariq Lamptey,Brighton,9.8,17,9,7,6,4,6,13,46.2,7,8,1,7,19,36,12,1
1463,Loick Landre,Nîmes,18.1,14,7,9,5,0,13,28,46.4,15,22,19,3,31,45,52,0
1464,Michael Langer,Schalke 04,2.7,0,0,0,0,0,0,0,0.0,0,0,0,0,0,0,3,0
1465,Manuel Lanzini,West Ham,6.3,9,2,3,4,2,3,10,30.0,7,9,0,9,7,16,5,0
1466,Gianluca Lapadula,Benevento,28.5,22,12,3,13,6,6,25,24.0,19,18,3,15,5,27,16,0
1467,Aymeric Laporte,Manchester City,14.9,13,6,10,3,0,7,11,63.6,4,12,7,5,11,24,28,0
1468,Julien Laporte,Lorient,29.5,65,39,48,16,1,42,74,56.8,32,34,23,11,65,130,125,0
1469,Danilo Larangeira,Bologna,34.8,33,24,23,10,0,8,29,27.6,21,58,36,22,51,84,127,2
1470,Gautier Larsonneur,Brest,35.0,1,1,1,0,0,1,1,100.0,0,2,0,2,0,1,16,3
1471,Kevin Lasagna,Udinese,12.3,6,1,2,3,1,3,14,21.4,11,11,0,11,6,12,7,0
1472,Kevin Lasagna,Hellas Verona,14.1,7,3,0,5,2,1,5,20.0,4,12,1,11,1,8,11,0
1473,Jamaal Lascelles,Newcastle Utd,18.1,14,7,5,9,0,3,6,50.0,3,27,17,10,12,26,86,0
1474,Paul Lasne,Brest,18.7,46,26,25,19,2,17,40,42.5,23,25,5,20,47,93,17,2
1475,Toni Lato,Valencia,8.1,13,6,7,3,3,6,13,46.2,7,12,1,11,10,23,21,0
1476,Danny Latza,Mainz 05,20.0,43,26,12,19,12,23,70,32.9,47,39,3,36,27,70,23,0
1477,Armand Lauriente,Lorient,18.0,30,10,10,19,1,7,26,26.9,19,21,0,21,15,45,4,0
1478,Vincent Laurini,Parma,9.7,16,11,8,6,2,7,9,77.8,2,8,4,4,17,33,22,1
1479,Lauti,Celta Vigo,0.2,0,0,0,0,0,0,0,0.0,0,0,0,0,0,0,1,0
1480,Wesley Lautoa,Dijon,17.9,36,20,20,13,3,11,37,29.7,26,17,8,9,29,65,33,1
1482,Valentino Lazaro,M'Gladbach,13.8,17,11,7,5,5,12,19,63.2,7,18,1,17,15,32,20,0
1483,Darko Lazovic,Hellas Verona,27.8,29,17,8,17,4,20,42,47.6,22,17,7,10,20,49,29,0
1484,Manuel Lazzari,Lazio,29.0,24,14,15,4,5,14,39,35.9,25,22,3,19,18,42,28,0
1485,Jeremy Le Douaron,Brest,9.1,15,10,9,4,2,7,21,33.3,14,14,1,13,8,23,11,0
1486,Enzo Le Fee,Lorient,20.2,51,28,23,23,5,27,73,37.0,46,30,6,24,25,76,10,0
1487,Vincent Le Goff,Lorient,25.6,42,29,16,24,2,18,49,36.7,31,27,5,22,44,86,44,0
1488,Maxime Le Marchand,Fulham,1.4,2,2,2,0,0,2,2,100.0,0,0,0,0,0,2,3,0
1489,Robin Le Normand,Real Sociedad,30.5,34,20,25,8,1,9,19,47.4,10,35,24,11,36,70,87,1
1490,Damien Le Tallec,Montpellier,13.6,16,10,10,4,2,10,30,33.3,20,15,8,7,25,41,21,2
1491,James Lea Siliki,Rennes,2.8,5,2,1,3,1,2,2,100.0,0,3,0,3,1,6,1,1
1492,Rafael Leao,Milan,21.4,13,6,4,7,2,6,15,40.0,9,17,0,17,4,17,14,1
1493,Jean-Louis Leca,Lens,36.8,3,2,3,0,0,3,5,60.0,2,0,0,0,1,4,14,4
1494,Mathew Leckie,Hertha BSC,5.6,12,3,5,5,2,4,11,36.4,7,8,0,8,13,25,9,0
1495,Benjamin Lecomte,Monaco,28.0,0,0,0,0,0,0,2,0.0,2,1,0,1,2,2,20,1
1496,Jeremias Ledesma,Cádiz,32.0,1,0,1,0,0,1,1,100.0,0,1,0,1,0,1,22,6
1497,Pierre Lees-Melou,Nice,22.9,67,39,33,31,3,25,83,30.1,58,50,14,36,29,96,31,1
1498,Lucas Leiva,Lazio,23.7,68,32,38,28,2,30,86,34.9,56,21,0,21,57,125,21,0
1499,Florian Lejeune,Alavés,33.5,43,32,36,7,0,21,35,60.0,14,38,24,14,51,94,149,1
1500,Inigo Lekue,Athletic Club,7.2,9,7,6,3,0,3,8,37.5,5,8,1,7,4,13,24,0
1501,Thomas Lemar,Atlético Madrid,15.2,30,17,9,17,4,11,24,45.8,13,22,1,21,11,41,10,0
1502,Mario Lemina,Fulham,18.9,62,35,25,30,7,23,44,52.3,21,26,5,21,30,92,21,0
1503,Fabien Lemoine,Lorient,21.5,74,45,39,33,2,36,89,40.4,53,25,1,24,27,101,35,0
1504,Clement Lenglet,Barcelona,27.5,36,21,23,10,3,19,28,67.9,9,26,12,14,33,69,71,1
1505,Bernd Leno,Arsenal,34.8,1,0,1,0,0,1,1,100.0,0,1,0,1,0,1,11,2
1506,Christopher Lenz,Union Berlin,25.0,74,41,39,30,5,35,71,49.3,36,34,5,29,35,109,50,0
1508,Pedro Leon,Eibar,10.4,9,8,3,3,3,3,17,17.6,14,11,0,11,7,16,2,0
1509,Sergio Leon,Levante,8.3,6,2,0,4,2,2,8,25.0,6,4,0,4,3,9,2,0
1510,Lukas Lerager,Genoa,12.9,24,13,14,9,1,11,30,36.7,19,13,3,10,14,38,25,1
1511,Mehdi Leris,Sampdoria,4.3,11,5,6,4,1,6,16,37.5,10,12,2,10,12,23,15,0
1512,Khanya Leshabela,Leicester City,0.1,0,0,0,0,0,0,0,0.0,0,0,0,0,0,0,0,0
1513,Karlo Letica,Sampdoria,1.0,0,0,0,0,0,0,0,0.0,0,0,0,0,0,0,2,0
1514,Gaetano Letizia,Benevento,17.4,36,25,19,13,4,17,36,47.2,19,15,3,12,20,56,42,1
1515,Robert Lewandowski,Bayern Munich,27.3,15,9,0,7,8,2,13,15.4,11,9,1,8,3,18,11,0
1516,Jamal Lewis,Newcastle Utd,20.4,37,20,23,13,1,16,38,42.1,22,21,7,14,11,48,44,1
1517,Aaron Leya Iseka,Metz,11.2,6,4,2,3,1,0,4,0.0,4,4,2,2,0,6,6,0
1518,Yanis Lhery,Saint-Étienne,0.3,0,0,0,0,0,0,0,0.0,0,0,0,0,0,0,0,0
1519,Dimitri Lienard,Strasbourg,20.3,39,27,17,19,3,24,55,43.6,31,23,1,22,18,57,10,0
1520,Philipp Lienhart,Freiburg,33.3,21,13,12,7,2,9,20,45.0,11,30,21,9,42,63,100,0
1521,Matthijs de Ligt,Juventus,24.7,37,19,20,16,1,18,28,64.3,10,42,21,21,31,68,64,0
1522,Isaac Lihadji,Lille,2.2,11,4,2,6,3,4,5,80.0,1,5,1,4,1,12,0,1
1523,Dimitris Limnios,Köln,4.2,9,6,3,5,1,5,6,83.3,1,5,0,5,2,11,1,0
1524,Victor Lindelof,Manchester Utd,28.7,22,10,12,10,0,12,24,50.0,12,22,14,8,30,52,95,1
1525,Karol Linetty,Torino,20.4,38,28,13,19,6,16,45,35.6,29,19,5,14,15,53,7,0
1526,Jesse Lingard,West Ham,15.8,12,6,4,8,0,5,14,35.7,9,7,1,6,4,16,0,0
1527,Pol Lirola,Fiorentina,5.5,13,8,8,2,3,6,12,50.0,6,6,3,3,6,19,9,0
1528,Pol Lirola,Marseille,17.3,28,16,11,15,2,16,28,57.1,12,18,5,13,25,53,26,0
1529,Jake Livermore,West Brom,13.8,33,18,14,16,3,14,31,45.2,17,21,6,15,16,49,26,0
1530,Diego Llorente,Leeds United,13.4,34,21,21,13,0,19,32,59.4,13,18,13,5,20,54,40,2
1531,Diego Llorente,Real Sociedad,1.0,1,0,1,0,0,1,2,50.0,1,1,1,0,2,3,5,0
1532,Fernando Llorente,Udinese,7.9,4,1,2,2,0,2,5,40.0,3,3,0,3,2,6,17,0
1534,Fernando Llorente,Napoli,0.6,0,0,0,0,0,0,0,0.0,0,0,0,0,0,0,0,0
1535,Marcos Llorente,Atlético Madrid,32.8,71,42,21,40,10,26,62,41.9,36,40,3,37,29,100,28,0
1536,Hugo Lloris,Tottenham,38.0,0,0,0,0,0,0,1,0.0,1,0,0,0,0,0,10,1
1537,Giovani Lo Celso,Tottenham,10.5,28,22,12,11,5,10,29,34.5,19,12,1,11,7,35,5,0
1538,Stanislav Lobotka,Napoli,1.7,1,1,0,1,0,0,1,0.0,1,1,1,0,0,1,1,1
1539,Manuel Locatelli,Sassuolo,32.0,81,47,43,28,10,29,56,51.8,27,35,15,20,51,132,65,1
1540,Renan Lodi,Atlético Madrid,12.5,30,17,13,12,5,17,26,65.4,9,15,0,15,16,46,18,0
1541,Ruben Loftus-Cheek,Chelsea,0.7,0,0,0,0,0,0,0,0.0,0,0,0,0,0,0,0,0
1542,Ruben Loftus-Cheek,Fulham,21.2,25,14,7,15,3,7,23,30.4,16,20,2,18,7,32,18,0
1543,Niklas Lomb,Leverkusen,1.5,0,0,0,0,0,0,0,0.0,0,0,0,0,0,0,0,2
1544,Kevin Long,Burnley,7.1,11,6,9,2,0,7,9,77.8,2,11,7,4,6,17,24,0
1545,Shane Long,Southampton,2.3,2,1,0,0,2,2,3,66.7,1,0,0,0,3,5,1,0
1546,Matthew Longstaff,Newcastle Utd,4.2,3,2,2,1,0,2,8,25.0,6,7,0,7,7,10,2,0
1547,Sean Longstaff,Newcastle Utd,15.7,31,14,13,15,3,18,42,42.9,24,26,5,21,19,50,14,2
1548,Ademola Lookman,Fulham,30.5,35,11,18,9,8,13,44,29.5,31,31,1,30,20,55,9,0
1549,Anthony Lopes,Lyon,38.0,1,1,1,0,0,1,2,50.0,1,1,0,1,1,2,20,1
1550,Rony Lopes,Nice,19.8,20,14,4,13,3,6,27,22.2,21,14,3,11,8,28,6,0
1551,Adrian Lopez,Osasuna,5.3,3,3,0,1,2,1,5,20.0,4,3,0,3,0,3,3,0
1552,Javi Lopez,Alavés,2.8,5,5,3,2,0,2,3,66.7,1,2,0,2,3,8,3,1
1553,Maxime Lopez,Sassuolo,20.7,24,13,15,6,3,14,41,34.1,27,9,0,9,16,40,10,1
1554,Maxime Lopez,Marseille,1.5,1,1,1,0,0,0,2,0.0,2,0,0,0,2,3,2,0
1555,Pedro Lopez Munoz,Huesca,11.9,23,15,10,8,5,15,22,68.2,7,10,4,6,16,39,23,1
1556,Pau Lopez,Roma,20.2,2,0,2,0,0,2,2,100.0,0,1,0,1,0,2,7,4
1557,Roberto Lopez,Real Sociedad,5.6,5,1,1,2,2,2,5,40.0,3,2,0,2,4,9,6,0
1558,Unai Lopez,Athletic Club,15.8,27,17,13,13,1,10,29,34.5,19,20,5,15,18,45,9,1
1560,Dion Lopy,Reims,2.8,1,1,0,1,0,0,0,0.0,0,0,0,0,2,3,1,0
1561,Jordan Lotomba,Nice,23.6,35,25,19,11,5,20,34,58.8,14,19,7,12,33,68,52,1
1562,Adrien Louveau,Lens,0.1,0,0,0,0,0,0,0,0.0,0,0,0,0,0,0,1,0
1563,Imran Louza,Nantes,26.4,55,28,25,26,4,21,69,30.4,48,20,4,16,33,88,15,2
1564,Matteo Lovato,Hellas Verona,15.4,21,12,14,5,2,10,21,47.6,11,20,10,10,37,58,48,1
1565,Max Lowe,Sheffield Utd,6.1,26,11,18,6,2,9,21,42.9,12,12,4,8,5,31,11,0
1566,Eduard Lowen,Hertha BSC,0.9,5,1,3,1,1,2,5,40.0,3,1,0,1,1,6,1,0
1567,Matthew Lowton,Burnley,34.0,54,32,31,22,1,32,73,43.8,41,36,13,23,56,110,91,1
1568,Anthony Lozano,Cádiz,16.9,12,4,1,5,6,2,13,15.4,11,3,1,2,3,15,8,0
1569,Hirving Lozano,Napoli,21.8,29,18,10,13,6,10,36,27.8,26,37,1,36,18,47,14,0
1570,Jan Luca Schuler,Schalke 04,0.4,2,2,1,1,0,0,1,0.0,1,1,0,1,0,2,0,0
1571,Jean Lucas,Lyon,1.9,3,2,2,1,0,1,4,25.0,3,3,1,2,2,5,1,0
1572,Jean Lucas,Brest,11.2,19,13,10,9,0,8,29,27.6,21,7,0,7,8,27,10,1
1573,Anderson Lucoqui,Arminia,17.8,40,25,23,17,0,20,40,50.0,20,30,7,23,27,67,53,0
1574,Jeison Lucumi,Elche,0.5,1,1,0,1,0,0,0,0.0,0,1,0,1,0,1,0,0
1575,Kilian Ludewig,Schalke 04,5.8,16,6,10,5,1,8,25,32.0,17,7,0,7,3,19,14,0
1576,Florentino Luis,Monaco,2.7,7,2,4,2,1,6,10,60.0,4,1,0,1,6,13,2,1
1577,Jose Luis Gaya,Valencia,31.6,59,33,40,13,6,33,68,48.5,35,22,3,19,38,97,62,1
1578,Jose Luis Morales,Levante,27.1,18,10,7,9,2,8,36,22.2,28,17,0,17,11,29,11,0
1579,Jose Luis Palomino,Atalanta,27.0,67,33,41,19,7,24,48,50.0,24,30,16,14,79,146,60,2
1580,Luisinho,Huesca,2.0,3,3,2,1,0,1,3,33.3,2,3,0,3,4,7,7,0
1581,Luismi,Elche,1.9,4,2,1,3,0,1,2,50.0,1,2,0,2,4,8,0,0
1582,David Luiz,Arsenal,15.5,12,9,5,7,0,4,4,100.0,0,16,9,7,16,28,50,2
1583,Douglas Luiz,Aston Villa,30.9,49,18,22,26,1,20,58,34.5,38,52,17,35,43,92,44,2
1584,Romelu Lukaku,Inter,32.0,11,1,1,6,4,6,14,42.9,8,11,1,10,3,14,34,0
1586,Dodi Lukebakio,Hertha BSC,20.6,21,14,13,5,3,9,20,45.0,11,14,1,13,12,33,8,0
1587,Sasa Lukic,Torino,23.4,32,13,11,18,3,15,50,30.0,35,23,5,18,17,49,17,0
1588,Senad Lulic,Lazio,8.0,14,7,6,5,3,7,15,46.7,8,10,1,9,4,18,13,0
1589,John Lundstram,Sheffield Utd,22.6,25,16,12,11,2,13,47,27.7,34,26,8,18,14,39,29,1
1590,Sebastiano Luperto,Crotone,20.9,38,20,28,8,2,16,27,59.3,11,17,7,10,27,65,74,1
1591,Andreas Luthe,Union Berlin,30.8,1,1,1,0,0,1,3,33.3,2,1,0,1,0,1,8,3
1592,Lyanco,Torino,21.8,21,14,13,6,2,8,14,57.1,6,36,26,10,46,67,76,0
1593,Charalambos Lykogiannis,Cagliari,26.9,34,21,22,9,3,22,38,57.9,16,34,13,21,32,66,94,0
1594,Yann M'Vila,Saint-Étienne,0.2,0,0,0,0,0,0,2,0.0,2,0,0,0,1,1,0,0
1595,Alexis Mac Allister,Brighton,12.4,26,12,6,16,4,11,38,28.9,27,25,4,21,9,35,4,0
1596,Darwin Machis,Granada,22.5,30,17,12,10,8,6,19,31.6,13,21,2,19,22,52,13,0
1597,Tim Maciejewski,Union Berlin,0.1,0,0,0,0,0,0,0,0.0,0,0,0,0,0,0,0,0
1598,Luca Mack,Stuttgart,0.1,0,0,0,0,0,0,0,0.0,0,0,0,0,0,0,1,0
1599,Yvann Macon,Saint-Étienne,6.0,30,20,20,8,2,7,19,36.8,12,6,2,4,9,39,13,0
1600,James Maddison,Leicester City,23.3,32,16,5,16,11,14,41,34.1,27,14,1,13,9,41,5,0
1601,Mikail Maden,Schalke 04,0.1,0,0,0,0,0,0,0,0.0,0,0,0,0,0,0,0,0
1602,Pablo Maffeo,Huesca,21.8,26,17,21,4,1,12,26,46.2,14,18,6,12,35,61,27,0
1603,Lisandro Magallan,Crotone,24.2,54,31,28,24,2,17,42,40.5,25,29,15,14,44,98,78,1
1604,Christian Maggio,Benevento,3.3,9,4,2,7,0,3,9,33.3,6,4,1,3,2,11,6,0
1605,Giulio Maggiore,Spezia,24.6,61,36,26,28,7,21,53,39.6,32,33,6,27,19,80,25,1
1606,Francesco Magnanelli,Sassuolo,4.9,7,5,2,5,0,3,10,30.0,7,6,2,4,13,20,10,0
1607,Giangiacomo Magnani,Hellas Verona,16.8,26,15,14,9,3,9,16,56.3,7,25,16,9,44,70,105,1
1608,Hugo Magnetti,Brest,6.7,24,12,10,13,1,20,40,50.0,20,6,1,5,14,38,8,0
1609,Harry Maguire,Manchester Utd,33.9,29,17,19,10,0,18,29,62.1,11,28,23,5,60,89,122,4
1610,Abdallahi Mahmoud,Alavés,0.7,2,2,1,1,0,0,1,0.0,1,0,0,0,1,3,0,0
1612,Hicham Mahou,Nice,0.4,1,1,1,0,0,1,2,50.0,1,2,0,2,1,2,0,0
1613,Riyad Mahrez,Manchester City,21.7,20,5,2,10,8,6,30,20.0,24,19,0,19,8,28,4,0
1614,Arne Maier,Arminia,11.5,13,9,5,7,1,4,11,36.4,7,10,3,7,8,21,11,1
1615,Arne Maier,Hertha BSC,0.3,1,1,0,1,0,0,1,0.0,1,0,0,0,0,1,0,0
1616,Habib Maiga,Metz,29.9,81,52,36,40,5,42,85,49.4,43,37,6,31,49,130,36,0
1617,Mike Maignan,Lille,38.0,0,0,0,0,0,0,0,0.0,0,0,0,0,0,0,7,2
1618,Ainsley Maitland-Niles,Arsenal,5.4,11,7,6,5,0,8,12,66.7,4,12,2,10,14,25,7,1
1619,Ainsley Maitland-Niles,West Brom,13.7,22,10,7,8,7,9,28,32.1,19,12,1,11,17,39,24,0
1620,Josh Maja,Fulham,9.0,7,4,0,3,4,4,10,40.0,6,3,1,2,4,11,1,0
1621,Josh Maja,Bordeaux,8.9,8,2,3,3,2,3,14,21.4,11,3,0,3,6,14,9,0
1622,Radoslaw Majecki,Monaco,1.0,0,0,0,0,0,0,0,0.0,0,0,0,0,0,0,1,0
1623,Abdul Majeed Waris,Strasbourg,6.1,1,1,1,0,0,1,6,16.7,5,0,0,0,2,3,2,0
1624,Marco Majouga,Nîmes,1.4,1,1,1,0,0,1,3,33.3,2,0,0,0,0,1,0,0
1625,Jean-Victor Makengo,Udinese,5.8,8,7,5,3,0,3,13,23.1,10,7,1,6,5,13,7,0
1626,Nemanja Maksimovic,Getafe,30.3,50,28,22,24,4,19,46,41.3,27,40,9,31,57,107,46,1
1627,Nikola Maksimovic,Napoli,13.4,18,9,11,6,1,9,18,50.0,9,15,6,9,21,39,49,3
1628,Filip Malbasic,Cádiz,9.6,12,7,4,5,3,6,18,33.3,12,10,0,10,4,16,2,0
1629,Kevin Malcuit,Fiorentina,2.3,5,3,2,2,1,0,1,0.0,1,5,0,5,3,8,6,0
1630,Kevin Malcuit,Napoli,0.4,2,1,2,0,0,0,1,0.0,1,0,0,0,2,4,2,0
1631,Daniel Maldini,Milan,0.3,1,0,0,1,0,0,2,0.0,2,0,0,0,0,1,0,0
1632,Ruslan Malinovskyi,Atalanta,20.8,19,8,2,13,4,8,23,34.8,15,16,1,15,2,21,4,0
1633,Yunus Malli,Wolfsburg,0.6,1,0,0,1,0,1,1,100.0,0,0,0,0,0,1,0,0
1634,Hugo Mallo,Celta Vigo,28.9,58,40,34,23,1,24,52,46.2,28,42,11,31,37,95,77,0
1635,Mickael Malsa,Levante,26.0,55,26,28,24,3,23,51,45.1,28,38,9,29,43,98,36,2
1636,Dennis Man,Parma,7.8,12,6,6,4,2,6,21,28.6,15,5,0,5,2,14,6,0
1638,Hianga Mananga Mbock,Brest,5.1,4,3,2,2,0,2,9,22.2,7,2,0,2,3,7,6,0
1639,Vincent Manceau,Angers,25.7,42,27,23,17,2,30,63,47.6,33,23,2,21,35,77,61,0
1640,Gianluca Mancini,Roma,31.7,50,29,29,19,2,18,31,58.1,13,38,18,20,72,122,77,3
1641,Steve Mandanda,Marseille,37.0,0,0,0,0,0,0,1,0.0,1,0,0,0,2,2,8,6
1642,Reinildo Mandava,Lille,24.2,79,43,39,32,8,35,58,60.3,23,26,3,23,45,124,53,0
1643,Aissa Mandi,Betis,26.6,30,17,20,10,0,10,16,62.5,6,21,13,8,39,69,90,0
1644,Rolando Mandragora,Udinese,4.4,8,5,3,4,1,3,10,30.0,7,10,3,7,6,14,5,0
1645,Rolando Mandragora,Torino,16.9,19,4,4,9,6,7,30,23.3,23,19,6,13,20,39,19,0
1646,Mario Mandzukic,Milan,2.4,7,6,2,4,1,2,3,66.7,1,0,0,0,2,9,3,0
1647,Sadio Mane,Liverpool,31.2,48,30,6,22,20,12,33,36.4,21,30,0,30,15,63,11,0
1648,Niccolo Manfredini,Benevento,1.0,0,0,0,0,0,0,0,0.0,0,0,0,0,0,0,2,1
1649,Eliaquim Mangala,Valencia,3.6,0,0,0,0,0,0,1,0.0,1,8,6,2,6,6,12,0
1650,Orel Mangala,Stuttgart,23.4,27,15,13,11,3,17,28,60.7,11,27,10,17,26,53,30,0
1651,Thomas Mangani,Angers,29.9,54,37,25,26,3,30,90,33.3,60,31,8,23,38,92,39,0
1652,Vito Mannone,Monaco,9.0,0,0,0,0,0,0,0,0.0,0,0,0,0,0,0,3,1
1653,Kostas Manolas,Napoli,25.5,31,18,24,7,0,17,24,70.8,7,22,13,9,23,54,82,2
1654,Javier Manquillo,Newcastle Utd,9.2,24,14,8,14,2,11,17,64.7,6,8,1,7,9,33,15,1
1655,Juan Manuel Ramos,Spezia,3.3,5,0,3,0,2,4,7,57.1,3,1,0,1,2,7,6,0
1656,Myziane Maolida,Nice,12.0,13,8,4,4,5,4,11,36.4,7,6,1,5,6,19,4,0
1657,Faitout Maouassa,Rennes,13.0,20,11,10,8,2,11,19,57.9,8,9,1,8,17,37,36,0
1658,Sekou Mara,Bordeaux,2.5,5,3,1,3,1,2,10,20.0,8,0,0,0,1,6,1,0
1659,Fernando Marcal,Wolves,6.9,13,5,6,7,0,6,11,54.5,5,11,2,9,12,25,25,0
1660,Fernando Marcal,Lyon,0.9,1,0,0,1,0,0,0,0.0,0,0,0,0,2,3,0,0
1661,Marcelo,Real Madrid,11.7,25,21,11,6,8,11,24,45.8,13,13,1,12,10,35,15,0
1662,Marcelo,Lyon,32.3,44,29,30,12,2,26,37,70.3,11,35,25,10,49,93,122,2
1664,Solly March,Brighton,18.6,49,23,24,15,10,18,34,52.9,16,30,5,25,22,71,30,0
1665,Federico Marchetti,Genoa,3.7,1,0,1,0,0,1,1,100.0,0,0,0,0,0,1,2,1
1666,Riccardo Marchizza,Spezia,17.3,20,11,12,5,3,12,21,57.1,9,13,4,9,11,31,27,0
1667,Gian Marco Ferrari,Sassuolo,33.5,32,20,15,14,3,10,23,43.5,13,46,37,9,50,82,100,1
1668,Ivan Marcone,Elche,29.4,64,41,42,17,5,35,84,41.7,49,27,8,19,36,100,33,3
1669,Oscar de Marcos,Athletic Club,16.9,28,17,12,10,6,10,25,40.0,15,12,1,11,12,40,38,0
1670,Dario Maresic,Reims,5.7,12,7,8,4,0,8,14,57.1,6,7,2,5,10,22,17,1
1671,Jose Mari,Cádiz,16.1,32,17,13,18,1,14,31,45.2,17,16,7,9,27,59,33,1
1672,Pablo Mari,Arsenal,10.0,15,9,12,3,0,5,10,50.0,5,8,7,1,9,24,30,2
1673,Jose Maria Gimenez,Atlético Madrid,19.6,20,7,14,5,1,12,17,70.6,5,17,11,6,21,41,65,0
1674,Mariano,Real Madrid,5.7,4,2,2,1,1,0,9,0.0,9,3,1,2,0,4,3,0
1675,Jordan Marie,Dijon,15.9,34,17,9,23,2,23,56,41.1,33,14,5,9,23,57,12,2
1676,Adrian Marin,Alavés,1.0,1,1,0,1,0,0,2,0.0,2,1,0,1,2,3,2,0
1677,Adrian Marin,Granada,3.0,5,2,1,3,1,2,3,66.7,1,5,2,3,4,9,9,0
1678,Razvan Marin,Cagliari,32.9,54,33,26,22,6,27,53,50.9,26,29,10,19,29,83,15,0
1679,Guillermo Maripan,Monaco,23.2,26,11,17,9,0,15,27,55.6,12,18,11,7,27,53,66,1
1680,Marlon,Sassuolo,19.4,19,13,13,6,0,13,18,72.2,5,23,17,6,27,46,44,2
1681,Omar Marmoush,Wolfsburg,0.0,0,0,0,0,0,0,0,0.0,0,0,0,0,0,0,0,0
1682,Marquinhos,Paris S-G,23.6,27,21,14,10,3,15,26,57.7,11,21,9,12,27,54,75,2
1683,Luca Marrone,Crotone,17.6,25,18,16,9,0,13,21,61.9,8,22,11,11,26,51,56,1
1684,Roger Marti,Levante,24.4,11,7,5,4,2,6,23,26.1,17,10,3,7,4,15,6,0
1685,Anthony Martial,Manchester Utd,16.4,2,1,1,1,0,0,10,0.0,10,17,3,14,1,3,8,0
1686,Aaron Martin,Celta Vigo,17.1,34,20,15,16,3,10,33,30.3,23,15,4,11,13,47,37,0
1687,Aaron Martin,Mainz 05,2.9,3,2,2,1,0,2,4,50.0,2,1,0,1,2,5,2,0
1688,Alex Martin,Cádiz,1.1,2,0,1,1,0,2,4,50.0,2,1,1,0,0,2,6,0
1690,Jonas Martin,Rennes,5.4,11,9,5,4,2,5,14,35.7,9,11,2,9,13,24,2,1
1691,Gabriel Martinelli,Arsenal,6.5,7,1,2,3,2,4,10,40.0,6,6,0,6,8,15,4,0
1692,Emiliano Martinez,Aston Villa,38.0,3,3,3,0,0,3,4,75.0,1,0,0,0,2,5,10,2
1693,Inigo Martinez,Athletic Club,28.0,22,15,16,6,0,9,27,33.3,18,17,7,10,28,50,96,0
1694,Javi Martinez,Osasuna,5.1,9,4,1,6,2,5,12,41.7,7,9,0,9,5,14,4,0
1695,Javi Martinez,Bayern Munich,5.2,10,5,4,4,2,7,9,77.8,2,8,4,4,13,23,19,0
1696,Josep Martinez,RB Leipzig,1.0,0,0,0,0,0,0,0,0.0,0,0,0,0,0,0,0,0
1697,Lautaro Martinez,Inter,28.5,25,12,5,11,9,7,24,29.2,17,31,1,30,27,52,16,0
1698,Pablo Martinez,Nîmes,6.0,10,7,7,3,0,7,7,100.0,0,6,4,2,11,21,28,0
1699,Lucas Martinez Quarta,Fiorentina,16.5,32,20,17,11,4,18,41,43.9,23,27,9,18,39,71,48,0
1700,Gelson Martins,Monaco,17.2,41,26,12,16,13,15,37,40.5,22,20,0,20,13,54,8,0
1701,Adam Marusic,Lazio,33.0,38,22,22,15,1,20,40,50.0,20,38,6,32,40,78,54,0
1702,Sylvain Marveaux,Lorient,2.2,6,3,1,4,1,3,3,100.0,0,2,0,2,1,7,2,0
1703,Marvin,Real Madrid,1.5,3,2,0,3,0,1,2,50.0,1,1,0,1,2,5,3,0
1704,Omar Mascarell,Schalke 04,19.6,41,24,15,19,7,21,54,38.9,33,40,14,26,37,78,32,1
1705,Andrea Masiello,Genoa,28.5,38,22,29,6,3,23,48,47.9,25,32,13,19,53,91,107,3
1706,Jordi Masip,Valladolid,25.0,0,0,0,0,0,0,2,0.0,2,2,0,2,2,2,8,1
1707,Roberto Massimo,Stuttgart,8.4,21,11,13,5,3,11,24,45.8,13,5,1,4,11,32,13,0
1708,Giuseppe Mastinu,Spezia,0.4,1,1,0,0,1,1,1,100.0,0,1,0,1,0,1,0,0
1709,Arthur Masuaku,West Ham,11.2,20,12,14,6,0,11,34,32.4,23,12,0,12,8,28,28,2
1710,Jaime Mata,Getafe,22.6,12,7,1,3,8,3,18,16.7,15,13,2,11,6,18,16,0
1711,Juan Mata,Manchester Utd,5.7,1,0,1,0,0,0,7,0.0,7,3,0,3,3,4,3,0
1712,Pape Matar Sarr,Metz,17.7,45,29,19,21,5,20,38,52.6,18,24,4,20,27,72,16,0
1713,Eliot Matazo,Monaco,3.5,11,5,6,5,0,3,7,42.9,4,1,0,1,1,12,2,0
1714,Jean-Philippe Mateta,Crystal Palace,2.5,1,1,0,1,0,1,3,33.3,2,1,0,1,0,1,2,0
1716,Jean-Philippe Mateta,Mainz 05,11.1,6,3,1,3,2,0,3,0.0,3,3,1,2,4,10,6,0
1717,Nemanja Matic,Manchester Utd,12.3,25,11,13,12,0,13,31,41.9,18,19,5,14,22,47,10,3
1718,Joel Matip,Liverpool,7.7,14,9,7,7,0,7,8,87.5,1,6,0,6,7,21,22,0
1719,Rabbi Matondo,Schalke 04,2.4,3,2,0,3,0,2,3,66.7,1,1,0,1,1,4,1,0
1720,Ryder Matos,Udinese,0.1,0,0,0,0,0,0,0,0.0,0,0,0,0,0,0,0,0
1721,Henning Matriciani,Schalke 04,0.3,1,1,1,0,0,1,1,100.0,0,1,0,1,0,1,1,0
1722,Chrislain Matsima,Monaco,3.9,5,4,3,2,0,4,7,57.1,3,3,0,3,4,9,12,0
1723,Federico Mattiello,Spezia,0.4,0,0,0,0,0,0,0,0.0,0,0,0,0,0,0,0,0
1724,Neal Maupay,Brighton,27.9,20,8,9,7,4,4,24,16.7,20,20,0,20,13,33,6,0
1725,Tony Mauricio,Lens,5.6,19,12,7,8,4,11,17,64.7,6,8,1,7,3,22,4,0
1726,Stephy Mavididi,Montpellier,22.6,18,5,7,10,1,8,23,34.8,15,12,0,12,14,32,6,0
1727,Konstantinos Mavropanos,Stuttgart,16.3,42,29,29,12,1,27,46,58.7,19,25,10,15,59,101,66,1
1728,Eric Maxim Choupo-Moting,Bayern Munich,9.1,8,2,0,5,3,1,4,25.0,3,6,0,6,2,10,7,0
1729,Borja Mayoral,Roma,17.2,3,2,0,0,3,1,10,10.0,9,5,0,5,0,3,5,2
1730,Borja Mayoral,Real Madrid,0.3,0,0,0,0,0,0,1,0.0,1,0,0,0,0,0,0,0
1731,Youssef Maziz,Metz,2.9,2,0,1,1,0,1,5,20.0,4,1,0,1,6,8,1,0
1732,Antonio Mazzotta,Crotone,0.6,1,1,0,1,0,0,0,0.0,0,0,0,0,0,1,1,0
1733,Kevin Mbabu,Wolfsburg,18.2,51,33,27,17,7,24,35,68.6,11,28,7,21,22,73,59,1
1734,Kylian Mbappe,Paris S-G,26.4,4,2,0,1,3,2,9,22.2,7,7,1,6,3,7,4,1
1735,Ibrahima Mbaye,Bologna,4.8,6,5,5,1,0,3,5,60.0,2,5,3,2,1,7,10,0
1736,Jean-Manuel Mbom,Werder Bremen,12.9,19,13,14,3,2,8,27,29.6,19,17,6,11,13,32,27,0
1737,Nathanael Mbuku,Reims,24.6,33,19,9,13,11,8,28,28.6,20,17,0,17,14,47,10,0
1738,James McArthur,Crystal Palace,16.3,57,32,25,27,5,15,39,38.5,24,28,3,25,23,80,31,0
1739,Oliver McBurnie,Sheffield Utd,14.7,15,7,7,7,1,5,17,29.4,12,10,3,7,6,21,30,0
1740,Alex McCarthy,Southampton,30.0,1,0,1,0,0,1,4,25.0,3,0,0,0,0,1,11,1
1742,James McCarthy,Crystal Palace,9.1,16,12,9,7,0,8,21,38.1,13,15,7,8,8,24,12,0
1743,John McGinn,Aston Villa,37.0,61,37,23,31,7,27,84,32.1,57,38,6,32,43,104,23,2
1744,David McGoldrick,Sheffield Utd,26.6,33,21,8,15,10,13,31,41.9,18,19,3,16,2,35,25,0
1745,Weston McKennie,Juventus,18.9,34,19,9,20,5,12,33,36.4,21,21,3,18,28,62,26,0
1746,Dwight McNeil,Burnley,34.1,47,24,24,18,5,18,56,32.1,38,44,6,38,32,79,32,1
1747,Scott McTominay,Manchester Utd,23.7,51,24,23,25,3,23,36,63.9,13,35,10,25,29,80,46,0
1748,Gary Medel,Bologna,5.7,12,9,6,5,1,4,10,40.0,6,8,6,2,7,19,10,0
1749,Facundo Medina,Lens,22.3,39,22,22,15,2,24,38,63.2,14,25,9,16,39,78,51,3
1750,Nathan de Medina,Arminia,7.1,16,10,9,6,1,3,10,30.0,7,12,2,10,11,27,22,0
1751,Ben Mee,Burnley,29.9,32,15,16,14,2,14,29,48.3,15,54,45,9,43,75,148,2
1752,Joshua Mees,Union Berlin,0.1,0,0,0,0,0,0,0,0.0,0,0,0,0,0,0,0,0
1753,Admir Mehmedi,Wolfsburg,9.1,17,9,6,7,4,6,16,37.5,10,7,0,7,5,22,1,0
1754,Soualiho Meite,Torino,10.2,11,7,6,4,1,5,16,31.3,11,18,1,17,10,21,9,1
1755,Soualiho Meite,Milan,6.5,18,10,10,6,2,8,17,47.1,9,9,2,7,8,26,16,0
1756,Hannibal Mejbri,Manchester Utd,0.1,0,0,0,0,0,0,0,0.0,0,0,0,0,0,0,0,0
1757,Farid El Melali,Angers,4.6,9,5,5,4,0,2,13,15.4,11,12,0,12,6,15,2,0
1758,Filippo Melegoni,Genoa,4.3,7,6,2,5,0,3,6,50.0,3,5,0,5,5,12,8,0
1759,Gonzalo Melero,Levante,20.6,24,15,11,6,7,10,39,25.6,29,14,5,9,18,42,22,1
1760,Birger Meling,Nîmes,25.9,49,31,27,15,7,33,50,66.0,17,43,9,34,36,85,70,0
1761,Arthur Melo,Juventus,12.9,17,9,7,10,0,12,31,38.7,19,6,1,5,18,35,9,1
1762,Memphis,Lyon,32.5,4,3,0,3,1,1,20,5.0,19,11,1,10,5,9,3,0
1763,Houboulang Mendes,Lorient,14.4,28,19,19,5,4,16,28,57.1,12,14,2,12,14,42,35,0
1764,Pedro Mendes,Montpellier,18.1,21,19,16,5,0,14,21,66.7,7,23,13,10,34,55,58,0
1765,Thiago Mendes,Lyon,24.9,37,22,13,20,4,18,38,47.4,20,33,7,26,39,76,21,2
1766,Brais Mendez,Celta Vigo,29.7,59,31,23,27,9,16,65,24.6,49,27,2,25,32,91,34,0
1768,Edgar Mendez,Alavés,23.2,39,29,18,13,8,15,48,31.3,33,20,3,17,19,58,14,0
1769,Enaut Mendia,Eibar,0.7,2,1,2,0,0,1,2,50.0,1,1,1,0,0,2,0,0
1770,Batista Mendy,Nantes,0.8,1,1,0,1,0,0,1,0.0,1,3,1,2,1,2,1,0
1771,Benjamin Mendy,Manchester City,10.6,13,9,1,8,4,5,21,23.8,16,12,5,7,5,18,14,1
1772,Edouard Mendy,Chelsea,30.5,0,0,0,0,0,0,1,0.0,1,0,0,0,1,1,9,3
1773,Edouard Mendy,Rennes,1.0,0,0,0,0,0,0,0,0.0,0,0,0,0,0,0,0,0
1774,Ferland Mendy,Real Madrid,24.5,26,16,17,6,3,12,24,50.0,12,16,4,12,26,52,32,1
1775,Nampalys Mendy,Leicester City,16.2,26,17,18,6,2,7,20,35.0,13,12,1,11,14,40,8,0
1776,Hamza Mendyl,Schalke 04,1.1,2,2,2,0,0,0,2,0.0,2,2,0,2,0,2,2,0
1777,Levent Mercan,Schalke 04,0.1,0,0,0,0,0,0,0,0.0,0,0,0,0,0,0,0,0
1778,Jorge Mere,Köln,14.4,13,6,9,3,1,6,13,46.2,7,14,11,3,15,28,63,0
1779,Alex Meret,Napoli,22.0,0,0,0,0,0,0,1,0.0,1,0,0,0,0,0,5,0
1780,Mikel Merino,Real Sociedad,23.9,61,36,14,36,11,18,45,40.0,27,36,8,28,32,93,26,0
1781,Martin Merquelanz,Real Sociedad,6.1,9,3,3,2,4,2,7,28.6,5,7,1,6,3,12,4,0
1782,Yildirim Mert Cetin,Hellas Verona,4.6,8,4,3,5,0,2,6,33.3,4,7,5,2,14,22,11,1
1783,Dries Mertens,Napoli,16.2,16,14,4,7,5,5,25,20.0,20,7,1,6,9,25,3,1
1784,Roque Mesa,Valladolid,19.6,46,29,18,24,4,20,47,42.6,27,11,2,9,14,60,23,1
1785,Illan Meslier,Leeds United,35.0,0,0,0,0,0,0,1,0.0,1,0,0,0,0,0,17,8
1786,Lionel Messi,Barcelona,33.6,18,10,3,9,6,6,17,35.3,11,12,0,12,6,24,0,2
1787,Junior Messias,Crotone,35.7,60,35,26,24,10,22,70,31.4,48,32,12,20,35,95,40,0
1788,Thomas Meunier,Dortmund,16.4,30,21,19,6,5,20,29,69.0,9,16,6,10,18,48,29,2
1789,Mexer,Bordeaux,7.9,9,6,8,0,1,5,10,50.0,5,8,5,3,17,26,22,0
1790,Max Meyer,Köln,3.9,7,4,3,3,1,4,8,50.0,4,4,1,3,3,10,1,0
1791,Omenuke Mfulu,Elche,8.8,18,12,10,8,0,5,15,33.3,10,7,1,6,11,29,18,0
1792,Michel,Valladolid,10.5,18,11,10,3,5,5,22,22.7,17,10,1,9,9,27,12,1
1794,Jonas Michelbrink,Hertha BSC,0.4,0,0,0,0,0,0,0,0.0,0,0,0,0,0,0,0,0
1795,Clement Michelin,Lens,12.8,25,19,13,9,3,9,16,56.3,7,13,4,9,25,50,32,0
1796,Edouard Michut,Paris S-G,0.0,0,0,0,0,0,0,0,0.0,0,0,0,0,0,0,0,0
1797,Petar Micin,Udinese,0.2,0,0,0,0,0,0,0,0.0,0,0,0,0,0,0,0,0
1798,Florian Miguel,Nîmes,17.1,14,13,12,2,0,9,17,52.9,8,21,13,8,45,59,66,1
1799,Valentin Mihaila,Parma,7.8,2,1,1,1,0,0,10,0.0,10,8,1,7,5,7,8,0
1800,Nikola Milenkovic,Fiorentina,33.7,49,29,33,14,2,21,33,63.6,12,42,33,9,44,93,122,1
1801,Arkadiusz Milik,Marseille,13.6,14,9,0,7,7,2,12,16.7,10,5,1,4,2,16,9,0
1802,Sergej Milinkovic-Savic,Lazio,30.5,59,40,20,30,9,27,84,32.1,57,52,12,40,33,92,47,0
1803,Vanja Milinkovic-Savic,Torino,5.0,1,1,1,0,0,1,1,100.0,0,0,0,0,0,1,1,3
1804,Eder Militao,Real Madrid,12.6,20,8,13,6,1,8,14,57.1,6,19,6,13,19,39,42,0
1805,Luka Milivojevic,Crystal Palace,26.2,65,34,25,31,9,42,77,54.5,35,29,6,23,35,100,47,2
1806,Luis Milla,Granada,13.9,22,11,11,10,1,6,28,21.4,22,10,0,10,24,46,16,1
1807,Pere Milla,Elche,22.0,24,17,12,10,2,8,37,21.6,29,17,5,12,13,37,17,1
1808,Alex Millan,Villarreal,0.0,0,0,0,0,0,0,0,0.0,0,0,0,0,0,0,0,0
1809,Vincenzo Millico,Torino,0.2,0,0,0,0,0,0,0,0.0,0,0,0,0,0,0,0,0
1810,Enzo Millot,Monaco,0.5,2,0,0,1,1,1,1,100.0,0,0,0,0,2,4,0,0
1811,James Milner,Liverpool,11.9,26,19,9,14,3,11,33,33.3,22,30,3,27,14,40,16,1
1812,Santi Mina,Celta Vigo,26.8,31,13,9,12,10,6,37,16.2,31,15,3,12,6,37,17,0
1813,Yerry Mina,Everton,21.5,21,14,17,4,0,8,12,66.7,4,30,23,7,24,45,110,1
1814,Takumi Minamino,Southampton,7.9,7,3,2,5,0,2,19,10.5,17,13,1,12,4,11,9,0
1815,Takumi Minamino,Liverpool,3.3,4,3,1,2,1,0,12,0.0,12,1,0,1,2,6,3,0
1816,Tyrone Mings,Aston Villa,35.5,32,16,23,7,2,16,24,66.7,8,59,40,19,41,73,172,3
1817,Oscar Mingueza,Barcelona,21.1,52,33,28,17,7,30,53,56.6,23,19,6,13,20,72,48,2
1818,Rafa Mir,Huesca,32.0,15,9,4,4,7,7,22,31.8,15,14,2,12,15,30,25,0
1820,Jorge Miramon,Levante,19.2,32,22,26,6,0,21,35,60.0,14,22,2,20,27,59,54,0
1821,Aleksei Miranchuk,Atalanta,7.5,24,13,8,9,7,6,9,66.7,3,1,0,1,3,27,1,0
1822,Juan Miranda,Betis,18.4,27,11,16,9,2,16,32,50.0,16,18,2,16,29,56,58,1
1823,Antonio Mirante,Roma,12.8,0,0,0,0,0,0,1,0.0,1,1,0,1,0,0,7,2
1824,Tyrick Mitchell,Crystal Palace,19.0,64,35,48,9,7,23,40,57.5,17,29,10,19,21,85,62,1
1825,Aleksandar Mitrovic,Fulham,15.6,7,4,0,3,4,2,8,25.0,6,12,3,9,3,10,8,0
1826,Stefan Mitrovic,Strasbourg,30.9,36,27,29,7,0,24,37,64.9,13,23,13,10,31,67,108,5
1827,Maximilian Mittelstadt,Hertha BSC,20.0,66,39,42,21,3,35,72,48.6,37,34,5,29,55,121,61,1
1828,Henrikh Mkhitaryan,Roma,30.5,58,24,13,27,18,13,62,21.0,49,34,0,34,39,97,10,0
1829,Jakub Moder,Brighton,7.2,15,7,5,7,3,7,20,35.0,13,12,1,11,3,18,9,0
1830,Anthony Modeste,Saint-Étienne,3.3,2,1,0,2,0,1,4,25.0,3,3,1,2,0,2,3,0
1831,Anthony Modeste,Köln,2.5,2,0,0,2,0,0,1,0.0,1,0,0,0,0,2,2,0
1832,Luka Modric,Real Madrid,30.4,37,23,18,16,3,13,36,36.1,23,14,2,12,48,85,14,1
1833,Terem Moffi,Lorient,23.0,13,8,0,8,5,4,19,21.1,15,5,2,3,4,17,8,0
1834,Kevin Mohwald,Werder Bremen,17.3,15,9,9,5,1,4,18,22.2,14,10,3,7,32,47,19,2
1835,Niklas Moisander,Werder Bremen,13.6,14,11,11,3,0,8,14,57.1,6,15,8,7,22,36,61,0
1836,Dion Moise Sahi,Strasbourg,1.0,1,0,0,1,0,1,1,100.0,0,1,0,1,0,1,0,0
1837,Johan Mojica,Atalanta,3.3,4,4,3,1,0,2,3,66.7,1,3,0,3,7,11,6,0
1838,Johan Mojica,Elche,13.4,21,10,15,5,1,8,18,44.4,10,15,4,11,15,36,27,0
1839,Guillem Molina,Valencia,1.7,1,0,1,0,0,0,5,0.0,5,1,1,0,4,5,5,0
1840,Jorge Molina,Granada,17.9,11,4,3,5,3,8,22,36.4,14,5,1,4,3,14,19,0
1841,Nahuel Molina,Udinese,20.3,27,18,13,10,4,16,42,38.1,26,26,4,22,21,48,49,1
1842,Salvatore Molina,Crotone,25.7,39,22,18,14,7,29,45,64.4,16,30,8,22,17,56,41,0
1843,Victor Mollejo,Getafe,0.8,2,1,1,0,1,0,1,0.0,1,0,0,0,0,2,0,0
1844,Florent Mollet,Montpellier,26.2,20,15,7,11,2,12,47,25.5,35,18,4,14,32,52,9,1
1846,Jayson Molumby,Brighton,0.0,0,0,0,0,0,0,0,0.0,0,0,0,0,0,0,0,0
1847,Alkhaly Momo Cisse,Stuttgart,0.4,1,1,1,0,0,0,0,0.0,0,1,0,1,0,1,0,0
1848,Jon Moncayola,Osasuna,29.6,61,36,27,23,11,24,67,35.8,43,27,9,18,23,84,38,0
1849,Gabriele Moncini,Benevento,4.0,2,1,2,0,0,0,1,0.0,1,2,0,2,2,4,4,0
1850,Thomas Monconduit,Lorient,12.8,28,15,9,16,3,15,41,36.6,26,10,3,7,13,41,21,1
1851,Kevin Monnet-Paquet,Saint-Étienne,6.3,11,7,7,2,2,5,10,50.0,5,5,0,5,6,17,7,0
1852,Nacho Monreal,Real Sociedad,23.1,31,19,17,11,3,7,20,35.0,13,14,3,11,31,62,43,0
1853,Cristobal Montiel,Fiorentina,0.0,0,0,0,0,0,0,1,0.0,1,0,0,0,0,0,0,0
1854,Lorenzo Montipo,Benevento,37.0,0,0,0,0,0,0,0,0.0,0,1,0,1,0,0,16,3
1855,Angel Montoro,Granada,15.1,15,9,7,7,1,4,16,25.0,12,13,3,10,22,37,21,0
1856,Martin Montoya,Betis,2.7,6,3,2,2,2,1,3,33.3,2,1,1,0,2,8,6,0
1857,Emre Mor,Celta Vigo,5.6,8,4,1,3,4,0,3,0.0,3,5,0,5,5,13,0,0
1858,Luca Mora,Spezia,1.3,3,1,1,2,0,2,4,50.0,2,2,1,1,0,3,2,0
1859,Wesley Moraes,Aston Villa,0.2,0,0,0,0,0,0,1,0.0,1,0,0,0,0,0,0,0
1860,Alvaro Morata,Juventus,22.4,17,12,2,10,5,4,28,14.3,24,22,2,20,5,22,21,0
1861,Jan Moravek,Augsburg,3.0,5,3,4,1,0,1,8,12.5,7,3,0,3,7,12,2,0
1862,Jon Morcillo,Athletic Club,15.1,16,9,3,6,7,7,30,23.3,23,9,0,9,15,31,11,0
1863,Jeremy Morel,Lorient,27.7,31,19,21,10,0,20,39,51.3,19,26,11,15,44,75,81,1
1864,Alberto Moreno,Villarreal,2.1,7,4,7,0,0,2,5,40.0,3,2,1,1,3,10,2,0
1865,Alex Moreno,Betis,19.8,42,26,25,12,5,20,43,46.5,23,18,4,14,35,77,48,0
1866,Gerard Moreno,Villarreal,29.7,24,15,8,10,6,7,34,20.6,27,17,4,13,15,39,26,0
1867,Tete Morente,Elche,22.4,31,17,17,9,5,9,39,23.1,30,20,0,20,13,44,28,0
1868,Mateu Morey,Dortmund,9.2,0.0,8,0.0,0.0,0.0,0.0,0.0,0.0,0.0,0.0,0.0,0.0,16,0.0,0.0,0.0
1869,Wes Morgan,Leicester City,0.2,0,0,0,0,0,0,0,0.0,0,0,0,0,0,0,1,0
1870,Ilaix Moriba,Barcelona,6.0,14,6,5,7,2,5,10,50.0,5,16,1,15,5,19,4,1
1872,Raul Moro,Lazio,0.1,0,0,0,0,0,0,1,0.0,1,0,0,0,0,0,0,0
1873,Loren Moron,Betis,11.0,11,7,2,6,3,1,16,6.3,15,11,0,11,3,14,14,0
1874,Pedro Mosquera,Huesca,22.8,38,18,19,18,1,13,53,24.5,40,23,6,17,31,69,38,1
1875,Aimen Moueffek,Saint-Étienne,8.3,25,15,16,6,3,13,32,40.6,19,17,2,15,9,34,18,0
1876,Youssoufa Moukoko,Dortmund,4.7,3,2,1,1,1,0,0,0.0,0,3,0,3,0,3,2,0
1877,Harold Moukoudi,Saint-Étienne,25.3,46,27,37,8,1,28,38,73.7,10,24,10,14,42,88,78,1
1878,Jessy Moulin,Saint-Étienne,29.0,2,1,2,0,0,2,3,66.7,1,0,0,0,2,4,9,2
1879,Steve Mounie,Brest,29.8,15,11,3,11,1,3,28,10.7,25,18,3,15,12,27,40,0
1880,Mason Mount,Chelsea,32.1,75,35,22,38,15,25,69,36.2,44,40,2,38,31,106,14,0
1881,Lucas Moura,Tottenham,15.7,32,16,12,16,4,8,29,27.6,21,12,0,12,18,50,10,0
1882,Lys Mousset,Sheffield Utd,3.3,1,0,0,0,1,0,2,0.0,2,1,0,1,0,1,1,1
1883,Joao Moutinho,Wolves,28.1,75,40,34,35,6,35,91,38.5,56,18,3,15,47,122,28,0
1884,Samuel Moutoussamy,Nantes,0.9,0,0,0,0,0,0,1,0.0,1,1,0,1,0,0,0,0
1885,Loris Mouyokolo,Lorient,0.2,1,1,1,0,0,1,1,100.0,0,1,1,0,0,1,1,0
1886,Javi Moyano,Valladolid,1.1,0,0,0,0,0,0,0,0.0,0,2,0,2,0,0,2,0
1887,Nordi Mukiele,RB Leipzig,18.6,44,30,14,28,2,21,37,56.8,16,33,1,32,23,67,33,2
1888,Mert Muldur,Sassuolo,18.6,43,20,26,9,8,27,53,50.9,26,17,1,16,36,79,41,0
1889,Florian Muller,Freiburg,31.0,0,0,0,0,0,0,3,0.0,3,1,0,1,2,2,10,1
1890,Sebastian Muller,Arminia,0.0,0,0,0,0,0,0,0,0.0,0,0,0,0,0,0,0,0
1891,Thomas Muller,Bayern Munich,29.7,49,22,11,23,15,24,73,32.9,49,43,3,40,21,70,18,1
1892,Joel Mumbongo,Burnley,0.4,0,0,0,0,0,0,0,0.0,0,1,0,1,0,0,0,0
1893,Marshall Munetsi,Reims,21.4,35,19,19,14,2,21,41,51.2,20,33,25,8,57,92,85,3
1894,Iker Muniain,Athletic Club,21.6,20,7,4,10,6,6,24,25.0,18,15,0,15,11,31,4,0
1895,Aihen Munoz,Real Sociedad,13.4,23,16,15,5,3,11,19,57.9,8,12,2,10,10,33,31,0
1896,Joaquin Munoz,Huesca,0.5,0,0,0,0,0,0,2,0.0,2,0,0,0,1,1,0,0
1898,Luis Muriel,Atalanta,16.0,20,9,4,8,8,9,26,34.6,17,17,0,17,7,27,4,0
1899,Jeison Murillo,Celta Vigo,30.0,45,21,35,9,1,24,44,54.5,20,29,17,12,36,81,100,2
1900,Vedat Muriqi,Lazio,9.2,3,1,0,2,1,0,8,0.0,8,9,2,7,3,6,20,0
1901,Jacob Murphy,Newcastle Utd,18.1,39,24,25,12,2,24,49,49.0,25,27,3,24,14,53,29,0
1902,Nicola Murru,Torino,6.3,9,6,1,5,3,3,5,60.0,2,11,1,10,12,21,24,0
1903,Petar Musa,Union Berlin,7.9,12,8,3,6,3,4,8,50.0,4,10,0,10,4,16,5,0
1904,Mateo Musacchio,Lazio,2.5,1,1,1,0,0,0,0,0.0,0,5,2,3,2,3,5,0
1905,Mateo Musacchio,Milan,0.4,2,1,2,0,0,2,3,66.7,1,1,0,1,3,5,0,0
1906,Yunus Musah,Valencia,17.0,21,18,12,3,6,8,24,33.3,16,20,0,20,15,36,12,1
1907,Jamal Musiala,Bayern Munich,9.8,20,12,5,7,8,7,22,31.8,15,17,2,15,14,34,3,0
1908,Juan Musso,Udinese,35.0,1,1,1,0,0,1,1,100.0,0,0,0,0,1,2,8,1
1909,Shkodran Mustafi,Arsenal,0.5,1,1,1,0,0,1,1,100.0,0,1,0,1,0,1,3,0
1910,Shkodran Mustafi,Schalke 04,11.5,16,5,15,1,0,3,12,25.0,9,20,15,5,32,48,76,1
1911,Yoshinori Muto,Eibar,12.5,12,7,1,4,7,3,8,37.5,5,5,0,5,3,15,2,0
1912,Phillipp Mwene,Mainz 05,18.6,36,23,21,11,4,19,38,50.0,19,26,3,23,24,60,33,0
1913,Joakim Maehle,Atalanta,13.5,18,10,7,5,6,8,19,42.1,11,17,2,15,11,29,5,0
1914,Obite N'Dicka,Eint Frankfurt,22.7,31,23,16,15,0,16,28,57.1,12,27,6,21,47,78,85,0
1915,Kevin N'Doram,Metz,3.4,3,2,0,3,0,1,3,33.3,2,0,0,0,6,9,2,0
1916,Stanley N'Soki,Nice,13.8,27,19,15,9,3,13,22,59.1,9,17,4,13,26,53,38,2
1917,Nacho,Valladolid,20.1,43,21,29,10,4,24,52,46.2,28,21,1,20,29,72,47,0
1918,Nacho,Real Madrid,22.2,27,14,13,11,3,12,35,34.3,23,19,9,10,40,67,58,0
1919,Yuto Nagatomo,Marseille,17.7,23,16,12,8,3,9,18,50.0,9,14,3,11,29,52,43,0
1920,Kenny Nagera,Paris S-G,0.0,0,0,0,0,0,0,0,0.0,0,0,0,0,0,0,0,0
1921,Radja Nainggolan,Cagliari,20.5,41,26,22,14,5,19,34,55.9,15,18,0,18,15,56,15,1
1922,Radja Nainggolan,Inter,0.5,0,0,0,0,0,0,0,0.0,0,0,0,0,1,1,0,0
1924,Marvelous Nakamba,Aston Villa,8.3,22,14,10,11,1,7,12,58.3,5,16,5,11,17,39,9,1
1925,Nahitan Nandez,Cagliari,30.4,56,28,23,23,10,25,68,36.8,43,26,4,22,23,79,49,0
1926,Nano,Cádiz,0.1,0,0,0,0,0,0,0,0.0,0,0,0,0,0,0,0,0
1927,Paul Nardi,Lorient,23.0,0,0,0,0,0,0,1,0.0,1,1,0,1,0,0,15,2
1928,Matija Nastasic,Schalke 04,13.6,11,7,9,2,0,9,16,56.3,7,22,18,4,26,37,51,1
1929,Roberto Navarro,Real Sociedad,0.4,1,1,1,0,0,0,2,0.0,2,0,0,0,1,2,0,0
1930,Ximo Navarro,Alavés,26.4,54,30,36,17,1,14,30,46.7,16,14,4,10,47,101,75,3
1931,Jesus Navas,Sevilla,31.4,27,21,15,11,1,15,22,68.2,7,10,3,7,37,64,62,1
1932,Keylor Navas,Paris S-G,28.0,0,0,0,0,0,0,0,0.0,0,0,0,0,0,0,10,0
1933,Raul Navas,Osasuna,1.9,6,3,5,1,0,4,6,66.7,2,0,0,0,3,9,13,0
1934,Papa Ndiaga Yade,Metz,11.1,15,8,9,2,4,7,20,35.0,13,9,0,9,4,19,6,0
1935,Iliman Ndiaye,Sheffield Utd,0.1,1,1,0,1,0,1,1,100.0,0,0,0,0,0,1,0,0
1936,Wilfred Ndidi,Leicester City,24.2,96,63,45,44,7,26,66,39.4,40,38,11,27,61,157,55,0
1937,Bridge Ndilu,Nantes,0.5,0,0,0,0,0,0,2,0.0,2,2,0,2,0,0,0,0
1938,Tanguy Ndombele,Tottenham,23.2,41,20,11,21,9,18,44,40.9,26,28,4,24,19,60,15,0
1939,Dan Ndoye,Nice,6.1,7,6,3,4,0,1,8,12.5,7,4,0,4,7,14,4,0
1940,Paul Nebel,Mainz 05,0.6,1,1,0,1,0,0,1,0.0,1,0,0,0,2,3,0,0
1941,Alvaro Negredo,Cádiz,24.4,11,5,3,4,4,5,11,45.5,6,7,2,5,3,14,19,0
1942,Reiss Nelson,Arsenal,0.8,1,0,0,0,1,0,0,0.0,0,0,0,0,1,2,1,0
1943,Ilija Nestorovski,Udinese,7.8,6,4,2,3,1,2,13,15.4,11,5,0,5,1,7,7,0
1944,Neto,Barcelona,7.0,0,0,0,0,0,0,1,0.0,1,0,0,0,0,0,3,1
1945,Pedro Neto,Wolves,28.3,16,9,4,6,6,6,28,21.4,22,18,2,16,31,47,8,0
1946,Luca Netz,Hertha BSC,3.4,14,8,12,2,0,6,17,35.3,11,3,0,3,6,20,8,0
1947,Manuel Neuer,Bayern Munich,33.0,0,0,0,0,0,0,1,0.0,1,0,0,0,2,2,12,3
1948,Florian Neuhaus,M'Gladbach,29.1,48,28,19,26,3,19,63,30.2,44,35,7,28,50,98,20,1
1950,Carlos Neva,Granada,20.0,12,6,6,6,0,6,11,54.5,5,16,4,12,27,39,58,0
1951,Ruben Neves,Wolves,29.7,86,46,42,38,6,36,88,40.9,52,55,11,44,65,151,46,2
1952,Neymar,Paris S-G,15.7,14,11,1,6,7,8,37,21.6,29,8,0,8,9,23,0,0
1953,Yvan Neyou,Saint-Étienne,27.1,58,31,24,33,1,25,60,41.7,35,34,5,29,31,89,13,1
1954,Jessic Ngankam,Hertha BSC,3.3,5,2,1,2,2,1,3,33.3,2,6,1,5,0,5,1,0
1955,Muzinga Ngonda,Dijon,25.6,59,40,37,21,1,30,50,60.0,20,28,3,25,72,131,58,0
1956,Ahmad Ngouyamsa,Dijon,1.7,6,4,5,1,0,4,8,50.0,4,2,1,1,2,8,8,0
1957,Opa Nguette,Metz,12.6,15,8,2,8,5,3,10,30.0,7,14,2,12,1,16,1,0
1958,Moussa Niakhate,Mainz 05,31.8,42,22,28,13,1,14,29,48.3,15,31,15,16,49,91,79,0
1959,Ibrahima Niane,Metz,7.4,1,1,0,0,1,1,2,50.0,1,3,0,3,0,1,8,0
1960,M'Baye Niang,Rennes,4.7,3,2,2,1,0,0,0,0.0,0,2,0,2,1,4,2,0
1961,Mamor Niang,Getafe,0.2,1,1,0,1,0,0,0,0.0,0,1,0,1,0,1,0,0
1962,Tanguy Nianzou,Bayern Munich,1.3,3,1,3,0,0,1,1,100.0,0,0,0,0,3,6,1,0
1963,Florian Niederlechner,Augsburg,19.3,7,5,1,4,2,0,10,0.0,10,8,3,5,10,17,18,0
1964,Nieto,Cádiz,0.2,1,1,0,1,0,0,0,0.0,0,0,0,0,0,1,1,0
1965,Saul Niguez,Atlético Madrid,22.6,57,34,27,23,7,30,59,50.8,29,35,2,33,19,76,43,0
1966,Joakim Nilsson,Arminia,24.0,36,24,23,12,1,14,23,60.9,9,29,22,7,39,75,111,0
1967,Casimir Ninga,Angers,0.3,0,0,0,0,0,0,0,0.0,0,0,0,0,0,0,1,0
1968,Nino,Elche,3.2,0,0,0,0,0,0,1,0.0,1,1,0,1,0,0,0,0
1969,Fernando Nino,Villarreal,6.6,8,3,0,4,4,2,9,22.2,7,1,0,1,2,10,2,0
1970,Eddie Nketiah,Arsenal,4.7,3,1,0,2,1,0,2,0.0,2,6,0,6,0,3,5,0
1971,Nicolas Nkoulou,Torino,15.1,14,9,11,3,0,7,12,58.3,5,28,14,14,33,47,71,1
1972,Niels Nkounkou,Everton,0.9,4,3,1,2,1,3,8,37.5,5,4,0,4,0,4,4,0
1973,Christopher Nkunku,RB Leipzig,21.0,16,11,3,7,6,8,18,44.4,10,27,1,26,9,25,14,0
1974,Dan Nlundulu,Southampton,1.2,0,0,0,0,0,0,1,0.0,1,2,0,2,0,0,2,0
1976,Mark Noble,West Ham,7.9,8,4,2,5,1,4,14,28.6,10,7,3,4,13,21,3,0
1977,Nolito,Celta Vigo,28.9,70,36,30,30,10,32,92,34.8,60,46,2,44,22,92,19,0
1978,Arnaud Nordin,Saint-Étienne,19.7,14,8,5,5,4,6,21,28.6,15,13,2,11,9,23,10,0
1979,Havard Nordtveit,Hoffenheim,7.8,6,2,5,1,0,6,8,75.0,2,4,2,2,13,19,42,0
1980,Will Norris,Burnley,2.0,0,0,0,0,0,0,0,0.0,0,0,0,0,0,0,0,0
1981,Oliver Norwood,Sheffield Utd,24.7,49,22,16,28,5,21,72,29.2,51,29,12,17,36,85,51,1
1982,Olivier Ntcham,Marseille,1.3,1,0,0,1,0,1,3,33.3,2,3,1,2,2,3,3,0
1983,Alexander Nubel,Bayern Munich,1.0,0,0,0,0,0,0,0,0.0,0,0,0,0,0,0,1,0
1984,Kasim Nuhu,Hoffenheim,11.0,13,7,9,4,0,6,10,60.0,4,8,3,5,15,28,38,0
1985,Unai Nunez,Athletic Club,23.4,23,12,16,7,0,10,15,66.7,5,19,14,5,32,55,110,0
1986,Bram Nuytinck,Udinese,18.2,21,15,10,9,2,13,20,65.0,7,30,17,13,25,46,77,0
1987,Kelechi Nwakali,Huesca,1.6,4,3,1,2,1,0,4,0.0,4,1,0,1,1,5,1,0
1988,Simeon Nwankwo,Crotone,32.7,9,2,2,6,1,3,22,13.6,19,21,5,16,6,15,51,0
1989,Gerzino Nyamsi,Rennes,9.7,12,10,2,8,2,4,6,66.7,2,8,5,3,10,22,32,1
1990,Allan Nyom,Getafe,25.8,38,23,14,19,5,15,30,50.0,15,16,2,14,22,60,42,0
1991,M'Bala Nzola,Spezia,21.1,12,5,2,6,4,4,7,57.1,3,15,1,14,3,15,20,0
1992,Steven Nzonzi,Rennes,32.3,34,16,15,16,3,12,31,38.7,19,24,10,14,16,50,26,0
1993,Jack O'Connell,Sheffield Utd,2.0,3,1,1,1,1,0,1,0.0,1,4,3,1,2,5,7,0
1994,Dara O'Shea,West Brom,23.4,45,25,30,13,2,21,45,46.7,24,32,17,15,45,90,108,0
1995,Michael Obafemi,Southampton,0.7,1,0,0,1,0,0,1,0.0,1,1,0,1,0,1,0,0
1996,Pedro Obiang,Sassuolo,16.3,35,22,17,15,3,12,35,34.3,23,26,7,19,22,57,27,0
1997,Jan Oblak,Atlético Madrid,38.0,0,0,0,0,0,0,0,0.0,0,0,0,0,0,0,6,2
1998,Lucas Ocampos,Sevilla,29.2,36,24,12,16,8,13,37,35.1,24,33,1,32,19,55,30,1
1999,Bastian Oczipka,Schalke 04,21.4,33,20,22,10,1,7,21,33.3,14,22,4,18,24,57,41,0
2000,Brian Oddei,Sassuolo,0.5,2,1,1,1,0,2,3,66.7,1,1,0,1,0,2,1,0
2002,Denis Odoi,Fulham,3.0,3,3,2,1,0,1,4,25.0,3,3,1,2,5,8,5,0
2003,Alvaro Odriozola,Real Madrid,9.2,14,7,5,8,1,3,5,60.0,2,6,3,3,6,20,12,1
2004,Angelo Ogbonna,West Ham,27.7,26,13,20,5,1,9,17,52.9,8,25,11,14,30,56,119,0
2005,Stefano Okaka,Udinese,16.5,10,7,2,5,3,2,10,20.0,8,7,1,6,2,12,19,0
2006,Shinji Okazaki,Huesca,12.5,7,5,5,0,2,0,5,0.0,5,5,0,5,4,11,6,0
2007,Masaya Okugawa,Arminia,10.2,17,8,5,11,1,6,14,42.9,8,17,2,15,8,25,5,0
2008,Lucas Olaza,Valladolid,14.0,20,9,11,7,2,9,17,52.9,8,15,7,8,15,35,38,0
2009,Lucas Olaza,Celta Vigo,17.9,25,16,12,12,1,10,18,55.6,8,15,1,14,24,49,34,0
2010,Christian Oliva,Cagliari,4.3,10,4,6,3,1,6,17,35.3,11,11,1,10,8,18,7,0
2011,Christian Oliva,Valencia,2.2,2,0,1,1,0,1,6,16.7,5,1,0,1,6,8,0,0
2012,Kiko Olivas,Valladolid,2.0,3,2,2,1,0,3,5,60.0,2,2,2,0,7,10,3,0
2013,Paulo Oliveira,Eibar,29.3,42,21,32,8,2,19,36,52.8,17,39,14,25,59,101,112,0
2014,Mathias Olivera,Getafe,29.0,61,33,31,21,9,32,56,57.1,24,33,3,30,31,92,55,0
2015,Maximiliano Olivera,Fiorentina,1.0,2,0,1,1,0,1,1,100.0,0,3,1,2,0,2,8,0
2016,Dani Olmo,RB Leipzig,24.4,23,14,6,13,4,4,23,17.4,19,15,0,15,13,36,21,0
2017,Robin Olsen,Everton,7.0,0,0,0,0,0,0,0,0.0,0,0,0,0,0,0,4,1
2018,Jonas Omlin,Montpellier,29.7,1,1,1,0,0,1,4,25.0,3,0,0,0,0,1,9,1
2019,Jerome Onguene,Genoa,2.0,2,1,2,0,0,2,7,28.6,5,2,0,2,2,4,8,0
2020,Karim Onisiwo,Mainz 05,20.5,31,20,7,15,9,14,23,60.9,9,20,1,19,5,36,12,0
2021,Josh Onomah,Fulham,4.2,11,8,1,6,4,0,5,0.0,5,4,2,2,2,13,1,0
2022,Javier Ontiveros,Huesca,10.2,21,14,10,10,1,9,26,34.6,17,12,0,12,9,30,6,0
2023,Henry Onyekuru,Monaco,1.6,1,0,1,0,0,1,4,25.0,3,1,0,1,0,1,0,0
2024,Willi Orban,RB Leipzig,26.3,40,26,19,15,6,23,37,62.2,14,29,20,9,40,80,74,0
2025,Fabian Orellana,Valladolid,23.8,33,19,12,14,7,12,55,21.8,43,18,0,18,15,48,9,0
2026,Divock Origi,Liverpool,2.1,3,2,0,2,1,1,3,33.3,2,5,1,4,1,4,2,0
2028,Riccardo Orsolini,Bologna,19.5,37,18,13,12,12,16,39,41.0,23,22,3,19,10,47,22,0
2029,Stefan Ortega,Arminia,34.0,2,1,2,0,0,2,6,33.3,4,0,0,0,0,2,12,3
2030,Yuya Osako,Werder Bremen,8.5,12,8,2,5,5,2,9,22.2,7,6,1,5,5,17,7,0
2031,Ben Osborn,Sheffield Utd,17.8,33,18,15,10,8,13,40,32.5,27,20,3,17,12,45,17,0
2032,Victor Osimhen,Napoli,17.5,22,15,2,6,14,3,15,20.0,12,6,0,6,7,29,10,0
2033,Yordan Osorio,Parma,20.1,22,14,13,9,0,9,24,37.5,15,30,18,12,53,75,77,1
2034,David Ospina,Napoli,16.0,0,0,0,0,0,0,0,0.0,0,0,0,0,0,0,4,0
2035,Owen Otasowie,Wolves,2.1,5,5,3,2,0,1,2,50.0,1,1,1,0,3,8,4,0
2036,Otavio,Bordeaux,17.3,54,31,33,19,2,26,55,47.3,29,20,5,15,26,80,36,0
2037,Paulo Otavio,Wolfsburg,19.3,60,40,32,22,6,34,62,54.8,28,51,7,44,42,102,59,0
2038,Remi Oudin,Bordeaux,26.9,34,16,22,7,5,15,36,41.7,21,22,2,20,51,85,40,1
2039,Alexandre Oukidja,Metz,34.0,0,0,0,0,0,0,1,0.0,1,1,0,1,0,0,17,3
2040,Zinedine Ould Khaled,Angers,0.4,0,0,0,0,0,0,0,0.0,0,0,0,0,1,1,0,0
2041,Adam Ounas,Crotone,13.3,9,4,4,4,1,0,7,0.0,7,12,1,11,3,12,4,0
2042,Adam Ounas,Cagliari,3.4,3,2,3,0,0,0,11,0.0,11,5,0,5,3,6,0,0
2043,Thomas Ouwejan,Udinese,4.6,4,1,0,3,1,2,9,22.2,7,4,0,4,5,9,6,0
2044,Reece Oxford,Augsburg,15.1,26,18,15,11,0,10,17,58.8,7,28,22,6,29,55,89,0
2045,Alex Oxlade-Chamberlain,Liverpool,2.8,4,0,0,3,1,0,2,0.0,2,1,0,1,2,6,0,0
2046,Mikel Oyarzabal,Real Sociedad,26.8,30,17,14,12,4,10,31,32.3,21,30,5,25,15,45,17,0
2047,Ambroise Oyongo,Montpellier,6.2,13,6,10,3,0,9,15,60.0,6,3,2,1,8,21,26,1
2048,Salih Ozcan,Köln,15.2,21,13,11,10,0,12,33,36.4,21,11,2,9,20,41,14,1
2049,Levin Oztunali,Mainz 05,8.4,24,18,14,8,2,8,17,47.1,9,15,0,15,15,39,16,0
2050,Pablo,Bordeaux,12.0,17,11,13,4,0,8,14,57.1,6,17,12,5,25,42,46,1
2051,Fernando Pacheco,Alavés,37.2,2,0,2,0,0,2,4,50.0,2,0,0,0,2,4,19,0
2052,Jon Pacheco,Real Sociedad,0.4,0,0,0,0,0,0,0,0.0,0,0,0,0,1,1,0,0
2054,Goncalo Paciencia,Schalke 04,8.3,8,3,4,1,3,4,16,25.0,12,4,1,3,1,9,3,0
2055,Daniele Padelli,Inter,0.5,0,0,0,0,0,0,0,0.0,0,0,0,0,0,0,0,0
2056,Mattia Pagliuca,Bologna,0.1,0,0,0,0,0,0,0,0.0,0,0,0,0,1,1,0,0
2057,Vincent Pajot,Metz,10.2,35,20,19,11,5,10,18,55.6,8,9,2,7,42,77,11,0
2058,Rodrigo Palacio,Bologna,27.8,13,6,2,3,8,1,15,6.7,14,18,0,18,7,20,29,0
2059,Exequiel Palacios,Leverkusen,6.4,31,17,12,16,3,17,30,56.7,13,13,0,13,12,43,7,0
2060,Helibelton Palacios,Elche,8.3,20,10,16,3,1,8,13,61.5,5,9,1,8,5,25,21,0
2061,Ante Palaversa,Getafe,0.1,0,0,0,0,0,0,1,0.0,1,0,0,0,0,0,0,0
2062,Alberto Paleari,Genoa,2.3,0,0,0,0,0,0,0,0.0,0,0,0,0,0,0,1,0
2063,Nicolas Pallois,Nantes,30.8,58,36,42,14,2,38,72,52.8,34,44,20,24,37,95,155,1
2064,Emerson Palmieri,Chelsea,1.0,3,3,2,0,1,1,3,33.3,2,0,0,0,1,4,6,0
2065,Antonio Palumbo,Sampdoria,0.1,0,0,0,0,0,0,1,0.0,1,0,0,0,0,0,0,0
2066,Martin Palumbo,Udinese,0.7,0,0,0,0,0,0,0,0.0,0,5,0,5,1,1,0,0
2067,Goran Pandev,Genoa,15.6,9,5,1,6,2,4,10,40.0,6,6,0,6,2,11,7,1
2068,Ivor Pandur,Hellas Verona,3.7,0,0,0,0,0,0,0,0.0,0,0,0,0,0,0,0,0
2069,Jonathan Panzo,Dijon,20.0,17,12,13,4,0,8,11,72.7,3,27,13,14,59,76,91,2
2070,Matondo-Merveille Papela,Mainz 05,0.0,0,0,0,0,0,0,1,0.0,1,0,0,0,0,0,0,0
2071,Lucas Paqueta,Lyon,25.3,70,36,30,28,12,23,66,34.8,43,28,3,25,20,90,16,1
2072,Gaetan Paquiez,Nîmes,11.6,21,12,12,7,2,12,29,41.4,17,10,3,7,16,37,28,0
2073,Ruben Pardo,Bordeaux,0.3,0,0,0,0,0,0,0,0.0,0,0,0,0,1,1,0,0
2074,Leandro Paredes,Paris S-G,14.5,30,18,12,15,3,19,39,48.7,20,17,5,12,17,47,13,1
2075,Daniel Parejo,Villarreal,34.6,65,40,32,23,10,33,81,40.7,48,35,8,27,45,110,21,3
2076,Vittorio Parigini,Genoa,0.6,5,2,4,0,1,0,1,0.0,1,0,0,0,0,5,0,0
2077,Marco Parolo,Lazio,7.3,21,8,8,11,2,8,20,40.0,12,20,6,14,14,35,31,0
2078,Thomas Partey,Arsenal,17.0,44,21,16,24,4,24,56,42.9,32,17,5,12,23,67,18,0
2080,Thomas Partey,Atlético Madrid,2.2,7,4,4,3,0,5,8,62.5,3,4,1,3,2,9,1,0
2081,Mario Pasalic,Atalanta,12.5,26,15,5,17,4,12,19,63.2,7,12,1,11,8,34,6,0
2082,Felix Passlack,Dortmund,4.0,9,6,4,2,3,4,8,50.0,4,11,1,10,3,12,2,0
2083,Christian Pastina,Benevento,1.3,0,0,0,0,0,0,1,0.0,1,1,0,1,1,1,8,0
2084,Javier Pastore,Roma,0.9,2,2,2,0,0,2,2,100.0,0,0,0,0,0,2,0,0
2085,Patric,Lazio,17.7,30,16,15,11,4,13,24,54.2,11,13,3,10,18,48,51,1
2086,Rui Patricio,Wolves,37.0,0,0,0,0,0,0,1,0.0,1,0,0,0,1,1,3,3
2087,Paulinho,Leverkusen,0.7,0,0,0,0,0,0,0,0.0,0,0,0,0,0,0,0,0
2088,Gabriel Paulista,Valencia,30.2,17,11,9,5,3,6,17,35.3,11,32,27,5,59,76,132,3
2089,Benjamin Pavard,Bayern Munich,21.6,44,27,20,16,8,23,40,57.5,17,29,5,24,48,92,31,1
2090,Jiri Pavlenka,Werder Bremen,34.0,2,0,2,0,0,2,2,100.0,0,0,0,0,1,3,17,4
2091,Vasileios Pavlidis,Schalke 04,0.0,0,0,0,0,0,0,0,0.0,0,0,0,0,0,0,0,0
2092,Mateo Pavlovic,Angers,12.3,11,6,8,3,0,8,23,34.8,15,13,11,2,21,32,40,0
2093,Strahinja Pavlovic,Monaco,0.0,0,0,0,0,0,0,0,0.0,0,0,0,0,0,0,0,0
2094,Leonardo Pavoletti,Cagliari,17.6,7,3,2,5,0,1,20,5.0,19,4,2,2,4,11,32,0
2095,Dimitri Payet,Marseille,26.9,27,17,4,16,7,17,40,42.5,23,19,2,17,8,35,10,0
2096,Nehuen Paz,Bologna,4.0,9,4,4,5,0,6,7,85.7,1,4,2,2,11,20,16,0
2097,Bailey Peacock-Farrell,Burnley,4.0,0,0,0,0,0,0,0,0.0,0,0,0,0,0,0,0,0
2098,Mads Pedersen,Augsburg,9.9,25,16,20,3,2,10,22,45.5,12,13,3,10,15,40,32,0
2099,Alfonso Pedraza,Villarreal,23.3,35,19,16,11,8,11,31,35.5,20,21,5,16,34,69,47,1
2100,Pedri,Barcelona,26.8,44,27,16,16,12,17,71,23.9,54,46,1,45,33,77,7,0
2101,Pedro,Roma,17.7,22,14,6,11,5,7,35,20.0,28,10,0,10,9,31,2,1
2102,Joao Pedro,Cagliari,36.1,13,6,2,6,5,2,27,7.4,25,32,6,26,13,26,28,0
2103,Gianluca Pegolo,Sassuolo,1.0,0,0,0,0,0,0,0,0.0,0,0,0,0,0,0,1,0
2104,Peter Pekarik,Hertha BSC,18.8,24,18,17,7,0,17,31,54.8,14,19,8,11,27,51,41,0
2106,Yohann Pele,Marseille,1.0,0,0,0,0,0,0,0,0.0,0,0,0,0,0,0,0,0
2107,Graziano Pelle,Parma,6.8,2,2,0,1,1,1,8,12.5,7,3,0,3,2,4,8,0
2108,Pietro Pellegri,Monaco,2.6,2,1,0,2,0,0,0,0.0,0,1,0,1,0,2,0,0
2109,Lorenzo Pellegrini,Roma,28.9,40,24,13,20,7,21,60,35.0,39,37,2,35,42,82,23,1
2110,Luca Pellegrini,Genoa,7.1,9,6,6,2,1,4,10,40.0,6,11,2,9,8,17,13,1
2111,Facundo Pellistri,Alavés,6.0,8,5,2,4,2,3,13,23.1,10,0,0,0,4,12,3,0
2112,Andy Pelmard,Nice,13.4,18,12,12,5,1,9,12,75.0,3,11,3,8,20,38,35,0
2113,Lee Peltier,West Brom,2.5,9,4,8,1,0,4,4,100.0,0,1,1,0,1,10,11,0
2114,Federico Peluso,Sassuolo,2.3,1,1,1,0,0,1,2,50.0,1,2,2,0,3,4,12,0
2115,Timothee Pembele,Paris S-G,4.3,8,7,4,4,0,5,14,35.7,9,4,0,4,5,13,8,1
2116,Ruben Pena,Villarreal,12.4,25,14,8,15,2,19,33,57.6,14,20,1,19,13,38,19,0
2117,Philipp Pentke,Hoffenheim,3.0,0,0,0,0,0,0,0,0.0,0,0,0,0,0,0,0,0
2118,Nicolas Pepe,Arsenal,18.0,20,15,8,6,6,8,23,34.8,15,16,1,15,12,32,19,0
2119,Alberto Perea,Cádiz,17.2,28,17,12,10,6,9,35,25.7,26,26,1,25,21,49,9,0
2120,Andreas Pereira,Lazio,6.0,5,0,1,3,1,2,12,16.7,10,6,0,6,1,6,4,0
2121,Danilo Pereira,Paris S-G,15.9,21,11,6,11,4,6,14,42.9,8,14,6,8,29,50,33,4
2122,Mathias Pereira Lage,Angers,16.3,29,17,12,15,2,10,40,25.0,30,21,4,17,15,44,16,0
2123,Matheus Pereira,West Brom,28.6,26,15,14,10,2,12,54,22.2,42,18,0,18,29,55,16,0
2124,Pedro Pereira,Crotone,28.3,50,32,29,17,4,21,40,52.5,19,33,11,22,19,69,61,0
2125,Ricardo Pereira,Leicester City,10.7,31,22,16,8,7,14,35,40.0,21,24,1,23,15,46,23,0
2126,Gaston Pereiro,Cagliari,3.0,3,1,2,1,0,1,2,50.0,1,2,0,2,1,4,2,1
2127,Bruno Peres,Roma,15.9,21,11,11,7,3,13,24,54.2,11,18,4,14,27,48,11,0
2128,Roberto Pereyra,Udinese,32.5,18,11,7,8,3,7,23,30.4,16,24,5,19,27,45,24,0
2129,Ayoze Perez,Leicester City,14.8,32,15,6,20,6,13,48,27.1,35,28,0,28,10,42,7,0
2130,Carles Perez,Roma,8.6,9,4,3,6,0,6,31,19.4,25,9,0,9,6,15,1,0
2132,Inigo Perez,Osasuna,15.0,20,10,9,6,5,10,16,62.5,6,12,0,12,15,35,8,1
2133,Juan Perez,Osasuna,3.0,0,0,0,0,0,0,0,0.0,0,0,0,0,0,0,1,0
2134,Kike Perez,Valladolid,12.9,26,19,8,14,4,7,33,21.2,26,10,1,9,17,43,18,0
2135,Lucas Perez,Alavés,19.5,6,2,3,3,0,2,10,20.0,8,6,1,5,2,8,5,0
2136,Luis Perez,Valladolid,14.4,33,17,16,17,0,18,30,60.0,12,26,8,18,14,47,54,1
2137,Manuel Perez,Lens,1.4,1,0,1,0,0,0,8,0.0,8,2,0,2,2,3,2,0
2138,Nehuen Perez,Granada,8.2,6,3,6,0,0,4,6,66.7,2,5,4,1,12,18,33,0
2139,Mattia Perin,Genoa,32.0,0,0,0,0,0,0,0,0.0,0,0,0,0,1,1,6,0
2140,Ivan Perisic,Inter,19.9,22,13,11,6,5,12,33,36.4,21,33,4,29,19,41,36,1
2141,Romain Perraud,Brest,34.9,60,34,42,16,2,24,45,53.3,21,36,3,33,45,105,76,0
2142,Lucas Perrin,Marseille,3.4,7,4,4,3,0,5,12,41.7,7,5,4,1,8,15,16,0
2143,Pavao Pervan,Wolfsburg,2.0,0,0,0,0,0,0,0,0.0,0,0,0,0,0,0,1,0
2144,Matteo Pessina,Atalanta,18.3,14,7,4,6,4,7,24,29.2,17,17,2,15,17,31,7,1
2145,Andrea Petagna,Napoli,10.7,2,0,0,2,0,2,7,28.6,5,4,0,4,1,3,7,0
2146,Nils Petersen,Freiburg,14.5,11,7,2,6,3,3,21,14.3,18,25,1,24,9,20,28,0
2147,Lukas Petkov,Augsburg,0.0,0,0,0,0,0,0,0,0.0,0,0,0,0,0,0,0,0
2148,Jacopo Petriccione,Crotone,10.6,14,8,6,7,1,9,24,37.5,15,11,2,9,8,22,11,0
2149,Jens Petter Hauge,Milan,5.9,7,4,3,3,1,6,10,60.0,4,4,0,4,1,8,3,0
2150,German Pezzella,Fiorentina,30.5,34,20,22,12,0,18,32,56.3,14,26,14,12,36,70,109,1
2151,Giuseppe Pezzella,Parma,20.3,34,19,23,9,2,22,41,53.7,19,22,9,13,12,46,52,3
2152,Maximilian Philipp,Wolfsburg,12.3,15,6,3,6,6,5,21,23.8,16,17,0,17,6,21,3,0
2153,Rayan Philippe,Dijon,1.0,3,1,1,1,1,2,2,100.0,0,0,0,0,0,3,0,0
2154,Romain Philippoteaux,Nîmes,2.4,1,1,1,0,0,1,5,20.0,4,2,0,2,2,3,1,0
2155,Romain Philippoteaux,Brest,6.5,11,6,6,3,2,6,9,66.7,3,4,0,4,10,21,2,0
2156,Kalvin Phillips,Leeds United,27.0,74,38,38,29,7,26,62,41.9,36,49,14,35,45,119,53,3
2158,Matt Phillips,West Brom,20.3,15,8,4,11,0,7,23,30.4,16,32,4,28,10,25,32,1
2159,Nathaniel Phillips,Liverpool,16.2,22,14,15,7,0,11,24,45.8,13,17,14,3,20,42,81,0
2160,Jaden Philogene Bidace,Aston Villa,0.0,0,0,0,0,0,0,0,0.0,0,0,0,0,0,0,0,0
2161,Krzysztof Piatek,Hertha BSC,18.1,9,4,1,7,1,3,22,13.6,19,11,0,11,6,15,14,0
2162,Pablo Piatti,Elche,4.0,8,6,3,3,2,3,12,25.0,9,5,0,5,2,10,1,0
2163,Cristiano Piccini,Atalanta,0.7,1,1,1,0,0,0,1,0.0,1,1,0,1,0,1,0,0
2164,Cristiano Piccini,Valencia,0.7,1,1,1,0,0,1,2,50.0,1,0,0,0,0,1,3,0
2165,Roberto Piccoli,Spezia,7.8,7,3,0,4,3,2,4,50.0,2,4,0,4,2,9,5,0
2166,Jordan Pickford,Everton,30.5,0,0,0,0,0,0,2,0.0,2,2,0,2,3,3,16,4
2167,Jeremy Pied,Lille,3.5,7,0,3,3,1,4,9,44.4,5,3,1,2,6,13,8,0
2168,Amos Pieper,Arminia,29.8,58,32,39,17,2,20,33,60.6,13,48,35,13,66,124,160,3
2169,Ronael Pierre-Gabriel,Brest,25.6,60,40,42,16,2,35,52,67.3,17,17,7,10,30,90,57,0
2170,Erik Pieters,Burnley,14.1,30,21,18,9,3,19,39,48.7,20,30,9,21,12,42,34,0
2171,Tomas Pina Isla,Alavés,28.6,39,18,18,16,5,16,42,38.1,26,28,8,20,37,76,42,0
2172,Andrea Pinamonti,Inter,1.9,0,0,0,0,0,0,0,0.0,0,1,0,1,1,1,2,0
2173,Yeremi Pino,Villarreal,8.9,19,11,10,7,2,8,28,28.6,20,20,1,19,9,28,8,0
2174,Carlo Pinsoglio,Juventus,0.3,0,0,0,0,0,0,0,0.0,0,0,0,0,0,0,0,0
2175,Gerard Pique,Barcelona,16.5,16,11,11,5,0,9,12,75.0,3,9,4,5,26,42,46,0
2176,Fabio Pisacane,Cagliari,2.5,3,2,2,1,0,3,7,42.9,4,8,5,3,1,4,9,1
2177,Lukasz Piszczek,Dortmund,5.1,10,7,6,4,0,5,12,41.7,7,5,1,4,5,15,12,0
2178,Marko Pjaca,Genoa,15.8,13,6,6,3,4,4,16,25.0,12,7,2,5,7,20,12,0
2179,Miralem Pjanic,Barcelona,7.0,13,8,7,4,2,7,13,53.8,6,5,1,4,11,24,5,0
2180,Oscar Plano,Valladolid,28.0,42,24,24,12,6,14,46,30.4,32,35,6,29,34,76,43,0
2181,Marvin Plattenhardt,Hertha BSC,11.9,15,10,6,7,2,5,9,55.6,4,9,1,8,1,16,19,1
2182,Alassane Plea,M'Gladbach,20.0,19,9,4,10,5,5,20,25.0,15,1,0,1,5,24,7,0
2184,Dani Plomer,Granada,0.5,0,0,0,0,0,0,1,0.0,1,0,0,0,0,0,1,0
2185,Tommaso Pobega,Spezia,13.7,24,13,7,13,4,11,31,35.5,20,10,2,8,9,33,22,0
2186,Daniel Podence,Wolves,18.5,12,6,5,5,2,2,19,10.5,17,5,1,4,13,25,2,0
2187,Paul Pogba,Manchester Utd,21.1,36,26,15,16,5,11,33,33.3,22,24,2,22,26,62,37,0
2188,Joel Pohjanpalo,Union Berlin,9.5,5,1,0,3,2,1,6,16.7,5,1,0,1,1,6,12,0
2189,Joel Pohjanpalo,Leverkusen,0.1,0,0,0,0,0,0,0,0.0,0,0,0,0,0,0,0,0
2190,Andrea Poli,Bologna,4.3,9,7,4,2,3,6,12,50.0,6,7,1,6,7,16,7,0
2191,Matteo Politano,Napoli,21.2,24,16,13,9,2,11,47,23.4,36,14,1,13,14,38,18,0
2192,Jorge Pombo,Cádiz,5.8,7,3,3,2,2,1,8,12.5,7,2,0,2,2,9,3,0
2193,Marin Pongracic,Wolfsburg,6.4,13,9,9,3,1,6,8,75.0,2,12,5,7,11,24,27,0
2194,Pere Pons,Alavés,13.2,20,10,8,8,4,5,16,31.3,11,15,2,13,7,27,10,0
2195,Nick Pope,Burnley,32.0,1,1,1,0,0,0,1,0.0,1,0,0,0,2,3,29,2
2196,Manolo Portanova,Genoa,0.7,3,3,1,1,1,0,2,0.0,2,3,1,2,1,4,2,0
2197,Manolo Portanova,Juventus,0.8,2,0,2,0,0,0,2,0.0,2,4,1,3,0,2,1,0
2198,Francisco Portillo,Getafe,4.6,5,3,1,4,0,2,14,14.3,12,3,0,3,5,10,1,0
2199,Portu,Real Sociedad,24.3,18,8,4,10,4,7,36,19.4,29,24,2,22,8,26,5,0
2200,Stefan Posch,Hoffenheim,23.5,52,24,29,17,6,27,47,57.4,20,27,8,19,37,89,73,1
2201,Sergio Postigo,Levante,18.0,16,12,12,3,1,7,18,38.9,11,21,10,11,33,49,84,1
2202,Yussuf Poulsen,RB Leipzig,15.0,10,6,1,6,3,1,17,5.9,16,16,0,16,6,16,13,0
2203,Maxime Poundje,Bordeaux,5.5,10,7,9,1,0,2,6,33.3,4,7,3,4,11,21,5,0
2204,Dario Poveda,Getafe,0.1,0,0,0,0,0,0,0,0.0,0,1,0,1,0,0,0,0
2205,Alejandro Pozo Pozo,Eibar,24.3,38,22,17,15,6,17,38,44.7,21,35,2,33,27,65,40,1
2206,Dennis Praet,Leicester City,8.0,14,7,4,7,3,6,15,40.0,9,12,2,10,7,21,3,0
2207,Sanjin Prcic,Strasbourg,3.9,3,2,0,3,0,2,5,40.0,3,4,3,1,4,7,2,1
2208,Nicolas de Preville,Bordeaux,17.9,19,14,7,6,6,9,42,21.4,33,15,0,15,13,32,7,0
2210,Manuel Prietl,Arminia,28.0,65,44,33,28,4,12,73,16.4,61,34,7,27,45,110,24,0
2211,Grischa Promel,Union Berlin,20.2,39,23,14,23,2,18,34,52.9,16,20,2,18,24,63,22,0
2212,Davy Propper,Brighton,2.4,6,5,0,6,0,2,5,40.0,3,3,0,3,1,7,0,0
2213,Ivan Provedel,Spezia,29.0,2,0,2,0,0,2,6,33.3,4,0,0,0,2,4,20,1
2214,Antonio Puertas,Granada,24.1,27,13,9,12,6,10,32,31.3,22,24,5,19,12,39,25,0
2215,Riqui Puig,Barcelona,3.2,5,3,1,3,1,4,8,50.0,4,0,0,0,1,6,0,0
2216,Erick Pulgar,Fiorentina,22.2,41,18,17,23,1,22,49,44.9,27,24,10,14,41,82,45,1
2217,Jorge Pulido,Huesca,32.1,39,24,31,8,0,17,29,58.6,12,32,18,14,52,91,98,0
2218,Christian Pulisic,Chelsea,19.3,19,11,8,10,1,8,21,38.1,13,25,2,23,12,31,9,0
2219,Ignacio Pussetto,Udinese,8.4,16,8,5,6,5,6,17,35.3,11,14,0,14,13,29,6,0
2220,Fabio Quagliarella,Sampdoria,24.5,12,8,4,4,4,2,19,10.5,17,14,1,13,7,19,10,0
2221,Robin Quaison,Mainz 05,16.4,14,6,3,6,5,7,14,50.0,7,10,0,10,13,27,10,0
2222,Domingos Quina,Granada,3.8,5,5,1,3,1,3,6,50.0,3,8,0,8,2,7,0,0
2223,Quini,Granada,13.2,33,22,23,7,3,19,36,52.8,17,15,6,9,15,48,39,0
2224,Quique,Eibar,1.9,0,0,0,0,0,0,1,0.0,1,2,0,2,0,0,0,0
2225,Dani Raba,Villarreal,1.7,2,1,0,1,1,2,8,25.0,6,1,0,1,0,2,0,0
2226,Simone Rabbi,Bologna,0.4,0,0,0,0,0,0,1,0.0,1,0,0,0,0,0,0,0
2227,Adrien Rabiot,Juventus,25.7,72,42,24,41,7,28,60,46.7,32,32,11,21,43,115,29,1
2228,Uros Racic,Valencia,24.3,38,22,16,16,6,16,54,29.6,38,33,11,22,26,64,54,0
2229,Anthony Racioppi,Dijon,21.0,0,0,0,0,0,0,2,0.0,2,0,0,0,2,2,12,4
2230,Nemanja Radoja,Levante,12.5,23,15,12,10,1,5,19,26.3,14,9,3,6,19,42,12,1
2231,Nemanja Radonjic,Marseille,4.4,6,5,1,2,3,2,12,16.7,10,8,0,8,3,9,1,0
2232,Nemanja Radonjic,Hertha BSC,6.8,5,3,2,2,1,1,5,20.0,4,1,0,1,2,7,1,0
2233,Aleksandar Radovanovic,Lens,1.0,1,1,0,1,0,0,0,0.0,0,2,1,1,0,1,2,0
2234,Ivan Radovanovic,Genoa,24.8,18,15,13,5,0,12,31,38.7,19,39,21,18,37,55,114,2
2236,Ionut Radu,Inter,1.5,0,0,0,0,0,0,0,0.0,0,0,0,0,0,0,1,0
2237,Stefan Radu,Lazio,27.3,43,24,20,19,4,25,40,62.5,15,27,14,13,45,88,73,1
2238,Rafael,Spezia,2.3,0,0,0,0,0,0,0,0.0,0,0,0,0,0,0,0,0
2239,Rafinha,Paris S-G,15.1,54,26,18,28,8,28,49,57.1,21,18,3,15,13,67,6,0
2240,Antonio Raimondo,Bologna,0.0,0,0,0,0,0,0,0,0.0,0,0,0,0,0,0,0,0
2241,Predrag Rajkovic,Reims,36.5,2,1,2,0,0,2,5,40.0,3,1,0,1,2,4,17,3
2242,Ivan Rakitic,Sevilla,24.8,32,18,18,10,4,12,41,29.3,29,19,4,15,26,58,29,1
2243,Jonas Ramalho,Osasuna,3.4,5,4,4,0,1,1,3,33.3,2,3,0,3,2,7,7,0
2244,Benito Raman,Schalke 04,13.8,19,13,11,6,2,6,29,20.7,23,11,0,11,5,24,5,0
2245,Gaston Ramirez,Sampdoria,10.8,31,15,10,17,4,8,27,29.6,19,19,3,16,4,35,13,0
2246,Sandro Ramirez,Huesca,14.3,13,9,3,8,2,4,11,36.4,7,11,1,10,10,23,2,0
2247,Sergio Ramos,Real Madrid,14.2,15,12,8,6,1,6,10,60.0,4,9,5,4,19,34,39,1
2248,Aaron Ramsdale,Sheffield Utd,38.0,1,1,1,0,0,1,1,100.0,0,0,0,0,2,3,22,6
2249,Aaron Ramsey,Juventus,12.1,22,14,8,13,1,8,25,32.0,17,13,2,11,7,29,8,2
2250,Jacob Ramsey,Aston Villa,7.0,10,5,3,4,3,2,12,16.7,10,13,6,7,4,14,5,0
2251,Kayne Ramsey,Southampton,1.0,5,2,4,1,0,3,3,100.0,0,0,0,0,0,5,3,0
2252,Darren Randolph,West Ham,3.0,0,0,0,0,0,0,0,0.0,0,0,0,0,0,0,1,0
2253,Andrea Ranocchia,Inter,7.8,13,10,6,6,1,7,8,87.5,1,5,3,2,12,25,19,0
2254,Raphinha,Leeds United,26.2,34,17,13,16,5,12,58,20.7,46,31,1,30,29,63,27,0
2255,Raphinha,Rennes,4.5,5,2,1,3,1,1,4,25.0,3,5,0,5,3,8,4,0
2256,Marcus Rashford,Manchester Utd,32.4,18,9,2,8,8,7,27,25.9,20,22,2,20,8,26,10,0
2257,Milot Rashica,Werder Bremen,16.2,24,12,11,11,2,12,23,52.2,11,7,0,7,4,28,6,0
2258,Giacomo Raspadori,Sassuolo,13.7,5,3,1,1,3,0,4,0.0,4,13,5,8,2,7,9,0
2259,Federico Ravaglia,Bologna,4.0,0,0,0,0,0,0,1,0.0,1,0,0,0,0,0,2,0
2260,Tim Ream,Fulham,7.0,12,5,9,3,0,8,11,72.7,3,8,5,3,6,18,26,1
2262,Ante Rebic,Milan,19.7,26,9,4,8,14,8,37,21.6,29,21,1,20,7,33,17,0
2263,Arkadiusz Reca,Crotone,25.7,34,16,15,11,8,10,45,22.2,35,30,3,27,50,84,64,0
2264,Recio,Eibar,8.2,17,5,4,8,5,8,18,44.4,10,6,0,6,4,21,1,0
2265,Daishawn Redan,Hertha BSC,1.1,0,0,0,0,0,0,0,0.0,0,1,0,1,0,0,0,0
2266,Nathan Redmond,Southampton,19.3,30,17,14,12,4,8,24,33.3,16,24,2,22,11,41,9,0
2267,Harrison Reed,Fulham,25.0,63,38,28,28,7,29,73,39.7,44,34,11,23,50,113,31,1
2268,Vasco Regini,Sampdoria,1.0,2,2,2,0,0,2,2,100.0,0,1,1,0,1,3,5,0
2269,Sergio Reguilon,Tottenham,24.9,47,25,30,13,4,23,48,47.9,25,39,7,32,32,79,50,1
2270,Bobby Reid,Fulham,26.4,31,15,17,10,4,18,39,46.2,21,19,5,14,21,52,39,0
2271,Pepe Reina,Lazio,29.0,0,0,0,0,0,0,1,0.0,1,0,0,0,1,1,6,0
2272,Jeff Reine-Adelaide,Nice,11.8,7,4,1,4,2,2,9,22.2,7,10,1,9,4,11,6,0
2273,Jeff Reine-Adelaide,Lyon,0.3,0,0,0,0,0,0,0,0.0,0,0,0,0,0,0,0,0
2274,Reinier,Dortmund,2.9,9,4,6,1,2,2,4,50.0,2,4,1,3,2,11,0,0
2275,Francisco Reis Ferreira,Valencia,2.0,1,1,1,0,0,0,3,0.0,3,0,0,0,0,1,6,0
2276,Rocco Reitz,M'Gladbach,0.7,3,2,0,3,0,2,2,100.0,0,3,1,2,1,4,1,0
2277,Karim Rekik,Sevilla,7.3,7,5,2,5,0,1,4,25.0,3,8,3,5,6,13,17,0
2278,Alex Remiro,Real Sociedad,38.0,0,0,0,0,0,0,1,0.0,1,0,0,0,3,3,14,0
2279,Panagiotis Retsos,Saint-Étienne,3.0,5,3,5,0,0,3,7,42.9,4,1,1,0,3,8,12,0
2280,Marco Reus,Dortmund,25.3,33,16,9,16,8,9,33,27.3,24,22,2,20,14,47,13,0
2281,Elvis Rexhbecaj,Köln,20.4,53,32,17,27,9,19,53,35.8,34,32,7,25,26,79,18,0
2282,Oriol Rey,Valladolid,0.2,0,0,0,0,0,0,0,0.0,0,0,0,0,1,1,0,0
2283,Gio Reyna,Dortmund,22.0,24,13,9,8,7,9,25,36.0,16,14,1,13,10,34,11,0
2284,Baptiste Reynet,Nîmes,38.0,2,1,2,0,0,2,4,50.0,2,1,0,1,1,3,9,2
2285,Bryan Reynolds,Roma,3.1,4,2,1,1,2,1,5,20.0,4,4,0,4,6,10,4,0
2286,Franck Ribery,Fiorentina,23.9,24,11,4,9,11,5,29,17.2,24,11,2,9,3,27,1,0
2288,Federico Ricci,Sassuolo,0.0,0,0,0,0,0,0,0,0.0,0,0,0,0,0,0,0,0
2289,Giacomo Ricci,Parma,0.7,3,1,1,2,0,0,0,0.0,0,2,2,0,1,4,4,0
2290,Matteo Ricci,Spezia,24.8,40,23,14,24,2,27,52,51.9,25,24,4,20,34,74,13,0
2291,Declan Rice,West Ham,32.0,59,35,33,25,1,21,51,41.2,30,39,11,28,59,118,41,0
2292,Chris Richards,Hoffenheim,10.5,19,8,12,6,1,10,16,62.5,6,13,4,9,21,40,40,1
2293,Chris Richards,Bayern Munich,1.0,0,0,0,0,0,0,0,0.0,0,0,0,0,1,1,1,0
2294,Lewis Richardson,Burnley,0.0,0,0,0,0,0,0,0,0.0,0,0,0,0,0,0,0,0
2295,Richarlison,Everton,31.8,50,32,21,22,7,16,51,31.4,35,28,3,25,14,64,36,1
2296,Marco Richter,Augsburg,15.7,17,9,3,12,2,7,23,30.4,16,10,0,10,6,23,9,0
2297,Mikel Rico,Huesca,24.3,24,12,14,8,2,11,34,32.4,23,20,3,17,23,47,22,0
2298,Sergio Rico,Paris S-G,9.0,0,0,0,0,0,0,0,0.0,0,0,0,0,0,0,1,0
2299,Jairo Riedewald,Crystal Palace,20.2,34,15,13,17,4,16,36,44.4,20,39,7,32,29,63,25,0
2300,Emiliano Rigoni,Elche,12.7,12,7,3,8,1,3,15,20.0,12,16,1,15,6,18,9,0
2301,Tomas Rincon,Torino,31.6,68,38,27,33,8,36,71,50.7,35,32,7,25,31,99,44,0
2302,Luis Rioja,Alavés,23.2,21,14,11,7,3,7,39,17.9,32,23,1,22,20,41,30,0
2303,Renaud Ripart,Nîmes,33.9,52,30,25,19,8,26,84,31.0,58,58,12,46,36,88,53,0
2304,Andrea Rispoli,Crotone,7.2,6,3,2,3,1,2,7,28.6,5,12,3,9,5,11,15,1
2305,Mihailo Ristic,Montpellier,24.8,45,22,25,13,7,28,44,63.6,16,30,9,21,26,71,57,0
2306,Matt Ritchie,Newcastle Utd,15.0,10,3,5,3,2,3,17,17.6,14,17,2,15,12,22,47,0
2307,Maxence Rivera,Saint-Étienne,2.7,12,10,6,4,2,4,10,40.0,6,5,0,5,1,13,0,0
2308,Emmanuel Riviere,Crotone,7.1,2,1,2,0,0,0,3,0.0,3,5,1,4,1,3,0,0
2309,Rober,Levante,15.8,14,7,8,3,3,8,18,44.4,10,24,16,8,35,49,52,1
2310,Roberto,Valladolid,13.0,0,0,0,0,0,0,1,0.0,1,0,0,0,0,0,7,0
2311,Sergi Roberto,Barcelona,10.5,9,6,5,2,2,7,13,53.8,6,12,6,6,10,19,20,0
2312,Tyler Roberts,Leeds United,14.9,15,13,1,11,3,5,22,22.7,17,17,2,15,9,24,12,0
2314,Andrew Robertson,Liverpool,37.6,46,34,23,18,5,28,57,49.1,29,39,9,30,21,67,79,1
2315,Antonee Robinson,Fulham,24.0,45,28,24,16,5,27,44,61.4,17,21,4,17,37,82,68,0
2316,Callum Robinson,West Brom,17.3,7,5,5,1,1,3,19,15.8,16,9,0,9,7,14,8,0
2317,Jack Robinson,Sheffield Utd,9.7,14,6,8,5,1,6,11,54.5,5,10,4,6,9,23,42,0
2318,Joel Robles,Betis,18.0,0,0,0,0,0,0,1,0.0,1,1,0,1,0,0,11,2
2319,Hal Robson-Kanu,West Brom,6.2,2,1,1,0,1,0,1,0.0,1,2,0,2,2,4,7,0
2320,Marc Roca,Bayern Munich,2.0,2,2,0,0,2,0,4,0.0,4,4,1,3,2,4,1,0
2321,Christopher Rocchia,Marseille,0.2,1,0,1,0,0,0,2,0.0,2,0,0,0,0,1,1,0
2322,Ruben Rochina,Levante,15.6,38,28,12,23,3,12,35,34.3,23,22,2,20,22,60,7,0
2323,Marek Rodak,Fulham,2.0,0,0,0,0,0,0,0,0.0,0,0,0,0,0,0,0,0
2324,Sebastian Rode,Eint Frankfurt,18.1,44,25,21,16,7,14,46,30.4,32,30,3,27,47,91,18,0
2325,Joe Rodon,Tottenham,8.1,14,9,11,2,1,3,4,75.0,1,10,8,2,21,35,36,2
2326,Rodri,Manchester City,30.5,72,40,24,40,8,33,66,50.0,33,23,9,14,36,108,54,3
2327,Rodri,Betis,6.0,3,3,1,2,0,1,6,16.7,5,7,0,7,2,5,0,0
2328,Rodrigo,Leeds United,14.3,14,7,8,3,3,4,22,18.2,18,7,0,7,5,19,16,0
2329,Kevin Rodrigues,Eibar,12.2,16,8,8,5,3,7,23,30.4,16,10,1,9,20,36,15,1
2330,Angel Rodriguez,Getafe,15.3,7,4,1,4,2,1,16,6.3,15,7,0,7,2,9,8,0
2331,Oscar Rodriguez Arnaiz,Sevilla,5.7,15,9,3,8,4,6,13,46.2,7,2,0,2,10,25,1,0
2332,Guido Rodriguez,Betis,31.8,98,56,52,40,6,40,85,47.1,45,52,14,38,68,166,58,2
2333,James Rodriguez,Everton,19.6,28,17,8,15,5,11,46,23.9,35,17,0,17,15,43,3,0
2334,Jay Rodriguez,Burnley,14.1,25,16,5,15,5,13,28,46.4,15,25,4,21,2,27,7,0
2335,Miguel Rodriguez,Celta Vigo,0.3,1,1,0,1,0,0,0,0.0,0,0,0,0,0,1,0,0
2336,Ricardo Rodriguez,Torino,13.8,21,14,11,8,2,13,22,59.1,9,16,5,11,20,41,43,0
2337,Victor Rodriguez,Elche,4.7,4,3,3,1,0,0,9,0.0,9,5,1,4,5,9,4,0
2338,Rodrygo,Real Madrid,10.9,15,6,10,4,1,2,17,11.8,15,15,0,15,7,22,4,0
2340,Marko Rog,Cagliari,12.9,40,24,15,22,3,16,37,43.2,21,17,6,11,19,59,15,0
2341,Rogerio,Sassuolo,20.9,26,13,19,5,2,19,27,70.4,8,26,5,21,31,57,53,0
2342,Luis Rojas,Crotone,1.2,1,0,0,1,0,1,2,50.0,1,2,0,2,1,2,0,0
2343,Alessio Romagnoli,Milan,21.2,17,7,8,7,2,8,19,42.1,11,29,22,7,24,41,80,0
2344,Cristian Romero,Atalanta,28.3,63,32,41,19,3,27,49,55.1,22,31,13,18,96,159,71,2
2345,Oriol Romeu,Southampton,19.6,69,35,25,39,5,26,68,38.2,42,28,7,21,30,99,18,0
2346,Cristiano Ronaldo,Juventus,31.1,6,3,1,3,2,3,15,20.0,12,11,3,8,5,11,15,1
2347,Facundo Roncaglia,Osasuna,13.7,25,14,14,11,0,11,20,55.0,9,11,6,5,25,50,26,0
2348,Valentin Rongier,Marseille,21.0,93,59,31,55,7,43,85,50.6,42,32,2,30,28,121,21,1
2349,Marten de Roon,Atalanta,33.6,80,48,30,36,14,36,84,42.9,48,44,9,35,69,149,40,0
2350,Jerome Roussillon,Wolfsburg,13.7,24,12,14,8,2,11,20,55.0,9,10,1,9,19,43,28,0
2351,Nolan Roux,Nîmes,7.2,7,3,1,4,2,3,8,37.5,5,6,0,6,5,12,4,0
2352,Nicolo Rovella,Genoa,13.2,29,16,15,11,3,9,32,28.1,23,11,0,11,20,49,19,1
2353,Amir Rrahmani,Napoli,12.2,13,8,7,6,0,6,9,66.7,3,17,14,3,8,21,39,1
2354,Ruben,Osasuna,2.1,0,0,0,0,0,0,0,0.0,0,0,0,0,0,0,1,0
2355,Waldo Rubio,Valladolid,4.2,6,4,2,2,2,1,14,7.1,13,6,0,6,3,9,3,0
2356,John Ruddy,Wolves,1.0,0,0,0,0,0,0,0,0.0,0,0,0,0,0,0,0,0
2357,Antonio Rudiger,Chelsea,19.0,31,23,16,14,1,12,15,80.0,3,17,10,7,18,49,51,0
2358,Sebastian Rudy,Hoffenheim,18.6,35,26,15,15,5,16,45,35.6,29,24,4,20,13,48,21,1
2359,Sebastian Rudy,Schalke 04,2.0,4,2,2,0,2,4,7,57.1,3,6,4,2,1,5,4,0
2360,Kevin Ruegg,Hellas Verona,2.3,0,0,0,0,0,0,0,0.0,0,3,0,3,2,2,3,0
2361,Daniele Rugani,Cagliari,11.1,24,11,10,12,2,10,20,50.0,10,15,10,5,15,39,46,0
2362,Daniele Rugani,Rennes,1.0,0,0,0,0,0,0,1,0.0,1,1,1,0,1,1,1,0
2363,Matteo Ruggeri,Atalanta,2.3,3,0,1,2,0,2,3,66.7,1,2,0,2,4,7,2,0
2364,Mario Rui,Napoli,18.5,24,13,17,6,1,17,33,51.5,16,17,4,13,28,52,29,1
2366,Aitor Ruibal,Betis,17.7,32,18,14,14,4,10,35,28.6,25,26,0,26,11,43,8,0
2367,Isma Ruiz,Granada,0.7,1,0,0,1,0,0,1,0.0,1,0,0,0,0,1,3,0
2368,Kays Ruiz,Paris S-G,2.1,1,1,0,1,0,0,4,0.0,4,1,0,1,3,4,2,0
2369,Fabian Ruiz Pena,Napoli,28.5,58,31,26,21,11,25,70,35.7,45,33,3,30,36,94,32,1
2370,Victor Ruiz,Betis,24.0,11,7,7,4,0,4,13,30.8,9,17,13,4,44,55,85,0
2371,Geronimo Rulli,Villarreal,2.0,0,0,0,0,0,0,0,0.0,0,0,0,0,0,0,0,1
2372,Georginio Rutter,Rennes,0.5,2,2,0,1,1,1,3,33.3,2,2,0,2,0,2,0,0
2373,Georginio Rutter,Hoffenheim,2.7,4,4,2,2,0,1,2,50.0,1,2,0,2,0,4,2,0
2374,Mathew Ryan,Arsenal,3.0,0,0,0,0,0,0,0,0.0,0,0,0,0,0,0,1,0
2375,Mathew Ryan,Brighton,11.0,1,0,1,0,0,0,0,0.0,0,0,0,0,0,1,4,0
2376,Julian Ryerson,Union Berlin,11.9,22,15,4,14,4,12,15,80.0,3,13,0,13,11,33,17,0
2377,Frederik Ronnow,Schalke 04,10.5,0,0,0,0,0,0,0,0.0,0,0,0,0,1,1,9,1
2378,Joao Victor Santos Sa,Wolfsburg,5.2,9,6,2,6,1,6,11,54.5,5,11,0,11,8,17,2,0
2379,Roli Pereira de Sa,Nantes,0.6,4,3,1,3,0,3,4,75.0,1,2,0,2,0,4,0,0
2380,Idriss Saadi,Strasbourg,1.4,0,0,0,0,0,0,2,0.0,2,0,0,0,0,0,0,0
2381,Youssouf Sabaly,Bordeaux,32.3,47,33,24,17,6,27,45,60.0,18,31,8,23,49,96,57,2
2382,Mathys Saban,Saint-Étienne,0.1,0,0,0,0,0,0,0,0.0,0,0,0,0,0,0,0,0
2383,Marcel Sabitzer,RB Leipzig,22.5,29,21,12,16,1,12,37,32.4,25,7,2,5,35,64,27,0
2384,Alexis Saelemaekers,Milan,22.4,43,26,20,18,5,19,60,31.7,41,29,1,28,25,68,6,0
2385,Modibo Sagnan,Real Sociedad,6.9,12,7,6,6,0,4,6,66.7,2,7,2,5,6,18,25,1
2386,Allan Saint-Maximin,Newcastle Utd,17.3,16,9,6,9,1,4,9,44.4,5,10,0,10,4,20,2,0
2387,Borja Sainz,Alavés,5.0,7,3,3,2,2,4,16,25.0,12,4,0,4,6,13,1,0
2388,Romain Saiss,Wolves,26.7,35,24,23,12,0,19,33,57.6,14,28,13,15,52,87,115,1
2389,Bukayo Saka,Arsenal,28.4,25,16,10,13,2,11,40,27.5,29,21,2,19,25,50,24,0
2390,Hiroki Sakai,Marseille,26.5,81,48,34,35,12,39,51,76.5,12,21,5,16,54,135,65,0
2392,Moise Sakava,Reims,0.1,0,0,0,0,0,0,0,0.0,0,0,0,0,0,0,0,0
2393,Mamadou Sakho,Crystal Palace,3.1,3,2,1,2,0,3,3,100.0,0,3,2,1,3,6,11,0
2394,Jacopo Sala,Spezia,4.2,17,9,14,1,2,8,22,36.4,14,5,2,3,5,22,6,0
2395,Mohamed Salah,Liverpool,34.2,18,9,4,4,10,7,16,43.8,9,10,0,10,1,19,10,1
2396,Eddie Salcedo,Hellas Verona,8.4,6,2,3,2,1,3,3,100.0,0,6,0,6,6,12,6,0
2397,William Saliba,Nice,20.0,15,9,8,5,2,5,6,83.3,1,17,16,1,26,41,80,2
2398,Romain Salin,Rennes,15.0,0,0,0,0,0,0,1,0.0,1,0,0,0,1,1,6,3
2399,Mohammed Salisu,Southampton,9.4,38,21,20,16,2,25,34,73.5,9,22,5,17,17,55,30,0
2400,Roland Sallai,Freiburg,18.5,18,14,7,9,2,5,13,38.5,8,11,1,10,11,29,8,0
2401,Salvi,Cádiz,21.5,18,10,14,3,1,8,26,30.8,18,14,1,13,20,38,24,0
2402,Lazar Samardzic,RB Leipzig,2.2,10,7,4,6,0,5,13,38.5,8,6,0,6,2,12,1,0
2403,Diadie Samassekou,Hoffenheim,28.5,71,41,22,42,7,33,90,36.7,57,41,12,29,78,149,50,0
2404,Mama Samba Balde,Dijon,24.0,23,9,4,13,6,9,22,40.9,13,16,1,15,4,27,26,0
2405,Junior Sambia,Montpellier,27.2,41,29,20,14,7,26,38,68.4,12,27,14,13,39,80,46,0
2406,Frederic Sammaritano,Dijon,12.6,15,10,9,5,1,9,26,34.6,17,6,0,6,9,24,3,0
2407,Fede San Emeterio,Valladolid,16.2,25,14,15,7,3,11,31,35.5,20,23,8,15,28,53,33,0
2408,Antonio Sanabria,Torino,10.9,8,3,0,4,4,2,9,22.2,7,5,0,5,5,13,8,0
2409,Antonio Sanabria,Betis,10.4,5,5,0,4,1,0,2,0.0,2,8,1,7,3,8,9,0
2410,Oihan Sancet,Athletic Club,11.5,8,2,3,4,1,2,7,28.6,5,4,0,4,5,13,7,0
2411,Renato Sanches,Lille,14.1,13,7,4,8,1,5,25,20.0,20,13,2,11,13,26,8,0
2412,Ricard Sanchez,Atlético Madrid,0.3,1,1,0,0,1,0,0,0.0,0,1,0,1,0,1,1,0
2413,Alexis Sanchez,Inter,12.7,14,8,4,4,6,5,18,27.8,13,11,0,11,7,21,1,1
2414,Davinson Sanchez,Tottenham,16.5,40,20,31,9,0,21,32,65.6,11,18,13,5,14,54,85,2
2415,German Sanchez,Granada,29.3,24,11,13,9,2,11,23,47.8,12,28,26,2,38,62,130,1
2416,Javi Sanchez,Valladolid,10.2,15,10,10,4,1,9,10,90.0,1,15,7,8,15,30,37,0
2418,Manu Sanchez,Osasuna,10.8,27,15,10,10,7,11,25,44.0,14,8,0,8,8,35,14,0
2419,Manu Sanchez,Atlético Madrid,0.5,0,0,0,0,0,0,1,0.0,1,1,0,1,0,0,1,0
2420,Juan Sanchez Mino,Elche,5.5,8,5,5,3,0,6,14,42.9,8,4,0,4,4,12,7,0
2421,Pepe Sanchez,Granada,2.8,4,2,2,2,0,3,4,75.0,1,5,2,3,4,8,9,0
2422,Robert Sanchez,Brighton,27.0,1,0,1,0,0,1,1,100.0,0,1,0,1,1,2,11,2
2423,Jadon Sancho,Dortmund,22.9,18,11,4,10,4,7,16,43.8,9,20,1,19,16,34,9,0
2424,Alex Sandro,Juventus,20.6,37,23,19,13,5,13,25,52.0,12,20,4,16,31,68,57,0
2425,Leroy Sane,Bayern Munich,20.1,18,10,2,10,6,13,30,43.3,17,23,1,22,9,27,8,1
2426,Salif Sane,Schalke 04,11.9,17,9,9,7,1,13,23,56.5,10,25,13,12,25,42,66,0
2427,Oier Sanjurjo,Osasuna,23.2,39,16,8,27,4,17,60,28.3,43,24,6,18,29,68,41,0
2428,Mohamed Sankoh,Stuttgart,0.2,0,0,0,0,0,0,0,0.0,0,1,0,1,0,0,0,0
2429,Siriki Sanogo,Benevento,0.1,0,0,0,0,0,0,0,0.0,0,0,0,0,0,0,0,0
2430,Morgan Sanson,Aston Villa,3.3,7,4,4,2,1,1,4,25.0,3,5,0,5,4,11,1,0
2431,Morgan Sanson,Marseille,9.2,21,12,6,12,3,9,28,32.1,19,12,0,12,9,30,5,0
2432,Nicola Sansone,Bologna,13.0,22,11,7,12,3,10,31,32.3,21,15,0,15,9,31,7,0
2433,Baptiste Santamaria,Angers,3.0,9,6,3,5,1,2,7,28.6,5,4,0,4,7,16,8,0
2434,Baptiste Santamaria,Freiburg,24.5,51,38,19,24,8,20,54,37.0,34,36,7,29,52,103,34,1
2435,Federico Santander,Bologna,0.4,0,0,0,0,0,0,0,0.0,0,0,0,0,0,0,0,0
2436,Davide Santon,Roma,6.5,4,3,2,2,0,3,7,42.9,4,10,1,9,4,8,12,0
2437,Samir Santos,Udinese,24.6,40,23,26,12,2,13,29,44.8,16,33,17,16,58,98,60,1
2438,Riccardo Saponara,Fiorentina,0.6,2,1,0,2,0,1,3,33.3,2,0,0,0,1,3,0,0
2439,Riccardo Saponara,Spezia,4.3,4,1,1,0,3,1,3,33.3,2,1,0,1,1,5,4,0
2440,Ivan Saponjic,Cádiz,4.3,1,0,0,1,0,0,2,0.0,2,2,0,2,1,2,4,0
2441,Pablo Sarabia,Paris S-G,14.7,15,11,6,6,3,10,38,26.3,28,9,1,8,5,20,8,0
2442,Josh Sargent,Werder Bremen,27.8,32,19,13,13,6,13,27,48.1,14,39,4,35,17,49,36,0
2444,Bouna Sarr,Marseille,0.8,1,1,0,0,1,1,1,100.0,0,1,1,0,1,2,1,0
2445,Bouna Sarr,Bayern Munich,5.0,9,8,4,3,2,3,6,50.0,3,7,0,7,10,19,7,1
2446,Sidy Sarr,Nîmes,5.1,10,6,4,6,0,2,5,40.0,3,1,1,0,7,17,4,0
2447,Marco Sau,Benevento,8.7,6,2,0,6,0,1,16,6.3,15,7,0,7,5,11,3,0
2448,Teji Savanier,Montpellier,24.1,49,33,16,25,8,22,73,30.1,51,28,6,22,38,87,15,0
2449,Stefan Savic,Atlético Madrid,32.8,40,25,32,7,1,21,34,61.8,13,33,19,14,42,82,110,0
2450,Romaine Sawyers,West Brom,16.5,30,18,16,12,2,14,43,32.6,29,20,4,16,18,48,12,3
2451,Gianluca Scamacca,Genoa,15.0,19,10,6,7,6,7,19,36.8,12,21,4,17,9,28,12,0
2452,Dane Scarlett,Tottenham,0.0,0,0,0,0,0,0,0,0.0,0,0,0,0,0,0,0,0
2453,Fabian Schar,Newcastle Utd,13.8,13,4,8,5,0,7,19,36.8,12,19,12,7,27,40,52,1
2454,Aurelien Scheidler,Dijon,3.8,2,0,0,2,0,0,2,0.0,2,0,0,0,1,3,5,0
2455,Nicolas Schiappacasse,Sassuolo,0.2,0,0,0,0,0,0,0,0.0,0,0,0,0,0,0,0,0
2456,Pasquale Schiattarella,Benevento,25.0,37,22,25,12,0,19,47,40.4,28,19,5,14,32,69,29,2
2457,Patrik Schick,Leverkusen,20.7,7,2,0,5,2,1,4,25.0,3,5,2,3,3,10,20,0
2458,Sven Schipplock,Arminia,8.3,15,8,7,6,2,6,27,22.2,21,13,2,11,6,21,8,0
2459,Xaver Schlager,Wolfsburg,29.2,66,40,20,38,8,22,68,32.4,46,50,6,44,54,120,38,0
2460,Keven Schlotterbeck,Freiburg,18.4,31,10,16,15,0,10,23,43.5,13,26,18,8,36,67,89,2
2461,Nico Schlotterbeck,Union Berlin,14.3,34,19,14,19,1,18,28,64.3,10,13,6,7,31,65,29,1
2462,Jeffrey Schlupp,Crystal Palace,15.9,29,16,14,12,3,6,23,26.1,17,24,8,16,22,51,16,0
2463,Kasper Schmeichel,Leicester City,38.0,0,0,0,0,0,0,0,0.0,0,0,0,0,0,0,10,0
2464,Jonathan Schmid,Freiburg,26.6,37,19,17,13,7,16,30,53.3,14,26,10,16,28,65,38,0
2465,Romano Schmid,Werder Bremen,13.1,22,16,8,10,4,8,35,22.9,27,21,0,21,8,30,6,0
2466,Benno Schmitz,Köln,4.6,14,7,6,7,1,7,13,53.8,6,8,2,6,6,20,7,0
2467,Morgan Schneiderlin,Nice,24.4,51,31,21,24,6,20,54,37.0,34,21,11,10,53,104,46,0
2468,Alessandro Schopf,Schalke 04,10.5,11,9,3,7,1,1,6,16.7,5,15,1,14,6,17,6,0
2470,Jerdy Schouten,Bologna,27.9,50,25,23,25,2,16,37,43.2,21,36,13,23,79,129,37,6
2471,Nico Schulz,Dortmund,6.8,9,6,4,3,2,2,11,18.2,9,12,4,8,6,15,10,0
2472,Alexander Schwolow,Hertha BSC,26.0,0,0,0,0,0,0,0,0.0,0,1,0,1,0,0,6,0
2473,Christopher Scott,Bayern Munich,0.4,2,1,0,1,1,2,2,100.0,0,0,0,0,0,2,1,0
2474,Matteo Scozzarella,Parma,1.7,4,0,3,1,0,2,3,66.7,1,3,1,2,6,10,0,0
2475,Simone Scuffet,Udinese,1.0,0,0,0,0,0,0,0,0.0,0,0,0,0,0,0,0,0
2476,Jacopo Segre,Torino,2.1,5,2,2,1,2,2,5,40.0,3,0,0,0,0,5,1,0
2477,Davie Selke,Werder Bremen,9.0,3,2,1,1,1,0,6,0.0,6,3,2,1,1,4,7,0
2478,Malik Sellouki,Nice,0.7,0,0,0,0,0,0,1,0.0,1,2,0,2,2,2,0,0
2479,Matz Sels,Strasbourg,6.0,0,0,0,0,0,0,0,0.0,0,0,0,0,0,0,4,0
2480,Nelson Semedo,Wolves,33.1,85,48,53,23,9,42,72,58.3,30,30,10,20,41,126,78,2
2481,Leo Sena,Spezia,9.8,22,12,7,10,5,12,26,46.2,14,19,4,15,11,33,5,0
2482,Stefano Sensi,Inter,6.7,9,6,3,5,1,4,11,36.4,7,6,1,5,7,16,1,0
2483,Jaime Seoane,Huesca,22.9,50,30,20,23,7,24,65,36.9,41,27,6,21,17,67,14,0
2484,Luigi Sepe,Parma,36.0,0,0,0,0,0,0,2,0.0,2,0,0,0,2,2,13,2
2485,Suat Serdar,Schalke 04,21.7,55,35,18,33,4,17,52,32.7,35,29,4,25,23,78,21,0
2486,Jean Seri,Bordeaux,7.9,17,9,3,12,2,4,15,26.7,11,8,2,6,12,29,7,0
2487,Femi Seriki,Sheffield Utd,0.0,0,0,0,0,0,0,0,0.0,0,0,0,0,0,0,0,0
2488,Ryan Sessegnon,Hoffenheim,17.5,47,25,26,13,8,15,34,44.1,19,26,3,23,30,77,46,0
2489,Nils Seufert,Arminia,3.8,12,9,2,5,5,2,8,25.0,6,3,1,2,5,17,6,0
2490,Edgar Sevikyan,Levante,0.1,0,0,0,0,0,0,0,0.0,0,0,0,0,0,0,0,0
2491,Stephan El Shaarawy,Roma,6.4,4,3,0,3,1,2,9,22.2,7,3,1,2,3,7,2,0
2492,Jamie Shackleton,Leeds United,5.1,10,6,6,4,0,4,11,36.4,7,3,1,2,9,19,3,0
2493,Xherdan Shaqiri,Liverpool,6.2,7,4,3,1,3,2,7,28.6,5,4,0,4,2,9,0,0
2494,Billy Sharp,Sheffield Utd,8.2,5,1,0,3,2,2,9,22.2,7,2,0,2,0,5,2,0
2496,Luke Shaw,Manchester Utd,29.5,44,28,21,16,7,21,36,58.3,15,34,9,25,20,64,44,2
2497,Jonjo Shelvey,Newcastle Utd,29.1,39,14,18,19,2,10,37,27.0,27,26,14,12,36,75,42,0
2498,Eldor Shomurodov,Genoa,18.6,28,14,7,13,8,9,37,24.3,28,17,2,15,6,34,11,0
2499,Shola Shoretire,Manchester Utd,0.1,0,0,0,0,0,0,0,0.0,0,0,0,0,0,0,0,0
2500,Mahame Siby,Strasbourg,0.2,0,0,0,0,0,0,1,0.0,1,0,0,0,0,0,1,0
2501,Abdoulaye Sidibe,Saint-Étienne,0.1,1,1,1,0,0,1,2,50.0,1,0,0,0,0,1,0,0
2502,Djibril Sidibe,Monaco,22.0,58,34,26,29,3,37,52,71.2,15,20,5,15,50,108,37,2
2503,Sidnei,Betis,7.7,9,3,6,3,0,4,9,44.4,5,6,4,2,16,25,28,0
2504,Kaj Sierhuis,Reims,7.2,7,2,1,2,4,2,9,22.2,7,2,1,1,2,9,5,0
2505,Tim Siersleben,Wolfsburg,0.4,2,2,2,0,0,1,1,100.0,0,1,0,1,0,2,0,0
2506,Gylfi Sigurdsson,Everton,25.0,30,20,9,14,7,13,44,29.5,31,31,2,29,34,64,21,1
2507,Luca Siligardi,Crotone,0.5,4,2,0,3,1,1,5,20.0,4,0,0,0,0,4,0,0
2508,Luca Siligardi,Parma,0.4,0,0,0,0,0,0,2,0.0,2,0,0,0,0,0,0,0
2509,Adrien Silva,Sampdoria,17.8,49,22,21,22,6,18,54,33.3,36,34,1,33,30,79,10,1
2510,Andre Silva,Eint Frankfurt,30.7,11,2,0,7,4,6,13,46.2,7,11,1,10,3,14,15,0
2511,Bernardo Silva,Manchester City,22.9,26,14,7,12,7,11,52,21.2,41,17,1,16,17,43,8,0
2512,Caio Henrique Oliveira Silva,Monaco,26.3,50,34,25,20,5,31,51,60.8,20,20,3,17,16,66,37,0
2513,David Silva,Real Sociedad,15.5,19,12,2,14,3,8,21,38.1,13,14,1,13,13,32,8,2
2514,Fabio Silva,Wolves,15.2,6,4,1,4,1,4,12,33.3,8,12,1,11,4,10,5,1
2515,Florent da Silva,Lyon,0.0,0,0,0,0,0,0,0,0.0,0,0,0,0,0,0,0,0
2516,Gabriel Silva,Saint-Étienne,3.9,7,6,7,0,0,1,2,50.0,1,4,1,3,6,13,8,0
2517,Gaston Silva,Huesca,6.7,16,12,11,5,0,8,14,57.1,6,10,4,6,11,27,16,0
2518,Rui Silva,Granada,32.0,1,0,1,0,0,1,3,33.3,2,0,0,0,2,3,14,0
2519,Thiago Silva,Chelsea,21.5,20,12,11,8,1,14,21,66.7,7,21,13,8,33,53,86,1
2520,Marco Silvestri,Hellas Verona,34.0,0,0,0,0,0,0,0,0.0,0,0,0,0,0,0,14,1
2522,Mohamed Simakan,Strasbourg,17.9,32,22,21,6,5,9,18,50.0,9,17,11,6,31,63,41,0
2523,Giovanni Simeone,Cagliari,19.3,24,11,2,15,7,7,31,22.6,24,23,1,22,10,34,18,0
2524,Moses Simon,Nantes,25.8,27,14,11,9,7,17,36,47.2,19,24,1,23,15,42,15,1
2525,Unai Simon,Athletic Club,37.0,1,0,1,0,0,1,2,50.0,1,0,0,0,0,1,7,7
2526,Xavi Simons,Paris S-G,0.0,0,0,0,0,0,0,0,0.0,0,0,0,0,0,0,0,0
2527,Joan Simun Edmundsson,Arminia,0.6,0,0,0,0,0,0,0,0.0,0,1,0,1,1,1,0,0
2528,Wilfried Singo,Torino,20.6,29,14,16,6,7,17,33,51.5,16,13,3,10,29,58,40,0
2529,Daley Sinkgraven,Leverkusen,17.4,32,17,13,16,3,18,35,51.4,17,22,5,17,23,55,23,0
2530,Dimitris Siovas,Huesca,34.1,46,24,34,10,2,20,30,66.7,10,38,17,21,62,108,125,2
2531,Tobias Sippel,M'Gladbach,3.8,0,0,0,0,0,0,0,0.0,0,0,0,0,1,1,4,0
2532,Salvatore Sirigu,Torino,32.0,1,0,1,0,0,1,2,50.0,1,0,0,0,0,1,6,2
2533,Issouf Sissokho,Bordeaux,0.9,6,4,4,2,0,3,6,50.0,3,2,0,2,1,7,0,0
2534,Ibrahima Sissoko,Strasbourg,28.7,68,48,25,35,8,28,68,41.2,40,22,5,17,48,116,44,0
2535,Moussa Sissoko,Tottenham,17.6,22,16,19,3,0,8,20,40.0,12,11,4,7,23,45,25,0
2536,Nelson Sissoko,Saint-Étienne,5.3,12,6,6,3,3,7,12,58.3,5,2,1,1,12,24,16,1
2537,Antonio Sivera,Alavés,0.8,0,0,0,0,0,0,0,0.0,0,0,0,0,0,0,0,0
2538,Jacques Siwe,Dijon,1.9,4,1,1,1,2,0,1,0.0,1,1,0,1,1,5,1,0
2539,Ellyes Skhiri,Köln,30.9,83,48,44,31,8,33,65,50.8,32,49,13,36,82,165,38,2
2540,Lukasz Skorupski,Bologna,28.0,1,1,1,0,0,1,4,25.0,3,0,0,0,0,1,23,5
2541,Andreas Skov Olsen,Bologna,13.1,19,10,11,4,4,11,21,52.4,10,15,0,15,3,22,25,0
2542,Robert Skov,Hoffenheim,12.9,19,10,9,7,3,7,16,43.8,9,9,2,7,15,34,10,1
2543,Milan Skriniar,Inter,30.9,48,32,29,16,3,23,34,67.6,11,30,19,11,30,78,89,1
2544,Steven Skrzybski,Schalke 04,4.7,5,4,0,5,0,1,7,14.3,6,13,1,12,5,10,1,1
2545,Petar Skuletic,Montpellier,2.6,3,2,1,2,0,0,5,0.0,5,4,2,2,0,3,4,0
2546,Islam Slimani,Leicester City,0.2,0,0,0,0,0,0,0,0.0,0,0,0,0,0,0,0,0
2548,Islam Slimani,Lyon,6.4,7,5,3,1,3,3,12,25.0,9,4,1,3,1,8,6,0
2549,William Smallbone,Southampton,1.9,6,3,2,4,0,1,3,33.3,2,5,0,5,2,8,1,0
2550,Chris Smalling,Roma,12.3,14,8,5,7,2,6,10,60.0,4,17,11,6,28,42,46,1
2551,Emile Smith Rowe,Arsenal,16.0,14,7,5,5,4,6,17,35.3,11,15,1,14,10,24,12,0
2552,Robert Snodgrass,West Brom,5.8,17,12,12,4,1,10,16,62.5,6,11,2,9,1,18,12,0
2553,Robert Snodgrass,West Ham,0.1,0,0,0,0,0,0,0,0.0,0,0,0,0,0,0,0,0
2554,Cedric Soares,Arsenal,8.3,12,8,6,4,2,6,21,28.6,15,6,1,5,8,20,16,1
2555,Rafa Soares,Eibar,12.6,28,17,16,8,4,15,21,71.4,6,14,4,10,20,48,32,0
2556,Ruben Sobrino,Valencia,0.5,1,1,1,0,0,0,1,0.0,1,0,0,0,0,1,1,0
2557,Ruben Sobrino,Cádiz,12.4,29,13,8,16,5,8,18,44.4,10,19,0,19,15,44,11,0
2558,Simon Sohm,Parma,10.0,18,12,11,6,1,11,26,42.3,15,8,0,8,5,23,7,0
2559,Augusto Solari,Celta Vigo,5.4,18,13,9,8,1,6,26,23.1,20,13,1,12,6,24,5,0
2560,Roberto Soldado,Granada,16.0,7,4,1,4,2,2,11,18.2,9,8,0,8,4,11,13,1
2561,Carlos Soler,Valencia,30.4,41,24,14,24,3,19,52,36.5,33,35,11,24,23,64,41,0
2562,Yann Sommer,M'Gladbach,30.1,1,1,1,0,0,1,1,100.0,0,0,0,0,2,3,9,2
2563,Son,Levante,12.3,18,10,11,6,1,9,19,47.4,10,11,2,9,12,30,20,0
2564,Brandon Soppy,Rennes,6.2,21,15,16,5,0,10,16,62.5,6,3,0,3,6,27,12,0
2565,David Soria,Getafe,28.0,2,2,2,0,0,1,3,33.3,2,0,0,0,1,3,12,0
2566,Roberto Soriano,Bologna,36.1,48,26,15,20,13,15,64,23.4,49,31,8,23,18,66,43,0
2567,Alberto Soro,Granada,4.4,7,2,2,4,1,4,10,40.0,6,7,0,7,1,8,2,0
2568,Borna Sosa,Stuttgart,22.7,14,10,6,6,2,8,25,32.0,17,23,4,19,31,45,74,0
2569,Hugo Sotelo,Celta Vigo,0.0,0,0,0,0,0,0,0,0.0,0,0,0,0,0,0,0,0
2570,Florian Sotoca,Lens,26.8,31,20,3,20,8,6,22,27.3,16,27,0,27,9,40,24,0
2571,Riccardo Sottil,Cagliari,13.2,7,3,2,3,2,0,7,0.0,7,4,0,4,5,12,3,0
2572,Cheick Souare,Marseille,0.1,0,0,0,0,0,0,0,0.0,0,1,1,0,1,1,0,0
2574,Tomas Soucek,West Ham,38.0,78,41,37,36,5,28,77,36.4,49,43,18,25,62,140,107,0
2575,Rayan Souici,Saint-Étienne,0.1,0,0,0,0,0,0,0,0.0,0,0,0,0,0,0,0,0
2576,Cebio Soukou,Arminia,5.1,12,8,5,5,2,6,11,54.5,5,3,0,3,3,15,4,0
2577,Adama Soumaoro,Bologna,19.5,24,14,17,7,0,6,12,50.0,6,28,23,5,20,44,72,0
2578,Adama Soumaoro,Lille,1.6,1,0,0,0,1,0,0,0.0,0,1,1,0,2,3,2,0
2579,Boubakary Soumare,Lille,21.3,44,29,16,25,3,14,29,48.3,15,14,6,8,39,83,21,0
2580,Yaya Soumare,Lyon,0.0,1,1,1,0,0,1,2,50.0,1,0,0,0,2,3,0,0
2581,Arnaud Souquet,Montpellier,13.6,50,33,35,13,2,27,48,56.3,21,15,6,9,17,67,34,0
2582,Ansou Sow,Lens,0.1,0,0,0,0,0,0,0,0.0,0,1,0,1,0,0,0,0
2583,Djibril Sow,Eint Frankfurt,24.2,58,33,19,32,7,18,41,43.9,23,31,8,23,51,109,17,0
2584,Saidou Sow,Saint-Étienne,11.1,23,12,17,6,0,13,19,68.4,6,12,8,4,14,37,39,1
2585,Caglar Soyuncu,Leicester City,20.2,27,17,13,14,0,17,30,56.7,13,12,9,3,28,55,80,1
2586,Leonardo Spinazzola,Roma,23.6,12,6,3,9,0,8,20,40.0,12,16,1,15,25,37,31,0
2587,Marco Sportiello,Atalanta,14.0,2,2,2,0,0,1,3,33.3,2,0,0,0,2,4,5,1
2588,Mattia Sprocati,Parma,0.2,1,0,0,1,0,1,1,100.0,0,0,0,0,1,2,0,0
2589,Jerry St. Juste,Mainz 05,32.0,65,38,37,26,2,20,36,55.6,16,46,27,19,64,129,82,1
2590,Benjamin Stambouli,Schalke 04,21.7,45,29,24,18,3,15,37,40.5,22,42,14,28,49,94,45,1
2591,Josip Stanisic,Bayern Munich,1.0,2,2,1,1,0,1,1,100.0,0,3,0,3,2,4,2,0
2592,Niklas Stark,Hertha BSC,31.0,49,28,20,27,2,13,31,41.9,18,43,16,27,42,91,101,0
2593,Renato Steffen,Wolfsburg,17.4,24,15,6,12,6,13,24,54.2,11,21,2,19,22,46,15,0
2594,Zack Steffen,Manchester City,1.0,0,0,0,0,0,0,0,0.0,0,0,0,0,0,0,0,0
2595,Pascal Stenzel,Stuttgart,14.2,33,14,15,17,1,22,50,44.0,28,19,4,15,26,59,39,1
2596,Dale Stephens,Burnley,2.9,11,6,2,7,2,3,6,50.0,3,3,0,3,8,19,2,0
2597,Jack Stephens,Southampton,17.1,34,19,19,15,0,17,38,44.7,21,25,14,11,28,62,64,2
2598,Raheem Sterling,Manchester City,28.2,21,10,5,12,4,5,12,41.7,7,15,0,15,15,36,4,0
2600,Enda Stevens,Sheffield Utd,30.0,59,26,32,19,8,33,58,56.9,25,41,12,29,22,81,81,1
2601,Lars Stindl,M'Gladbach,21.8,24,17,3,16,5,7,32,21.9,25,26,3,23,13,37,14,0
2602,Kevin Stoger,Mainz 05,6.0,12,6,2,9,1,5,16,31.3,11,5,0,5,6,18,4,0
2603,John Stones,Manchester City,21.5,21,10,13,5,3,9,14,64.3,5,23,15,8,18,39,56,1
2604,Thomas Strakosha,Lazio,9.0,1,1,1,0,0,0,0,0.0,0,0,0,0,1,2,4,0
2605,Tobias Strobl,Augsburg,20.5,21,10,12,9,0,10,30,33.3,20,21,8,13,28,49,27,0
2606,Kevin Strootman,Genoa,14.6,30,18,13,15,2,14,32,43.8,18,35,3,32,25,55,18,0
2607,Kevin Strootman,Marseille,2.6,9,6,5,4,0,4,8,50.0,4,5,2,3,5,14,7,0
2608,Pascal Struijk,Leeds United,23.1,49,30,28,19,2,17,28,60.7,11,35,21,14,47,96,92,0
2609,Jens Stryger Larsen,Udinese,29.3,17,11,14,3,0,8,25,32.0,17,26,11,15,24,41,65,0
2610,Stefano Sturaro,Hellas Verona,4.7,4,3,3,0,1,2,8,25.0,6,5,1,4,5,9,10,0
2611,Stefano Sturaro,Genoa,4.9,11,5,3,6,2,3,15,20.0,12,5,0,5,7,18,2,0
2612,Damian Suarez,Getafe,27.0,59,39,29,23,7,30,81,37.0,51,43,2,41,31,90,42,0
2613,Denis Suarez,Celta Vigo,31.7,64,32,22,30,12,21,94,22.3,73,30,2,28,22,86,15,2
2614,Luis Suarez,Atlético Madrid,27.9,11,7,0,4,7,3,12,25.0,9,7,0,7,5,16,13,0
2615,Marek Suchy,Augsburg,3.4,4,2,1,3,0,1,2,50.0,1,3,3,0,4,8,9,0
2616,Niklas Sule,Bayern Munich,16.7,32,21,15,14,3,13,21,61.9,8,24,12,12,21,53,36,1
2617,Suso,Sevilla,24.6,20,10,8,6,6,10,41,24.4,31,12,0,12,8,28,8,0
2618,Bosko Sutalo,Atalanta,2.6,5,5,0,3,2,4,5,80.0,1,2,1,1,2,7,7,1
2619,Mattias Svanberg,Bologna,20.6,38,17,21,9,8,16,45,35.6,29,25,4,21,30,68,25,1
2620,Abdoulaye Sylla,Nantes,0.1,2,1,2,0,0,1,1,100.0,0,1,0,1,0,2,1,0
2621,Issiaga Sylla,Lens,12.4,28,20,11,17,0,11,21,52.4,10,13,3,10,16,44,21,0
2622,Eddy Sylvestre,Nice,1.1,1,1,1,0,0,0,1,0.0,1,1,0,1,1,2,0,0
2623,Adam Szalai,Mainz 05,8.1,7,6,3,2,2,2,8,25.0,6,4,1,3,2,9,4,0
2624,Wojciech Szczesny,Juventus,29.7,0,0,0,0,0,0,0,0.0,0,2,0,2,3,3,5,1
2626,Frederik Sorensen,Köln,1.1,2,1,0,2,0,1,1,100.0,0,2,0,2,0,2,0,0
2627,Alexander Sorloth,RB Leipzig,16.0,7,5,0,5,2,2,14,14.3,12,13,2,11,3,10,13,0
2628,Tachi,Alavés,9.4,11,9,9,2,0,6,14,42.9,8,9,6,3,11,22,32,0
2629,Jonathan Tah,Leverkusen,24.7,30,17,19,9,2,11,21,52.4,10,19,12,7,33,63,89,1
2630,Waniss Taibi,Angers,0.4,0,0,0,0,0,0,2,0.0,2,1,0,1,0,0,0,0
2631,Flavien Tait,Rennes,15.2,26,11,11,12,3,10,32,31.3,22,17,3,14,13,39,2,0
2632,Adrien Tameze,Hellas Verona,25.6,39,25,23,15,1,11,27,40.7,16,31,8,23,32,71,46,2
2633,Japhet Tanganga,Tottenham,5.4,5,4,3,2,0,1,3,33.3,2,6,5,1,3,8,15,0
2634,Renato Tapia,Celta Vigo,30.0,93,44,50,34,9,32,83,38.6,51,56,13,43,53,146,75,2
2635,Edmond Tapsoba,Leverkusen,29.5,54,28,35,18,1,21,45,46.7,24,55,29,26,48,102,96,0
2636,Matt Targett,Aston Villa,37.8,83,39,52,20,11,56,88,63.6,32,40,14,26,55,138,102,1
2637,James Tarkowski,Burnley,36.0,66,39,52,11,3,25,49,51.0,24,54,42,12,44,110,163,1
2638,Ciprian Tatarusanu,Milan,1.0,0,0,0,0,0,0,0,0.0,0,0,0,0,0,0,0,1
2639,Percy Tau,Brighton,1.1,1,1,1,0,0,0,2,0.0,2,1,0,1,0,1,1,0
2640,Niklas Tauer,Mainz 05,0.8,1,1,0,1,0,1,2,50.0,1,3,1,2,3,4,1,0
2641,Heriberto Tavares,Brest,0.5,2,0,0,0,2,1,3,33.3,2,0,0,0,1,3,1,0
2642,Sidnei Tavares,Leicester City,0.9,1,1,0,1,0,0,0,0.0,0,1,1,0,0,1,0,0
2643,Tomas Tavares,Alavés,0.7,2,1,2,0,0,2,2,100.0,0,1,0,1,0,2,1,0
2644,Charlie Taylor,Burnley,27.0,48,28,30,15,3,25,46,54.3,21,36,19,17,29,77,87,2
2645,Neil Taylor,Aston Villa,0.2,1,1,1,0,0,0,0,0.0,0,1,0,1,0,1,0,0
2646,Allan Tchaptchet,Southampton,0.1,0,0,0,0,0,0,0,0.0,0,0,0,0,0,0,0,0
2647,Warren Tchimbembe,Metz,5.5,7,4,4,3,0,3,9,33.3,6,6,1,5,2,9,3,0
2648,Aurelien Tchouameni,Monaco,34.0,127,68,47,62,18,48,92,52.2,44,39,11,28,60,187,47,0
2649,Alvaro Tejero,Eibar,1.2,1,1,0,0,1,1,3,33.3,2,1,0,1,3,4,6,0
2650,Nathan Tella,Southampton,8.3,8,5,1,4,3,6,15,40.0,9,13,0,13,3,11,2,0
2652,Alex Telles,Manchester Utd,7.7,14,7,10,3,1,8,17,47.1,9,7,2,5,16,30,20,0
2653,Andres Tello,Benevento,4.6,9,6,8,0,1,5,20,25.0,15,8,1,7,6,15,6,0
2654,Cristian Tello,Betis,14.3,16,10,5,9,2,4,22,18.2,18,14,0,14,11,27,8,0
2655,Lino Tempelmann,Freiburg,3.0,5,3,2,2,1,0,4,0.0,4,6,1,5,2,7,6,0
2656,Hidde ter Avest,Udinese,3.9,5,2,3,2,0,2,5,40.0,3,3,1,2,2,7,5,0
2657,Marc-Andre ter Stegen,Barcelona,31.0,0,0,0,0,0,0,2,0.0,2,0,0,0,0,0,12,2
2658,Pietro Terracciano,Fiorentina,3.0,0,0,0,0,0,0,0,0.0,0,0,0,0,0,0,1,0
2659,Martin Terrier,Rennes,27.1,33,15,5,15,13,10,36,27.8,26,23,0,23,16,49,7,0
2660,Claudio Terzi,Spezia,20.8,34,21,19,14,1,19,28,67.9,9,23,12,11,35,69,55,1
2661,Kenny Tete,Fulham,16.5,48,30,27,16,5,10,18,55.6,8,14,5,9,27,75,49,0
2662,Kenny Tete,Lyon,0.2,2,0,1,1,0,0,0,0.0,0,0,0,0,2,4,0,0
2663,Cedric Teuchert,Union Berlin,8.4,7,5,2,4,1,3,16,18.8,13,12,0,12,5,12,6,0
2664,Florian Thauvin,Marseille,30.4,40,22,14,21,5,20,54,37.0,34,26,2,24,14,54,11,0
2665,Malick Thiaw,Schalke 04,16.1,42,27,24,17,1,15,26,57.7,11,17,12,5,33,75,70,0
2666,Jan Thielmann,Köln,11.4,11,6,1,8,2,5,9,55.6,4,10,1,9,9,20,2,0
2667,Sada Thioub,Angers,14.0,17,14,7,6,4,7,23,30.4,16,10,0,10,9,26,3,0
2668,William Thomas Fish,Manchester Utd,0.0,0,0,0,0,0,0,0,0.0,0,0,0,0,0,0,0,0
2669,Luke Thomas,Leicester City,10.8,23,14,11,5,7,14,21,66.7,7,15,2,13,17,40,21,0
2670,Romain Thomas,Angers,33.6,47,25,34,11,2,20,35,57.1,15,35,20,15,50,97,138,0
2671,Adrien Thomasson,Strasbourg,29.2,36,17,8,16,12,12,58,20.7,46,44,5,39,22,58,2,0
2672,Erik Thommy,Stuttgart,3.5,3,1,0,3,0,0,3,0.0,3,3,0,3,3,6,4,0
2673,Morten Thorsby,Sampdoria,29.4,76,42,32,36,8,20,60,33.3,40,51,16,35,25,101,30,0
2674,Khephren Thuram,Nice,16.6,32,16,5,21,6,9,27,33.3,18,21,9,12,18,50,22,1
2675,Marcus Thuram,M'Gladbach,19.2,24,14,9,10,5,10,23,43.5,13,27,4,23,15,39,13,1
2676,Cheikh Tidiane Sabaly,Metz,0.1,0,0,0,0,0,0,0,0.0,0,0,0,0,0,0,0,0
2678,Youri Tielemans,Leicester City,37.3,86,45,32,38,16,45,108,41.7,63,35,8,27,46,132,20,1
2679,Kieran Tierney,Arsenal,25.5,27,15,5,14,8,11,31,35.5,20,31,10,21,16,43,63,0
2680,Steffen Tigges,Dortmund,0.6,4,4,0,1,3,2,3,66.7,1,1,0,1,0,4,1,0
2681,Guus Til,Freiburg,1.4,4,3,2,1,1,2,3,66.7,1,2,0,2,2,6,2,0
2682,David Timor,Getafe,15.5,13,9,5,6,2,9,21,42.9,12,5,1,4,19,32,32,1
2683,Jean-Clair Todibo,Nice,14.8,25,15,16,9,0,16,31,51.6,15,13,7,6,19,44,48,1
2684,Karl Toko Ekambi,Lyon,31.2,16,10,5,3,8,8,32,25.0,24,20,1,19,26,42,8,0
2685,Corentin Tolisso,Bayern Munich,8.7,19,19,4,11,4,9,29,31.0,20,15,2,13,6,25,8,0
2686,Jeremy Toljan,Sassuolo,16.6,21,12,16,3,2,12,27,44.4,15,15,7,8,13,34,28,0
2687,Rafael Toloi,Atalanta,28.2,51,23,21,26,4,26,48,54.2,22,37,7,30,33,84,66,0
2688,Takehiro Tomiyasu,Bologna,30.2,47,31,27,14,6,21,34,61.8,13,37,19,18,54,101,106,0
2689,James Tomkins,Crystal Palace,6.1,4,2,4,0,0,3,4,75.0,1,4,3,1,4,8,45,0
2690,Fikayo Tomori,Chelsea,0.5,2,1,2,0,0,0,0,0.0,0,1,1,0,2,4,8,0
2691,Fikayo Tomori,Milan,16.3,28,18,17,9,2,8,14,57.1,6,32,20,12,18,46,61,1
2692,Sandro Tonali,Milan,14.8,28,19,14,13,1,13,28,46.4,15,18,5,13,22,50,18,0
2693,Lorenzo Tonelli,Sampdoria,19.8,33,18,20,11,2,10,21,47.6,11,21,14,7,25,58,94,1
2694,Tono,Levante,8.1,4,0,4,0,0,0,2,0.0,2,10,1,9,7,11,12,0
2695,Omer Toprak,Werder Bremen,21.6,23,16,15,6,2,12,24,50.0,12,27,16,11,36,59,115,1
2696,Tyron Tormin,Saint-Étienne,0.2,0,0,0,0,0,0,0,0.0,0,0,0,0,0,0,0,0
2697,Ernesto Torregrossa,Sampdoria,1.9,1,1,0,0,1,0,2,0.0,2,4,0,4,1,2,1,0
2698,Lucas Torreira,Atlético Madrid,5.8,8,4,2,3,3,0,3,0.0,3,5,3,2,12,20,8,0
2699,Ferran Torres,Manchester City,14.5,12,5,4,6,2,5,16,31.3,11,16,0,16,3,15,8,0
2700,Oliver Torres,Sevilla,15.6,34,22,13,15,6,19,53,35.8,34,15,0,15,15,49,9,0
2701,Pau Torres,Villarreal,33.0,17,11,10,5,2,11,18,61.1,7,33,25,8,23,40,111,1
2702,Roberto Torres,Osasuna,21.0,15,8,6,5,4,8,29,27.6,21,12,0,12,16,31,13,0
2704,Lucas Torro,Osasuna,17.2,32,15,11,19,2,21,34,61.8,13,16,7,9,27,59,43,0
2705,Jordan Torunarigha,Hertha BSC,10.8,7,4,7,0,0,5,8,62.5,3,8,2,6,15,22,54,1
2706,Cenk Tosun,Everton,0.5,0,0,0,0,0,0,1,0.0,1,0,0,0,0,0,0,0
2707,Abdoulaye Toure,Nantes,18.7,28,12,10,16,2,14,31,45.2,17,17,2,15,22,50,19,0
2708,Almamy Toure,Eint Frankfurt,7.8,18,12,8,7,3,10,14,71.4,4,5,1,4,8,26,22,0
2709,Lucas Tousart,Hertha BSC,23.2,33,18,16,15,2,13,27,48.1,14,33,6,27,40,73,52,0
2710,Andros Townsend,Crystal Palace,25.1,78,41,45,20,13,30,79,38.0,49,48,2,46,41,119,19,0
2711,Conor Townsend,West Brom,24.8,44,28,32,9,3,30,49,61.2,19,38,15,23,36,80,55,2
2712,Matteo Tramoni,Cagliari,0.8,4,2,2,1,1,1,2,50.0,1,5,0,5,1,5,2,0
2713,Adama Traore,Wolves,29.4,28,16,11,13,4,13,21,61.9,8,23,1,22,7,35,12,1
2714,Amadou Traore,Bordeaux,3.4,6,1,2,2,2,2,9,22.2,7,9,0,9,1,7,2,0
2715,Bertrand Traore,Aston Villa,25.7,26,10,8,10,8,10,34,29.4,24,23,1,22,15,41,14,1
2716,Boubacar Traore,Metz,0.6,3,2,1,2,0,1,1,100.0,0,1,0,1,0,3,0,0
2717,Chaka Traore,Parma,0.2,0,0,0,0,0,0,0,0.0,0,0,0,0,0,0,1,1
2718,Charles Traore,Nantes,18.9,53,34,30,17,6,27,54,50.0,27,26,5,21,36,89,65,0
2719,Cheick Traore,Lens,0.4,2,2,1,1,0,2,4,50.0,2,1,0,1,2,4,1,0
2720,Hamari Traore,Rennes,33.3,56,38,23,27,6,22,59,37.3,37,31,5,26,76,132,50,0
2721,Ibrahima Traore,M'Gladbach,1.1,4,1,1,2,1,0,0,0.0,0,2,0,2,0,4,0,0
2722,Ismael Traore,Angers,33.3,32,14,23,9,0,20,37,54.1,17,27,13,14,40,72,107,0
2723,Kevin Trapp,Eint Frankfurt,33.0,0,0,0,0,0,0,1,0.0,1,1,0,1,3,3,11,3
2724,Miguel Trauco,Saint-Étienne,22.6,47,29,25,14,8,23,43,53.5,20,19,4,15,30,77,34,1
2725,Trezeguet,Aston Villa,13.0,33,18,14,15,4,13,45,28.9,32,13,1,12,19,52,17,0
2726,Manu Trigueros,Villarreal,28.1,51,30,25,21,5,21,77,27.3,56,32,2,30,17,68,19,0
2727,Christopher Trimmel,Union Berlin,28.6,50,25,28,18,4,28,54,51.9,26,32,7,25,50,100,99,0
2728,Francisco Trincao,Barcelona,7.8,4,2,0,3,1,2,5,40.0,3,4,0,4,1,5,2,0
2730,Alessandro Tripaldelli,Cagliari,3.3,13,6,5,6,2,5,6,83.3,1,6,1,5,3,16,15,0
2731,Kieran Trippier,Atlético Madrid,27.5,61,39,30,25,6,26,52,50.0,26,22,4,18,40,101,58,1
2732,Leandro Trossard,Brighton,29.0,33,14,11,16,6,10,36,27.8,26,34,2,32,26,59,7,1
2733,Alexis Trouillet,Nice,1.2,5,4,1,4,0,4,5,80.0,1,0,0,0,3,8,0,0
2734,Adrien Truffert,Rennes,21.7,38,18,18,12,8,13,24,54.2,11,26,5,21,18,56,38,1
2735,Marvin Tshibuabua,Saint-Étienne,0.5,1,0,1,0,0,0,0,0.0,0,0,0,0,1,2,1,0
2736,Kostas Tsimikas,Liverpool,0.1,0,0,0,0,0,0,0,0.0,0,0,0,0,0,0,0,0
2737,Axel Tuanzebe,Manchester Utd,4.5,13,7,5,7,1,8,9,88.9,1,7,5,2,3,16,18,0
2738,Alessandro Tuia,Benevento,19.6,39,17,34,4,1,15,25,60.0,10,22,10,12,36,75,91,1
2739,Lubomir Tupta,Hellas Verona,0.6,0,0,0,0,0,0,0,0.0,0,0,0,0,0,0,0,0
2740,Tuta,Eint Frankfurt,16.2,35,20,22,13,0,24,43,55.8,19,19,2,17,29,64,53,0
2741,Destiny Udogie,Hellas Verona,1.9,6,4,2,2,2,2,2,100.0,0,3,0,3,2,8,4,0
2742,Matthieu Udol,Metz,19.2,34,21,18,12,4,17,39,43.6,22,25,5,20,39,73,30,0
2743,Naomichi Ueda,Nîmes,7.9,4,2,3,1,0,4,6,66.7,2,5,4,1,6,10,30,1
2744,Lesley Ugochukwu,Rennes,0.7,3,1,0,3,0,2,3,66.7,1,1,0,1,0,3,0,0
2745,Hwang Ui-jo,Bordeaux,27.8,14,6,5,8,1,6,25,24.0,19,17,2,15,8,22,14,0
2746,Samir Ujkani,Torino,1.0,0,0,0,0,0,0,0,0.0,0,0,0,0,0,0,1,0
2747,Samuel Umtiti,Barcelona,7.2,5,1,3,2,0,1,2,50.0,1,11,6,5,9,14,15,0
2748,Enes Unal,Getafe,14.6,11,3,0,8,3,4,15,26.7,11,11,0,11,2,13,14,0
2749,Cengiz Under,Leicester City,3.1,4,1,0,3,1,3,5,60.0,2,3,0,3,2,6,0,0
2750,Dayot Upamecano,RB Leipzig,25.9,37,30,18,19,0,14,20,70.0,6,25,14,11,33,70,74,2
2751,Kacper Urbanski,Bologna,0.0,0,0,0,0,0,0,0,0.0,0,0,0,0,0,0,0,0
2752,Mark Uth,Schalke 04,16.6,25,13,13,10,2,5,23,21.7,18,21,0,21,5,30,10,0
2753,Tomas Vaclik,Sevilla,5.0,0,0,0,0,0,0,1,0.0,1,0,0,0,0,0,0,1
2754,Eugeni Valderrama,Huesca,1.3,2,2,1,0,1,0,1,0.0,1,0,0,0,5,7,3,0
2756,Lautaro Valenti,Parma,5.5,10,4,7,2,1,6,15,40.0,9,11,3,8,11,21,30,0
2757,Antoine Valerio,Nîmes,0.8,0,0,0,0,0,0,1,0.0,1,1,0,1,2,2,0,0
2758,Borja Valero,Fiorentina,5.5,13,9,7,4,2,3,15,20.0,12,6,1,5,6,19,2,0
2759,Yan Valery,Southampton,1.1,5,3,2,3,0,1,5,20.0,4,2,0,2,2,7,5,0
2760,Jesus Vallejo,Granada,15.0,11,6,7,3,1,7,18,38.9,11,21,11,10,13,24,55,0
2761,Manu Vallejo,Valencia,10.6,18,8,5,8,5,5,26,19.2,21,8,0,8,3,21,3,0
2762,Federico Valverde,Real Madrid,14.8,25,16,9,8,8,10,26,38.5,16,16,2,14,22,47,4,0
2763,Virgil van Dijk,Liverpool,4.1,3,2,1,2,0,0,0,0.0,0,1,1,0,5,8,8,1
2764,Raphael Varane,Real Madrid,30.2,22,14,16,5,1,10,19,52.6,9,26,18,8,36,58,114,2
2765,Jamie Vardy,Leicester City,31.6,18,12,1,8,9,2,15,13.3,13,14,5,9,4,22,32,0
2766,Ruben Vargas,Augsburg,17.9,18,12,6,9,3,1,16,6.3,15,26,2,24,18,36,27,0
2767,Denis Vavro,Lazio,0.4,0,0,0,0,0,0,1,0.0,1,0,0,0,1,1,3,0
2768,Denis Vavro,Huesca,6.8,7,4,2,4,1,2,5,40.0,3,2,0,2,11,18,21,0
2769,Franco Vazquez,Sevilla,1.8,5,1,0,3,2,1,5,20.0,4,2,1,1,1,6,1,0
2770,Kevin Vazquez,Celta Vigo,6.2,11,5,9,2,0,3,9,33.3,6,8,0,8,9,20,18,0
2771,Lucas Vazquez,Real Madrid,20.5,61,37,30,22,9,22,52,42.3,30,14,1,13,19,80,31,1
2772,Matias Vecino,Inter,3.1,1,1,0,0,1,0,5,0.0,5,7,1,6,4,5,3,0
2773,Koke Vegas,Levante,1.0,0,0,0,0,0,0,0,0.0,0,0,0,0,0,0,1,1
2774,Gabriel Veiga,Celta Vigo,1.3,3,0,3,0,0,1,4,25.0,3,3,0,3,3,6,0,0
2775,Milos Veljkovic,Werder Bremen,19.1,24,14,17,6,1,15,31,48.4,16,22,9,13,29,53,94,1
2776,Miguel Veloso,Hellas Verona,14.6,24,17,10,10,4,12,34,35.3,22,12,1,11,12,36,25,0
2777,Joel Veltman,Brighton,25.3,67,33,34,25,8,29,57,50.9,28,24,5,19,33,100,64,0
2778,Unai Vencedor Paris,Athletic Club,18.9,31,21,10,15,6,11,42,26.2,31,17,6,11,18,49,14,0
2779,Lorenzo Venuti,Fiorentina,19.5,24,11,14,7,3,14,28,50.0,14,18,3,15,17,41,24,0
2780,Daniele Verde,Spezia,10.9,5,4,2,2,1,4,10,40.0,6,5,0,5,9,14,7,0
2782,Simone Verdi,Torino,18.0,19,12,10,6,3,6,19,31.6,13,8,0,8,8,27,2,2
2783,Gonzalo Verdu,Elche,32.7,34,19,26,8,0,16,28,57.1,12,40,30,10,52,86,113,0
2784,Jordan Veretout,Roma,22.8,20,12,8,12,0,9,33,27.3,24,14,3,11,14,34,21,3
2785,Edoardo Vergani,Bologna,0.1,0,0,0,0,0,0,0,0.0,0,0,0,0,0,0,0,0
2786,Marco Verratti,Paris S-G,16.6,53,30,17,25,11,24,72,33.3,48,22,5,17,26,79,4,1
2787,Valerio Verre,Sampdoria,11.1,11,7,2,7,2,4,19,21.1,15,14,2,12,9,20,3,0
2788,Mikel Vesga,Athletic Club,19.1,28,14,8,16,4,12,50,24.0,38,28,8,20,27,55,35,1
2789,Jannik Vestergaard,Southampton,28.6,50,31,31,15,4,35,52,67.3,17,29,16,13,42,92,122,0
2790,Ruben Vezo,Levante,25.7,34,19,26,7,1,12,29,41.4,17,22,11,11,46,80,106,3
2791,Guglielmo Vicario,Cagliari,4.0,0,0,0,0,0,0,0,0.0,0,0,0,0,0,0,1,0
2792,Inigo Vicente,Athletic Club,0.6,1,1,1,0,0,1,1,100.0,0,0,0,0,0,1,0,0
2793,Fede Vico,Granada,8.5,10,6,5,5,0,3,10,30.0,7,15,1,14,12,22,5,0
2794,Aleix Vidal,Sevilla,6.6,9,5,5,3,1,5,12,41.7,7,10,1,9,12,21,9,0
2795,Arturo Vidal,Inter,12.6,27,14,8,13,6,12,41,29.3,29,23,3,20,29,56,11,0
2796,Clement Vidal,Montpellier,1.0,2,1,1,1,0,2,4,50.0,2,4,4,0,1,3,6,1
2797,Nacho Vidal,Osasuna,26.1,56,28,27,22,7,22,31,71.0,9,39,10,29,43,99,68,0
2798,Ronaldo Vieira,Hellas Verona,2.5,5,3,1,3,1,0,2,0.0,2,4,3,1,0,5,2,0
2799,Luca Vignali,Spezia,17.7,19,9,10,6,3,7,25,28.0,18,13,5,8,22,41,25,0
2800,Emanuel Vignato,Bologna,13.4,18,9,9,6,3,3,15,20.0,12,6,1,5,10,28,7,0
2801,Toni Villa,Valladolid,10.8,31,16,11,14,6,15,42,35.7,27,15,1,14,5,36,3,0
2802,Asier Villalibre,Athletic Club,17.7,3,2,0,2,1,2,8,25.0,6,4,0,4,2,5,16,0
2803,Gonzalo Villar,Roma,20.7,44,18,14,24,6,18,61,29.5,43,25,3,22,22,66,14,1
2804,Ivan Villar,Celta Vigo,19.8,0,0,0,0,0,0,1,0.0,1,0,0,0,0,0,18,0
2805,Ruben Vinagre,Wolves,1.9,7,5,5,2,0,3,4,75.0,1,3,0,3,2,9,4,0
2806,Carlos Vinicius,Tottenham,3.4,3,1,2,1,0,1,1,100.0,0,0,0,0,2,5,5,0
2808,Nicolas Viola,Benevento,11.5,16,9,2,11,3,6,28,21.4,22,10,3,7,9,25,7,0
2809,Joao Virginia,Everton,0.5,0,0,0,0,0,0,0,0.0,0,0,0,0,0,0,0,0
2810,Vitinha,Wolves,5.8,7,3,2,5,0,3,8,37.5,5,3,0,3,3,10,1,0
2811,Vitolo,Atlético Madrid,3.3,4,1,2,0,2,1,6,16.7,5,3,0,3,3,7,2,0
2812,Dusan Vlahovic,Fiorentina,32.5,13,4,3,4,6,5,16,31.3,11,16,2,14,4,17,15,0
2813,Michel Vlap,Arminia,4.1,1,1,0,1,0,0,8,0.0,8,4,0,4,5,6,3,0
2814,Andreas Voglsammer,Arminia,11.1,12,8,6,6,0,8,17,47.1,9,11,0,11,3,15,11,0
2815,Kevin Vogt,Hoffenheim,20.5,18,12,11,6,1,12,21,57.1,9,21,12,9,16,34,71,0
2816,Mergim Vojvoda,Torino,15.1,24,14,18,5,1,12,22,54.5,10,19,4,15,18,42,35,1
2817,Jake Vokins,Southampton,0.7,0,0,0,0,0,0,1,0.0,1,0,0,0,0,0,0,0
2818,Kevin Volland,Monaco,30.8,33,16,11,19,3,8,34,23.5,26,23,0,23,4,37,4,0
2819,Stefan de Vrij,Inter,30.4,28,16,15,12,1,15,24,62.5,9,24,18,6,41,69,95,0
2820,Giacomo Vrioni,Juventus,0.0,0,0,0,0,0,0,0,0.0,0,0,0,0,0,0,0,0
2821,Sime Vrsaljko,Atlético Madrid,5.8,18,12,13,5,0,8,12,66.7,4,5,0,5,8,26,14,0
2822,Nikola Vukcevic,Levante,9.0,14,7,5,8,1,9,18,50.0,9,8,5,3,8,22,12,1
2823,Milos Vulic,Crotone,14.5,15,8,9,1,5,8,21,38.1,13,10,1,9,8,23,8,0
2824,Matej Vydra,Burnley,15.2,9,5,2,4,3,1,8,12.5,7,8,1,7,6,15,5,0
2825,Franklin Wadja,Lorient,0.4,4,2,0,2,2,2,2,100.0,0,0,0,0,2,6,1,0
2826,Elye Wahi,Montpellier,6.2,4,3,2,1,1,1,6,16.7,5,4,0,4,2,6,5,0
2827,Walace,Udinese,22.8,50,23,28,19,3,21,60,35.0,39,36,3,33,34,84,23,0
2828,Theo Walcott,Southampton,18.0,23,11,8,9,6,11,32,34.4,21,16,0,16,14,37,5,0
2829,Theo Walcott,Everton,0.1,0,0,0,0,0,0,0,0.0,0,0,0,0,0,0,0,0
2830,Kyle Walker,Manchester City,21.6,29,19,15,12,2,16,24,66.7,8,19,7,12,14,43,28,0
2831,Kyle Walker-Peters,Southampton,29.4,83,53,56,25,2,34,57,59.6,23,41,10,31,38,121,66,2
2832,Sebastian Walukiewicz,Cagliari,18.0,27,19,11,13,3,12,30,40.0,18,22,14,8,36,63,60,0
2834,Aaron Wan-Bissaka,Manchester Utd,34.0,88,54,53,29,6,32,45,71.1,13,65,17,48,62,150,84,2
2835,Joel Ward,Crystal Palace,25.1,43,25,29,14,0,24,42,57.1,18,27,8,19,41,84,87,2
2836,James Ward-Prowse,Southampton,38.0,75,49,30,41,4,29,70,41.4,41,36,4,32,42,117,60,0
2837,Daniel Wass,Valencia,33.1,52,31,21,29,2,22,55,40.0,33,33,13,20,47,99,69,0
2838,Ollie Watkins,Aston Villa,37.0,29,17,5,16,8,10,33,30.3,23,21,2,19,7,36,24,0
2839,Caleb Watts,Southampton,0.4,2,1,2,0,0,1,2,50.0,1,0,0,0,0,2,0,0
2840,Timothy Weah,Lille,9.8,15,7,3,9,3,7,14,50.0,7,7,0,7,4,19,5,0
2841,Adam Webster,Brighton,28.8,29,16,15,10,4,12,25,48.0,13,29,16,13,47,76,92,3
2842,Wout Weghorst,Wolfsburg,32.7,13,8,2,8,3,4,20,20.0,16,17,3,14,4,17,26,0
2843,Mitchell Weiser,Leverkusen,2.5,4,1,1,2,1,2,4,50.0,2,1,0,1,3,7,4,0
2844,Shon Weissman,Valladolid,23.7,12,9,4,5,3,2,23,8.7,21,17,3,14,8,20,7,0
2845,Danny Welbeck,Brighton,17.2,12,6,2,6,4,7,19,36.8,12,17,0,17,7,19,13,0
2846,Wendell,Leverkusen,16.2,53,35,27,18,8,23,49,46.9,26,26,3,23,25,78,39,1
2847,Oscar Wendt,M'Gladbach,13.9,12,6,2,9,1,4,12,33.3,8,18,4,14,14,26,23,0
2848,Timo Werner,Chelsea,28.9,20,9,6,11,3,7,43,16.3,36,23,1,22,8,28,8,0
2849,Ashley Westwood,Burnley,37.9,23,15,6,12,5,10,42,23.8,32,26,9,17,44,67,33,0
2850,Ben White,Brighton,35.5,49,26,21,24,4,24,57,42.1,33,46,22,24,62,111,56,0
2851,Georginio Wijnaldum,Liverpool,32.7,23,7,6,14,3,7,31,22.6,24,18,3,15,26,49,18,1
2852,William,Wolfsburg,0.0,0,0,0,0,0,0,0,0.0,0,0,0,0,0,0,0,0
2853,William,Schalke 04,5.3,14,10,10,4,0,5,15,33.3,10,16,5,11,11,25,15,1
2854,Brandon Williams,Manchester Utd,2.1,0,0,0,0,0,0,1,0.0,1,1,0,1,1,1,7,0
2855,Inaki Williams,Athletic Club,26.5,11,7,0,4,7,2,14,14.3,12,13,1,12,5,16,22,0
2856,Neco Williams,Liverpool,2.8,6,5,4,2,0,5,9,55.6,4,3,1,2,6,12,6,0
2857,Nico Williams,Athletic Club,0.6,1,0,1,0,0,0,2,0.0,2,0,0,0,1,2,0,0
2858,Rhys Williams,Liverpool,7.3,6,4,3,3,0,3,3,100.0,0,4,3,1,6,12,27,1
2860,Willian,Arsenal,15.6,13,7,6,6,1,6,16,37.5,10,13,0,13,8,21,8,0
2861,Joe Willock,Arsenal,2.6,6,3,1,4,1,3,7,42.9,4,6,1,5,3,9,0,0
2862,Joe Willock,Newcastle Utd,10.9,26,13,16,7,3,9,42,21.4,33,21,3,18,17,43,15,1
2863,Callum Wilson,Newcastle Utd,23.2,12,5,1,6,5,2,12,16.7,10,10,3,7,7,19,14,0
2864,Marten Winkler,Hertha BSC,0.0,0,0,0,0,0,0,0,0.0,0,0,0,0,0,0,0,0
2865,Harry Winks,Tottenham,9.6,16,9,11,5,0,5,20,25.0,15,16,4,12,11,27,12,1
2866,Florian Wirtz,Leverkusen,24.7,35,18,8,22,5,11,37,29.7,26,27,1,26,9,44,8,0
2867,Yoane Wissa,Lorient,29.7,35,20,12,14,9,11,34,32.4,23,25,3,22,20,55,14,0
2868,Axel Witsel,Dortmund,12.6,18,12,6,11,1,8,16,50.0,8,13,3,10,22,40,13,0
2869,Hannes Wolf,M'Gladbach,15.3,26,13,8,10,8,8,36,22.2,28,18,1,17,9,35,4,0
2870,Marius Wolf,Köln,28.3,35,19,19,13,3,13,38,34.2,25,29,3,26,28,63,47,1
2871,Nick Woltemade,Werder Bremen,1.6,3,2,1,1,1,2,4,50.0,2,1,0,1,0,3,0,0
2872,Jeong Woo-yeong,Freiburg,9.1,9,5,1,6,2,2,11,18.2,9,8,1,7,11,20,11,0
2873,Chris Wood,Burnley,30.5,12,7,2,4,6,5,18,27.8,13,14,3,11,1,13,21,0
2874,Joscha Wosz,RB Leipzig,0.4,1,1,1,0,0,0,0,0.0,0,1,0,1,1,2,0,0
2875,Xeka,Lille,13.3,33,17,14,15,4,16,43,37.2,27,14,2,12,20,53,18,0
2876,Granit Xhaka,Arsenal,28.0,50,26,18,17,15,30,58,51.7,28,23,7,16,24,74,38,3
2877,Reinhold Yabo,Arminia,7.2,5,2,2,2,1,2,9,22.2,7,6,1,5,4,9,1,0
2878,Jawad El Yamiq,Valladolid,15.3,21,14,14,7,0,8,11,72.7,3,15,10,5,46,67,100,0
2879,Ruben Yanez,Getafe,10.0,0,0,0,0,0,0,1,0.0,1,0,0,0,2,2,2,0
2880,Andriy Yarmolenko,West Ham,4.2,5,4,2,2,1,2,8,25.0,6,1,0,1,1,6,2,0
2881,Yusuf Yazici,Lille,12.1,12,5,6,2,4,1,24,4.2,23,5,1,4,2,14,2,0
2882,DeAndre Yedlin,Newcastle Utd,4.8,9,4,8,1,0,4,10,40.0,6,5,1,4,7,16,17,0
2883,Burak Yilmaz,Lille,22.8,13,6,3,7,3,4,30,13.3,26,7,0,7,5,18,22,0
2884,Yoel,Eibar,3.3,0,0,0,0,0,0,0,0.0,0,0,0,0,0,0,2,0
2886,Okay Yokuslu,West Brom,14.6,38,25,21,13,4,17,35,48.6,18,15,3,12,35,73,33,1
2887,Okay Yokuslu,Celta Vigo,5.1,14,8,8,4,2,5,9,55.6,4,5,2,3,10,24,9,0
2888,Maya Yoshida,Sampdoria,25.3,17,4,10,7,0,7,13,53.8,6,45,34,11,57,74,93,1
2889,Amin Younes,Eint Frankfurt,15.5,25,14,8,10,7,6,32,18.8,26,19,1,18,13,38,4,0
2890,Ashley Young,Inter,15.8,15,7,8,4,3,3,13,23.1,10,13,0,13,6,21,31,0
2891,Wilitty Younoussa,Dijon,0.9,6,3,3,3,0,3,7,42.9,4,3,0,3,2,8,0,0
2892,Zaydou Youssouf,Saint-Étienne,13.7,30,15,19,10,1,16,40,40.0,24,15,0,15,25,55,12,1
2893,Mattia Zaccagni,Hellas Verona,29.0,27,13,8,11,8,8,25,32.0,17,28,4,24,27,54,13,1
2894,Dan-Axel Zagadou,Dortmund,3.1,2,2,2,0,0,0,0,0.0,0,3,2,1,6,8,13,0
2895,Vasilios Zagaritis,Parma,0.7,0,0,0,0,0,0,0,0.0,0,1,0,1,0,0,0,0
2896,Arthur Zagre,Dijon,1.4,3,1,2,1,0,2,2,100.0,0,1,1,0,3,6,1,0
2897,Wilfried Zaha,Crystal Palace,29.0,26,18,8,15,3,11,30,36.7,19,21,0,21,9,35,4,0
2898,Miha Zajc,Genoa,20.7,22,14,9,10,3,13,39,33.3,26,30,4,26,27,49,19,0
2899,Denis Zakaria,M'Gladbach,15.8,30,15,12,15,3,11,20,55.0,9,20,7,13,23,53,29,1
2900,Joseba Zaldua,Real Sociedad,7.1,15,12,7,5,3,6,18,33.3,12,6,2,4,6,21,13,0
2901,Nicola Zalewski,Roma,0.1,1,1,0,1,0,1,1,100.0,0,0,0,0,0,1,0,0
2902,Andre-Frank Zambo Anguissa,Fulham,28.7,78,37,27,38,13,27,68,39.7,41,35,6,29,56,134,17,2
2903,Niccolo Zanellato,Crotone,18.2,24,14,16,6,2,13,36,36.1,23,19,5,14,16,40,12,2
2904,Cristian Zapata,Genoa,10.8,18,12,11,7,0,10,14,71.4,4,15,11,4,15,33,56,0
2905,Duvan Zapata,Atalanta,26.4,12,5,2,3,7,4,13,30.8,9,19,5,14,6,18,19,0
2906,Gabriele Zappa,Cagliari,26.6,34,17,16,15,3,22,49,44.9,27,36,4,32,24,58,50,0
2907,Davide Zappacosta,Genoa,22.7,33,16,15,13,5,15,30,50.0,15,17,1,16,18,51,41,0
2908,Oier Zarraga,Athletic Club,1.1,1,1,0,1,0,1,2,50.0,1,1,0,1,0,1,0,0
2909,Simone Zaza,Torino,16.6,15,9,4,6,5,6,20,30.0,14,14,0,14,3,18,5,1
2910,Deyovaisio Zeefuik,Hertha BSC,10.1,13,9,8,3,2,8,19,42.1,11,15,3,12,12,25,36,0
2912,Marvin Zeegelaar,Udinese,19.3,40,18,23,16,1,20,39,51.3,19,21,9,12,24,64,43,0
2913,Arber Zeneli,Reims,14.3,20,10,11,1,8,8,22,36.4,14,12,1,11,3,23,8,0
2914,Robin Zentner,Mainz 05,31.0,1,1,1,0,0,1,3,33.3,2,0,0,0,3,4,9,2
2915,Andi Zeqiri,Brighton,1.9,3,2,0,2,1,1,2,50.0,1,1,0,1,0,3,2,0
2916,Mehdi Zerkane,Bordeaux,13.2,23,15,7,10,6,5,18,27.8,13,15,2,13,9,32,5,0
2917,Ron-Robert Zieler,Köln,0.6,0,0,0,0,0,0,0,0.0,0,0,0,0,0,0,0,0
2918,Piotr Zielinski,Napoli,28.0,18,10,8,7,3,7,20,35.0,13,23,4,19,18,36,12,0
2919,Oleksandr Zinchenko,Manchester City,16.4,25,15,12,9,4,14,24,58.3,10,17,4,13,23,48,28,0
2920,Joshua Zirkzee,Parma,1.3,2,2,1,1,0,1,3,33.3,2,1,1,0,0,2,1,0
2921,Joshua Zirkzee,Bayern Munich,1.0,1,0,0,1,0,1,2,50.0,1,0,0,0,0,1,0,0
2922,Hakim Ziyech,Chelsea,13.0,14,10,5,7,2,5,19,26.3,14,9,1,8,10,24,2,0
2923,Jeroen Zoet,Spezia,6.7,0,0,0,0,0,0,1,0.0,1,0,0,0,0,0,4,2
2924,Kevin Zohi,Strasbourg,4.8,9,5,3,4,2,2,6,33.3,4,6,0,6,6,15,3,0
2925,Kurt Zouma,Chelsea,22.5,16,10,8,6,2,4,8,50.0,4,13,9,4,28,44,93,0
2926,Igor Zubeldia,Real Sociedad,21.8,23,16,15,8,0,8,14,57.1,6,20,13,7,12,35,46,0
2927,Steven Zuber,Eint Frankfurt,6.5,24,12,8,13,3,8,16,50.0,8,4,1,3,4,28,1,0
2928,Martin Zubimendi,Real Sociedad,20.9,41,22,18,20,3,20,34,58.8,14,22,10,12,40,81,39,0
2929,Martin Odegaard,Arsenal,9.6,9,3,2,6,1,4,14,28.6,10,2,0,2,2,11,5,0
2930,Martin Odegaard,Real Madrid,2.6,1,0,0,1,0,1,2,50.0,1,1,0,1,1,2,0,0
2931,Filip Duricic,Sassuolo,23.1,32,23,6,16,10,12,30,40.0,18,20,2,18,9,41,12,0
2932,Blanco,Real Madrid,2.4,0.0,2,0.0,0.0,0.0,0.0,0.0,0.0,0.0,0.0,0.0,0.0,6,0.0,0.0,0.0
2933,Hugo Guillamon,Valencia,22.1,0.0,13,0.0,0.0,0.0,0.0,0.0,0.0,0.0,0.0,0.0,0.0,26,0.0,0.0,0.0
