,Player,90s,Tackles - Tkl,Tackles - TklW,Tackles - Def 3rd,Tackles - Mid 3rd,Tackles - Att 3rd,Challenges - Tkl,Challenges - Att,Challenges - Tkl%,Challenges - Lost,Blocks - Blocks,Blocks - Sh,Blocks - Pass,Int,Tkl+Int,Clr,Err
1,Patrick van Aanholt,19.7,35,22,18,17,0,19,43,44.2,24,18,6,12,30,65,40,2
3,Yunis Abdelhamid,32.1,59,37,36,23,0,26,42,61.9,16,34,15,19,61,120,132,0
4,Sabit Abdulai,0.7,2,0,1,1,0,1,3,33.3,2,0,0,0,0,2,0,0
5,Mehdi Abeid,14.7,34,19,16,14,4,15,30,50.0,15,9,2,7,20,54,10,0
6,Laurent Abergel,32.9,145,84,64,69,12,54,162,33.3,108,64,6,58,46,191,12,0
7,Charles Abi,10.1,8,2,5,0,3,3,12,25.0,9,6,2,4,4,12,5,0
9,Pape Abou Cisse,14.0,15,13,10,5,0,6,10,60.0,4,7,4,3,27,42,87,0
10,David Abraham,13.6,18,12,13,3,2,11,17,64.7,6,13,4,9,17,35,34,0
11,Tammy Abraham,11.6,7,5,3,3,1,1,7,14.3,6,6,0,6,5,12,17,0
13,Gennaro Acampora,4.9,6,4,1,4,1,2,7,28.6,5,4,1,3,4,10,4,0
14,Francesco Acerbi,31.3,51,32,34,13,4,18,40,45.0,22,24,15,9,76,127,121,2
16,Marcos Acuna,25.9,62,42,34,20,8,23,41,56.1,18,23,2,21,23,85,30,1
17,Che Adams,29.6,25,16,4,15,6,6,17,35.3,11,20,2,18,4,29,19,1
18,Tyler Adams,20.6,35,24,12,15,8,17,31,54.8,14,22,5,17,29,64,30,0
19,Sargis Adamyan,5.3,9,4,4,3,2,7,14,50.0,7,2,0,2,6,15,1,0
20,Tosin Adarabioyo,32.8,37,19,30,6,1,19,40,47.5,21,26,20,6,42,79,197,2
21,Bobby Adekanye,0.4,0,0,0,0,0,0,1,0.0,1,0,0,0,0,0,1,0
22,Yacine Adli,26.9,74,37,30,33,11,35,92,38.0,57,27,2,25,39,113,17,2
26,Martin Agirregabiria,17.3,32,18,17,12,3,17,33,51.5,16,9,3,6,27,59,36,0
27,Lucien Agoume,8.9,18,10,11,7,0,6,19,31.6,13,10,5,5,15,33,10,0
28,Felix Agu,7.8,20,9,10,9,1,10,18,55.6,8,14,3,11,12,32,18,0
29,Kevin Agudelo,15.1,39,28,9,15,15,12,34,35.3,22,30,0,30,10,49,2,0
30,Nayef Aguerd,35.0,37,30,28,9,0,21,33,63.6,12,34,22,12,47,84,102,0
31,Sergio Aguero,6.2,4,1,0,2,2,2,11,18.2,9,2,0,2,2,6,0,0
32,Ruben Aguilar,24.7,63,37,32,21,10,32,52,61.5,20,30,3,27,47,110,43,1
33,Naouirou Ahamada,2.8,4,1,3,1,0,1,1,100.0,0,2,0,2,1,5,1,0
34,Matteo Ahlinvi,10.0,26,20,10,14,2,11,39,28.2,28,6,0,6,2,28,8,0
35,Jean-Eudes Aholou,23.8,46,25,18,25,3,19,48,39.6,29,17,5,12,53,99,32,0
36,Jean-Eudes Aholou,0.4,1,0,0,1,0,1,3,33.3,2,0,0,0,1,2,1,0
37,Joseph Aidoo,14.3,26,17,17,9,0,12,21,57.1,9,7,4,3,25,51,88,1
38,Ola Aina,29.6,37,20,22,7,8,21,43,48.8,22,22,6,16,45,82,94,2
39,Rayan Ait Nouri,15.6,29,16,18,10,1,13,27,48.1,14,14,1,13,15,44,25,0
40,Rayan Ait Nouri,2.1,3,2,1,2,0,3,5,60.0,2,2,1,1,4,7,1,0
41,Semi Ajayi,30.9,40,14,34,6,0,23,41,56.1,18,51,32,19,42,82,122,2
42,Ludovic Ajorque,33.0,30,18,6,18,6,7,31,22.6,24,14,5,9,11,41,54,0
43,Manuel Akanji,26.1,41,22,23,12,6,19,31,61.3,12,23,10,13,49,90,70,1
44,Carlos Akapo,9.6,18,14,14,4,0,10,18,55.6,8,16,3,13,19,37,33,0
45,Marley Ake,1.6,3,3,1,0,2,0,1,0.0,1,2,0,2,0,3,1,0
46,Nathan Ake,8.9,10,5,3,6,1,3,4,75.0,1,2,1,1,9,19,23,0
47,Paul Akouokou,4.2,11,8,2,8,1,5,8,62.5,3,3,1,2,6,17,7,0
48,Jean-Daniel Akpa-Akpro,11.7,38,25,13,22,3,8,27,29.6,19,24,6,18,18,56,13,0
49,Kevin Akpoguma,13.2,18,12,11,6,1,8,14,57.1,6,28,15,13,13,31,32,2
50,David Alaba,29.7,37,21,14,19,4,17,32,53.1,15,29,13,16,43,80,60,0
52,Sofiane Alakouch,16.7,53,33,30,16,7,29,45,64.4,16,17,2,15,21,74,38,0
53,Jony Alamo,0.8,2,1,1,0,1,0,1,0.0,1,0,0,0,1,3,0,0
54,Lucas Alario,13.8,8,2,2,5,1,2,4,50.0,2,9,1,8,2,10,10,0
55,Jordi Alba,33.6,45,30,22,16,7,24,52,46.2,28,21,2,19,49,94,48,0
56,Luis Alberto,29.1,43,24,15,19,9,15,73,20.5,58,41,2,39,13,56,11,1
57,Raul Albiol,34.6,22,15,19,3,0,13,18,72.2,5,32,22,10,22,44,146,2
58,Marc Albrighton,19.4,33,19,14,15,4,16,45,35.6,29,29,3,26,17,50,27,1
59,Paco Alcacer,17.2,6,3,1,2,3,3,7,42.9,4,8,0,8,9,15,6,0
60,Pedro Alcala,10.1,8,4,6,2,0,3,5,60.0,2,19,13,6,16,24,50,0
61,Thiago Alcantara,20.6,61,36,20,30,11,17,49,34.7,32,26,0,26,30,91,14,0
62,Ruben Alcaraz,24.1,54,29,32,21,1,30,80,37.5,50,35,8,27,31,85,28,0
63,Omar Alderete,14.4,16,10,11,5,0,7,16,43.8,9,14,10,4,21,37,61,1
64,Toby Alderweireld,24.9,35,22,22,11,2,18,30,60.0,12,40,28,12,10,45,121,0
65,Ivan Alejo,9.2,14,10,8,4,2,4,23,17.4,19,14,1,13,3,17,10,0
67,Carles Alena,15.2,15,10,3,9,3,7,25,28.0,18,14,1,13,2,17,2,0
69,Trent Alexander-Arnold,33.7,56,33,31,18,7,36,56,64.3,20,24,3,21,49,105,50,3
71,Mohamed Ali Cho,3.9,9,7,2,6,1,4,9,44.4,5,4,0,4,3,12,0,0
72,Ezgjan Alioski,27.3,74,31,38,28,8,32,74,43.2,42,17,2,15,23,97,50,2
73,Rachid Alioui,0.2,0,0,0,0,0,0,1,0.0,1,0,0,0,0,0,0,0
74,Alisson,33.0,3,2,3,0,0,3,4,75.0,1,0,0,0,2,5,26,7
75,Saturnin Allagbe,12.0,0,0,0,0,0,0,1,0.0,1,0,0,0,0,0,9,3
76,Allan,22.8,80,45,39,37,4,28,95,29.5,67,31,12,19,19,99,25,1
78,Dele Alli,6.9,18,11,8,6,4,7,19,36.8,12,9,0,9,7,25,3,0
79,Miguel Almiron,27.0,49,29,21,25,3,14,56,25.0,42,23,4,19,25,74,20,1
80,Marcos Alonso,10.7,13,3,6,4,3,7,14,50.0,7,12,1,11,12,25,30,0
81,Sergio Alvarez,17.4,42,25,13,26,3,8,22,36.4,14,22,5,17,22,64,24,2
82,Yeray Alvarez,21.6,19,12,11,8,0,9,21,42.9,12,12,5,7,53,72,73,0
83,Bruno Alves,18.1,13,10,10,3,0,7,9,77.8,2,17,12,5,26,39,81,0
84,Steven Alzate,10.0,17,8,10,4,3,6,15,40.0,9,8,1,7,8,25,10,0
85,Ibrahim Amadou,16.7,39,26,18,19,2,15,38,39.5,23,14,4,10,23,62,25,0
86,Romain Amalfitano,1.3,4,2,3,1,0,1,3,33.3,2,2,1,1,1,5,1,0
87,Emmanuel Amankwaa Akurugu,0.5,0,0,0,0,0,0,1,0.0,1,1,0,1,2,2,1,0
88,Daniel Amartey,8.0,11,7,6,4,1,8,12,66.7,4,8,4,4,12,23,26,0
89,Jordan Amavi,9.0,11,9,9,1,1,9,12,75.0,3,12,2,10,27,38,33,1
90,Thierry Ambrose,8.4,7,4,1,1,5,2,12,16.7,10,2,0,2,2,9,4,0
92,Nadiem Amiri,21.0,12,7,4,8,0,7,33,21.2,26,18,3,15,12,24,7,0
93,Ethan Ampadu,23.2,57,36,31,24,2,20,46,43.5,26,40,19,21,49,106,87,3
94,Sofyan Amrabat,27.1,39,22,11,24,4,18,48,37.5,30,30,5,25,23,62,12,0
95,Jon Ander Garrido,8.9,18,10,8,7,3,10,26,38.5,16,12,4,8,14,32,13,0
96,Joachim Andersen,30.3,33,19,18,11,4,15,28,53.6,13,24,13,11,44,77,151,1
97,Joachim Andersen,2.1,2,1,1,1,0,2,2,100.0,0,1,1,0,2,4,6,0
98,Djavan Anderson,0.8,0,0,0,0,0,0,1,0.0,1,1,0,1,1,1,0,0
101,Sebastian Andersson,12.5,3,2,0,3,0,1,8,12.5,7,10,3,7,2,5,9,0
104,Benjamin Andre,32.1,114,68,47,61,6,53,122,43.4,69,39,10,29,76,190,49,0
105,Marcos Andre,13.1,8,2,2,2,4,0,8,0.0,8,15,2,13,2,10,9,0
106,Robert Andrich,28.1,51,24,22,27,2,24,53,45.3,29,40,6,34,51,102,31,2
107,Victorien Angban,18.6,36,24,17,15,4,17,42,40.5,25,17,4,13,19,55,9,1
109,Jose Angel,10.0,15,8,9,4,2,8,12,66.7,4,7,0,7,13,28,17,1
111,Angelino,24.0,31,19,10,18,3,13,24,54.2,11,22,1,21,30,61,40,0
114,Cristian Ansaldi,21.6,48,33,25,14,9,24,38,63.2,14,21,7,14,16,64,38,0
115,Waldemar Anton,30.1,31,20,17,14,0,12,31,38.7,19,28,18,10,47,78,114,0
116,Michail Antonio,21.9,7,4,1,5,1,1,7,14.3,6,20,3,17,7,14,7,0
117,Jose Antonio Miranda,0.3,0,0,0,0,0,0,1,0.0,1,1,0,1,0,0,0,0
118,Valentin Antov,2.6,4,2,3,1,0,3,10,30.0,7,6,5,1,4,8,13,0
119,Houssem Aouar,19.8,17,12,0,13,4,8,25,32.0,17,17,1,16,17,34,4,0
120,Adil Aouchiche,19.2,38,20,12,17,9,13,49,26.5,36,15,1,14,10,48,6,0
121,Dennis Appiah,17.3,55,34,33,15,7,32,59,54.2,27,23,6,17,25,80,43,0
122,Aritz Arambarri,0.3,1,1,0,1,0,1,2,50.0,1,0,0,0,0,1,0,0
123,Mauro Arambarri,33.1,64,39,22,35,7,23,80,28.8,57,40,5,35,42,106,28,0
124,Charles Aranguiz,18.5,41,23,16,21,4,17,43,39.5,26,32,4,28,33,74,17,0
125,Luiz Araujo,16.6,38,25,12,18,8,8,28,28.6,20,23,1,22,11,49,3,0
126,Nestor Araujo,27.0,24,16,14,9,1,7,15,46.7,8,23,18,5,43,67,89,2
127,Ronald Araujo,16.8,22,11,12,8,2,9,9,100.0,0,24,15,9,20,42,47,1
128,Anaitz Arbilla,31.2,45,26,31,11,3,27,54,50.0,27,36,11,25,69,114,73,1
130,Alphonse Areola,36.0,1,0,1,0,0,1,5,20.0,4,0,0,0,1,2,13,3
131,Santiago Arias,1.0,2,1,0,1,1,1,1,100.0,0,0,0,0,1,3,4,0
132,Karim Aribi,3.3,2,2,0,1,1,0,5,0.0,5,1,0,1,0,2,3,0
135,Stuart Armstrong,30.7,60,41,19,32,9,27,75,36.0,48,26,1,25,24,84,19,0
136,Maximilian Arnold,28.7,47,32,20,26,1,18,49,36.7,31,24,3,21,49,96,57,0
138,Sergio Arribas,1.5,3,1,2,1,0,1,3,33.3,2,2,0,2,4,7,2,0
139,Kepa Arrizabalaga,6.5,0,0,0,0,0,0,1,0.0,1,0,0,0,0,0,0,3
140,Tolgay Arslan,20.2,52,32,24,24,4,25,54,46.3,29,22,2,20,22,74,15,1
141,Kwadwo Asamoah,2.5,4,3,2,2,0,2,3,66.7,1,5,1,4,4,8,2,1
142,Santiago Ascacibar,8.5,30,15,15,14,1,15,28,53.6,13,23,2,21,13,43,14,0
143,Sergio Asenjo,36.0,0,0,0,0,0,0,1,0.0,1,0,0,0,0,0,13,2
144,Marco Asensio,20.8,12,6,7,4,1,3,24,12.5,21,15,0,15,11,23,10,0
146,Iago Aspas,31.8,11,3,2,7,2,2,23,8.7,21,25,2,23,16,27,21,0
147,Roger Assale,9.2,10,8,3,5,2,4,12,33.3,8,7,3,4,2,12,2,0
148,Youcef Atal,10.6,25,12,11,14,0,13,26,50.0,13,10,2,8,26,51,12,0
149,Miguel Atienza,9.3,20,9,5,15,0,8,23,34.8,15,14,1,13,9,29,12,0
150,Pierre-Emerick Aubameyang,25.9,12,8,7,4,1,3,20,15.0,17,18,0,18,7,19,17,0
151,Emil Audero,37.0,1,1,1,0,0,1,2,50.0,1,0,0,0,1,2,16,0
152,Tommaso Augello,35.7,42,30,27,10,5,23,39,59.0,16,22,2,20,32,74,76,1
153,Jean-Kevin Augustin,0.4,2,0,0,2,0,2,2,100.0,0,0,0,0,0,2,0,0
154,Ludwig Augustinsson,21.7,37,20,19,14,4,17,29,58.6,12,21,7,14,20,57,62,0
156,Serge Aurier,17.8,55,33,33,17,5,15,40,37.5,25,28,5,23,19,74,44,3
157,Charlie Austin,1.5,4,2,1,2,1,1,3,33.3,2,0,0,0,3,7,4,0
158,Ezequiel Avila,2.2,6,2,3,1,2,2,4,50.0,2,1,0,1,1,7,0,0
159,Taiwo Awoniyi,15.1,5,3,2,3,0,1,14,7.1,13,9,0,9,3,8,4,0
160,Mehmet Aydin,5.6,15,7,9,6,0,4,10,40.0,6,6,1,5,6,21,16,0
161,Jordan Ayew,23.3,38,26,8,16,14,16,44,36.4,28,28,2,26,16,54,12,0
162,Kaan Ayhan,8.8,15,9,8,5,2,8,13,61.5,5,9,5,4,16,31,33,0
163,Luke Ayling,37.8,108,61,69,30,9,49,87,56.3,38,53,36,17,36,144,96,5
165,Cesar Azpilicueta,24.3,53,28,22,24,7,19,37,51.4,18,30,5,25,28,81,62,2
166,Ludovic Baal,3.3,6,5,4,1,1,2,5,40.0,3,4,1,3,5,11,5,0
167,Carlos Bacca,8.7,9,5,5,3,1,3,5,60.0,2,5,0,5,3,12,2,0
168,Loic Bade,29.0,57,34,47,10,0,30,55,54.5,25,43,17,26,74,131,135,2
169,Milan Badelj,26.8,56,27,27,22,7,26,84,31.0,58,51,10,41,87,143,45,1
170,Edgar Badia,30.0,1,0,1,0,0,1,3,33.3,2,0,0,0,0,1,17,3
171,Benoit Badiashile,31.9,24,17,15,9,0,13,28,46.4,15,21,12,9,58,82,102,4
172,Alex Baena,1.5,4,3,1,2,1,1,3,33.3,2,1,1,0,1,5,1,0
173,Miguel Baeza,6.0,7,6,5,2,0,5,13,38.5,8,3,0,3,3,10,2,0
174,Stephane Bahoken,18.0,9,6,1,7,1,4,12,33.3,8,9,0,9,9,18,9,0
175,Leon Bailey,23.8,14,8,3,7,4,4,15,26.7,11,13,0,13,9,23,3,0
176,Eric Bailly,10.2,5,5,3,1,1,0,1,0.0,1,13,11,2,13,18,36,2
178,Tiemoue Bakayoko,21.8,69,41,21,41,7,23,40,57.5,17,24,2,22,36,105,13,2
179,Mitchel Bakker,18.8,38,30,15,14,9,17,26,65.4,9,22,2,20,22,60,20,0
180,Ridle Baku,29.8,50,31,20,20,10,22,53,41.5,31,54,4,50,40,90,33,1
182,Ridle Baku,2.0,4,2,3,1,0,2,6,33.3,4,3,1,2,3,7,6,0
183,Dilane Bakwa,0.6,2,2,1,1,0,0,1,0.0,1,2,0,2,1,3,0,0
184,Fabian Balbuena,13.3,24,12,23,1,0,14,23,60.9,9,23,6,17,25,49,63,0
185,Keita Balde,13.3,9,6,2,6,1,4,10,40.0,6,10,1,9,0,9,3,0
186,George Baldock,31.0,47,34,28,14,5,21,50,42.0,29,26,7,19,25,72,70,1
187,Gareth Bale,10.2,17,10,4,9,4,7,14,50.0,7,13,2,11,8,25,16,0
188,Mikel Balenziaga,18.8,26,15,11,12,3,9,18,50.0,9,22,7,15,7,33,46,0
189,Leonardo Balerdi,18.2,29,18,19,7,3,14,31,45.2,17,17,9,8,28,57,65,3
190,Fode Ballo-Toure,7.4,21,17,9,11,1,6,13,46.2,7,7,0,7,6,27,11,1
191,Botond Balogh,1.8,9,7,9,0,0,2,5,40.0,3,4,3,1,2,11,8,0
192,Abdoulaye Bamba,15.0,27,17,19,7,1,19,28,67.9,9,7,1,6,19,46,34,0
193,Jonathan Bamba,33.2,45,23,15,19,11,24,84,28.6,60,24,2,22,24,69,15,0
194,Robson Bambu,11.6,16,11,14,2,0,11,14,78.6,3,8,7,1,10,26,57,0
195,Patrick Bamford,33.9,21,9,2,11,8,8,27,29.6,19,14,4,10,10,31,37,0
196,Mattia Bani,10.2,10,5,5,5,0,5,12,41.7,7,16,11,5,27,37,44,0
197,Mattia Bani,12.7,20,11,15,4,1,4,8,50.0,4,10,6,4,33,53,50,0
198,Simon Banza,15.2,13,6,0,4,9,1,14,7.1,13,16,1,15,7,20,15,0
199,Antonin Barak,30.7,30,19,8,16,6,14,47,29.8,33,26,7,19,12,42,38,1
200,Federico Barba,29.5,31,16,22,8,1,21,35,60.0,14,39,18,21,48,79,94,4
201,Danilo Barbosa,2.8,6,3,5,1,0,4,6,66.7,2,2,1,1,2,8,11,2
203,Melvin Bard,4.8,12,8,7,4,1,6,11,54.5,5,10,2,8,6,18,14,0
204,Enis Bardhi,18.7,28,12,8,16,4,10,36,27.8,26,8,2,6,21,49,14,0
205,Phil Bardsley,3.0,6,5,4,2,0,3,6,50.0,3,3,1,2,6,12,12,0
206,Nicolo Barella,32.2,58,31,23,29,6,23,72,31.9,49,29,4,25,26,84,14,0
209,Kike Barja,15.9,10,5,6,1,3,5,24,20.8,19,10,1,9,16,26,8,0
210,Ross Barkley,17.0,6,2,2,4,0,3,15,20.0,12,9,1,8,5,11,6,1
212,Aymen Barkok,10.9,29,15,11,9,9,10,31,32.3,21,15,1,14,10,39,9,1
213,Ashley Barnes,14.8,12,6,2,6,4,3,13,23.1,10,14,2,12,5,17,11,0
214,Harvey Barnes,21.6,19,9,11,3,5,5,22,22.7,17,16,3,13,8,27,11,0
215,Marc Baro,1.0,2,1,2,0,0,0,2,0.0,2,1,0,1,2,4,2,1
216,Antonio Barragan,24.8,28,14,21,5,2,12,21,57.1,9,22,8,14,33,61,67,1
217,Antonio Barreca,0.9,1,0,0,1,0,1,1,100.0,0,0,0,0,0,1,1,0
218,Leandro Barreiro Martins,25.6,58,32,19,26,13,20,50,40.0,30,34,9,25,57,115,55,0
219,Ander Barrenetxea,14.5,29,19,5,18,6,9,24,37.5,15,20,0,20,6,35,8,0
220,Jacob Barrett Laursen,12.3,23,12,13,8,2,10,16,62.5,6,14,4,10,24,47,37,0
221,Musa Barrow,32.5,26,10,8,10,8,10,25,40.0,15,37,2,35,11,37,15,0
222,Kyle Bartley,28.7,27,16,14,10,3,11,23,47.8,12,50,35,15,38,65,159,1
223,Paolo Bartolomei,3.6,6,2,3,1,2,4,7,57.1,3,1,0,1,1,7,2,0
224,Marc Bartra,18.8,27,16,18,8,1,12,22,54.5,10,19,5,14,40,67,74,3
225,Daniele Baselli,4.4,12,7,3,6,3,6,10,60.0,4,2,0,2,9,21,5,0
226,Chris Basham,28.6,69,42,41,23,5,41,67,61.2,26,36,15,21,49,118,105,1
227,Toma Basic,28.9,33,22,15,16,2,16,58,27.6,42,21,5,16,32,65,42,1
229,Alessandro Bastoni,32.5,36,22,13,21,2,17,27,63.0,10,34,16,18,40,76,75,0
230,Simone Bastoni,16.9,50,29,26,22,2,27,52,51.9,25,19,1,18,16,66,31,0
231,Bastos,0.7,3,1,2,0,1,3,5,60.0,2,1,0,1,0,3,3,0
232,Michy Batshuayi,8.1,5,3,1,2,2,1,9,11.1,8,5,1,4,4,9,5,0
234,Rodrigo Battaglia,27.7,38,16,21,14,3,16,50,32.0,34,30,14,16,29,67,40,1
235,Cristian Battocchio,3.9,5,2,1,4,0,2,9,22.2,7,0,0,0,4,9,5,0
236,Oliver Baumann,31.0,0,0,0,0,0,0,1,0.0,1,0,0,0,2,2,14,0
237,Julian Baumgartlinger,11.9,43,20,14,26,3,16,31,51.6,15,12,0,12,12,55,10,1
238,Christoph Baumgartner,26.3,44,31,13,24,7,14,51,27.5,37,40,8,32,24,68,24,0
239,Jon Bautista,4.1,5,3,0,2,3,0,3,0.0,3,3,1,2,2,7,4,0
240,Paul Baysse,29.0,35,18,21,13,1,16,21,76.2,5,33,24,9,52,87,123,1
241,Noah Joel Sarenren Bazee,0.4,0,0,0,0,0,0,1,0.0,1,0,0,0,1,1,0,0
242,Ihlas Bebou,24.4,24,9,5,10,9,8,14,57.1,6,18,4,14,17,41,16,0
243,Rodrigo Becao,30.9,59,33,36,20,3,27,49,55.1,22,48,27,21,68,127,94,2
244,Sheraldo Becker,12.3,5,4,2,2,1,3,5,60.0,2,4,0,4,6,11,7,0
245,Timo Becker,18.2,34,23,28,6,0,16,25,64.0,9,18,4,14,22,56,58,0
246,Jan Bednarek,34.4,37,19,25,11,1,25,49,51.0,24,44,27,17,84,121,132,0
247,Donny van de Beek,5.8,15,10,2,11,2,7,15,46.7,8,10,1,9,6,21,7,0
248,Valon Behrami,9.9,21,9,9,10,2,9,26,34.6,17,13,5,8,9,30,13,0
249,Brian Behrendt,0.9,0,0,0,0,0,0,1,0.0,1,0,0,0,0,0,1,0
250,Maximilian Beier,0.1,0,0,0,0,0,0,1,0.0,1,0,0,0,0,0,0,0
251,Ishak Belfodil,6.6,3,2,0,0,3,0,2,0.0,2,1,0,1,1,4,3,0
252,Erwan Belhadji,0.3,3,0,3,0,0,3,5,60.0,2,1,0,1,0,3,0,0
253,Haris Belkebla,30.3,69,39,32,28,9,31,66,47.0,35,26,5,21,57,126,34,0
254,Stefan Bell,14.1,24,18,15,9,0,14,23,60.9,9,19,11,8,27,51,76,1
255,Karim Bellarabi,8.9,12,10,3,4,5,4,17,23.5,13,12,0,12,12,24,4,0
256,Jean-Ricner Bellegarde,23.2,56,39,22,25,9,14,23,60.9,9,20,2,18,19,75,16,0
257,Hector Bellerin,23.2,29,19,14,12,3,12,41,29.3,29,26,8,18,33,62,33,0
258,Jude Bellingham,18.9,49,31,11,29,9,19,46,41.3,27,37,5,32,24,73,13,0
260,Andrea Belotti,32.1,30,18,4,16,10,11,35,31.4,24,27,4,23,12,42,21,0
261,Fran Beltran,15.5,30,22,15,12,3,8,24,33.3,16,14,1,13,16,46,24,0
263,Hatem Ben Arfa,18.9,11,7,1,7,3,2,9,22.2,7,3,0,3,2,13,0,0
265,Wissam Ben Yedder,29.0,18,9,2,10,6,3,13,23.1,10,16,0,16,13,31,3,0
266,Ahmad Benali,13.5,19,11,10,9,0,11,38,28.9,27,15,2,13,6,25,15,0
268,Lars Bender,10.4,19,13,12,6,1,9,21,42.9,12,19,5,14,16,35,19,0
269,Sven Bender,13.0,17,9,8,8,1,7,20,35.0,13,20,9,11,21,38,41,1
270,Dario Benedetto,17.5,6,4,1,4,1,5,13,38.5,8,9,2,7,3,9,17,0
271,Laszlo Benes,7.3,8,6,4,4,0,2,8,25.0,6,6,2,4,7,15,1,1
272,Laszlo Benes,1.7,6,2,5,1,0,2,4,50.0,2,0,0,0,2,8,1,0
273,Walter Benitez,38.0,1,1,1,0,0,1,3,33.3,2,1,0,1,1,2,7,2
274,Loris Benito,29.5,42,26,27,12,3,22,48,45.8,26,33,10,23,42,84,70,0
276,Bilal Benkhedim,0.8,0,0,0,0,0,0,1,0.0,1,1,0,1,0,0,0,0
277,Djamel Benlamri,1.7,5,3,5,0,0,3,6,50.0,3,3,2,1,6,11,11,0
278,Ismael Bennacer,14.7,39,18,17,21,1,15,32,46.9,17,10,1,9,20,59,12,0
279,Said Benrahma,15.5,24,15,8,11,5,8,28,28.6,20,10,0,10,8,32,8,0
280,Yassine Benrahou,13.8,16,9,8,6,2,7,25,28.0,18,9,0,9,4,20,5,1
281,Ramy Bensebaini,20.1,43,24,27,13,3,26,42,61.9,16,39,7,32,47,90,66,0
282,Josh Benson,2.9,5,1,3,0,2,1,6,16.7,5,3,0,3,3,8,2,0
283,Nabil Bentaleb,6.1,14,8,7,6,1,4,15,26.7,11,5,2,3,6,20,8,0
284,Rodrigo Bentancur,25.8,63,33,21,37,5,20,59,33.9,39,35,12,23,47,110,46,1
286,Christian Benteke,20.2,15,7,1,7,7,2,9,22.2,7,17,6,11,4,19,39,0
287,Karim Benzema,32.2,8,6,4,2,2,5,15,33.3,10,9,2,7,8,16,24,0
288,Yassine Benzia,4.5,10,5,5,3,2,2,10,20.0,8,3,0,3,6,16,2,0
290,Domenico Berardi,27.5,42,22,17,11,14,21,62,33.9,41,23,1,22,26,68,34,0
292,Yuri Berchiche,18.7,24,19,14,5,5,10,24,41.7,14,14,0,14,11,35,29,0
293,Alex Berenguer,1.5,2,0,0,0,2,2,5,40.0,3,2,0,2,0,2,1,0
294,Alex Berenguer,25.3,47,31,21,20,6,9,51,17.6,42,48,3,45,18,65,27,0
295,Bartosz Bereszynski,29.0,66,44,37,22,7,41,73,56.2,32,40,20,20,42,108,88,0
296,Johann Berg Gudmundsson,15.1,19,11,6,9,4,11,23,47.8,12,11,2,9,17,36,19,0
297,Sander Berge,12.4,16,7,8,5,3,7,15,46.7,8,11,2,9,4,20,18,0
298,Steven Bergwijn,13.4,15,7,8,3,4,7,20,35.0,13,7,1,6,5,20,9,0
299,Valon Berisha,18.3,40,23,19,17,4,11,47,23.4,36,14,2,12,25,65,21,1
300,Bernard,5.1,8,3,3,3,2,7,15,46.7,8,5,0,5,8,16,6,0
301,Federico Bernardeschi,10.8,9,4,3,5,1,4,20,20.0,16,6,2,4,14,23,7,1
302,Bernardo,2.3,10,8,8,1,1,4,6,66.7,2,2,0,2,1,11,1,0
303,Paul Bernardoni,38.0,1,1,1,0,0,1,2,50.0,1,0,0,0,2,3,23,1
304,Juan Bernat,2.2,5,3,0,4,1,3,5,60.0,2,4,0,4,1,6,6,0
307,Ryan Bertrand,28.9,60,32,26,27,7,30,48,62.5,18,19,1,18,30,90,41,1
308,Daniel Bessa,6.8,15,8,3,11,1,6,14,42.9,8,5,1,4,2,17,0,0
310,Jordan Beyer,2.1,2,1,2,0,0,1,2,50.0,1,5,4,1,5,7,5,0
312,Giulian Biancone,1.0,3,3,1,1,1,2,3,66.7,1,1,0,1,1,4,4,0
313,Bartosz Bialek,3.0,6,5,1,4,1,4,4,100.0,0,5,1,4,3,9,4,0
314,Ermin Bicakcic,1.4,1,1,0,1,0,1,1,100.0,0,1,1,0,3,4,9,0
315,Pedro Bigas,17.0,11,9,7,4,0,7,14,50.0,7,12,6,6,23,34,54,0
316,El Bilal Toure,13.8,22,12,3,16,3,8,18,44.4,10,8,3,5,6,28,10,1
317,Cristiano Biraghi,31.1,42,23,19,15,8,27,45,60.0,18,23,9,14,27,69,56,3
318,Davide Biraschi,10.2,17,9,12,5,0,5,10,50.0,5,12,6,6,21,38,26,0
319,Yves Bissouma,34.6,104,68,50,48,6,33,67,49.3,34,42,6,36,64,168,67,0
320,Leonardo Bittencourt,16.8,58,32,24,28,6,16,51,31.4,35,29,2,27,13,71,10,0
321,Alejandro Blanco,6.4,8,4,4,4,0,3,18,16.7,15,5,0,5,8,16,9,0
323,Ludovic Blas,31.0,58,30,18,37,3,23,54,42.6,31,33,4,29,21,79,19,0
325,Jerome Boateng,26.3,26,16,17,8,1,14,32,43.8,18,24,17,7,40,66,63,1
326,Antonin Bobichon,10.1,23,14,10,8,5,9,15,60.0,6,4,1,3,2,25,1,0
327,Yann Bodiger,2.8,2,2,1,1,0,1,6,16.7,5,7,3,4,8,10,4,0
328,Jean-Paul Boetius,22.9,42,28,13,15,14,17,47,36.2,30,37,3,34,33,75,14,0
329,Sacha Boey,20.7,54,40,30,23,1,27,55,49.1,28,25,5,20,41,95,62,0
330,Sacha Boey,1.4,3,3,2,1,0,3,4,75.0,1,0,0,0,2,5,2,0
331,Jeremie Boga,19.8,11,9,5,0,6,3,11,27.3,8,10,0,10,8,19,7,0
332,Melayro Bogarde,3.1,7,3,3,3,1,5,9,55.6,4,0,0,0,5,12,1,0
333,Jayden Bogle,12.3,33,23,21,10,2,20,39,51.3,19,14,4,10,14,47,22,0
334,Quentin Boisgard,14.6,24,17,3,15,6,11,24,45.8,13,17,2,15,15,39,1,0
335,Willy Boly,20.9,33,20,26,7,0,13,24,54.2,11,18,12,6,32,65,84,1
336,Giacomo Bonaventura,25.1,34,19,16,13,5,16,53,30.2,37,26,2,24,39,73,12,0
338,Federico Bonazzoli,6.3,6,4,0,4,2,2,13,15.4,11,3,0,3,2,8,3,0
340,Kevin Bonifazi,27.4,32,21,24,6,2,8,23,34.8,15,33,20,13,50,82,85,1
341,Leonardo Bonucci,22.5,19,14,10,8,1,6,14,42.9,8,24,13,11,33,52,67,0
342,Elias Bordner,1.0,1,0,1,0,0,1,1,100.0,0,0,0,0,2,3,1,0
344,Sebastiaan Bornauw,23.1,29,20,25,4,0,14,25,56.0,11,33,26,7,40,69,104,0
345,Sven Botman,36.8,31,21,18,12,1,14,26,53.8,12,31,21,10,57,88,126,2
346,Denis Bouanga,30.2,52,28,22,24,6,16,58,27.6,42,32,3,29,20,72,36,0
347,Hicham Boudaoui,19.3,52,35,20,24,8,26,68,38.2,42,14,4,10,23,75,26,1
348,Ryad Boudebouz,7.2,9,4,1,7,1,4,8,50.0,4,3,0,3,5,14,5,0
349,Sofiane Boufal,8.1,17,11,8,6,3,8,28,28.6,20,8,0,8,3,20,1,0
350,Nassim Boujellab,6.7,13,9,2,10,1,2,12,16.7,10,10,3,7,7,20,9,0
351,Farid Boulaya,31.3,24,16,4,17,3,13,51,25.5,38,19,3,16,12,36,7,0
352,Yassine Bounou,33.0,1,1,1,0,0,0,2,0.0,2,0,0,0,0,1,12,2
353,Ismaelben Boura,9.1,11,7,8,2,1,3,9,33.3,6,7,2,5,21,32,12,0
354,Mehdi Bourabia,5.9,6,5,1,4,1,2,7,28.6,5,14,6,8,12,18,8,0
355,Benjamin Bourigeaud,28.4,40,23,17,16,7,21,71,29.6,50,37,1,36,19,59,25,0
356,Edoardo Bove,0.1,0,0,0,0,0,0,1,0.0,1,0,0,0,0,0,0,0
357,Jarrod Bowen,28.5,26,15,12,7,7,10,29,34.5,19,19,1,18,22,48,10,0
358,Dedryck Boyata,17.2,14,7,10,3,1,7,15,46.7,8,23,20,3,26,40,68,1
359,John Boye,33.8,58,34,43,13,2,31,54,57.4,23,36,20,16,80,138,146,1
360,Lucas Boye,29.9,47,31,13,27,7,10,49,20.4,39,37,2,35,19,66,21,0
361,Can Bozdogan,7.2,13,5,6,6,1,4,15,26.7,11,10,2,8,7,20,5,0
362,Umut Bozok,0.7,0,0,0,0,0,0,2,0.0,2,0,0,0,0,0,0,0
364,Jayden Braaf,1.3,0,0,0,0,0,0,1,0.0,1,0,0,0,0,0,0,0
365,Domagoj Bradaric,14.0,28,18,11,13,4,12,27,44.4,15,14,4,10,26,54,21,0
366,Robbie Brady,11.7,22,15,12,6,4,12,35,34.3,23,16,0,16,9,31,29,1
367,Martin Braithwaite,13.1,8,4,2,3,3,1,6,16.7,5,2,0,2,6,14,7,0
368,Julian Brandt,16.6,27,14,13,9,5,12,43,27.9,31,25,1,24,17,44,7,1
369,Darko Brasanac,10.1,10,6,6,4,0,5,16,31.3,11,8,1,7,7,17,10,0
370,Lilian Brassier,10.7,19,10,12,4,3,7,11,63.6,4,13,6,7,23,42,38,1
371,Alvaro Bravo,0.2,1,1,1,0,0,1,2,50.0,1,0,0,0,1,2,0,0
372,Claudio Bravo,20.0,0,0,0,0,0,0,1,0.0,1,0,0,0,0,0,11,0
374,Josip Brekalo,20.2,22,10,10,7,5,8,29,27.6,21,18,0,18,17,39,3,1
375,Gleison Bremer,32.6,51,34,36,14,1,21,36,58.3,15,54,21,33,70,121,142,1
377,Rhian Brewster,12.5,8,5,1,4,3,1,13,7.7,12,15,2,13,5,13,5,0
378,Anthony Briancon,13.6,12,7,9,3,0,9,19,47.4,10,19,12,7,33,45,57,2
379,Jimmy Briand,6.3,7,3,3,2,2,1,1,100.0,0,2,0,2,1,8,3,0
380,Yan Brice Eteki,14.7,23,15,10,12,1,8,19,42.1,11,13,3,10,13,36,16,1
382,Dylan Bronn,37.9,57,37,38,19,0,24,44,54.5,20,31,14,17,44,101,112,0
383,John Brooks,30.8,47,29,33,14,0,30,54,55.6,24,35,10,25,55,102,134,0
384,Daniel Brosinski,15.9,19,14,10,7,2,12,31,38.7,19,18,1,17,14,33,33,0
385,Josh Brownhill,31.3,45,27,9,29,7,15,44,34.1,29,33,11,22,69,114,39,0
386,Marcelo Brozovic,28.7,54,29,23,24,7,20,61,32.8,41,43,17,26,40,94,38,0
387,Gaston Brugman,18.0,35,19,18,15,2,11,44,25.0,33,33,4,29,45,80,34,0
390,Juan Brunetta,5.3,2,2,0,2,0,1,6,16.7,5,5,0,5,1,3,2,0
391,Cedric Brunner,29.5,42,22,24,15,3,27,40,67.5,13,30,10,20,42,84,96,0
393,Joe Bryan,7.4,15,8,7,5,3,7,12,58.3,5,8,2,6,14,29,16,0
394,Kean Bryan,11.2,20,10,9,11,0,9,19,47.4,10,16,10,6,13,33,39,1
396,Ante Budimir,18.1,20,12,2,11,7,4,15,26.7,11,17,4,13,2,22,17,1
398,Marius Bulter,10.9,15,8,6,6,3,5,17,29.4,12,17,2,15,12,27,11,0
399,Alessandro Buongiorno,9.5,12,5,8,4,0,7,12,58.3,5,15,9,6,11,23,44,1
400,Esteban Burgos,12.3,7,6,4,3,0,1,5,20.0,4,8,7,1,23,30,54,2
401,Burgui,0.2,3,1,2,1,0,1,1,100.0,0,0,0,0,0,3,0,0
402,Jonathan Burkardt,15.3,27,13,15,10,2,11,19,57.9,8,20,3,17,8,35,15,0
403,Nishan Burkart,0.2,0,0,0,0,0,0,1,0.0,1,0,0,0,0,0,0,0
404,Oliver Burke,14.1,16,8,6,9,1,5,24,20.8,19,24,0,24,2,18,6,0
406,Dan Burn,22.9,50,26,33,14,3,27,53,50.9,26,30,7,23,31,81,75,0
408,Patrick Burner,14.6,25,11,14,10,1,13,26,50.0,13,10,3,7,24,49,41,1
409,Maxime Busi,13.3,23,13,19,3,1,11,28,39.3,17,14,1,13,16,39,32,0
410,Sergio Busquets,28.0,63,35,21,29,13,27,76,35.5,49,27,4,23,53,116,18,2
413,Oskar Buur,0.2,0,0,0,0,0,0,2,0.0,2,0,0,0,0,0,0,0
416,Erick Cabaco,14.7,24,14,11,12,1,12,22,54.5,10,8,6,2,13,37,51,1
418,Jimmy Cabot,10.5,26,13,8,14,4,11,36,30.6,25,8,0,8,12,38,6,0
419,Martin Caceres,24.9,28,12,16,11,1,15,35,42.9,20,20,14,6,14,42,52,1
420,Anthony Caci,31.1,80,46,47,27,6,35,69,50.7,34,30,4,26,55,135,65,1
421,Mathieu Cafaro,23.0,40,17,15,19,6,13,43,30.2,30,11,0,11,17,57,12,0
422,Gary Cahill,20.0,13,9,10,3,0,7,11,63.6,4,27,22,5,13,26,88,0
423,Yannick Cahuzac,25.0,26,12,12,10,4,9,27,33.3,18,18,5,13,33,59,72,0
424,Felipe Caicedo,10.3,10,7,4,4,2,1,8,12.5,7,7,0,7,4,14,2,0
426,Tom Cairney,8.4,9,3,1,4,4,1,4,25.0,3,6,0,6,0,9,3,0
427,Cala,25.2,21,12,15,6,0,11,21,52.4,10,18,8,10,35,56,91,0
429,Arturo Calabresi,0.2,0,0,0,0,0,0,1,0.0,1,0,0,0,0,0,0,0
430,Davide Calabria,29.4,101,64,61,32,8,54,90,60.0,36,42,9,33,37,138,82,1
431,Riccardo Calafiori,0.7,1,0,1,0,0,1,4,25.0,3,1,0,1,0,1,0,0
432,Mattia Caldara,1.2,1,0,0,1,0,1,1,100.0,0,3,2,1,4,5,3,0
433,Luca Caldirola,17.5,21,13,13,6,2,10,22,45.5,12,20,15,5,20,41,56,0
434,Duje Caleta-Car,31.3,29,17,19,9,1,17,30,56.7,13,29,22,7,44,73,130,0
435,Hakan Calhanoglu,29.0,26,7,3,17,6,7,28,25.0,21,21,6,15,15,41,24,1
436,Kerim Calhanoglu,3.3,3,3,1,1,1,0,3,0.0,3,4,0,4,7,10,6,0
437,Fabrizio Caligara,2.0,6,4,2,2,2,6,9,66.7,3,9,2,7,3,9,3,0
438,Daniel Caligiuri,29.6,71,46,29,31,11,29,92,31.5,63,45,6,39,38,109,41,0
439,Jose Callejon,7.4,10,7,0,6,4,5,9,55.6,4,4,1,3,4,14,5,0
440,Jonathan Calleri,17.2,15,6,2,4,9,3,17,17.6,14,18,2,16,1,16,10,1
442,Dominic Calvert-Lewin,31.9,17,8,1,8,8,6,12,50.0,6,22,6,16,6,23,33,0
443,Dani Calvo,19.8,20,13,13,7,0,7,10,70.0,3,18,12,6,11,31,71,0
445,Mahdi Camara,36.6,99,67,43,46,10,33,60,55.0,27,50,12,38,78,177,51,0
446,Eduardo Camavinga,26.7,98,58,39,48,11,38,77,49.4,39,36,2,34,23,121,15,1
447,Jose Campana,8.3,14,6,3,6,5,5,14,35.7,9,2,0,2,13,27,4,0
448,Emre Can,23.7,43,34,20,20,3,20,37,54.1,17,35,10,25,48,91,52,0
449,Sergio Canales,27.8,16,9,9,6,1,3,21,14.3,18,18,0,18,13,29,5,0
450,Joao Cancelo,25.5,68,41,42,19,7,43,83,51.8,40,23,2,21,41,109,33,2
451,Antonio Candreva,27.8,28,19,17,9,2,21,53,39.6,32,24,3,21,9,37,27,1
452,Alex Cantero,2.6,2,1,0,2,0,1,2,50.0,1,1,0,1,0,2,3,0
453,Ander Capa,23.7,37,18,22,13,2,18,37,48.6,19,21,8,13,25,62,57,0
454,Pierrick Capelle,22.8,53,28,24,17,12,31,79,39.2,48,25,1,24,47,100,32,0
455,Etienne Capoue,13.2,20,10,14,6,0,8,18,44.4,10,7,1,6,20,40,23,0
456,Elio Capradossi,1.0,2,1,2,0,0,2,2,100.0,0,0,0,0,1,3,5,0
457,Gianluca Caprari,20.7,16,11,5,5,6,6,31,19.4,25,19,1,18,18,34,8,0
458,Francesco Caputo,18.9,0,0,0,0,0,0,2,0.0,2,4,0,4,1,1,3,0
459,Maxence Caqueret,19.6,72,45,17,39,16,35,106,33.0,71,35,3,32,23,95,5,2
460,Andrea Carboni,12.1,34,23,23,11,0,15,28,53.6,13,15,4,11,14,48,52,0
461,Isaac Carcelen,28.7,68,43,36,25,7,33,60,55.0,27,37,12,25,49,117,89,0
462,Cardenas,8.0,0,0,0,0,0,0,1,0.0,1,0,0,0,3,3,5,1
463,Irvin Cardona,22.5,10,5,3,6,1,4,22,18.2,18,17,3,14,9,19,23,2
464,Marc Cardona,0.6,1,0,1,0,0,1,1,100.0,0,0,0,0,0,1,0,0
465,Ian Carlo Poveda,3.9,5,4,3,0,2,1,7,14.3,6,5,1,4,1,6,2,0
466,Diego Carlos,31.0,22,13,17,4,1,8,16,50.0,8,35,27,8,31,53,114,1
468,Juan Carlos,3.2,5,3,4,1,0,2,15,13.3,13,7,0,7,1,6,1,0
469,Lionel Carole,14.9,37,25,18,14,5,16,29,55.2,13,3,1,2,38,75,28,0
470,Yannick Carrasco,24.2,27,15,14,6,7,15,34,44.1,19,24,0,24,17,44,16,1
471,Sergio Carreira,2.9,3,0,2,1,0,1,1,100.0,0,2,0,2,1,4,7,0
472,Guido Carrillo,11.1,9,8,1,7,1,2,8,25.0,6,2,1,1,4,13,14,0
473,Andy Carroll,4.4,3,1,1,1,1,1,8,12.5,7,1,0,1,0,3,14,0
475,Dani Carvajal,10.6,27,20,12,10,5,11,20,55.0,9,19,1,18,13,40,27,0
476,Fabio Carvalho,2.8,9,6,4,4,1,5,9,55.6,4,2,0,2,1,10,1,1
477,William Carvalho,13.6,19,12,7,11,1,5,21,23.8,16,11,3,8,11,30,14,1
478,Casemiro,32.2,84,49,50,30,4,33,73,45.2,40,50,17,33,70,154,62,0
479,Matty Cash,26.4,71,40,43,22,6,41,74,55.4,33,50,11,39,60,131,95,0
482,Moreto Cassama,22.6,49,36,24,23,2,27,49,55.1,22,19,6,13,36,85,33,4
483,Francesco Cassata,2.5,7,6,7,0,0,4,7,57.1,3,0,0,0,3,10,1,0
484,Timothy Castagne,26.1,52,32,29,18,5,24,44,54.5,20,29,5,24,29,81,62,1
485,Koen Casteels,32.0,0,0,0,0,0,0,1,0.0,1,1,0,1,2,2,9,2
486,Jean-Charles Castelletto,21.6,32,18,20,11,1,18,31,58.1,13,25,19,6,42,74,79,0
487,Samu Castillejo,13.1,24,12,9,14,1,14,40,35.0,26,21,0,21,6,30,9,0
488,Gonzalo Castro,19.2,21,7,6,9,6,8,23,34.8,15,16,3,13,8,29,12,0
489,Jonny Castro,5.5,11,5,6,4,1,6,13,46.2,7,9,3,6,9,20,7,0
490,Gaetano Castrovilli,25.9,33,19,15,11,7,11,42,26.2,31,25,2,23,34,67,14,0
491,Danilo Cataldi,6.3,7,2,1,5,1,4,18,22.2,14,3,1,2,9,16,7,0
492,Ivan Cavaleiro,27.5,23,14,9,11,3,12,34,35.3,22,25,1,24,19,42,14,0
494,Edinson Cavani,15.3,12,8,1,8,3,2,13,15.4,11,2,0,2,6,18,11,0
495,Dani Ceballos,17.9,37,22,20,11,6,21,51,41.2,30,23,6,17,35,72,14,1
496,Federico Ceccherini,19.3,16,12,10,6,0,2,7,28.6,5,15,8,7,40,56,60,0
497,Federico Ceccherini,3.0,4,1,1,3,0,1,1,100.0,0,6,5,1,7,11,15,0
498,Zeki Celik,26.5,72,33,30,30,12,44,81,54.3,37,32,6,26,38,110,52,0
499,Bersant Celina,25.5,20,12,8,8,4,7,38,18.4,31,20,2,18,8,28,10,0
500,Fabien Centonze,35.8,104,68,64,30,10,43,73,58.9,30,62,17,45,112,216,119,1
501,Luca Ceppitelli,16.3,25,19,13,10,2,14,26,53.8,12,23,12,11,25,50,58,1
502,Alberto Cerri,4.1,3,2,0,2,1,0,5,0.0,5,4,2,2,2,5,6,0
503,Sava Cestic,10.0,20,9,12,6,2,8,17,47.1,9,13,4,9,18,38,40,0
504,Julian Chabot,18.4,48,34,28,16,4,23,37,62.2,14,25,13,12,37,85,43,1
505,Nassim Chadli,0.3,2,1,2,0,0,0,1,0.0,1,1,0,1,0,2,0,0
506,Fouad Chafik,18.0,39,24,29,8,2,16,35,45.7,19,19,10,9,21,60,41,0
507,Mehdi Chahiri,8.9,18,8,7,5,6,8,20,40.0,12,9,0,9,6,24,5,0
509,Sofian Chakla,10.0,12,8,10,1,1,5,7,71.4,2,3,2,1,14,26,48,1
510,Anibal Chala,8.3,10,7,6,3,1,6,12,50.0,6,5,3,2,14,24,15,1
511,Trevoh Chalobah,24.9,45,26,32,13,0,24,50,48.0,26,20,7,13,69,114,56,0
512,Calum Chambers,8.4,7,3,3,2,2,3,8,37.5,5,6,2,4,10,17,37,0
513,Timothy Chandler,4.8,4,0,2,1,1,1,4,25.0,3,5,2,3,3,7,5,0
514,Kwon Chang-hoon,2.4,3,1,1,0,2,1,3,33.3,2,3,1,2,7,10,2,1
515,Gaetan Charbonnier,17.4,24,15,6,11,7,12,32,37.5,20,15,1,14,9,33,19,0
516,Brendan Chardonnet,30.2,51,29,31,19,1,27,41,65.9,14,54,41,13,64,115,151,0
517,Xavier Chavalerin,28.3,92,50,47,38,7,26,74,35.1,48,43,9,34,43,135,29,1
518,Pape Cheikh Diop,12.1,24,14,15,6,3,13,33,39.4,20,14,2,12,6,30,6,0
520,Chema,6.2,11,5,6,5,0,5,7,71.4,2,1,0,1,10,21,23,0
521,Rayan Cherki,7.8,5,3,0,3,2,1,11,9.1,10,3,0,3,4,9,0,0
522,Denis Cheryshev,12.2,19,15,6,7,6,6,26,23.1,20,15,1,14,12,31,15,0
523,Giorgio Chiellini,15.4,12,9,9,3,0,5,11,45.5,6,18,13,5,27,39,56,0
524,Federico Chiesa,2.7,6,2,2,2,2,3,8,37.5,5,3,1,2,1,7,3,0
525,Federico Chiesa,24.6,47,26,21,14,12,19,50,38.0,31,23,1,22,12,59,16,0
526,Ben Chilwell,25.4,42,22,16,22,4,15,33,45.5,18,28,3,25,24,66,58,0
527,Vlad Chiriches,20.4,38,23,34,3,1,21,35,60.0,14,31,21,10,50,88,59,2
528,Pedro Chirivella,25.3,26,8,7,13,6,14,49,28.6,35,23,4,19,41,67,19,0
529,Tahith Chong,4.3,11,6,1,9,1,4,8,50.0,4,4,0,4,5,16,1,0
530,Joris Chotard,12.9,12,8,5,6,1,6,31,19.4,25,12,3,9,11,23,15,0
531,Hamza Choudhury,3.5,8,7,3,5,0,4,10,40.0,6,4,1,3,4,12,9,1
532,Mounir Chouiar,14.3,22,12,10,9,3,6,18,33.3,12,10,0,10,11,33,8,0
533,Andreas Christensen,15.2,11,6,8,3,0,0,8,0.0,8,19,14,5,20,31,51,1
534,Carney Chukwuemeka,0.2,2,2,1,0,1,1,3,33.3,2,0,0,0,0,2,0,0
535,Samuel Chukwueze,15.2,12,7,4,4,4,3,17,17.6,14,8,0,8,10,22,3,0
536,Darko Churlinov,2.4,2,2,2,0,0,1,3,33.3,2,5,1,4,0,2,2,0
537,Victor Chust,1.1,1,1,0,1,0,0,2,0.0,2,2,2,0,1,2,5,0
539,Cifu,5.0,10,7,7,3,0,7,13,53.8,6,5,1,4,8,18,10,0
541,Luca Cigarini,10.3,26,14,11,12,3,12,28,42.9,16,10,1,9,12,38,9,0
544,Tim Civeja,0.4,0,0,0,0,0,0,1,0.0,1,0,0,0,3,3,0,0
546,Ciaran Clark,21.0,24,14,15,6,3,6,13,46.2,7,27,20,7,29,53,104,1
547,Alexis Claude-Maurice,21.2,40,19,17,14,9,14,48,29.2,34,16,2,14,14,54,3,0
548,Jonathan Clauss,28.0,43,20,12,20,11,17,38,44.7,21,24,1,23,45,88,46,0
549,Carlos Clerc,30.9,56,29,33,16,7,22,39,56.4,17,26,4,22,37,93,55,1
550,Nathaniel Clyne,12.7,17,10,8,8,1,9,16,56.3,7,7,2,5,18,35,25,1
551,Conor Coady,36.7,35,23,25,10,0,19,35,54.3,16,40,32,8,27,62,134,2
552,Marcus Coco,16.4,36,21,17,15,4,16,36,44.4,20,16,3,13,20,56,17,0
553,Coke,9.3,24,10,14,7,3,14,27,51.9,13,13,1,12,14,38,27,0
554,Seamus Coleman,17.9,39,26,21,14,4,21,30,70.0,9,22,6,16,13,52,37,2
555,Ebrima Colley,8.2,11,4,2,6,3,3,11,27.3,8,6,0,6,6,17,1,0
556,Omar Colley,28.8,28,16,19,8,1,13,23,56.5,10,43,29,14,68,96,133,1
558,Lorenzo Colombo,1.0,2,1,1,1,0,0,3,0.0,3,0,0,0,0,2,3,0
560,Kingsley Coman,19.5,14,8,6,7,1,2,21,9.5,19,22,0,22,4,18,3,0
561,Daniel Congre,36.6,59,35,45,12,2,36,70,51.4,34,50,33,17,69,128,144,3
562,Aaron Connolly,8.8,6,3,1,3,2,0,2,0.0,2,4,0,4,0,6,2,0
563,Andrea Consigli,37.0,2,2,2,0,0,2,2,100.0,0,0,0,0,0,2,14,4
564,Andrea Conti,0.3,1,1,1,0,0,0,1,0.0,1,0,0,0,1,2,0,0
565,Andrea Conti,9.0,21,10,16,4,1,13,26,50.0,13,13,4,9,16,37,23,0
566,Liam Cooper,24.3,68,45,39,27,2,37,59,62.7,22,39,32,7,61,129,70,1
567,Francis Coquelin,8.2,19,14,4,12,3,8,19,42.1,11,8,2,6,21,40,11,1
568,Theo Corbeanu,0.1,2,1,0,2,0,1,1,100.0,0,0,0,0,1,3,0,0
569,Sebastien Corchia,23.0,55,30,29,17,9,33,60,55.0,27,28,10,18,38,93,40,1
572,Inigo Cordoba,1.1,0,0,0,0,0,0,3,0.0,3,4,0,4,2,2,1,0
573,Inigo Cordoba,2.4,6,4,1,3,2,2,10,20.0,8,7,0,7,3,9,2,0
574,Jhon Cordoba,17.1,9,4,1,5,3,2,4,50.0,2,13,2,11,6,15,4,0
575,Sergio Cordova,12.1,16,8,0,10,6,2,15,13.3,13,14,3,11,9,25,9,0
576,Jack Cork,15.0,26,10,5,17,4,11,31,35.5,20,15,4,11,16,42,20,0
577,Andreas Cornelius,21.1,11,4,1,5,5,2,12,16.7,10,9,2,7,1,12,25,1
578,Maxwel Cornet,27.2,70,41,39,24,7,33,58,56.9,25,23,5,18,43,113,47,2
579,Angel Correa,26.6,38,21,10,23,5,15,45,33.3,30,18,1,17,22,60,16,0
580,Joaquin Correa,21.5,21,12,6,11,4,7,25,28.0,18,14,0,14,7,28,12,0
581,Rober Correa,12.6,16,9,8,6,2,8,12,66.7,4,9,1,8,20,36,31,0
583,Thierry Correia,23.7,47,27,32,10,5,21,43,48.8,22,24,6,18,42,89,63,1
584,Danny da Costa,13.4,22,16,6,9,7,13,27,48.1,14,17,2,15,17,39,27,0
585,Danny da Costa,1.2,0,0,0,0,0,0,1,0.0,1,3,1,2,0,0,4,0
586,David Pereira da Costa,1.8,4,4,1,2,1,2,3,66.7,1,2,0,2,0,4,4,0
587,Diego Costa,2.3,1,0,1,0,0,1,3,33.3,2,0,0,0,0,1,2,0
588,Douglas Costa,0.5,1,0,1,0,0,1,3,33.3,2,0,0,0,0,1,0,0
589,Douglas Costa,3.6,2,1,1,1,0,1,3,33.3,2,7,0,7,2,4,1,0
590,Helder Costa,12.8,25,11,12,5,8,11,32,34.4,21,11,0,11,3,28,5,1
591,Jaume Costa,3.9,10,6,4,6,0,7,9,77.8,2,7,1,6,6,16,8,0
594,Benoit Costil,38.0,1,1,1,0,0,1,3,33.3,2,1,0,1,1,2,17,0
595,Vladimir Coufal,33.9,73,36,50,15,8,52,89,58.4,37,41,7,34,41,114,102,1
596,Kalifa Coulibaly,10.9,3,1,0,1,2,2,8,25.0,6,3,1,2,2,5,12,0
598,Lassana Coulibaly,18.7,78,41,33,34,11,39,75,52.0,36,29,4,25,33,111,17,0
600,Senou Coulibaly,21.5,33,21,23,10,0,12,24,50.0,12,18,12,6,30,63,89,0
601,Tanguy Coulibaly,16.7,26,15,10,7,9,11,23,47.8,12,20,0,20,10,36,11,0
602,Thibaut Courtois,38.0,0,0,0,0,0,0,1,0.0,1,1,0,1,1,1,17,2
603,Philippe Coutinho,7.3,8,6,2,5,1,3,9,33.3,6,7,0,7,2,10,1,0
604,Nicolas Cozza,15.2,39,30,27,11,1,20,40,50.0,20,20,11,9,26,65,62,0
605,Alessio Cragno,34.0,0,0,0,0,0,0,1,0.0,1,0,0,0,1,1,10,0
607,Aaron Cresswell,35.2,32,13,15,15,2,18,32,56.3,14,29,14,15,32,64,79,2
608,Domenico Criscito,19.2,43,22,29,11,3,22,39,56.4,17,27,14,13,44,87,51,0
609,Bryan Cristante,23.9,27,20,10,14,3,10,28,35.7,18,21,7,14,40,67,61,1
610,Giovanni Crociata,0.3,1,0,0,1,0,0,1,0.0,1,1,0,1,0,1,0,0
611,Juan Cruz Armada,21.8,36,22,17,16,3,19,35,54.3,16,19,5,14,15,51,50,0
612,Juan Cuadrado,24.2,43,25,22,15,6,29,60,48.3,31,16,2,14,43,86,22,2
613,Andres Cubas,24.9,80,47,30,44,6,33,74,44.6,41,37,10,27,50,130,29,3
615,Cucho,16.3,19,10,1,14,4,2,23,8.7,21,18,1,17,6,25,8,0
616,Marc Cucurella,36.0,64,51,19,40,5,25,66,37.9,41,45,4,41,40,104,27,0
617,Mickael Cuisance,11.4,24,11,2,15,7,10,33,30.3,23,13,1,12,3,27,4,0
619,Matheus Cunha,23.9,36,16,10,19,7,13,49,26.5,36,29,2,27,31,67,9,0
620,Giuseppe Cuomo,8.9,26,19,17,9,0,9,14,64.3,5,10,2,8,18,44,19,1
622,Patrick Cutrone,2.2,4,3,1,2,1,1,2,50.0,1,1,0,1,1,5,0,0
624,Patrick Cutrone,1.2,0,0,0,0,0,0,1,0.0,1,0,0,0,1,1,0,0
625,Wylan Cyprien,4.6,9,4,5,3,1,2,4,50.0,2,13,8,5,5,14,6,1
626,Rafael Czichos,25.1,48,24,33,13,2,23,42,54.8,19,25,9,16,53,101,109,0
627,Lennart-Marten Czyborra,13.0,19,10,7,7,5,11,19,57.9,8,6,1,5,17,36,27,0
628,Danilo D'Ambrosio,7.8,15,9,6,7,2,6,15,40.0,9,9,7,2,4,19,15,0
629,Damien Da Silva,29.6,22,13,13,8,1,12,18,66.7,6,17,13,4,44,66,99,1
630,Moanes Dabbur,11.1,6,3,3,1,2,1,13,7.7,12,6,0,6,9,15,7,0
631,Bryan Dabo,12.4,11,8,5,3,3,5,16,31.3,11,7,1,6,13,24,16,0
632,Colin Dagba,15.1,23,11,4,17,2,14,19,73.7,5,18,5,13,16,39,18,1
633,Finn Dahmen,3.0,0,0,0,0,0,0,1,0.0,1,0,0,0,0,0,1,0
634,Mahmoud Dahoud,14.0,30,18,9,20,1,14,38,36.8,24,23,5,18,18,48,11,1
636,Stuart Dallas,37.9,74,45,46,22,6,30,88,34.1,58,41,3,38,44,118,52,1
637,Diogo Dalot,12.1,32,17,23,6,3,17,34,50.0,17,18,5,13,25,57,42,0
638,Mikkel Damsgaard,19.7,42,21,14,20,8,22,70,31.4,48,40,4,36,24,66,17,0
639,Flavius Daniliuc,16.4,23,15,15,5,3,10,21,47.6,11,17,6,11,14,37,32,0
640,Danilo,32.4,62,31,37,16,9,35,66,53.0,31,32,12,20,66,128,68,2
641,Scott Dann,15.0,6,4,5,1,0,4,11,36.4,7,16,14,2,18,24,59,1
643,Dante,8.6,10,5,6,4,0,3,7,42.9,4,6,4,2,10,20,20,0
644,Andrea Danzi,1.2,0,0,0,0,0,0,1,0.0,1,0,0,0,3,3,1,0
645,Ebrima Darboe,3.6,5,2,3,1,1,3,10,30.0,7,3,0,3,8,13,0,1
646,Marton Dardai,9.1,17,10,10,6,1,9,16,56.3,7,7,3,4,16,33,31,0
647,Vladimir Darida,21.1,34,19,11,19,4,9,31,29.0,22,34,2,32,27,61,18,0
650,Matteo Darmian,2.3,6,5,3,3,0,4,7,57.1,3,2,0,2,6,12,7,0
651,Matteo Darmian,12.9,30,16,12,7,11,16,28,57.1,12,9,2,7,17,47,35,0
652,Jonathan David,26.2,17,10,5,5,7,9,24,37.5,15,19,1,18,3,20,9,0
653,Alphonso Davies,19.6,39,27,16,17,6,28,40,70.0,12,21,1,20,28,67,33,1
654,Ben Davies,15.0,27,17,10,11,6,13,30,43.3,17,10,5,5,18,45,49,2
655,Tom Davies,15.8,31,18,17,12,2,16,39,41.0,23,15,9,6,34,65,21,2
656,Keinan Davis,3.1,2,1,1,0,1,0,1,0.0,1,1,0,1,0,2,2,0
657,Leif Davis,0.4,0,0,0,0,0,0,3,0.0,3,1,0,1,1,1,0,0
658,Pawel Dawidowicz,20.7,42,28,30,10,2,14,24,58.3,10,28,19,9,27,69,62,1
659,Craig Dawson,21.4,11,8,7,4,0,5,12,41.7,7,26,22,4,32,43,88,3
660,Kevin De Bruyne,22.2,34,21,6,18,10,13,48,27.1,35,26,1,25,9,43,10,0
661,Sebastien De Maio,9.5,15,10,6,9,0,4,5,80.0,1,16,9,7,18,33,41,0
662,Rodrigo De Paul,35.6,41,24,17,22,2,15,60,25.0,45,32,1,31,17,58,20,1
664,Mattia De Sciglio,16.3,29,17,15,11,3,18,27,66.7,9,13,4,9,27,56,44,0
665,Lorenzo De Silvestri,23.8,34,24,18,13,3,16,37,43.2,21,37,10,27,30,64,62,3
666,Thibault De Smet,5.5,11,6,8,3,0,6,15,40.0,9,8,1,7,6,17,16,0
667,Lucas Deaux,19.5,47,32,20,22,5,16,49,32.7,33,20,3,17,20,67,30,4
668,Mathieu Debuchy,23.4,58,33,37,17,4,40,62,64.5,22,27,9,18,45,103,61,0
669,Gregoire Defrel,14.8,13,8,5,5,3,5,13,38.5,8,9,0,9,7,20,5,0
670,Alessandro Deiola,4.0,6,3,2,3,1,5,13,38.5,8,3,1,2,3,9,1,0
671,Alessandro Deiola,6.8,13,5,5,4,4,8,23,34.8,15,7,2,5,11,24,11,0
672,Romain Del Castillo,7.2,30,11,5,14,11,5,25,20.0,20,6,0,6,3,33,4,1
673,Lorenzo Del Pinto,0.1,0,0,0,0,0,0,2,0.0,2,0,0,0,0,0,0,0
674,Thomas Delaine,19.8,32,18,19,11,2,20,35,57.1,15,22,5,17,24,56,30,1
676,Thomas Delaney,14.3,40,30,15,20,5,11,31,35.5,20,28,10,18,22,62,15,1
678,Jonathan Delaplace,10.1,8,5,5,1,2,7,13,53.8,6,12,5,7,17,25,19,1
679,Sacha Delaye,0.1,0,0,0,0,0,0,1,0.0,1,0,0,0,1,1,1,0
680,Cristian Dell'Orco,2.9,1,0,1,0,0,1,3,33.3,2,8,5,3,7,8,9,1
681,Andy Delort,27.6,12,7,1,9,2,8,18,44.4,10,11,1,10,4,16,34,0
682,Fabian Delph,3.0,5,2,3,2,0,1,3,33.3,2,2,0,2,4,9,8,1
683,Moussa Dembele,1.1,0,0,0,0,0,0,1,0.0,1,0,0,0,1,1,0,0
684,Moussa Dembele,7.5,2,2,0,1,1,0,4,0.0,4,4,2,2,5,7,9,0
685,Ousmane Dembele,19.7,14,9,4,9,1,6,17,35.3,11,10,0,10,9,23,3,1
686,Merih Demiral,10.4,12,9,8,4,0,5,13,38.5,8,16,9,7,21,33,40,0
687,Kerem Demirbay,19.4,46,31,15,26,5,19,38,50.0,19,21,4,17,8,54,6,1
688,Ermedin Demirovic,16.6,15,9,4,6,5,2,16,12.5,14,29,5,24,0,15,27,0
689,Diego Demme,17.7,56,32,26,22,8,23,63,36.5,40,14,1,13,11,67,15,1
690,Jason Denayer,29.0,25,16,16,9,0,6,13,46.2,7,36,25,11,27,52,91,1
691,Leander Dendoncker,27.8,54,29,29,22,3,31,60,51.7,29,38,15,23,27,81,52,2
692,Kevin Denkey,5.8,4,2,0,3,1,0,3,0.0,3,2,0,2,1,5,2,0
693,Emmanuel Dennis,5.3,13,7,6,5,2,1,6,16.7,5,6,0,6,0,13,0,1
694,Stefano Denswil,1.3,2,1,1,1,0,0,1,0.0,1,1,0,1,1,3,1,0
695,Fabio Depaoli,12.4,25,13,15,6,4,15,32,46.9,17,16,4,12,12,37,38,0
696,Fabio Depaoli,0.9,1,0,0,1,0,0,2,0.0,2,0,0,0,1,2,1,0
697,Fabio Depaoli,2.1,3,2,0,1,2,1,2,50.0,1,4,0,4,3,6,2,0
699,Mike van der Hoorn,15.1,8,4,3,5,0,1,3,33.3,2,12,8,4,27,35,73,0
702,Kiril Despodov,0.1,1,1,0,1,0,1,1,100.0,0,0,0,0,0,1,0,0
703,Sergino Dest,21.2,31,16,23,6,2,18,32,56.3,14,25,4,21,10,41,24,1
704,Mattia Destro,17.8,6,3,0,3,3,2,9,22.2,7,11,0,11,4,10,8,0
705,Gerard Deulofeu,6.6,2,2,1,1,0,2,12,16.7,10,2,0,2,3,5,0,0
706,Deyverson,9.7,6,4,3,1,2,2,13,15.4,11,9,0,9,9,15,13,0
707,Jacopo Dezi,0.9,4,3,0,2,2,3,6,50.0,3,2,0,2,0,4,0,0
708,Samuel Di Carmine,5.6,1,2,0,1,0,0,3,0.0,3,1,0,1,0,1,5,0
709,Samuel Di Carmine,5.3,2,2,1,0,1,1,3,33.3,2,2,0,2,0,2,5,0
710,Giovanni Di Lorenzo,36.0,79,50,54,21,4,43,75,57.3,32,37,13,24,35,114,64,1
711,Angel Di Maria,20.6,26,17,6,8,12,11,45,24.4,34,14,1,13,6,32,7,0
713,Giuseppe Di Serio,3.2,2,2,1,1,0,0,4,0.0,4,5,0,5,0,2,4,0
714,Boulaye Dia,32.6,23,12,3,11,9,4,22,18.2,18,19,5,14,12,35,37,1
716,Moussa Diaby,26.5,10,6,4,5,1,6,20,30.0,14,11,0,11,12,22,5,0
717,Mbaye Diagne,13.2,4,3,3,0,1,1,4,25.0,3,2,1,1,1,5,16,0
718,Mouctar Diakhaby,23.1,16,8,10,6,0,8,12,66.7,4,28,21,7,27,43,102,1
719,Abdou Diallo,16.6,16,11,9,5,2,8,13,61.5,5,15,8,7,25,41,36,0
722,Habib Diallo,25.8,11,6,3,6,2,7,18,38.9,11,12,2,10,13,24,12,0
723,Habib Diallo,1.6,1,1,0,1,0,1,1,100.0,0,0,0,0,0,1,5,0
724,Ibrahima Diallo,11.3,29,16,11,17,1,9,16,56.3,7,10,1,9,10,39,12,2
725,Ibrahima Diallo,4.9,14,9,2,9,3,4,8,50.0,4,4,0,4,3,17,3,0
728,Grady Diangana,13.7,35,19,19,9,7,19,43,44.2,24,16,2,14,16,51,9,0
729,Stephane Diarra,2.2,0,0,0,0,0,0,7,0.0,7,6,1,5,4,4,1,0
730,Ruben Dias,31.6,24,13,13,8,3,4,16,25.0,12,31,23,8,35,59,92,0
731,Krepin Diatta,4.3,4,3,1,1,2,1,3,33.3,2,5,1,4,4,8,1,0
732,Amadou Diawara,7.3,10,8,4,6,0,2,8,25.0,6,11,2,9,12,22,4,0
733,Brahim Diaz,13.6,18,10,7,7,4,10,23,43.5,13,10,0,10,2,20,2,0
734,Victor Diaz,9.2,21,10,13,6,2,10,19,52.6,9,14,8,6,16,37,39,0
735,Daniel Didavi,10.8,16,6,2,9,5,7,12,58.3,5,10,0,10,3,19,8,0
736,Bamba Dieng,1.4,5,3,3,2,0,2,4,50.0,2,2,0,2,0,5,0,0
737,Eric Dier,28.0,23,14,13,10,0,11,18,61.1,7,37,31,6,23,46,123,3
738,Daan Dierckx,5.2,5,4,5,0,0,3,5,60.0,2,10,6,4,13,18,21,0
739,Lucas Digne,29.8,63,38,40,16,7,29,54,53.7,25,42,4,38,31,94,87,0
740,Mitchell Dijks,16.5,21,14,15,5,1,12,21,57.1,9,17,2,15,17,38,35,0
741,Javairo Dilrosun,5.9,5,3,2,2,1,1,6,16.7,5,5,0,5,4,9,3,0
742,Federico Dimarco,29.0,32,19,23,7,2,13,28,46.4,15,18,9,9,47,79,50,1
743,Junior Dina Ebimbe,23.8,38,25,14,19,5,15,45,33.3,30,17,1,16,14,52,9,0
744,Tristan Dingome,0.2,0,0,0,0,0,0,1,0.0,1,0,0,0,0,0,0,0
745,Eren Dinkci,1.2,1,1,1,0,0,0,1,0.0,1,4,0,4,2,3,1,0
746,Sinaly Diomande,12.6,10,7,8,1,1,5,14,35.7,9,19,15,4,33,43,53,1
747,Lois Diony,19.4,15,10,3,9,3,4,18,22.2,14,6,3,3,5,20,16,0
748,Issa Diop,15.3,20,14,12,8,0,7,18,38.9,11,32,22,10,22,42,59,0
749,Papakouli Diop,25.8,43,29,15,22,6,12,41,29.3,29,23,5,18,39,82,34,1
750,Sofiane Diop,22.5,49,34,17,25,7,18,53,34.0,35,25,1,24,31,80,15,0
756,Axel Disasi,22.3,29,20,17,12,0,20,35,57.1,15,18,11,7,26,55,66,1
757,Tiago Djalo,9.7,22,13,14,5,3,15,23,65.2,8,10,4,6,9,31,23,0
758,Djene,32.7,61,39,31,26,4,26,34,76.5,8,24,11,13,42,103,96,0
759,Moussa Djenepo,13.8,52,27,27,17,8,28,63,44.4,35,24,2,22,10,62,14,0
760,Koffi Djidji,16.9,39,28,30,8,1,10,20,50.0,10,35,20,15,28,67,73,0
761,Alexander Djiku,28.4,60,41,45,13,2,32,52,61.5,20,28,10,18,91,151,104,0
762,Berat Djimsiti,29.2,41,29,27,12,2,17,34,50.0,17,34,20,14,62,103,89,1
763,Marko Dmitrovic,34.7,4,3,4,0,0,2,4,50.0,2,0,0,0,0,4,16,2
764,Ritsu Doan,30.8,53,31,22,19,12,19,52,36.5,33,42,1,41,31,84,11,0
765,Mihai Dobre,5.9,12,5,6,2,4,7,14,50.0,7,5,0,5,10,22,3,0
766,Matt Doherty,13.8,29,15,15,10,4,13,33,39.4,20,20,5,15,23,52,46,0
767,Jeremy Doku,25.7,44,25,9,24,11,11,26,42.3,15,18,1,17,11,55,1,0
768,Kasper Dolberg,21.4,6,2,1,3,2,2,11,18.2,9,11,2,9,6,12,19,1
769,Keagan Dolly,5.0,7,2,6,0,1,4,8,50.0,4,3,0,3,5,12,2,0
770,Jaume Domenech,28.0,1,1,1,0,0,1,2,50.0,1,1,0,1,0,1,16,2
771,Carlos Dominguez,4.0,5,4,4,1,0,3,6,50.0,3,5,3,2,6,11,24,0
772,Nicolas Dominguez,13.9,48,28,26,17,5,15,37,40.5,22,26,7,19,24,72,20,0
775,Anastasios Donis,1.1,4,1,2,0,2,1,1,100.0,0,0,0,0,0,4,0,0
776,Gianluigi Donnarumma,37.0,0,0,0,0,0,0,1,0.0,1,1,0,1,1,1,23,2
777,Gabriel Dos Santos,22.2,25,15,19,5,1,13,19,68.4,6,27,19,8,26,51,74,2
778,Bas Dost,9.1,3,2,1,1,1,2,5,40.0,3,5,1,4,2,5,8,0
780,Abdoulaye Doucoure,27.1,52,32,25,19,8,14,43,32.6,29,24,7,17,39,91,31,1
781,Cheick Doucoure,29.2,87,47,40,42,5,32,65,49.2,33,20,4,16,52,139,26,1
782,Fode Doucoure,3.7,11,8,7,4,0,4,9,44.4,5,2,0,2,4,15,11,0
783,Mahamadou Doucoure,0.5,1,1,1,0,0,1,1,100.0,0,0,0,0,0,1,0,0
784,Cheick Doukoure,1.1,5,4,2,1,2,3,4,75.0,1,2,0,2,3,8,0,0
785,Idrissa Doumbia,8.7,15,8,6,7,2,5,13,38.5,8,6,3,3,7,22,9,0
786,Moussa Doumbia,10.0,10,6,4,4,2,4,22,18.2,18,5,1,4,10,20,4,0
787,Souleyman Doumbia,24.7,48,33,25,19,4,22,36,61.1,14,18,4,14,42,90,50,0
788,Aleksandar Dragovic,12.6,11,7,5,5,1,9,13,69.2,4,17,5,12,13,24,33,0
789,Bartlomiej Dragowski,35.0,1,0,1,0,0,1,1,100.0,0,0,0,0,1,2,13,1
790,Denis Dragus,2.0,3,1,0,0,3,0,4,0.0,4,4,0,4,1,4,0,0
792,Mouhamadou Drammeh,1.9,0,0,0,0,0,0,2,0.0,2,0,0,0,2,2,7,0
793,Julian Draxler,11.8,13,6,5,6,2,5,20,25.0,15,4,0,4,14,27,0,0
794,Dominick Drexler,13.7,36,26,15,18,3,12,30,40.0,18,5,1,4,14,50,15,0
796,Domingos Duarte,26.3,32,20,18,12,2,14,21,66.7,7,29,20,9,29,61,86,0
798,Oscar Duarte,22.9,22,13,17,5,0,10,18,55.6,8,23,15,8,36,58,97,1
799,Ruben Duarte,28.3,55,30,28,21,6,23,52,44.2,29,44,6,38,66,121,72,0
800,Leo Dubois,32.3,38,26,19,16,3,18,36,50.0,18,27,9,18,31,69,69,2
802,Ondrej Duda,28.2,36,14,13,18,5,8,39,20.5,31,28,2,26,19,55,20,0
803,Unai Dufur,0.7,2,2,2,0,0,2,4,50.0,2,0,0,0,1,3,0,0
804,Haris Duljevic,8.6,15,9,4,7,4,6,22,27.3,16,3,0,3,8,23,1,0
806,Paul Dummett,13.9,16,7,11,5,0,13,21,61.9,8,12,7,5,16,32,74,0
807,Alfred Duncan,1.8,3,0,1,1,1,0,2,0.0,2,2,0,2,2,5,0,0
808,Alfred Duncan,11.9,18,10,8,9,1,4,21,19.0,17,8,0,8,16,34,8,1
809,Lewis Dunk,32.6,30,15,20,8,2,16,23,69.6,7,29,20,9,32,62,106,0
810,Jimmy Dunne,3.0,3,3,2,1,0,1,2,50.0,1,3,2,1,6,9,16,1
811,Erik Durm,16.4,17,13,7,9,1,8,21,38.1,13,19,5,14,29,46,26,0
813,Jean-Kevin Duverne,22.5,38,21,24,14,0,15,32,46.9,17,24,16,8,30,68,70,0
814,Paulo Dybala,12.6,14,8,3,4,7,2,14,14.3,12,15,0,15,1,15,1,0
815,Edin Dzeko,20.3,8,6,2,3,3,3,9,33.3,6,9,4,5,1,9,11,0
816,Steeve-Mike Ebongue,0.6,2,1,1,0,1,0,3,0.0,3,1,0,1,0,2,0,0
817,Enzo Ebosse,2.9,5,3,5,0,0,3,4,75.0,1,1,1,0,2,7,13,0
818,Bruno Ecuele Manga,38.0,52,38,46,6,0,29,40,72.5,11,50,33,17,57,109,165,3
819,Simone Edera,0.6,3,1,2,1,0,3,4,75.0,1,0,0,0,1,4,1,0
820,Ederson,36.0,3,1,3,0,0,3,4,75.0,1,0,0,0,0,3,11,4
822,John Egan,29.2,41,21,29,12,0,22,39,56.4,17,43,31,12,41,82,131,0
823,Johannes Eggestein,0.4,0,0,0,0,0,0,1,0.0,1,0,0,0,1,1,2,0
824,Maximilian Eggestein,32.7,57,42,22,29,6,21,46,45.7,25,30,5,25,43,100,36,0
826,Kingsley Ehizibue,12.6,32,19,22,9,1,10,17,58.8,7,19,5,14,18,50,42,0
827,Albin Ekdal,25.5,56,29,21,32,3,23,65,35.4,42,31,12,19,49,105,35,0
828,Hugo Ekitike,1.0,1,1,0,0,1,0,1,0.0,1,0,0,0,0,1,0,0
829,Anthony Elanga,1.7,4,2,3,1,0,4,5,80.0,1,1,1,0,1,5,1,0
830,Niclas Eliasson,20.0,28,14,9,12,7,11,24,45.8,13,20,1,19,23,51,16,0
832,Elif Elmas,8.2,15,4,3,6,6,7,12,58.3,5,11,1,10,2,17,10,0
833,Ahmed Elmohamady,9.3,17,13,12,4,1,9,14,64.3,5,6,3,3,17,34,26,0
834,Mohamed Elneny,17.2,14,6,7,7,0,7,28,25.0,21,11,4,7,24,38,20,2
835,Aritz Elustondo,20.9,30,16,21,7,2,18,22,81.8,4,12,5,7,15,45,63,0
836,Nico Elvedi,28.2,49,35,36,12,1,25,37,67.6,12,38,22,16,65,114,123,0
837,Rodrigo Ely,5.2,5,2,3,2,0,3,4,75.0,1,2,1,1,7,12,23,1
838,Breel Embolo,16.0,15,10,1,13,1,0,6,0.0,6,16,1,15,8,23,8,0
839,Emerson,33.2,91,52,62,25,4,43,78,55.1,35,33,6,27,61,152,102,2
840,Renaud Emond,3.9,0,0,0,0,0,0,1,0.0,1,2,0,2,0,0,1,0
842,Youssef En-Nesyri,25.7,17,11,2,9,6,4,21,19.0,17,15,0,15,8,25,23,0
843,Keita Endo,5.1,8,3,1,5,2,3,9,33.3,6,5,2,3,6,14,4,0
844,Wataru Endo,32.8,65,44,25,34,6,29,71,40.8,42,53,14,39,51,116,59,0
845,Sergi Enrich,15.6,21,15,6,7,8,9,22,40.9,13,11,0,11,6,27,5,0
846,Christian Eriksen,15.4,12,6,6,4,2,7,20,35.0,13,16,1,15,9,21,13,1
847,Martin Erlic,20.0,23,14,16,6,1,11,20,55.0,9,22,16,6,41,64,71,2
848,Patrick Erras,0.3,0,0,0,0,0,0,1,0.0,1,0,0,0,0,0,0,0
849,Gonzalo Escalante,8.1,26,13,11,14,1,8,28,28.6,20,10,3,7,19,45,13,0
850,Aaron Escandell,5.0,1,1,1,0,0,1,1,100.0,0,0,0,0,0,1,6,0
851,Dani Escriche,9.5,9,7,5,2,2,3,10,30.0,7,11,0,11,8,17,5,0
852,Sergio Escudero,6.3,12,8,6,5,1,6,12,50.0,6,5,2,3,9,21,7,0
853,Alfonso Espino,28.9,92,48,63,28,1,43,85,50.6,42,30,5,25,41,133,74,0
854,Vicente Esquerdo,2.6,7,4,5,2,0,4,6,66.7,2,4,2,2,8,15,1,0
855,Nahuel Estevez,19.6,13,5,4,6,3,5,32,15.6,27,23,5,18,20,33,22,1
856,Pervis Estupinan,13.0,37,17,23,12,2,14,23,60.9,9,10,2,8,35,72,14,2
858,Yoann Etienne,1.0,2,0,1,1,0,1,1,100.0,0,1,0,1,1,3,2,0
859,Xabier Etxeita,9.8,8,4,5,3,0,7,14,50.0,7,6,3,3,13,21,38,0
860,Jonny Evans,27.5,25,12,22,2,1,14,20,70.0,6,8,3,5,46,71,98,1
861,Edu Exposito,27.3,51,30,16,31,4,20,66,30.3,46,25,4,21,22,73,17,0
862,Valentin Eysseric,8.1,14,8,6,7,1,5,11,45.5,6,11,0,11,7,21,8,0
863,Eberechi Eze,28.4,27,14,11,13,3,16,35,45.7,19,19,3,16,24,51,9,1
865,Lukasz Fabianski,35.0,1,0,1,0,0,1,1,100.0,0,1,0,1,1,2,12,3
866,Fabinho,28.5,58,31,21,29,8,27,54,50.0,27,28,10,18,44,102,66,1
867,Fabio,16.7,62,37,37,23,2,35,61,57.4,26,29,8,21,37,99,49,0
868,Cesc Fabregas,9.7,20,12,6,9,5,9,22,40.9,13,11,1,10,13,33,3,0
870,Bandiougou Fadiga,0.5,0,0,0,0,0,0,2,0.0,2,0,0,0,0,0,0,0
871,Wout Faes,32.2,35,22,26,9,0,20,39,51.3,19,40,31,9,68,103,144,1
873,Ralf Fahrmann,20.8,2,1,2,0,0,1,2,50.0,1,0,0,0,1,3,9,3
874,Romain Faivre,32.1,54,27,26,23,5,21,54,38.9,33,30,0,30,30,84,18,0
875,Fali,29.3,42,25,24,15,3,16,37,43.2,21,28,15,13,32,74,119,0
876,Iago Falque,4.0,4,2,2,2,0,1,6,16.7,5,4,1,3,0,4,1,0
877,Andri Fannar Baldursson,2.4,6,6,1,2,3,1,3,33.3,2,3,1,2,3,9,7,0
878,Paolo Farago,0.3,1,1,1,0,0,1,2,50.0,1,1,0,1,0,1,0,0
879,Paolo Farago,4.1,13,9,10,3,0,9,20,45.0,11,3,2,1,6,19,15,0
880,Davide Faraoni,32.1,62,33,36,19,7,28,51,54.9,23,48,17,31,49,111,83,1
881,Mohamed Fares,12.7,20,15,9,7,4,11,19,57.9,8,14,1,13,16,36,21,0
882,Diego Farias,16.8,9,5,4,1,4,4,21,19.0,17,12,0,12,13,22,3,0
886,Ansu Fati,4.8,9,4,2,4,3,2,10,20.0,8,4,0,4,3,12,1,0
887,Julien Faussurier,10.6,16,11,6,8,2,11,25,44.0,14,12,4,8,9,25,10,0
888,Andrea Favilli,3.8,3,1,0,1,2,2,3,66.7,1,2,0,2,0,3,2,0
889,Federico Fazio,4.5,3,2,3,0,0,3,4,75.0,1,3,3,0,7,10,18,1
890,Nabil Fekir,29.1,45,23,9,22,14,7,43,16.3,36,31,2,29,8,53,2,0
891,Felipe,22.9,29,17,19,10,0,18,23,78.3,5,30,15,15,36,65,128,2
892,Luiz Felipe,10.1,32,20,19,11,2,16,24,66.7,8,20,9,11,21,53,29,1
893,Joao Felix,17.5,8,4,1,6,1,4,17,23.5,13,3,0,3,5,13,2,0
894,Ohis Felix Uduokhai,29.0,33,24,19,10,4,18,27,66.7,9,48,25,23,54,87,164,2
895,Zinedine Ferhat,32.9,36,21,18,9,9,18,39,46.2,21,22,0,22,32,68,38,0
896,Bruno Fernandes,34.4,57,30,16,29,12,26,100,26.0,74,38,0,38,26,83,29,0
897,Edimilson Fernandes,9.3,8,4,4,4,0,4,7,57.1,3,12,4,8,29,37,25,0
899,Alex Fernandez,21.6,19,9,8,8,3,8,30,26.7,22,14,1,13,22,41,15,0
900,Alvaro Fernandez,22.0,1,1,0,1,0,1,3,33.3,2,0,0,0,2,3,7,0
902,Augusto Fernandez,4.1,11,3,5,6,0,2,13,15.4,11,5,1,4,9,20,5,0
903,Carlos Fernandez,1.6,1,0,1,0,0,0,2,0.0,2,3,1,2,1,2,0,0
904,Carlos Fernandez,4.3,3,2,0,2,1,1,8,12.5,7,6,1,5,0,3,6,0
905,Federico Fernandez,23.1,29,22,23,5,1,17,21,81.0,4,41,31,10,17,46,147,0
906,Joaquin Fernandez,23.0,30,16,21,8,1,12,21,57.1,9,24,15,9,43,73,113,0
907,Fernandinho,13.2,31,17,8,14,9,20,43,46.5,23,11,2,9,23,54,17,0
908,Fernando,28.3,54,28,24,25,5,23,43,53.5,20,25,11,14,41,95,70,0
910,Alex Ferrari,9.8,27,15,16,9,2,15,24,62.5,9,18,6,12,23,50,26,0
911,David Ferreiro,28.1,25,12,12,8,5,8,49,16.3,41,21,1,20,25,50,15,0
912,Salvador Ferrer,13.2,20,10,10,8,2,8,22,36.4,14,13,4,9,24,44,37,1
913,Facundo Ferreyra,3.3,4,3,1,2,1,0,2,0.0,2,5,0,5,2,6,2,0
914,Jordan Ferri,28.6,58,40,34,22,2,31,103,30.1,72,30,5,25,8,66,18,1
916,Fidel,26.6,46,30,28,15,3,25,64,39.1,39,22,2,20,16,62,14,0
918,Alfred Finnbogason,6.0,2,1,0,1,1,0,1,0.0,1,7,1,6,1,3,4,0
919,Roberto Firmino,31.5,33,15,3,17,13,6,32,18.8,26,42,5,37,11,44,12,0
920,Junior Firpo,3.2,1,1,1,0,0,0,1,0.0,1,5,3,2,4,5,7,0
921,John Fleck,28.6,51,33,28,18,5,26,83,31.3,57,26,4,22,28,79,12,1
923,Florian Flick,4.0,10,7,4,6,0,7,16,43.8,9,4,3,1,7,17,5,1
924,Alexis Flips,0.5,0,0,0,0,0,0,2,0.0,2,0,0,0,0,0,1,0
925,Alessandro Florenzi,17.1,24,16,9,9,6,12,29,41.4,17,7,1,6,17,41,25,0
927,Phil Foden,18.0,22,11,12,8,2,9,23,39.1,14,9,0,9,11,33,11,0
928,Mamadou Fofana,11.9,25,11,17,8,0,7,31,22.6,24,14,2,12,18,43,36,0
929,Seko Fofana,25.7,16,8,3,10,3,4,26,15.4,22,16,5,11,34,50,23,1
930,Wesley Fofana,25.1,51,37,27,22,2,31,46,67.4,15,28,16,12,61,112,94,0
931,Wesley Fofana,3.5,6,4,6,0,0,3,4,75.0,1,3,3,0,8,14,14,1
932,Youssouf Fofana,31.9,90,51,31,51,8,42,82,51.2,40,43,7,36,34,124,14,2
933,Thomas Foket,36.9,77,43,50,20,7,40,69,58.0,29,28,7,21,69,146,92,2
936,Lamine Fomba,24.2,66,36,30,25,11,30,65,46.2,35,48,19,29,59,125,39,2
937,Thomas Fontaine,3.6,5,2,5,0,0,2,2,100.0,0,3,2,1,5,10,14,0
938,Jose Fontan,7.2,12,9,8,4,0,5,11,45.5,6,4,3,1,13,25,27,0
939,Jose Fonte,35.4,40,29,28,10,2,27,33,81.8,6,36,23,13,36,76,137,1
940,Fernando Forestieri,6.1,9,7,4,4,1,3,7,42.9,4,7,0,7,2,11,0,0
941,Pablo Fornals,28.6,44,26,14,24,6,11,73,15.1,62,43,1,42,36,80,9,0
942,Emil Forsberg,17.1,11,6,1,6,4,5,27,18.5,22,10,1,9,11,22,4,0
943,Fraser Forster,8.0,1,0,1,0,0,1,2,50.0,1,0,0,0,0,1,9,0
944,Philipp Forster,16.8,22,13,7,12,3,6,25,24.0,19,18,1,17,15,37,2,0
945,Steven Fortes,15.9,33,20,20,10,3,16,22,72.7,6,25,10,15,27,60,52,0
947,Timothy Fosu-Mensah,0.9,2,0,1,1,0,1,1,100.0,0,0,0,0,3,5,1,0
948,Timothy Fosu-Mensah,4.5,4,2,1,2,1,2,4,50.0,2,7,3,4,7,11,4,0
949,Daam Foulon,11.3,26,15,21,5,0,16,28,57.1,12,12,3,9,14,40,34,0
950,Dimitri Foulquier,29.6,35,21,20,12,3,15,26,57.7,11,24,7,17,26,61,60,0
951,Juan Foyth,13.0,40,22,22,14,4,12,29,41.4,17,21,6,15,19,59,24,1
952,Gianluca Frabotta,7.7,7,4,5,0,2,5,12,41.7,7,9,1,8,14,21,15,0
953,Raphael Framberger,17.1,42,23,26,11,5,19,25,76.0,6,24,2,22,36,78,62,1
955,Ryan Fraser,10.3,4,1,3,1,0,2,5,40.0,3,1,0,1,6,10,7,0
956,Fred,26.6,81,39,39,38,4,29,89,32.6,60,49,9,40,45,126,26,1
957,Ryan Fredericks,6.3,9,5,5,4,0,3,7,42.9,4,6,2,4,11,20,20,0
958,Remo Freuler,30.1,63,39,17,38,8,32,76,42.1,44,52,4,48,39,102,27,2
959,Marco Friedl,30.9,50,34,31,17,2,30,62,48.4,32,38,17,21,55,105,118,1
960,Marvin Friedrich,34.0,47,29,35,11,1,18,32,56.3,14,38,18,20,52,99,109,0
962,Jeremie Frimpong,4.8,7,4,4,3,0,4,8,50.0,4,4,0,4,1,8,7,0
963,Jorge de Frutos,24.3,48,24,21,21,6,11,41,26.8,30,25,2,23,16,64,18,0
964,Christian Fuchs,7.8,18,7,15,2,1,8,15,53.3,7,6,4,2,16,34,34,1
965,Angelo Fulgini,30.3,22,13,4,12,6,12,34,35.3,22,17,0,17,15,37,9,0
966,Niclas Fullkrug,9.7,7,3,2,4,1,1,13,7.7,12,10,4,6,3,10,13,0
967,Ramiro Funes Mori,8.1,12,8,7,5,0,7,11,63.6,4,7,5,2,8,20,42,1
968,Darnell Furlong,32.6,45,27,27,12,6,21,44,47.7,23,39,16,23,49,94,90,0
970,Baptiste Gabard,1.5,4,3,1,3,0,1,5,20.0,4,4,0,4,1,5,0,0
971,Matteo Gabbia,6.2,9,5,3,6,0,2,2,100.0,0,8,6,2,3,12,21,0
972,Manolo Gabbiadini,9.7,2,2,0,2,0,0,1,0.0,1,3,1,2,3,5,5,0
973,Mijat Gacinovic,9.1,18,10,6,11,1,9,24,37.5,15,13,0,13,18,36,15,0
974,Roberto Gagliardini,13.7,30,17,17,8,5,5,28,17.9,23,15,3,12,19,49,16,0
975,Riccardo Gagliolo,21.7,45,18,35,8,2,28,45,62.2,17,34,7,27,36,81,64,1
976,Adolfo Gaich,8.5,9,4,1,7,1,1,13,7.7,12,4,0,4,2,11,4,0
977,Andrey Galabinov,4.8,2,1,1,1,0,1,3,33.3,2,2,0,2,0,2,5,0
978,Javi Galan,34.1,88,54,47,35,6,46,72,63.9,26,30,4,26,39,127,61,0
979,Conor Gallagher,28.1,81,41,30,39,12,29,97,29.9,68,47,8,39,27,108,31,0
980,Enric Gallego,9.0,6,3,2,2,2,2,14,14.3,12,5,1,4,1,7,9,0
981,Kevin Gameiro,12.0,7,4,3,2,2,3,11,27.3,8,10,0,10,0,7,3,0
982,Idrissa Gana Gueye,17.6,63,35,20,34,9,26,50,52.0,24,26,7,19,20,83,9,3
983,Ignatius Ganago,14.5,4,3,0,2,2,3,12,25.0,9,7,1,6,6,10,3,0
984,Aleix Garcia,4.9,5,4,2,2,1,1,10,10.0,9,5,0,5,8,13,2,0
985,Borja Garcia,12.4,13,7,4,6,3,6,12,50.0,6,12,0,12,10,23,4,1
986,Dani Garcia,21.3,39,19,10,23,6,15,46,32.6,31,20,7,13,33,72,34,0
988,David Garcia,35.0,26,17,13,13,0,13,24,54.2,11,36,19,17,59,85,171,0
989,Eric Garcia,4.3,8,7,5,3,0,5,7,71.4,2,4,1,3,4,12,10,0
990,Manu Garcia,12.5,24,13,10,13,1,8,35,22.9,27,16,1,15,12,36,21,0
991,Raul Garcia,5.6,10,8,5,5,0,6,20,30.0,14,5,1,4,9,19,10,0
992,Raul Garcia,19.4,34,19,9,19,6,7,22,31.8,15,30,1,29,15,49,20,0
993,Ruben Garcia,30.2,50,29,21,22,7,14,45,31.1,31,28,2,26,29,79,20,0
994,Sergi Garcia,0.2,1,1,0,1,0,0,1,0.0,1,0,0,0,0,1,0,0
995,Unai Garcia,13.8,19,9,14,4,1,9,15,60.0,6,16,8,8,14,33,40,0
996,Mario Gaspar,20.6,55,34,22,24,9,21,40,52.5,19,26,4,22,30,85,47,1
998,Dwight Gayle,5.7,2,0,1,1,0,0,7,0.0,7,3,1,2,1,3,2,0
1001,Yann Gboho,3.4,6,3,3,1,2,3,8,37.5,5,1,0,1,1,7,3,1
1003,Christian Gebauer,7.6,9,4,2,5,2,4,11,36.4,7,4,1,3,6,15,14,0
1004,Theodor Gebre Selassie,33.7,61,35,39,17,5,28,64,43.8,36,33,11,22,58,119,98,1
1006,Dennis Geiger,7.3,13,10,3,8,2,5,8,62.5,3,10,0,10,3,16,0,0
1007,Christian Gentner,11.5,17,8,9,5,3,5,18,27.8,13,13,1,12,17,34,16,0
1008,Yannick Gerhardt,21.5,52,32,14,32,6,21,52,40.4,31,34,4,30,21,73,30,0
1009,Valere Germain,9.5,8,6,2,4,2,3,11,27.3,8,7,2,5,11,19,22,0
1010,Gervinho,22.5,5,1,2,2,1,1,14,7.1,13,11,1,10,10,15,3,0
1011,Willem Geubbels,3.3,12,8,5,7,0,5,13,38.5,8,9,0,9,3,15,5,0
1012,Hamadi Al Ghaddioui,0.5,0,0,0,0,0,0,1,0.0,1,0,0,0,0,0,0,0
1014,Anwar El Ghazi,17.9,16,13,6,7,3,7,23,30.4,16,11,0,11,6,22,11,0
1015,Paolo Ghiglione,15.1,27,15,17,8,2,13,28,46.4,15,14,2,12,13,40,25,0
1016,Faouzi Ghoulam,3.2,6,5,3,2,1,0,1,0.0,1,4,2,2,3,9,1,0
1017,Kieran Gibbs,9.0,15,11,11,3,1,8,10,80.0,2,8,6,2,16,31,30,1
1018,Morgan Gibbs-White,4.6,9,7,3,4,2,5,12,41.7,7,6,0,6,3,12,1,0
1019,Niko Giesselmann,4.8,12,9,7,4,1,5,8,62.5,3,9,3,6,8,20,13,1
1020,Rafal Gikiewicz,34.0,0,0,0,0,0,0,3,0.0,3,0,0,0,3,3,9,1
1022,Bryan Gil,25.2,28,18,12,11,5,6,23,26.1,17,20,0,20,17,45,6,0
1023,David Gil,4.0,0,0,0,0,0,0,1,0.0,1,0,0,0,0,0,2,0
1024,Billy Gilmour,2.9,4,2,1,2,1,2,7,28.6,5,3,2,1,3,7,1,0
1025,Alvaro Gimenez,4.5,4,2,2,2,0,0,3,0.0,3,2,0,2,2,6,3,0
1026,Daniel Ginczek,2.4,2,2,1,1,0,2,8,25.0,6,2,0,2,1,3,2,0
1027,Matthias Ginter,34.0,26,16,15,10,1,14,24,58.3,10,43,32,11,51,77,121,0
1028,Andrei Girotto,29.6,65,41,50,15,0,39,70,55.7,31,34,15,19,59,124,103,0
1029,Olivier Giroud,8.3,4,2,0,1,3,1,7,14.3,6,4,1,3,5,9,10,0
1030,Robert Glatzel,4.0,1,0,1,0,0,0,2,0.0,2,2,0,2,0,1,2,0
1031,Kamil Glik,35.6,44,24,33,10,1,25,53,47.2,28,37,31,6,62,106,153,0
1032,Serge Gnabry,18.3,39,19,7,19,13,12,32,37.5,20,17,0,17,26,65,3,0
1033,Ben Godfrey,29.8,55,33,37,15,3,27,41,65.9,14,56,37,19,33,88,120,0
1034,Diego Godin,27.9,60,32,51,9,0,24,39,61.5,15,41,24,17,56,116,117,0
1035,Akaki Gogia,1.6,1,0,0,1,0,0,2,0.0,2,0,0,0,1,2,0,0
1036,Amer Gojak,5.3,1,0,1,0,0,1,7,14.3,6,5,0,5,3,4,1,0
1037,Edoardo Goldaniga,20.6,28,18,21,7,0,14,23,60.9,9,17,7,10,38,66,62,1
1038,Vladimir Golemic,26.0,33,16,17,13,3,14,19,73.7,5,38,26,12,40,73,97,2
1040,Pierluigi Gollini,24.0,1,0,1,0,0,1,2,50.0,1,1,0,1,1,2,11,0
1041,Aleksandr Golovin,11.9,28,16,6,18,4,8,39,20.5,31,21,0,21,11,39,3,0
1043,Andre Gomes,17.4,35,23,16,16,3,17,58,29.3,41,19,1,18,10,45,12,1
1044,Dani Gomez,18.5,4,3,2,1,1,0,11,0.0,11,3,0,3,2,6,4,0
1045,Ibai Gomez,4.7,6,4,2,3,1,4,7,57.1,3,3,0,3,2,8,4,0
1046,Joe Gomez,6.6,3,2,1,1,1,0,4,0.0,4,3,2,1,4,7,29,0
1047,Maxi Gomez,29.9,11,9,3,7,1,3,14,21.4,11,13,3,10,2,13,34,0
1048,Moi Gomez,28.5,21,12,6,8,7,14,35,40.0,21,20,3,17,11,32,16,0
1049,Papu Gomez,7.4,3,2,2,1,0,2,8,25.0,6,8,1,7,1,4,1,0
1050,Papu Gomez,10.2,9,6,2,4,3,2,12,16.7,10,13,2,11,7,16,6,0
1051,Sergi Gomez,8.0,4,3,2,2,0,1,1,100.0,0,5,4,1,6,10,34,0
1052,Sergio Gomez,8.8,29,10,17,9,3,11,22,50.0,11,15,0,15,14,43,9,0
1053,Alfred Gomis,5.0,1,0,1,0,0,1,2,50.0,1,0,0,0,1,2,7,0
1054,Alfred Gomis,22.0,1,1,1,0,0,1,1,100.0,0,0,0,0,3,4,10,1
1055,Maxime Gonalons,16.4,53,37,18,33,2,15,37,40.5,22,17,0,17,25,78,21,1
1056,Vagner Goncalves,10.7,16,9,5,5,6,2,15,13.3,13,6,0,6,4,20,1,1
1057,Alvaro Gonzalez,31.5,26,17,20,6,0,19,31,61.3,12,30,18,12,33,59,119,1
1058,Bruno Gonzalez,25.1,26,17,18,8,0,17,31,54.8,14,22,14,8,37,63,112,1
1059,Diego Gonzalez,14.2,11,7,7,3,1,5,11,45.5,6,16,9,7,20,31,49,1
1060,Nicolas Gonzalez,10.4,5,5,1,2,2,0,6,0.0,6,10,3,7,4,9,6,0
1061,Sergio Gonzalez,1.0,1,0,0,1,0,1,2,50.0,1,0,0,0,2,3,0,0
1062,Urko Gonzalez,0.5,0,0,0,0,0,0,1,0.0,1,1,1,0,0,0,1,0
1063,Anthony Gordon,1.0,3,3,3,0,0,0,2,0.0,2,1,0,1,1,4,3,0
1064,Leon Goretzka,18.9,37,23,12,21,4,16,39,41.0,23,30,2,28,44,81,11,0
1066,Andoni Gorosabel,26.5,76,43,45,20,11,27,64,42.2,37,25,4,21,23,99,42,0
1067,Robin Gosens,28.0,46,35,20,15,11,17,41,41.5,24,50,7,43,41,87,34,0
1068,Amine Gouiri,30.5,31,18,7,16,8,10,41,24.4,31,22,6,16,17,48,23,0
1069,Lucas Gourna-Douath,14.7,32,22,18,11,3,15,28,53.6,13,10,0,10,24,56,18,0
1070,Jeffrey Gouweleeuw,31.5,36,20,24,11,1,16,33,48.5,17,37,18,19,69,105,149,2
1071,Jonathan Gradit,31.4,60,39,26,28,6,22,38,57.9,16,37,19,18,56,116,81,1
1072,Karlan Grant,12.5,5,3,3,2,0,2,4,50.0,2,7,0,7,5,10,17,0
1073,Alberto Grassi,13.1,30,11,14,13,3,8,29,27.6,21,22,9,13,26,56,32,0
1074,Andrew Gravillon,25.2,26,17,17,9,0,13,28,46.4,15,44,31,13,59,85,118,4
1076,Demarai Gray,4.9,3,2,1,2,0,1,1,100.0,0,3,0,3,4,7,3,0
1077,Adrian Grbic,10.7,6,4,2,2,2,1,7,14.3,6,6,0,6,5,11,7,0
1078,Jack Grealish,24.3,31,14,8,16,7,15,24,62.5,9,20,3,17,12,43,5,3
1080,Mason Greenwood,20.2,13,10,6,4,3,5,22,22.7,17,9,0,9,5,18,1,0
1081,Michael Gregoritsch,9.3,13,10,6,7,0,3,10,30.0,7,2,0,2,3,16,17,0
1082,Clement Grenier,12.0,20,8,9,8,3,7,31,22.6,24,7,0,7,5,25,3,0
1083,Sebastian Griesbeck,9.9,20,9,8,11,1,8,19,42.1,11,13,3,10,5,25,8,0
1084,Antoine Griezmann,28.9,37,22,10,18,9,12,40,30.0,28,20,1,19,12,49,11,0
1085,Vincenzo Grifo,25.7,18,7,6,7,5,14,34,41.2,20,13,0,13,27,45,18,1
1087,Florian Grillitsch,20.9,37,21,21,13,3,19,52,36.5,33,38,7,31,51,88,47,1
1088,Christian Gross,16.3,44,28,17,25,2,15,37,40.5,22,12,2,10,24,68,37,0
1089,Pascal Gross,27.6,45,24,24,15,6,24,53,45.3,29,25,4,21,23,68,18,1
1090,Kamil Grosicki,1.6,2,1,2,0,0,2,8,25.0,6,1,0,1,2,4,1,0
1093,Carlos Gruezo,23.2,57,32,20,32,5,20,52,38.5,32,32,5,27,35,92,29,1
1094,Vicente Guaita,37.0,1,1,1,0,0,1,1,100.0,0,0,0,0,1,2,11,1
1095,Andres Guardado,14.6,25,12,10,11,4,10,25,40.0,15,13,3,10,18,43,19,0
1096,Sergi Guardiola,19.9,11,5,1,5,5,2,27,7.4,25,12,1,11,7,18,16,3
1097,Nemanja Gudelj,11.6,23,12,16,5,2,4,10,40.0,6,10,6,4,24,47,24,2
1098,Goncalo Guedes,25.4,18,12,8,7,3,10,45,22.2,35,24,1,23,8,26,7,0
1099,Matteo Guendouzi,20.2,24,13,10,12,2,9,25,36.0,16,15,4,11,21,45,24,1
1100,Raphael Guerreiro,24.6,30,13,14,8,8,16,31,51.6,15,21,4,17,28,58,31,1
1101,Evann Guessand,0.3,0,0,0,0,0,0,1,0.0,1,1,1,0,1,1,1,0
1102,Kelyan Guessoum,12.5,13,7,11,1,1,11,16,68.8,5,8,6,2,24,37,51,0
1103,Ander Guevara,23.1,35,23,15,16,4,15,30,50.0,15,19,5,14,25,60,35,1
1104,Lamine Gueye,16.2,18,9,4,11,3,7,24,29.2,17,7,2,5,21,39,5,0
1105,Pape Gueye,22.9,49,21,25,19,5,15,45,33.3,30,25,6,19,47,96,34,0
1106,John Guidetti,2.3,2,2,0,2,0,0,2,0.0,2,0,0,0,1,3,2,0
1107,Josuha Guilavogui,8.3,17,9,9,8,0,5,12,41.7,7,12,5,7,29,46,25,0
1108,Frederic Guilbert,12.4,37,19,23,11,3,21,34,61.8,13,14,1,13,33,70,32,0
1109,Bruno Guimaraes,19.5,76,34,26,41,9,30,64,46.9,34,24,4,20,14,90,13,0
1110,Serhou Guirassy,19.6,4,1,1,3,0,1,3,33.3,2,10,1,9,5,9,17,0
1111,Peter Gulacsi,33.0,1,0,1,0,0,1,2,50.0,1,0,0,0,2,3,7,0
1112,Manuel Gulde,21.7,27,15,12,12,3,5,21,23.8,16,25,15,10,37,64,64,0
1113,Robert Gumny,15.3,24,15,12,9,3,15,23,65.2,8,12,2,10,18,42,31,0
1114,Ilkay Gundogan,22.5,25,15,8,12,5,10,39,25.6,29,13,4,9,20,45,9,0
1115,Christian Gunter,34.0,34,19,18,13,3,15,43,34.9,28,38,9,29,29,63,40,0
1116,Koray Gunter,19.6,20,10,10,9,1,4,9,44.4,5,27,21,6,70,90,87,0
1118,Jon Guridi,9.2,19,9,10,6,3,8,22,36.4,14,8,1,7,10,29,9,0
1120,Raul Guti,31.8,48,28,21,22,5,16,52,30.8,36,25,3,22,49,97,25,0
1121,Marcos Mauro Lopez Gutierrez,20.3,23,15,15,8,0,15,24,62.5,9,18,12,6,22,45,78,0
1122,Miguel Gutierrez,3.5,4,0,0,3,1,1,7,14.3,6,3,0,3,5,9,5,0
1124,Emmanuel Gyasi,31.7,30,16,16,10,4,9,31,29.0,22,13,2,11,14,44,8,0
1125,Erling Haaland,26.7,7,2,1,3,3,1,4,25.0,3,19,4,15,4,11,16,0
1126,Janik Haberer,5.4,7,4,4,3,0,3,15,20.0,12,4,1,3,7,14,9,0
1127,Alexander Hack,15.2,32,21,23,8,1,18,31,58.1,13,26,17,9,41,73,91,2
1129,Munir El Haddadi,9.4,12,8,5,5,2,2,12,16.7,10,6,0,6,5,17,6,0
1130,Andre Hahn,22.6,31,17,14,13,4,9,44,20.5,35,35,3,32,14,45,24,0
1131,Amadou Haidara,21.2,50,28,20,21,9,11,36,30.6,25,33,1,32,30,80,24,0
1132,Massadio Haidara,23.7,48,32,21,21,6,23,37,62.2,14,29,6,23,35,83,60,0
1133,Achraf Hakimi,29.6,53,32,23,19,11,23,48,47.9,25,31,1,30,22,75,23,1
1134,Sebastien Haller,10.4,14,9,1,6,7,4,20,20.0,16,7,1,6,5,19,7,0
1135,Marcel Halstenberg,18.3,29,18,20,8,1,19,41,46.3,22,15,3,12,16,45,35,0
1136,Pierre-Yves Hamel,9.4,15,8,3,9,3,1,6,16.7,5,12,1,11,10,25,6,0
1137,Romain Hamouma,19.7,12,7,5,6,1,4,24,16.7,20,17,1,16,7,19,11,0
1138,Samir Handanovic,36.0,1,0,1,0,0,1,1,100.0,0,0,0,0,0,1,6,3
1139,Lukas Haraslin,3.7,8,4,2,5,1,2,5,40.0,3,1,0,1,0,8,2,0
1140,Amine Harit,23.3,22,13,8,11,3,10,23,43.5,13,9,1,8,17,39,7,1
1142,Jack Harrison,31.6,63,38,20,30,13,26,59,44.1,33,30,2,28,15,78,21,0
1144,Marcel Hartel,18.7,35,19,15,18,2,20,40,50.0,20,17,4,13,26,61,16,1
1145,Makoto Hasebe,25.4,43,29,21,20,2,25,51,49.0,26,31,12,19,31,74,68,2
1146,Hans Hateboer,19.6,28,17,12,14,2,13,23,56.5,10,8,1,7,17,45,9,0
1147,Kortney Hause,7.0,4,2,3,1,0,0,3,0.0,3,4,2,2,8,12,53,0
1148,Kai Havertz,16.9,18,9,6,10,2,6,27,22.2,21,25,0,25,4,22,22,1
1149,Isaac Hayden,21.6,52,29,23,22,7,14,35,40.0,21,32,9,23,43,95,47,0
1150,Eden Hazard,5.9,3,2,1,2,0,0,3,0.0,3,3,0,3,3,6,0,0
1151,Thorgan Hazard,7.3,8,2,6,1,1,3,13,23.1,10,4,0,4,10,18,1,0
1152,Jonas Hector,14.3,34,22,8,21,5,15,35,42.9,20,24,5,19,19,53,20,1
1153,Michael Hector,2.9,3,2,1,2,0,1,6,16.7,5,4,2,2,0,3,6,0
1154,Hwang Hee-chan,5.1,3,2,1,0,2,1,7,14.3,6,4,0,4,1,4,1,0
1156,Dominique Heintz,15.2,22,11,19,3,0,10,19,52.6,9,10,8,2,35,57,49,0
1157,Dean Henderson,12.5,1,1,1,0,0,1,2,50.0,1,0,0,0,0,1,3,2
1158,Jordan Henderson,18.9,24,15,12,9,3,10,26,38.5,16,12,1,11,34,58,30,0
1159,Jeff Hendrick,15.8,8,3,5,3,0,1,13,7.7,12,14,9,5,19,27,18,0
1160,Benjamin Henrichs,6.0,12,7,4,5,3,2,9,22.2,7,9,1,8,8,20,8,0
1161,Dalbert Henrique,4.1,7,6,4,2,1,6,8,75.0,2,8,2,6,5,12,8,0
1162,Eduardo Henrique,10.3,5,2,1,4,0,3,12,25.0,9,6,1,5,7,12,7,1
1163,Luis Henrique,7.5,5,4,3,1,1,4,9,44.4,5,5,1,4,7,12,4,0
1164,Christophe Herelle,15.3,19,13,12,6,1,10,12,83.3,2,13,9,4,31,50,41,2
1165,Jerome Hergault,18.1,38,23,22,10,6,17,31,54.8,14,16,2,14,22,60,34,0
1166,Mario Hermoso,28.6,55,31,40,11,4,37,61,60.7,24,23,10,13,36,91,73,0
1167,Aridane Hernandez,22.5,20,11,13,6,1,7,12,58.3,5,22,19,3,34,54,127,1
1168,Lucas Hernandez,17.7,41,31,16,17,8,17,31,54.8,14,24,6,18,19,60,38,0
1170,Pablo Hernandez,4.7,5,3,2,1,2,5,16,31.3,11,2,0,2,0,5,0,1
1171,Theo Hernandez,32.6,48,29,22,21,5,19,38,50.0,19,29,6,23,34,82,64,5
1172,Hernani,24.3,51,25,21,27,3,29,66,43.9,37,35,4,31,31,82,40,1
1173,Ander Herrera,20.6,53,35,17,26,10,30,77,39.0,47,31,5,26,31,84,22,1
1174,Hector Herrera,7.6,12,7,5,6,1,7,13,53.8,6,7,2,5,14,26,8,0
1175,Sergio Herrera,32.9,0,0,0,0,0,0,2,0.0,2,0,0,0,3,3,29,3
1176,Yangel Herrera,25.7,59,26,19,32,8,11,41,26.8,30,53,17,36,26,85,32,1
1177,Patrick Herrmann,9.7,9,6,4,3,2,2,14,14.3,12,16,0,16,10,19,8,0
1178,Pablo Hervias,13.4,19,12,7,9,3,9,26,34.6,17,6,0,6,11,30,8,0
1179,Perparim Hetemaj,24.6,44,27,21,18,5,26,61,42.6,35,41,5,36,22,66,24,1
1180,Son Heung-min,34.6,32,18,11,14,7,18,72,25.0,54,28,3,25,14,46,8,0
1181,Aaron Hickey,8.4,12,8,10,2,0,7,17,41.2,10,6,1,5,15,27,15,1
1182,Vitorino Hilton,23.5,15,10,10,4,1,3,14,21.4,11,34,26,8,38,53,104,3
1183,Martin Hinteregger,28.1,77,49,53,22,2,37,63,58.7,26,31,12,19,44,121,92,0
1184,Marwin Hitz,15.5,1,1,1,0,0,1,1,100.0,0,0,0,0,0,1,7,1
1185,Wesley Hoedt,10.6,22,16,18,4,0,10,17,58.8,7,9,5,4,17,39,48,1
1186,Ki-Jana Hoever,6.4,14,6,11,2,1,10,22,45.5,12,2,0,2,9,23,23,0
1187,Nicolas Hofler,30.3,54,28,16,31,7,23,59,39.0,36,34,10,24,66,120,41,2
1188,Jonas Hofmann,20.2,26,20,12,12,2,10,53,18.9,43,27,2,25,27,53,9,0
1189,Marco Hoger,0.6,1,0,0,1,0,1,2,50.0,1,2,0,2,2,3,1,0
1190,Rob Holding,28.4,43,20,28,13,2,17,35,48.6,18,37,27,10,24,67,120,0
1191,Lucas Holer,23.2,36,24,13,19,4,12,32,37.5,20,19,2,17,16,52,14,0
1192,Mason Holgate,25.4,56,36,31,18,7,20,50,40.0,30,37,13,24,35,91,90,3
1193,Jordan Holsgrove,1.6,6,4,4,1,1,5,8,62.5,3,2,0,2,2,8,1,0
1194,Franck Honorat,27.3,28,13,12,10,6,14,37,37.8,23,15,3,12,11,39,24,0
1196,Matthew Hoppe,14.5,6,6,1,3,2,2,12,16.7,10,8,2,6,4,10,15,0
1197,Jannes Horn,19.6,35,19,23,11,1,23,31,74.2,8,19,2,17,10,45,45,0
1198,Timo Horn,33.4,1,0,1,0,0,1,4,25.0,3,1,0,1,0,1,11,2
1200,Conor Hourihane,2.5,0,0,0,0,0,0,2,0.0,2,3,0,3,0,0,2,0
1201,Lukas Hradecky,28.5,0,0,0,0,0,0,1,0.0,1,0,0,0,1,1,11,3
1202,Ajdin Hrustic,3.0,6,5,2,3,1,3,10,30.0,7,2,0,2,4,10,3,0
1203,Florian Hubner,5.8,10,5,7,3,0,7,15,46.7,8,7,3,4,13,23,21,0
1204,Callum Hudson-Odoi,11.8,23,15,11,7,5,8,21,38.1,13,15,1,14,6,29,6,0
1205,Niall Huggins,0.4,0,0,0,0,0,0,1,0.0,1,0,0,0,0,0,1,0
1206,Mats Hummels,31.3,58,40,34,18,6,26,42,61.9,16,31,22,9,73,131,122,2
1207,Adrien Hunou,6.5,6,3,2,2,2,2,8,25.0,6,7,0,7,1,7,2,0
1208,Klaas-Jan Huntelaar,6.5,4,2,0,2,2,0,2,0.0,2,3,1,2,2,6,3,0
1209,Elseid Hysaj,19.6,29,17,16,11,2,17,33,51.5,16,18,4,14,30,59,52,0
1210,Pierre Hojbjerg,38.0,98,51,45,42,11,54,129,41.9,75,51,9,42,48,146,66,0
1211,Simone Iacoponi,13.3,22,12,16,5,1,13,26,50.0,13,9,4,5,11,33,42,1
1212,Iago,17.3,37,27,21,13,3,17,29,58.6,12,17,5,12,22,59,55,0
1213,Roger Ibanez,26.6,59,37,28,25,6,25,45,55.6,20,38,17,21,68,127,78,3
1215,Vicente Iborra,10.3,18,8,8,7,3,8,24,33.3,16,14,7,7,14,32,25,1
1216,Didier Ibrahim Ndong,29.0,53,32,22,30,1,25,70,35.7,45,35,7,28,37,90,40,0
1217,Zlatan Ibrahimovic,16.6,5,4,0,4,1,3,6,50.0,3,5,3,2,6,11,27,1
1218,Mauro Icardi,12.0,6,2,1,2,3,4,13,30.8,9,3,1,2,3,9,7,0
1219,Oussama Idrissi,0.3,1,1,0,1,0,1,2,50.0,1,2,0,2,1,2,0,0
1220,Blendi Idrizi,2.6,8,4,1,6,1,1,1,100.0,0,6,2,4,3,11,1,0
1222,Odion Ighalo,0.1,0,0,0,0,0,0,1,0.0,1,0,0,0,0,0,0,0
1223,Iglesias,6.7,27,15,14,10,3,11,19,57.9,8,11,1,10,17,44,19,0
1224,Borja Iglesias,15.7,1,1,0,0,1,1,8,12.5,7,7,2,5,3,4,9,0
1225,Igor,13.0,15,9,9,6,0,7,12,58.3,5,17,9,8,23,38,34,0
1226,Kelechi Iheanacho,16.2,12,5,2,4,6,4,17,23.5,13,14,0,14,2,14,1,1
1227,Jonathan Ikone,24.2,18,12,3,8,7,9,22,40.9,13,16,1,15,7,25,9,0
1228,Yun Il-lok,3.5,0,0,0,0,0,0,4,0.0,4,0,0,0,5,5,1,0
1229,Ivan Ilic,20.4,26,14,11,11,4,7,21,33.3,14,17,5,12,27,53,26,0
1230,Josip Ilicic,17.0,9,4,1,5,3,5,21,23.8,16,12,0,12,2,11,0,1
1231,Asier Illarramendi,3.7,5,2,1,4,0,1,5,20.0,4,2,0,2,5,10,7,0
1232,Stefan Ilsanker,17.5,33,20,17,15,1,21,42,50.0,21,30,8,22,30,63,51,2
1233,Ciro Immobile,31.7,14,13,4,6,4,7,22,31.8,15,13,1,12,6,20,9,0
1234,Riccardo Improta,25.9,39,23,25,8,6,21,45,46.7,24,23,4,19,28,67,47,0
1235,Roberto Inglese,6.4,5,2,1,2,2,2,11,18.2,9,10,0,10,0,5,3,0
1236,Danny Ings,24.1,22,13,3,16,3,12,28,42.9,16,39,2,37,3,25,27,1
1237,Marcus Ingvartsen,21.8,17,11,5,6,6,8,26,30.8,18,22,0,22,18,35,10,0
1238,Lorenzo Insigne,31.8,26,18,8,12,6,13,72,18.1,59,30,1,29,37,63,6,1
1239,Roberto Insigne,17.8,16,10,8,3,5,7,27,25.9,20,10,0,10,7,23,9,0
1240,Pablo Insua,17.6,37,18,26,9,2,14,31,45.2,17,14,8,6,24,61,68,0
1241,Takashi Inui,20.2,13,8,6,3,4,3,12,25.0,9,19,0,19,12,25,7,0
1242,Artur Ionita,31.5,47,22,11,31,5,17,63,27.0,46,38,14,24,19,66,28,0
1243,Alexander Isak,26.0,9,5,0,3,6,3,8,37.5,5,17,1,16,3,12,7,0
1244,Isco,10.1,13,9,5,5,3,2,14,14.3,12,7,1,6,2,15,2,0
1245,Ardian Ismajli,14.4,19,9,10,8,1,8,13,61.5,5,10,7,3,23,42,52,1
1246,Branislav Ivanovic,8.5,14,5,11,3,0,7,13,53.8,6,11,5,6,8,22,25,0
1248,Alex Iwobi,17.1,27,10,10,14,3,13,25,52.0,12,20,1,19,16,43,14,0
1249,Jairo Izquierdo,14.2,21,13,13,8,0,12,31,38.7,19,7,1,6,14,35,12,0
1251,Armando Izzo,22.3,30,16,13,13,4,13,33,39.4,20,22,9,13,53,83,62,0
1252,Phil Jagielka,5.8,5,4,4,0,1,2,7,28.6,5,11,5,6,10,15,26,2
1253,Alireza Jahanbakhsh,5.9,9,7,3,5,1,2,12,16.7,10,8,0,8,8,17,1,0
1254,Mato Jajalo,0.4,1,1,1,0,0,1,1,100.0,0,1,0,1,2,3,0,0
1255,Ismail Jakobs,19.2,25,10,17,4,4,11,21,52.4,10,18,1,17,16,41,36,0
1256,Daniel James,10.1,15,9,4,7,4,3,18,16.7,15,10,1,9,0,15,6,0
1257,Reece James,26.4,55,35,24,22,9,21,44,47.7,23,36,7,29,17,72,52,0
1258,Alexandre Jankewitz,0.0,2,1,2,0,0,1,1,100.0,0,0,0,0,0,2,0,0
1259,Saidy Janko,13.6,19,10,12,5,2,8,14,57.1,6,9,1,8,18,37,47,0
1260,Jakub Jankto,26.8,28,17,14,7,7,11,35,31.4,24,16,1,15,24,52,34,0
1261,Tony Jantschke,3.0,2,2,1,1,0,1,3,33.3,2,6,4,2,4,6,7,0
1262,Adnan Januzaj,11.3,9,8,0,6,3,3,8,37.5,5,7,2,5,3,12,4,0
1264,Jason,4.9,9,3,5,2,2,4,16,25.0,12,6,1,5,10,19,4,0
1265,Luis Javier Suarez,18.5,19,11,5,7,7,6,17,35.3,11,10,1,9,8,27,11,0
1266,Corentin Jean,6.4,4,3,1,1,2,0,5,0.0,5,4,0,4,2,6,2,0
1267,Daniel Jebbison,3.2,6,2,1,3,2,3,7,42.9,4,6,1,5,1,7,0,0
1268,Tin Jedvaj,1.7,5,2,2,3,0,1,3,33.3,2,2,1,1,2,7,9,0
1269,Fredrik Jensen,4.2,3,2,1,2,0,3,6,50.0,3,4,1,3,2,5,6,0
1270,Jese,0.3,0,0,0,0,0,0,1,0.0,1,0,0,0,0,0,0,0
1271,Gabriel Jesus,22.9,17,6,5,5,7,11,28,39.3,17,16,0,16,15,32,5,0
1272,Juan Jesus,1.7,3,1,2,1,0,2,4,50.0,2,1,0,1,2,5,5,0
1274,Raul Jimenez,9.1,3,2,1,2,0,0,7,0.0,7,2,0,2,8,11,12,0
1275,Joaquin,14.3,9,3,1,5,3,4,12,33.3,8,8,0,8,17,26,11,0
1277,Joelinton,22.0,33,21,7,21,5,14,37,37.8,23,30,2,28,9,42,24,0
1278,Marco John,11.1,21,15,9,5,7,10,22,45.5,12,18,1,17,16,37,21,0
1279,Ben Johnson,5.8,11,5,5,3,3,7,9,77.8,2,5,1,4,11,22,9,0
1281,Curtis Jones,13.1,16,6,6,7,3,12,25,48.0,13,13,0,13,19,35,11,1
1282,Frenkie de Jong,35.0,44,27,21,19,4,15,35,42.9,20,20,4,16,38,82,29,2
1283,Luuk de Jong,14.1,9,5,3,2,4,1,7,14.3,6,11,3,8,5,14,15,0
1284,Jony,9.7,7,3,1,2,4,5,20,25.0,15,5,0,5,14,21,3,0
1285,Joan Jordan,26.7,52,28,17,29,6,17,76,22.4,59,22,3,19,27,79,25,0
1286,Jorginho,22.3,57,30,22,31,4,31,76,40.8,45,33,5,28,40,97,21,3
1287,Josan,21.4,34,18,23,11,0,13,39,33.3,26,24,1,23,21,55,26,1
1288,Willian Jose,12.3,2,1,1,1,0,1,4,25.0,3,6,1,5,1,3,12,0
1289,Willian Jose,7.7,3,1,0,3,0,1,3,33.3,2,3,1,2,0,3,8,0
1290,Joselu,33.6,27,14,6,15,6,8,28,28.6,20,26,3,23,15,42,58,1
1291,Josema,21.8,43,28,33,10,0,10,18,55.6,8,17,7,10,37,80,92,0
1292,Jota,15.5,19,14,6,7,6,3,29,10.3,26,12,0,12,9,28,9,0
1293,Diogo Jota,12.4,12,6,4,7,1,2,29,6.9,27,9,0,9,5,17,3,0
1294,Stevan Jovetic,8.9,8,4,2,3,3,3,13,23.1,10,1,0,1,3,11,3,0
1296,Luka Jovic,9.9,2,0,0,2,0,0,4,0.0,4,3,0,3,1,3,7,0
1297,Juanmi,6.7,13,9,3,5,5,4,18,22.2,14,4,0,4,2,15,4,0
1298,Hamed Junior Traore,19.9,29,17,10,10,9,14,35,40.0,21,27,3,24,18,47,9,0
1300,Vinicius Junior,21.9,32,22,14,10,8,11,43,25.6,32,28,0,28,7,39,4,0
1301,James Justin,23.0,61,37,38,18,5,20,41,48.8,21,36,10,26,30,91,58,1
1302,Musa Juwara,0.5,2,2,2,0,0,1,3,33.3,2,1,0,1,0,2,0,0
1303,Jens Jonsson,29.1,55,29,25,25,5,22,52,42.3,30,39,7,32,51,106,45,0
1304,Ozan Kabak,8.9,19,10,11,4,4,6,9,66.7,3,2,2,0,12,31,28,1
1305,Ozan Kabak,13.8,17,9,11,5,1,6,13,46.2,7,20,11,9,13,30,57,0
1306,Abdoul Kader Bamba,10.2,18,3,7,8,3,11,18,61.1,7,10,0,10,7,25,4,1
1307,Pavel Kaderabek,17.6,15,12,7,6,2,6,15,40.0,9,12,3,9,18,33,31,0
1308,Tino Kadewere,22.3,35,22,12,16,7,17,49,34.7,32,16,3,13,21,56,31,0
1309,Damian Kadzior,2.2,1,0,0,1,0,1,5,20.0,4,1,0,1,0,1,0,0
1310,Florian Kainz,5.0,4,2,0,4,0,2,8,25.0,6,7,0,7,3,7,3,0
1311,Gael Kakuta,26.6,38,23,10,18,10,8,44,18.2,36,24,3,21,17,55,4,0
1312,Sasa Kalajdzic,23.7,16,12,4,5,7,2,17,11.8,15,10,1,9,9,25,21,0
1314,Arnaud Kalimuendo,13.5,8,2,2,2,4,1,7,14.3,6,11,0,11,2,10,2,0
1315,Nikola Kalinic,11.8,5,1,2,2,1,0,3,0.0,3,6,0,6,1,6,7,0
1317,Samuel Kalu,10.7,21,12,11,8,2,4,13,30.8,9,14,0,14,9,30,2,0
1318,Pierre Kalulu,8.1,18,14,11,6,1,10,14,71.4,4,9,3,6,19,37,20,0
1319,Daichi Kamada,26.2,48,28,21,16,11,16,49,32.7,33,18,1,17,14,62,22,0
1320,Aboubakar Kamara,3.5,2,2,1,1,0,0,5,0.0,5,6,0,6,1,3,0,0
1321,Aboubakar Kamara,6.2,3,1,0,2,1,1,7,14.3,6,1,0,1,0,3,2,0
1322,Bingourou Kamara,8.0,1,1,1,0,0,1,3,33.3,2,0,0,0,1,2,2,1
1323,Boubacar Kamara,32.2,88,51,31,49,8,40,74,54.1,34,36,13,23,34,122,51,0
1324,Hassane Kamara,32.9,65,39,40,16,9,27,49,55.1,22,39,12,27,55,120,61,1
1327,Kevin Kampl,21.5,38,26,9,24,5,18,35,51.4,17,20,2,18,29,67,14,0
1328,Harry Kane,34.2,22,12,1,17,4,8,26,30.8,18,28,11,17,11,33,40,0
1329,Lee Kang-in,14.0,15,11,8,4,3,3,31,9.7,28,12,0,12,2,17,0,0
1330,Wilfried Kanga,1.5,0,0,0,0,0,0,1,0.0,1,1,0,1,0,0,2,0
1331,N'Golo Kante,23.8,79,42,39,35,5,27,56,48.2,29,42,4,38,59,138,34,0
1332,Jimmy Kaparos,0.2,0,0,0,0,0,0,1,0.0,1,0,0,0,0,0,0,0
1333,Yann Karamoh,14.4,27,17,8,12,7,11,31,35.5,20,6,0,6,4,31,11,0
1334,Isaac Karamoko,0.0,1,0,0,0,1,1,1,100.0,0,0,0,0,0,1,0,0
1335,Atakan Karazor,11.5,20,12,12,7,1,13,22,59.1,9,18,8,10,21,41,50,2
1338,Rick Karsdorp,28.3,36,23,19,12,5,21,48,43.8,27,18,1,17,30,66,32,0
1339,Silas Katompa,21.3,48,29,19,19,10,21,44,47.7,23,29,1,28,22,70,11,2
1340,Noah Katterbach,12.3,18,11,11,6,1,13,21,61.9,8,7,3,4,23,41,22,0
1341,Eiji Kawashima,24.0,1,0,1,0,0,1,1,100.0,0,0,0,0,0,1,4,2
1343,Moise Kean,18.9,11,8,2,6,3,3,12,25.0,9,7,1,6,8,19,10,0
1344,Michael Keane,33.2,28,15,20,8,0,14,31,45.2,17,46,33,13,51,79,161,0
1345,Neeskens Kebano,1.3,0,0,0,0,0,0,1,0.0,1,3,0,3,0,0,0,0
1346,Thilo Kehrer,18.0,31,26,17,11,3,10,26,38.5,16,16,4,12,15,46,37,1
1348,Naby Keita,5.8,11,5,1,8,2,7,17,41.2,10,10,0,10,9,20,6,0
1349,Yannik Keitel,5.5,12,8,7,4,1,7,9,77.8,2,9,3,6,10,22,8,0
1352,Stephane Keller,0.2,1,0,1,0,0,1,1,100.0,0,0,0,0,0,1,0,0
1353,Martin Kelly,0.0,1,0,1,0,0,1,1,100.0,0,0,0,0,0,1,0,0
1354,Marc-Oliver Kempf,30.3,49,26,28,18,3,29,49,59.2,20,40,25,15,68,117,103,1
1355,Kenedy,16.3,22,12,10,7,5,5,25,20.0,20,21,4,17,26,48,15,1
1356,Jonjoe Kenny,0.9,2,1,1,0,1,2,2,100.0,0,0,0,0,1,3,3,0
1357,Franck Kessie,35.8,53,30,28,19,6,20,38,52.6,18,47,15,32,46,99,51,0
1360,Saif-Eddine Khaoui,6.7,19,11,7,6,6,7,16,43.8,9,8,0,8,12,31,1,0
1361,Wahbi Khazri,13.1,24,15,12,7,5,12,24,50.0,12,10,1,9,4,28,11,0
1362,Rani Khedira,20.2,29,10,13,15,1,10,20,50.0,10,14,5,9,31,60,47,0
1363,Sami Khedira,4.4,11,6,3,7,1,6,12,50.0,6,4,0,4,9,20,7,0
1364,Kike,34.3,24,18,5,7,12,6,22,27.3,16,24,1,23,7,31,29,0
1365,Luca Kilian,4.2,14,7,10,4,0,9,17,52.9,8,3,1,2,13,27,12,0
1366,Max Kilman,14.6,21,14,13,4,4,8,14,57.1,6,17,8,9,19,40,46,0
1367,Joshua Kimmich,24.4,40,28,16,19,5,10,53,18.9,43,25,5,20,36,76,19,0
1368,Presnel Kimpembe,25.6,46,28,23,19,4,24,34,70.6,10,19,11,8,30,76,61,4
1370,Simon Kjaer,26.6,45,26,23,20,2,18,30,60.0,12,42,26,16,42,87,125,0
1371,Davy Klaassen,2.5,3,1,0,1,2,0,5,0.0,5,5,1,4,3,6,4,0
1372,Felix Klaus,1.5,7,4,3,4,0,4,5,80.0,1,4,0,4,2,9,4,0
1373,Klauss,0.6,1,0,0,0,1,0,1,0.0,1,0,0,0,0,1,0,0
1374,Ragnar Klavan,8.6,15,9,9,5,1,7,11,63.6,4,9,4,5,8,23,34,0
1375,Philipp Klement,4.7,7,3,6,0,1,3,7,42.9,4,9,2,7,6,13,7,0
1376,Mateusz Klich,26.6,38,20,14,20,4,14,61,23.0,47,13,4,9,11,49,16,0
1378,Mateo Klimowicz,13.3,20,15,6,10,4,5,18,27.8,13,5,1,4,2,22,2,0
1379,Fabian Klos,30.1,24,13,9,11,4,7,26,26.9,19,20,6,14,4,28,29,0
1380,Lukas Klostermann,16.1,23,19,8,12,3,11,18,61.1,7,16,6,10,18,41,44,1
1382,Justin Kluivert,9.0,2,1,1,1,0,0,2,0.0,2,4,0,4,5,7,3,0
1383,Lukas Klunter,11.0,10,5,6,4,0,5,10,50.0,5,3,1,2,11,21,29,1
1384,Ansgar Knauff,0.8,0,0,0,0,0,0,1,0.0,1,3,1,2,0,0,0,0
1385,Robin Knoche,33.8,44,29,30,12,2,23,39,59.0,16,43,27,16,49,93,118,2
1386,Gregor Kobel,33.0,2,2,2,0,0,2,2,100.0,0,0,0,0,2,4,8,1
1387,Robin Koch,12.6,27,16,17,10,0,10,19,52.6,9,18,12,6,27,54,34,2
1389,Kenan Kodro,5.1,0,0,0,0,0,0,2,0.0,2,2,1,1,2,2,6,0
1390,Kenan Kodro,0.5,0,0,0,0,0,0,1,0.0,1,0,0,0,0,0,0,0
1391,Dominik Kohr,14.1,47,31,14,26,7,20,39,51.3,19,18,5,13,27,74,15,0
1392,Dominik Kohr,2.9,11,7,0,7,4,4,9,44.4,5,5,1,4,9,20,9,0
1393,Koba Koindredi,0.2,1,1,1,0,0,0,1,0.0,1,0,0,0,0,1,0,0
1394,Koke,33.6,64,42,22,31,11,28,98,28.6,70,35,6,29,36,100,40,0
1395,Aleksandr Kokorin,1.0,1,0,0,1,0,0,1,0.0,1,1,0,1,0,1,0,0
1396,Aleksandar Kolarov,4.3,4,4,0,4,0,1,2,50.0,1,2,0,2,7,11,8,0
1398,Sead Kolasinac,15.8,20,17,10,7,3,8,18,44.4,10,17,5,12,20,40,17,0
1399,Randal Kolo Muani,33.7,22,14,1,13,8,7,27,25.9,20,15,2,13,8,30,26,0
1400,Timothee Kolodziejczak,22.6,28,15,23,5,0,19,27,70.4,8,24,15,9,36,64,80,1
1401,Ghislain Konan,29.0,57,32,35,17,5,32,56,57.1,24,25,11,14,30,87,67,0
1402,Ibrahima Konate,7.7,6,4,2,3,1,2,8,25.0,6,6,3,3,8,14,24,0
1404,Moussa Konate,13.3,5,3,1,2,2,2,11,18.2,9,4,1,3,5,10,8,0
1405,Geoffrey Kondogbia,4.9,16,9,9,4,3,7,19,36.8,12,6,1,5,8,24,8,0
1406,Geoffrey Kondogbia,6.8,30,20,12,16,2,11,20,55.0,9,11,5,6,11,41,8,1
1407,Lamine Kone,11.6,9,6,5,4,0,5,8,62.5,3,4,3,1,15,24,36,0
1408,Moussa Kone,19.5,13,6,1,8,4,2,9,22.2,7,7,1,6,2,15,7,0
1409,Youssouf Kone,0.8,2,0,1,0,1,0,1,0.0,1,0,0,0,0,2,0,0
1410,Terence Kongolo,1.0,3,2,1,2,0,1,1,100.0,0,0,0,0,2,5,3,0
1411,Ezri Konsa,35.5,25,13,18,6,1,9,13,69.2,4,53,47,6,29,54,162,1
1412,Laurent Koscielny,24.6,29,17,18,11,0,16,24,66.7,8,44,34,10,54,83,115,1
1413,Filip Kostic,28.2,54,31,22,23,9,22,54,40.7,32,43,6,37,26,80,28,2
1414,Mark Kosznovszky,1.0,2,2,1,1,0,1,4,25.0,3,2,0,2,1,3,1,0
1415,Christian Kouame,11.1,9,4,2,4,3,4,12,33.3,8,9,1,8,5,14,4,0
1416,Kalidou Koulibaly,24.5,36,24,25,7,4,19,32,59.4,13,46,26,20,29,65,64,2
1417,Jules Kounde,33.1,27,15,14,11,2,10,24,41.7,14,24,16,8,40,67,104,0
1418,Boubakar Kouyate,21.8,60,35,45,15,0,32,58,55.2,26,44,27,17,60,120,132,1
1419,Cheikhou Kouyate,34.7,58,37,44,12,2,25,43,58.1,18,42,26,16,32,90,125,2
1420,Mateo Kovacic,20.2,46,28,19,24,3,17,32,53.1,15,18,1,17,15,61,11,2
1422,Emil Krafth,14.3,19,8,9,9,1,12,25,48.0,13,15,9,6,15,34,52,2
1423,Andrej Kramaric,26.4,7,4,4,0,3,3,8,37.5,5,8,1,7,7,14,5,1
1424,Christoph Kramer,22.6,55,37,22,28,5,28,58,48.3,30,32,11,21,34,89,39,0
1425,Jean-Philippe Krasso,2.5,5,3,1,4,0,2,4,50.0,2,5,0,5,1,6,3,0
1426,Toni Kroos,23.5,42,22,15,15,12,11,44,25.0,33,26,6,20,15,57,10,3
1427,Filip Krovinovic,6.1,13,10,6,5,2,6,18,33.3,12,2,0,2,4,17,2,0
1428,Rade Krunic,8.0,15,12,6,6,3,7,17,41.2,10,12,2,10,10,25,9,0
1430,Max Kruse,18.1,7,3,1,5,1,2,9,22.2,7,11,0,11,3,10,3,0
1431,Lukas Kubler,9.8,15,8,9,5,1,9,14,64.3,5,9,3,6,21,36,31,0
1432,Takefusa Kubo,3.3,1,1,0,0,1,1,5,20.0,4,2,0,2,1,2,2,0
1433,Takefusa Kubo,8.9,7,4,2,3,2,1,14,7.1,13,14,0,14,14,21,4,0
1434,Juraj Kucka,25.9,67,36,21,37,9,26,74,35.1,48,25,3,22,28,95,25,0
1435,Kuki,0.3,1,1,0,0,1,0,1,0.0,1,0,0,0,0,1,0,0
1436,Dejan Kulusevski,21.4,33,19,12,10,11,14,43,32.6,29,22,0,22,9,42,2,1
1437,Marash Kumbulla,15.1,16,11,8,7,1,5,17,29.4,12,12,5,7,24,40,38,1
1438,Pierre Kunde,5.7,8,4,1,5,2,2,9,22.2,7,6,0,6,10,18,9,0
1439,Fabian Kunze,14.1,38,26,19,15,4,19,42,45.2,23,19,3,16,18,56,22,1
1440,Jasmin Kurtic,30.4,46,28,22,21,3,21,70,30.0,49,22,2,20,33,79,57,1
1441,Layvin Kurzawa,14.2,26,19,10,10,6,9,28,32.1,19,20,5,15,28,54,26,1
1442,Dereck Kutesa,7.6,15,7,7,3,5,5,14,35.7,9,7,1,6,7,22,3,0
1443,Ahmed Kutucu,1.2,1,0,0,0,1,1,2,50.0,1,1,0,1,0,1,0,0
1444,Enock Kwateng,11.5,21,12,15,4,2,14,27,51.9,13,15,3,12,26,47,27,0
1445,Giorgos Kyriakopoulos,16.2,35,18,17,12,6,8,28,28.6,20,16,5,11,15,50,42,0
1446,Antonino La Gumina,3.8,3,2,0,1,2,0,3,0.0,3,5,1,4,3,6,5,0
1447,Gaetan Laborde,36.2,43,22,21,17,5,16,60,26.7,44,29,3,26,16,59,25,1
1448,Alexandre Lacazette,21.4,18,10,4,11,3,4,22,18.2,18,20,1,19,12,30,13,0
1449,Tom Lacoux,5.8,22,14,10,11,1,9,21,42.9,12,12,3,9,12,34,7,0
1450,Maxence Lacroix,28.8,49,29,37,12,0,24,45,53.3,21,51,21,30,65,114,140,1
1451,Alban Lafont,38.0,1,0,1,0,0,1,1,100.0,0,1,0,1,0,1,14,0
1452,Victor Laguardia,29.2,20,12,13,6,1,14,31,45.2,17,25,13,12,37,57,104,0
1453,Konrad Laimer,0.9,2,0,0,1,1,0,4,0.0,4,2,0,2,1,3,0,0
1454,Stefan Lainer,30.8,62,37,30,22,10,27,60,45.0,33,34,5,29,35,97,85,1
1456,Diego Lainez,9.6,9,4,3,5,1,6,16,37.5,10,15,0,15,11,20,6,0
1457,Kenny Lala,20.4,22,13,13,8,1,11,22,50.0,11,12,6,6,23,45,33,1
1458,Adam Lallana,17.7,28,13,11,13,4,8,39,20.5,31,18,3,15,15,43,13,0
1459,Erik Lamela,8.0,17,9,1,11,5,8,21,38.1,13,11,1,10,6,23,2,0
1460,Sam Lammers,3.2,2,0,0,2,0,0,6,0.0,6,0,0,0,0,2,3,0
1461,Tariq Lamptey,9.8,17,9,7,6,4,6,13,46.2,7,8,1,7,19,36,12,1
1462,Loick Landre,18.1,14,7,9,5,0,13,28,46.4,15,22,19,3,31,45,52,0
1464,Manuel Lanzini,6.3,9,2,3,4,2,3,10,30.0,7,9,0,9,7,16,5,0
1465,Gianluca Lapadula,28.5,22,12,3,13,6,6,25,24.0,19,18,3,15,5,27,16,0
1466,Aymeric Laporte,14.9,13,6,10,3,0,7,11,63.6,4,12,7,5,11,24,28,0
1467,Julien Laporte,29.5,65,39,48,16,1,42,74,56.8,32,34,23,11,65,130,125,0
1468,Danilo Larangeira,34.8,33,24,23,10,0,8,29,27.6,21,58,36,22,51,84,127,2
1469,Gautier Larsonneur,35.0,1,1,1,0,0,1,1,100.0,0,2,0,2,0,1,16,3
1470,Kevin Lasagna,12.3,6,1,2,3,1,3,14,21.4,11,11,0,11,6,12,7,0
1471,Kevin Lasagna,14.1,7,3,0,5,2,1,5,20.0,4,12,1,11,1,8,11,0
1472,Jamaal Lascelles,18.1,14,7,5,9,0,3,6,50.0,3,27,17,10,12,26,86,0
1473,Paul Lasne,18.7,46,26,25,19,2,17,40,42.5,23,25,5,20,47,93,17,2
1474,Toni Lato,8.1,13,6,7,3,3,6,13,46.2,7,12,1,11,10,23,21,0
1475,Danny Latza,20.0,43,26,12,19,12,23,70,32.9,47,39,3,36,27,70,23,0
1476,Armand Lauriente,18.0,30,10,10,19,1,7,26,26.9,19,21,0,21,15,45,4,0
1477,Vincent Laurini,9.7,16,11,8,6,2,7,9,77.8,2,8,4,4,17,33,22,1
1479,Wesley Lautoa,17.9,36,20,20,13,3,11,37,29.7,26,17,8,9,29,65,33,1
1480,Valentino Lazaro,13.8,17,11,7,5,5,12,19,63.2,7,18,1,17,15,32,20,0
1482,Darko Lazovic,27.8,29,17,8,17,4,20,42,47.6,22,17,7,10,20,49,29,0
1483,Manuel Lazzari,29.0,24,14,15,4,5,14,39,35.9,25,22,3,19,18,42,28,0
1484,Jeremy Le Douaron,9.1,15,10,9,4,2,7,21,33.3,14,14,1,13,8,23,11,0
1485,Enzo Le Fee,20.2,51,28,23,23,5,27,73,37.0,46,30,6,24,25,76,10,0
1486,Vincent Le Goff,25.6,42,29,16,24,2,18,49,36.7,31,27,5,22,44,86,44,0
1487,Maxime Le Marchand,1.4,2,2,2,0,0,2,2,100.0,0,0,0,0,0,2,3,0
1488,Robin Le Normand,30.5,34,20,25,8,1,9,19,47.4,10,35,24,11,36,70,87,1
1489,Damien Le Tallec,13.6,16,10,10,4,2,10,30,33.3,20,15,8,7,25,41,21,2
1490,James Lea Siliki,2.8,5,2,1,3,1,2,2,100.0,0,3,0,3,1,6,1,1
1491,Rafael Leao,21.4,13,6,4,7,2,6,15,40.0,9,17,0,17,4,17,14,1
1492,Jean-Louis Leca,36.8,3,2,3,0,0,3,5,60.0,2,0,0,0,1,4,14,4
1493,Mathew Leckie,5.6,12,3,5,5,2,4,11,36.4,7,8,0,8,13,25,9,0
1494,Benjamin Lecomte,28.0,0,0,0,0,0,0,2,0.0,2,1,0,1,2,2,20,1
1495,Jeremias Ledesma,32.0,1,0,1,0,0,1,1,100.0,0,1,0,1,0,1,22,6
1496,Pierre Lees-Melou,22.9,67,39,33,31,3,25,83,30.1,58,50,14,36,29,96,31,1
1497,Lucas Leiva,23.7,68,32,38,28,2,30,86,34.9,56,21,0,21,57,125,21,0
1498,Florian Lejeune,33.5,43,32,36,7,0,21,35,60.0,14,38,24,14,51,94,149,1
1499,Inigo Lekue,7.2,9,7,6,3,0,3,8,37.5,5,8,1,7,4,13,24,0
1500,Thomas Lemar,15.2,30,17,9,17,4,11,24,45.8,13,22,1,21,11,41,10,0
1501,Mario Lemina,18.9,62,35,25,30,7,23,44,52.3,21,26,5,21,30,92,21,0
1502,Fabien Lemoine,21.5,74,45,39,33,2,36,89,40.4,53,25,1,24,27,101,35,0
1503,Clement Lenglet,27.5,36,21,23,10,3,19,28,67.9,9,26,12,14,33,69,71,1
1504,Bernd Leno,34.8,1,0,1,0,0,1,1,100.0,0,1,0,1,0,1,11,2
1505,Christopher Lenz,25.0,74,41,39,30,5,35,71,49.3,36,34,5,29,35,109,50,0
1506,Pedro Leon,10.4,9,8,3,3,3,3,17,17.6,14,11,0,11,7,16,2,0
1508,Sergio Leon,8.3,6,2,0,4,2,2,8,25.0,6,4,0,4,3,9,2,0
1509,Lukas Lerager,12.9,24,13,14,9,1,11,30,36.7,19,13,3,10,14,38,25,1
1510,Mehdi Leris,4.3,11,5,6,4,1,6,16,37.5,10,12,2,10,12,23,15,0
1513,Gaetano Letizia,17.4,36,25,19,13,4,17,36,47.2,19,15,3,12,20,56,42,1
1514,Robert Lewandowski,27.3,15,9,0,7,8,2,13,15.4,11,9,1,8,3,18,11,0
1515,Jamal Lewis,20.4,37,20,23,13,1,16,38,42.1,22,21,7,14,11,48,44,1
1516,Aaron Leya Iseka,11.2,6,4,2,3,1,0,4,0.0,4,4,2,2,0,6,6,0
1518,Dimitri Lienard,20.3,39,27,17,19,3,24,55,43.6,31,23,1,22,18,57,10,0
1519,Philipp Lienhart,33.3,21,13,12,7,2,9,20,45.0,11,30,21,9,42,63,100,0
1520,Matthijs de Ligt,24.7,37,19,20,16,1,18,28,64.3,10,42,21,21,31,68,64,0
1521,Isaac Lihadji,2.2,11,4,2,6,3,4,5,80.0,1,5,1,4,1,12,0,1
1522,Dimitris Limnios,4.2,9,6,3,5,1,5,6,83.3,1,5,0,5,2,11,1,0
1523,Victor Lindelof,28.7,22,10,12,10,0,12,24,50.0,12,22,14,8,30,52,95,1
1524,Karol Linetty,20.4,38,28,13,19,6,16,45,35.6,29,19,5,14,15,53,7,0
1525,Jesse Lingard,15.8,12,6,4,8,0,5,14,35.7,9,7,1,6,4,16,0,0
1526,Pol Lirola,5.5,13,8,8,2,3,6,12,50.0,6,6,3,3,6,19,9,0
1527,Pol Lirola,17.3,28,16,11,15,2,16,28,57.1,12,18,5,13,25,53,26,0
1528,Jake Livermore,13.8,33,18,14,16,3,14,31,45.2,17,21,6,15,16,49,26,0
1529,Diego Llorente,13.4,34,21,21,13,0,19,32,59.4,13,18,13,5,20,54,40,2
1530,Diego Llorente,1.0,1,0,1,0,0,1,2,50.0,1,1,1,0,2,3,5,0
1531,Fernando Llorente,7.9,4,1,2,2,0,2,5,40.0,3,3,0,3,2,6,17,0
1534,Marcos Llorente,32.8,71,42,21,40,10,26,62,41.9,36,40,3,37,29,100,28,0
1535,Hugo Lloris,38.0,0,0,0,0,0,0,1,0.0,1,0,0,0,0,0,10,1
1536,Giovani Lo Celso,10.5,28,22,12,11,5,10,29,34.5,19,12,1,11,7,35,5,0
1537,Stanislav Lobotka,1.7,1,1,0,1,0,0,1,0.0,1,1,1,0,0,1,1,1
1538,Manuel Locatelli,32.0,81,47,43,28,10,29,56,51.8,27,35,15,20,51,132,65,1
1539,Renan Lodi,12.5,30,17,13,12,5,17,26,65.4,9,15,0,15,16,46,18,0
1541,Ruben Loftus-Cheek,21.2,25,14,7,15,3,7,23,30.4,16,20,2,18,7,32,18,0
1543,Kevin Long,7.1,11,6,9,2,0,7,9,77.8,2,11,7,4,6,17,24,0
1544,Shane Long,2.3,2,1,0,0,2,2,3,66.7,1,0,0,0,3,5,1,0
1545,Matthew Longstaff,4.2,3,2,2,1,0,2,8,25.0,6,7,0,7,7,10,2,0
1546,Sean Longstaff,15.7,31,14,13,15,3,18,42,42.9,24,26,5,21,19,50,14,2
1547,Ademola Lookman,30.5,35,11,18,9,8,13,44,29.5,31,31,1,30,20,55,9,0
1548,Anthony Lopes,38.0,1,1,1,0,0,1,2,50.0,1,1,0,1,1,2,20,1
1549,Rony Lopes,19.8,20,14,4,13,3,6,27,22.2,21,14,3,11,8,28,6,0
1550,Adrian Lopez,5.3,3,3,0,1,2,1,5,20.0,4,3,0,3,0,3,3,0
1551,Javi Lopez,2.8,5,5,3,2,0,2,3,66.7,1,2,0,2,3,8,3,1
1552,Maxime Lopez,20.7,24,13,15,6,3,14,41,34.1,27,9,0,9,16,40,10,1
1553,Maxime Lopez,1.5,1,1,1,0,0,0,2,0.0,2,0,0,0,2,3,2,0
1554,Pedro Lopez Munoz,11.9,23,15,10,8,5,15,22,68.2,7,10,4,6,16,39,23,1
1555,Pau Lopez,20.2,2,0,2,0,0,2,2,100.0,0,1,0,1,0,2,7,4
1556,Roberto Lopez,5.6,5,1,1,2,2,2,5,40.0,3,2,0,2,4,9,6,0
1557,Unai Lopez,15.8,27,17,13,13,1,10,29,34.5,19,20,5,15,18,45,9,1
1560,Jordan Lotomba,23.6,35,25,19,11,5,20,34,58.8,14,19,7,12,33,68,52,1
1562,Imran Louza,26.4,55,28,25,26,4,21,69,30.4,48,20,4,16,33,88,15,2
1563,Matteo Lovato,15.4,21,12,14,5,2,10,21,47.6,11,20,10,10,37,58,48,1
1564,Max Lowe,6.1,26,11,18,6,2,9,21,42.9,12,12,4,8,5,31,11,0
1565,Eduard Lowen,0.9,5,1,3,1,1,2,5,40.0,3,1,0,1,1,6,1,0
1566,Matthew Lowton,34.0,54,32,31,22,1,32,73,43.8,41,36,13,23,56,110,91,1
1567,Anthony Lozano,16.9,12,4,1,5,6,2,13,15.4,11,3,1,2,3,15,8,0
1568,Hirving Lozano,21.8,29,18,10,13,6,10,36,27.8,26,37,1,36,18,47,14,0
1569,Jan Luca Schuler,0.4,2,2,1,1,0,0,1,0.0,1,1,0,1,0,2,0,0
1570,Jean Lucas,1.9,3,2,2,1,0,1,4,25.0,3,3,1,2,2,5,1,0
1571,Jean Lucas,11.2,19,13,10,9,0,8,29,27.6,21,7,0,7,8,27,10,1
1572,Anderson Lucoqui,17.8,40,25,23,17,0,20,40,50.0,20,30,7,23,27,67,53,0
1574,Kilian Ludewig,5.8,16,6,10,5,1,8,25,32.0,17,7,0,7,3,19,14,0
1575,Florentino Luis,2.7,7,2,4,2,1,6,10,60.0,4,1,0,1,6,13,2,1
1576,Jose Luis Gaya,31.6,59,33,40,13,6,33,68,48.5,35,22,3,19,38,97,62,1
1577,Jose Luis Morales,27.1,18,10,7,9,2,8,36,22.2,28,17,0,17,11,29,11,0
1578,Jose Luis Palomino,27.0,67,33,41,19,7,24,48,50.0,24,30,16,14,79,146,60,2
1579,Luisinho,2.0,3,3,2,1,0,1,3,33.3,2,3,0,3,4,7,7,0
1580,Luismi,1.9,4,2,1,3,0,1,2,50.0,1,2,0,2,4,8,0,0
1581,David Luiz,15.5,12,9,5,7,0,4,4,100.0,0,16,9,7,16,28,50,2
1582,Douglas Luiz,30.9,49,18,22,26,1,20,58,34.5,38,52,17,35,43,92,44,2
1583,Romelu Lukaku,32.0,11,1,1,6,4,6,14,42.9,8,11,1,10,3,14,34,0
1584,Dodi Lukebakio,20.6,21,14,13,5,3,9,20,45.0,11,14,1,13,12,33,8,0
1586,Sasa Lukic,23.4,32,13,11,18,3,15,50,30.0,35,23,5,18,17,49,17,0
1587,Senad Lulic,8.0,14,7,6,5,3,7,15,46.7,8,10,1,9,4,18,13,0
1588,John Lundstram,22.6,25,16,12,11,2,13,47,27.7,34,26,8,18,14,39,29,1
1589,Sebastiano Luperto,20.9,38,20,28,8,2,16,27,59.3,11,17,7,10,27,65,74,1
1590,Andreas Luthe,30.8,1,1,1,0,0,1,3,33.3,2,1,0,1,0,1,8,3
1591,Lyanco,21.8,21,14,13,6,2,8,14,57.1,6,36,26,10,46,67,76,0
1592,Charalambos Lykogiannis,26.9,34,21,22,9,3,22,38,57.9,16,34,13,21,32,66,94,0
1593,Yann M'Vila,0.2,0,0,0,0,0,0,2,0.0,2,0,0,0,1,1,0,0
1594,Alexis Mac Allister,12.4,26,12,6,16,4,11,38,28.9,27,25,4,21,9,35,4,0
1595,Darwin Machis,22.5,30,17,12,10,8,6,19,31.6,13,21,2,19,22,52,13,0
1598,Yvann Macon,6.0,30,20,20,8,2,7,19,36.8,12,6,2,4,9,39,13,0
1599,James Maddison,23.3,32,16,5,16,11,14,41,34.1,27,14,1,13,9,41,5,0
1601,Pablo Maffeo,21.8,26,17,21,4,1,12,26,46.2,14,18,6,12,35,61,27,0
1602,Lisandro Magallan,24.2,54,31,28,24,2,17,42,40.5,25,29,15,14,44,98,78,1
1603,Christian Maggio,3.3,9,4,2,7,0,3,9,33.3,6,4,1,3,2,11,6,0
1604,Giulio Maggiore,24.6,61,36,26,28,7,21,53,39.6,32,33,6,27,19,80,25,1
1605,Francesco Magnanelli,4.9,7,5,2,5,0,3,10,30.0,7,6,2,4,13,20,10,0
1606,Giangiacomo Magnani,16.8,26,15,14,9,3,9,16,56.3,7,25,16,9,44,70,105,1
1607,Hugo Magnetti,6.7,24,12,10,13,1,20,40,50.0,20,6,1,5,14,38,8,0
1608,Harry Maguire,33.9,29,17,19,10,0,18,29,62.1,11,28,23,5,60,89,122,4
1609,Abdallahi Mahmoud,0.7,2,2,1,1,0,0,1,0.0,1,0,0,0,1,3,0,0
1610,Hicham Mahou,0.4,1,1,1,0,0,1,2,50.0,1,2,0,2,1,2,0,0
1612,Riyad Mahrez,21.7,20,5,2,10,8,6,30,20.0,24,19,0,19,8,28,4,0
1613,Arne Maier,11.5,13,9,5,7,1,4,11,36.4,7,10,3,7,8,21,11,1
1614,Arne Maier,0.3,1,1,0,1,0,0,1,0.0,1,0,0,0,0,1,0,0
1615,Habib Maiga,29.9,81,52,36,40,5,42,85,49.4,43,37,6,31,49,130,36,0
1617,Ainsley Maitland-Niles,5.4,11,7,6,5,0,8,12,66.7,4,12,2,10,14,25,7,1
1618,Ainsley Maitland-Niles,13.7,22,10,7,8,7,9,28,32.1,19,12,1,11,17,39,24,0
1619,Josh Maja,9.0,7,4,0,3,4,4,10,40.0,6,3,1,2,4,11,1,0
1620,Josh Maja,8.9,8,2,3,3,2,3,14,21.4,11,3,0,3,6,14,9,0
1622,Abdul Majeed Waris,6.1,1,1,1,0,0,1,6,16.7,5,0,0,0,2,3,2,0
1623,Marco Majouga,1.4,1,1,1,0,0,1,3,33.3,2,0,0,0,0,1,0,0
1624,Jean-Victor Makengo,5.8,8,7,5,3,0,3,13,23.1,10,7,1,6,5,13,7,0
1625,Nemanja Maksimovic,30.3,50,28,22,24,4,19,46,41.3,27,40,9,31,57,107,46,1
1626,Nikola Maksimovic,13.4,18,9,11,6,1,9,18,50.0,9,15,6,9,21,39,49,3
1627,Filip Malbasic,9.6,12,7,4,5,3,6,18,33.3,12,10,0,10,4,16,2,0
1628,Kevin Malcuit,2.3,5,3,2,2,1,0,1,0.0,1,5,0,5,3,8,6,0
1629,Kevin Malcuit,0.4,2,1,2,0,0,0,1,0.0,1,0,0,0,2,4,2,0
1630,Daniel Maldini,0.3,1,0,0,1,0,0,2,0.0,2,0,0,0,0,1,0,0
1631,Ruslan Malinovskyi,20.8,19,8,2,13,4,8,23,34.8,15,16,1,15,2,21,4,0
1632,Yunus Malli,0.6,1,0,0,1,0,1,1,100.0,0,0,0,0,0,1,0,0
1633,Hugo Mallo,28.9,58,40,34,23,1,24,52,46.2,28,42,11,31,37,95,77,0
1634,Mickael Malsa,26.0,55,26,28,24,3,23,51,45.1,28,38,9,29,43,98,36,2
1635,Dennis Man,7.8,12,6,6,4,2,6,21,28.6,15,5,0,5,2,14,6,0
1636,Hianga Mananga Mbock,5.1,4,3,2,2,0,2,9,22.2,7,2,0,2,3,7,6,0
1638,Vincent Manceau,25.7,42,27,23,17,2,30,63,47.6,33,23,2,21,35,77,61,0
1639,Gianluca Mancini,31.7,50,29,29,19,2,18,31,58.1,13,38,18,20,72,122,77,3
1640,Steve Mandanda,37.0,0,0,0,0,0,0,1,0.0,1,0,0,0,2,2,8,6
1641,Reinildo Mandava,24.2,79,43,39,32,8,35,58,60.3,23,26,3,23,45,124,53,0
1642,Aissa Mandi,26.6,30,17,20,10,0,10,16,62.5,6,21,13,8,39,69,90,0
1643,Rolando Mandragora,4.4,8,5,3,4,1,3,10,30.0,7,10,3,7,6,14,5,0
1644,Rolando Mandragora,16.9,19,4,4,9,6,7,30,23.3,23,19,6,13,20,39,19,0
1645,Mario Mandzukic,2.4,7,6,2,4,1,2,3,66.7,1,0,0,0,2,9,3,0
1646,Sadio Mane,31.2,48,30,6,22,20,12,33,36.4,21,30,0,30,15,63,11,0
1648,Eliaquim Mangala,3.6,0,0,0,0,0,0,1,0.0,1,8,6,2,6,6,12,0
1649,Orel Mangala,23.4,27,15,13,11,3,17,28,60.7,11,27,10,17,26,53,30,0
1650,Thomas Mangani,29.9,54,37,25,26,3,30,90,33.3,60,31,8,23,38,92,39,0
1652,Kostas Manolas,25.5,31,18,24,7,0,17,24,70.8,7,22,13,9,23,54,82,2
1653,Javier Manquillo,9.2,24,14,8,14,2,11,17,64.7,6,8,1,7,9,33,15,1
1654,Juan Manuel Ramos,3.3,5,0,3,0,2,4,7,57.1,3,1,0,1,2,7,6,0
1655,Myziane Maolida,12.0,13,8,4,4,5,4,11,36.4,7,6,1,5,6,19,4,0
1656,Faitout Maouassa,13.0,20,11,10,8,2,11,19,57.9,8,9,1,8,17,37,36,0
1657,Sekou Mara,2.5,5,3,1,3,1,2,10,20.0,8,0,0,0,1,6,1,0
1658,Fernando Marcal,6.9,13,5,6,7,0,6,11,54.5,5,11,2,9,12,25,25,0
1660,Marcelo,11.7,25,21,11,6,8,11,24,45.8,13,13,1,12,10,35,15,0
1661,Marcelo,32.3,44,29,30,12,2,26,37,70.3,11,35,25,10,49,93,122,2
1662,Solly March,18.6,49,23,24,15,10,18,34,52.9,16,30,5,25,22,71,30,0
1664,Federico Marchetti,3.7,1,0,1,0,0,1,1,100.0,0,0,0,0,0,1,2,1
1665,Riccardo Marchizza,17.3,20,11,12,5,3,12,21,57.1,9,13,4,9,11,31,27,0
1666,Gian Marco Ferrari,33.5,32,20,15,14,3,10,23,43.5,13,46,37,9,50,82,100,1
1667,Ivan Marcone,29.4,64,41,42,17,5,35,84,41.7,49,27,8,19,36,100,33,3
1668,Oscar de Marcos,16.9,28,17,12,10,6,10,25,40.0,15,12,1,11,12,40,38,0
1669,Dario Maresic,5.7,12,7,8,4,0,8,14,57.1,6,7,2,5,10,22,17,1
1670,Jose Mari,16.1,32,17,13,18,1,14,31,45.2,17,16,7,9,27,59,33,1
1671,Pablo Mari,10.0,15,9,12,3,0,5,10,50.0,5,8,7,1,9,24,30,2
1672,Jose Maria Gimenez,19.6,20,7,14,5,1,12,17,70.6,5,17,11,6,21,41,65,0
1673,Mariano,5.7,4,2,2,1,1,0,9,0.0,9,3,1,2,0,4,3,0
1674,Jordan Marie,15.9,34,17,9,23,2,23,56,41.1,33,14,5,9,23,57,12,2
1675,Adrian Marin,1.0,1,1,0,1,0,0,2,0.0,2,1,0,1,2,3,2,0
1676,Adrian Marin,3.0,5,2,1,3,1,2,3,66.7,1,5,2,3,4,9,9,0
1677,Razvan Marin,32.9,54,33,26,22,6,27,53,50.9,26,29,10,19,29,83,15,0
1678,Guillermo Maripan,23.2,26,11,17,9,0,15,27,55.6,12,18,11,7,27,53,66,1
1679,Marlon,19.4,19,13,13,6,0,13,18,72.2,5,23,17,6,27,46,44,2
1681,Marquinhos,23.6,27,21,14,10,3,15,26,57.7,11,21,9,12,27,54,75,2
1682,Luca Marrone,17.6,25,18,16,9,0,13,21,61.9,8,22,11,11,26,51,56,1
1683,Roger Marti,24.4,11,7,5,4,2,6,23,26.1,17,10,3,7,4,15,6,0
1684,Anthony Martial,16.4,2,1,1,1,0,0,10,0.0,10,17,3,14,1,3,8,0
1685,Aaron Martin,17.1,34,20,15,16,3,10,33,30.3,23,15,4,11,13,47,37,0
1686,Aaron Martin,2.9,3,2,2,1,0,2,4,50.0,2,1,0,1,2,5,2,0
1687,Alex Martin,1.1,2,0,1,1,0,2,4,50.0,2,1,1,0,0,2,6,0
1688,Jonas Martin,5.4,11,9,5,4,2,5,14,35.7,9,11,2,9,13,24,2,1
1690,Gabriel Martinelli,6.5,7,1,2,3,2,4,10,40.0,6,6,0,6,8,15,4,0
1691,Emiliano Martinez,38.0,3,3,3,0,0,3,4,75.0,1,0,0,0,2,5,10,2
1692,Inigo Martinez,28.0,22,15,16,6,0,9,27,33.3,18,17,7,10,28,50,96,0
1693,Javi Martinez,5.1,9,4,1,6,2,5,12,41.7,7,9,0,9,5,14,4,0
1694,Javi Martinez,5.2,10,5,4,4,2,7,9,77.8,2,8,4,4,13,23,19,0
1696,Lautaro Martinez,28.5,25,12,5,11,9,7,24,29.2,17,31,1,30,27,52,16,0
1697,Pablo Martinez,6.0,10,7,7,3,0,7,7,100.0,0,6,4,2,11,21,28,0
1698,Lucas Martinez Quarta,16.5,32,20,17,11,4,18,41,43.9,23,27,9,18,39,71,48,0
1699,Gelson Martins,17.2,41,26,12,16,13,15,37,40.5,22,20,0,20,13,54,8,0
1700,Adam Marusic,33.0,38,22,22,15,1,20,40,50.0,20,38,6,32,40,78,54,0
1701,Sylvain Marveaux,2.2,6,3,1,4,1,3,3,100.0,0,2,0,2,1,7,2,0
1702,Marvin,1.5,3,2,0,3,0,1,2,50.0,1,1,0,1,2,5,3,0
1703,Omar Mascarell,19.6,41,24,15,19,7,21,54,38.9,33,40,14,26,37,78,32,1
1704,Andrea Masiello,28.5,38,22,29,6,3,23,48,47.9,25,32,13,19,53,91,107,3
1705,Jordi Masip,25.0,0,0,0,0,0,0,2,0.0,2,2,0,2,2,2,8,1
1706,Roberto Massimo,8.4,21,11,13,5,3,11,24,45.8,13,5,1,4,11,32,13,0
1707,Giuseppe Mastinu,0.4,1,1,0,0,1,1,1,100.0,0,1,0,1,0,1,0,0
1708,Arthur Masuaku,11.2,20,12,14,6,0,11,34,32.4,23,12,0,12,8,28,28,2
1709,Jaime Mata,22.6,12,7,1,3,8,3,18,16.7,15,13,2,11,6,18,16,0
1710,Juan Mata,5.7,1,0,1,0,0,0,7,0.0,7,3,0,3,3,4,3,0
1711,Pape Matar Sarr,17.7,45,29,19,21,5,20,38,52.6,18,24,4,20,27,72,16,0
1712,Eliot Matazo,3.5,11,5,6,5,0,3,7,42.9,4,1,0,1,1,12,2,0
1713,Jean-Philippe Mateta,2.5,1,1,0,1,0,1,3,33.3,2,1,0,1,0,1,2,0
1714,Jean-Philippe Mateta,11.1,6,3,1,3,2,0,3,0.0,3,3,1,2,4,10,6,0
1716,Nemanja Matic,12.3,25,11,13,12,0,13,31,41.9,18,19,5,14,22,47,10,3
1717,Joel Matip,7.7,14,9,7,7,0,7,8,87.5,1,6,0,6,7,21,22,0
1718,Rabbi Matondo,2.4,3,2,0,3,0,2,3,66.7,1,1,0,1,1,4,1,0
1720,Henning Matriciani,0.3,1,1,1,0,0,1,1,100.0,0,1,0,1,0,1,1,0
1721,Chrislain Matsima,3.9,5,4,3,2,0,4,7,57.1,3,3,0,3,4,9,12,0
1723,Neal Maupay,27.9,20,8,9,7,4,4,24,16.7,20,20,0,20,13,33,6,0
1724,Tony Mauricio,5.6,19,12,7,8,4,11,17,64.7,6,8,1,7,3,22,4,0
1725,Stephy Mavididi,22.6,18,5,7,10,1,8,23,34.8,15,12,0,12,14,32,6,0
1726,Konstantinos Mavropanos,16.3,42,29,29,12,1,27,46,58.7,19,25,10,15,59,101,66,1
1727,Eric Maxim Choupo-Moting,9.1,8,2,0,5,3,1,4,25.0,3,6,0,6,2,10,7,0
1728,Borja Mayoral,17.2,3,2,0,0,3,1,10,10.0,9,5,0,5,0,3,5,2
1729,Borja Mayoral,0.3,0,0,0,0,0,0,1,0.0,1,0,0,0,0,0,0,0
1730,Youssef Maziz,2.9,2,0,1,1,0,1,5,20.0,4,1,0,1,6,8,1,0
1732,Kevin Mbabu,18.2,51,33,27,17,7,24,35,68.6,11,28,7,21,22,73,59,1
1733,Kylian Mbappe,26.4,4,2,0,1,3,2,9,22.2,7,7,1,6,3,7,4,1
1734,Ibrahima Mbaye,4.8,6,5,5,1,0,3,5,60.0,2,5,3,2,1,7,10,0
1735,Jean-Manuel Mbom,12.9,19,13,14,3,2,8,27,29.6,19,17,6,11,13,32,27,0
1736,Nathanael Mbuku,24.6,33,19,9,13,11,8,28,28.6,20,17,0,17,14,47,10,0
1737,James McArthur,16.3,57,32,25,27,5,15,39,38.5,24,28,3,25,23,80,31,0
1738,Oliver McBurnie,14.7,15,7,7,7,1,5,17,29.4,12,10,3,7,6,21,30,0
1739,Alex McCarthy,30.0,1,0,1,0,0,1,4,25.0,3,0,0,0,0,1,11,1
1740,James McCarthy,9.1,16,12,9,7,0,8,21,38.1,13,15,7,8,8,24,12,0
1742,John McGinn,37.0,61,37,23,31,7,27,84,32.1,57,38,6,32,43,104,23,2
1743,David McGoldrick,26.6,33,21,8,15,10,13,31,41.9,18,19,3,16,2,35,25,0
1744,Weston McKennie,18.9,34,19,9,20,5,12,33,36.4,21,21,3,18,28,62,26,0
1745,Dwight McNeil,34.1,47,24,24,18,5,18,56,32.1,38,44,6,38,32,79,32,1
1746,Scott McTominay,23.7,51,24,23,25,3,23,36,63.9,13,35,10,25,29,80,46,0
1747,Gary Medel,5.7,12,9,6,5,1,4,10,40.0,6,8,6,2,7,19,10,0
1748,Facundo Medina,22.3,39,22,22,15,2,24,38,63.2,14,25,9,16,39,78,51,3
1749,Nathan de Medina,7.1,16,10,9,6,1,3,10,30.0,7,12,2,10,11,27,22,0
1750,Ben Mee,29.9,32,15,16,14,2,14,29,48.3,15,54,45,9,43,75,148,2
1752,Admir Mehmedi,9.1,17,9,6,7,4,6,16,37.5,10,7,0,7,5,22,1,0
1753,Soualiho Meite,10.2,11,7,6,4,1,5,16,31.3,11,18,1,17,10,21,9,1
1754,Soualiho Meite,6.5,18,10,10,6,2,8,17,47.1,9,9,2,7,8,26,16,0
1756,Farid El Melali,4.6,9,5,5,4,0,2,13,15.4,11,12,0,12,6,15,2,0
1757,Filippo Melegoni,4.3,7,6,2,5,0,3,6,50.0,3,5,0,5,5,12,8,0
1758,Gonzalo Melero,20.6,24,15,11,6,7,10,39,25.6,29,14,5,9,18,42,22,1
1759,Birger Meling,25.9,49,31,27,15,7,33,50,66.0,17,43,9,34,36,85,70,0
1760,Arthur Melo,12.9,17,9,7,10,0,12,31,38.7,19,6,1,5,18,35,9,1
1761,Memphis,32.5,4,3,0,3,1,1,20,5.0,19,11,1,10,5,9,3,0
1762,Houboulang Mendes,14.4,28,19,19,5,4,16,28,57.1,12,14,2,12,14,42,35,0
1763,Pedro Mendes,18.1,21,19,16,5,0,14,21,66.7,7,23,13,10,34,55,58,0
1764,Thiago Mendes,24.9,37,22,13,20,4,18,38,47.4,20,33,7,26,39,76,21,2
1765,Brais Mendez,29.7,59,31,23,27,9,16,65,24.6,49,27,2,25,32,91,34,0
1766,Edgar Mendez,23.2,39,29,18,13,8,15,48,31.3,33,20,3,17,19,58,14,0
1768,Enaut Mendia,0.7,2,1,2,0,0,1,2,50.0,1,1,1,0,0,2,0,0
1769,Batista Mendy,0.8,1,1,0,1,0,0,1,0.0,1,3,1,2,1,2,1,0
1770,Benjamin Mendy,10.6,13,9,1,8,4,5,21,23.8,16,12,5,7,5,18,14,1
1771,Edouard Mendy,30.5,0,0,0,0,0,0,1,0.0,1,0,0,0,1,1,9,3
1773,Ferland Mendy,24.5,26,16,17,6,3,12,24,50.0,12,16,4,12,26,52,32,1
1774,Nampalys Mendy,16.2,26,17,18,6,2,7,20,35.0,13,12,1,11,14,40,8,0
1775,Hamza Mendyl,1.1,2,2,2,0,0,0,2,0.0,2,2,0,2,0,2,2,0
1777,Jorge Mere,14.4,13,6,9,3,1,6,13,46.2,7,14,11,3,15,28,63,0
1778,Alex Meret,22.0,0,0,0,0,0,0,1,0.0,1,0,0,0,0,0,5,0
1779,Mikel Merino,23.9,61,36,14,36,11,18,45,40.0,27,36,8,28,32,93,26,0
1780,Martin Merquelanz,6.1,9,3,3,2,4,2,7,28.6,5,7,1,6,3,12,4,0
1781,Yildirim Mert Cetin,4.6,8,4,3,5,0,2,6,33.3,4,7,5,2,14,22,11,1
1782,Dries Mertens,16.2,16,14,4,7,5,5,25,20.0,20,7,1,6,9,25,3,1
1783,Roque Mesa,19.6,46,29,18,24,4,20,47,42.6,27,11,2,9,14,60,23,1
1784,Illan Meslier,35.0,0,0,0,0,0,0,1,0.0,1,0,0,0,0,0,17,8
1785,Lionel Messi,33.6,18,10,3,9,6,6,17,35.3,11,12,0,12,6,24,0,2
1786,Junior Messias,35.7,60,35,26,24,10,22,70,31.4,48,32,12,20,35,95,40,0
1787,Thomas Meunier,16.4,30,21,19,6,5,20,29,69.0,9,16,6,10,18,48,29,2
1788,Mexer,7.9,9,6,8,0,1,5,10,50.0,5,8,5,3,17,26,22,0
1789,Max Meyer,3.9,7,4,3,3,1,4,8,50.0,4,4,1,3,3,10,1,0
1790,Omenuke Mfulu,8.8,18,12,10,8,0,5,15,33.3,10,7,1,6,11,29,18,0
1791,Michel,10.5,18,11,10,3,5,5,22,22.7,17,10,1,9,9,27,12,1
1794,Clement Michelin,12.8,25,19,13,9,3,9,16,56.3,7,13,4,9,25,50,32,0
1797,Florian Miguel,17.1,14,13,12,2,0,9,17,52.9,8,21,13,8,45,59,66,1
1798,Valentin Mihaila,7.8,2,1,1,1,0,0,10,0.0,10,8,1,7,5,7,8,0
1799,Nikola Milenkovic,33.7,49,29,33,14,2,21,33,63.6,12,42,33,9,44,93,122,1
1800,Arkadiusz Milik,13.6,14,9,0,7,7,2,12,16.7,10,5,1,4,2,16,9,0
1801,Sergej Milinkovic-Savic,30.5,59,40,20,30,9,27,84,32.1,57,52,12,40,33,92,47,0
1802,Vanja Milinkovic-Savic,5.0,1,1,1,0,0,1,1,100.0,0,0,0,0,0,1,1,3
1803,Eder Militao,12.6,20,8,13,6,1,8,14,57.1,6,19,6,13,19,39,42,0
1804,Luka Milivojevic,26.2,65,34,25,31,9,42,77,54.5,35,29,6,23,35,100,47,2
1805,Luis Milla,13.9,22,11,11,10,1,6,28,21.4,22,10,0,10,24,46,16,1
1806,Pere Milla,22.0,24,17,12,10,2,8,37,21.6,29,17,5,12,13,37,17,1
1809,Enzo Millot,0.5,2,0,0,1,1,1,1,100.0,0,0,0,0,2,4,0,0
1810,James Milner,11.9,26,19,9,14,3,11,33,33.3,22,30,3,27,14,40,16,1
1811,Santi Mina,26.8,31,13,9,12,10,6,37,16.2,31,15,3,12,6,37,17,0
1812,Yerry Mina,21.5,21,14,17,4,0,8,12,66.7,4,30,23,7,24,45,110,1
1813,Takumi Minamino,7.9,7,3,2,5,0,2,19,10.5,17,13,1,12,4,11,9,0
1814,Takumi Minamino,3.3,4,3,1,2,1,0,12,0.0,12,1,0,1,2,6,3,0
1815,Tyrone Mings,35.5,32,16,23,7,2,16,24,66.7,8,59,40,19,41,73,172,3
1816,Oscar Mingueza,21.1,52,33,28,17,7,30,53,56.6,23,19,6,13,20,72,48,2
1817,Rafa Mir,32.0,15,9,4,4,7,7,22,31.8,15,14,2,12,15,30,25,0
1818,Jorge Miramon,19.2,32,22,26,6,0,21,35,60.0,14,22,2,20,27,59,54,0
1820,Aleksei Miranchuk,7.5,24,13,8,9,7,6,9,66.7,3,1,0,1,3,27,1,0
1821,Juan Miranda,18.4,27,11,16,9,2,16,32,50.0,16,18,2,16,29,56,58,1
1822,Antonio Mirante,12.8,0,0,0,0,0,0,1,0.0,1,1,0,1,0,0,7,2
1823,Tyrick Mitchell,19.0,64,35,48,9,7,23,40,57.5,17,29,10,19,21,85,62,1
1824,Aleksandar Mitrovic,15.6,7,4,0,3,4,2,8,25.0,6,12,3,9,3,10,8,0
1825,Stefan Mitrovic,30.9,36,27,29,7,0,24,37,64.9,13,23,13,10,31,67,108,5
1826,Maximilian Mittelstadt,20.0,66,39,42,21,3,35,72,48.6,37,34,5,29,55,121,61,1
1827,Henrikh Mkhitaryan,30.5,58,24,13,27,18,13,62,21.0,49,34,0,34,39,97,10,0
1828,Jakub Moder,7.2,15,7,5,7,3,7,20,35.0,13,12,1,11,3,18,9,0
1829,Anthony Modeste,3.3,2,1,0,2,0,1,4,25.0,3,3,1,2,0,2,3,0
1830,Anthony Modeste,2.5,2,0,0,2,0,0,1,0.0,1,0,0,0,0,2,2,0
1831,Luka Modric,30.4,37,23,18,16,3,13,36,36.1,23,14,2,12,48,85,14,1
1832,Terem Moffi,23.0,13,8,0,8,5,4,19,21.1,15,5,2,3,4,17,8,0
1833,Kevin Mohwald,17.3,15,9,9,5,1,4,18,22.2,14,10,3,7,32,47,19,2
1834,Niklas Moisander,13.6,14,11,11,3,0,8,14,57.1,6,15,8,7,22,36,61,0
1835,Dion Moise Sahi,1.0,1,0,0,1,0,1,1,100.0,0,1,0,1,0,1,0,0
1836,Johan Mojica,3.3,4,4,3,1,0,2,3,66.7,1,3,0,3,7,11,6,0
1837,Johan Mojica,13.4,21,10,15,5,1,8,18,44.4,10,15,4,11,15,36,27,0
1838,Guillem Molina,1.7,1,0,1,0,0,0,5,0.0,5,1,1,0,4,5,5,0
1839,Jorge Molina,17.9,11,4,3,5,3,8,22,36.4,14,5,1,4,3,14,19,0
1840,Nahuel Molina,20.3,27,18,13,10,4,16,42,38.1,26,26,4,22,21,48,49,1
1841,Salvatore Molina,25.7,39,22,18,14,7,29,45,64.4,16,30,8,22,17,56,41,0
1842,Victor Mollejo,0.8,2,1,1,0,1,0,1,0.0,1,0,0,0,0,2,0,0
1843,Florent Mollet,26.2,20,15,7,11,2,12,47,25.5,35,18,4,14,32,52,9,1
1847,Jon Moncayola,29.6,61,36,27,23,11,24,67,35.8,43,27,9,18,23,84,38,0
1848,Gabriele Moncini,4.0,2,1,2,0,0,0,1,0.0,1,2,0,2,2,4,4,0
1849,Thomas Monconduit,12.8,28,15,9,16,3,15,41,36.6,26,10,3,7,13,41,21,1
1850,Kevin Monnet-Paquet,6.3,11,7,7,2,2,5,10,50.0,5,5,0,5,6,17,7,0
1851,Nacho Monreal,23.1,31,19,17,11,3,7,20,35.0,13,14,3,11,31,62,43,0
1852,Cristobal Montiel,0.0,0,0,0,0,0,0,1,0.0,1,0,0,0,0,0,0,0
1854,Angel Montoro,15.1,15,9,7,7,1,4,16,25.0,12,13,3,10,22,37,21,0
1855,Martin Montoya,2.7,6,3,2,2,2,1,3,33.3,2,1,1,0,2,8,6,0
1856,Emre Mor,5.6,8,4,1,3,4,0,3,0.0,3,5,0,5,5,13,0,0
1857,Luca Mora,1.3,3,1,1,2,0,2,4,50.0,2,2,1,1,0,3,2,0
1858,Wesley Moraes,0.2,0,0,0,0,0,0,1,0.0,1,0,0,0,0,0,0,0
1859,Alvaro Morata,22.4,17,12,2,10,5,4,28,14.3,24,22,2,20,5,22,21,0
1860,Jan Moravek,3.0,5,3,4,1,0,1,8,12.5,7,3,0,3,7,12,2,0
1861,Jon Morcillo,15.1,16,9,3,6,7,7,30,23.3,23,9,0,9,15,31,11,0
1862,Jeremy Morel,27.7,31,19,21,10,0,20,39,51.3,19,26,11,15,44,75,81,1
1863,Alberto Moreno,2.1,7,4,7,0,0,2,5,40.0,3,2,1,1,3,10,2,0
1864,Alex Moreno,19.8,42,26,25,12,5,20,43,46.5,23,18,4,14,35,77,48,0
1865,Gerard Moreno,29.7,24,15,8,10,6,7,34,20.6,27,17,4,13,15,39,26,0
1866,Tete Morente,22.4,31,17,17,9,5,9,39,23.1,30,20,0,20,13,44,28,0
1869,Ilaix Moriba,6.0,14,6,5,7,2,5,10,50.0,5,16,1,15,5,19,4,1
1870,Raul Moro,0.1,0,0,0,0,0,0,1,0.0,1,0,0,0,0,0,0,0
1872,Loren Moron,11.0,11,7,2,6,3,1,16,6.3,15,11,0,11,3,14,14,0
1873,Pedro Mosquera,22.8,38,18,19,18,1,13,53,24.5,40,23,6,17,31,69,38,1
1874,Aimen Moueffek,8.3,25,15,16,6,3,13,32,40.6,19,17,2,15,9,34,18,0
1876,Harold Moukoudi,25.3,46,27,37,8,1,28,38,73.7,10,24,10,14,42,88,78,1
1877,Jessy Moulin,29.0,2,1,2,0,0,2,3,66.7,1,0,0,0,2,4,9,2
1878,Steve Mounie,29.8,15,11,3,11,1,3,28,10.7,25,18,3,15,12,27,40,0
1879,Mason Mount,32.1,75,35,22,38,15,25,69,36.2,44,40,2,38,31,106,14,0
1880,Lucas Moura,15.7,32,16,12,16,4,8,29,27.6,21,12,0,12,18,50,10,0
1881,Lys Mousset,3.3,1,0,0,0,1,0,2,0.0,2,1,0,1,0,1,1,1
1882,Joao Moutinho,28.1,75,40,34,35,6,35,91,38.5,56,18,3,15,47,122,28,0
1883,Samuel Moutoussamy,0.9,0,0,0,0,0,0,1,0.0,1,1,0,1,0,0,0,0
1884,Loris Mouyokolo,0.2,1,1,1,0,0,1,1,100.0,0,1,1,0,0,1,1,0
1886,Nordi Mukiele,18.6,44,30,14,28,2,21,37,56.8,16,33,1,32,23,67,33,2
1887,Mert Muldur,18.6,43,20,26,9,8,27,53,50.9,26,17,1,16,36,79,41,0
1888,Florian Muller,31.0,0,0,0,0,0,0,3,0.0,3,1,0,1,2,2,10,1
1890,Thomas Muller,29.7,49,22,11,23,15,24,73,32.9,49,43,3,40,21,70,18,1
1892,Marshall Munetsi,21.4,35,19,19,14,2,21,41,51.2,20,33,25,8,57,92,85,3
1893,Iker Muniain,21.6,20,7,4,10,6,6,24,25.0,18,15,0,15,11,31,4,0
1894,Aihen Munoz,13.4,23,16,15,5,3,11,19,57.9,8,12,2,10,10,33,31,0
1895,Joaquin Munoz,0.5,0,0,0,0,0,0,2,0.0,2,0,0,0,1,1,0,0
1896,Luis Muriel,16.0,20,9,4,8,8,9,26,34.6,17,17,0,17,7,27,4,0
1898,Jeison Murillo,30.0,45,21,35,9,1,24,44,54.5,20,29,17,12,36,81,100,2
1899,Vedat Muriqi,9.2,3,1,0,2,1,0,8,0.0,8,9,2,7,3,6,20,0
1900,Jacob Murphy,18.1,39,24,25,12,2,24,49,49.0,25,27,3,24,14,53,29,0
1901,Nicola Murru,6.3,9,6,1,5,3,3,5,60.0,2,11,1,10,12,21,24,0
1902,Petar Musa,7.9,12,8,3,6,3,4,8,50.0,4,10,0,10,4,16,5,0
1904,Mateo Musacchio,0.4,2,1,2,0,0,2,3,66.7,1,1,0,1,3,5,0,0
1905,Yunus Musah,17.0,21,18,12,3,6,8,24,33.3,16,20,0,20,15,36,12,1
1906,Jamal Musiala,9.8,20,12,5,7,8,7,22,31.8,15,17,2,15,14,34,3,0
1907,Juan Musso,35.0,1,1,1,0,0,1,1,100.0,0,0,0,0,1,2,8,1
1908,Shkodran Mustafi,0.5,1,1,1,0,0,1,1,100.0,0,1,0,1,0,1,3,0
1909,Shkodran Mustafi,11.5,16,5,15,1,0,3,12,25.0,9,20,15,5,32,48,76,1
1910,Yoshinori Muto,12.5,12,7,1,4,7,3,8,37.5,5,5,0,5,3,15,2,0
1911,Phillipp Mwene,18.6,36,23,21,11,4,19,38,50.0,19,26,3,23,24,60,33,0
1912,Joakim Maehle,13.5,18,10,7,5,6,8,19,42.1,11,17,2,15,11,29,5,0
1913,Obite N'Dicka,22.7,31,23,16,15,0,16,28,57.1,12,27,6,21,47,78,85,0
1914,Kevin N'Doram,3.4,3,2,0,3,0,1,3,33.3,2,0,0,0,6,9,2,0
1915,Stanley N'Soki,13.8,27,19,15,9,3,13,22,59.1,9,17,4,13,26,53,38,2
1916,Nacho,20.1,43,21,29,10,4,24,52,46.2,28,21,1,20,29,72,47,0
1917,Nacho,22.2,27,14,13,11,3,12,35,34.3,23,19,9,10,40,67,58,0
1918,Yuto Nagatomo,17.7,23,16,12,8,3,9,18,50.0,9,14,3,11,29,52,43,0
1920,Radja Nainggolan,20.5,41,26,22,14,5,19,34,55.9,15,18,0,18,15,56,15,1
1922,Marvelous Nakamba,8.3,22,14,10,11,1,7,12,58.3,5,16,5,11,17,39,9,1
1924,Nahitan Nandez,30.4,56,28,23,23,10,25,68,36.8,43,26,4,22,23,79,49,0
1926,Paul Nardi,23.0,0,0,0,0,0,0,1,0.0,1,1,0,1,0,0,15,2
1927,Matija Nastasic,13.6,11,7,9,2,0,9,16,56.3,7,22,18,4,26,37,51,1
1928,Roberto Navarro,0.4,1,1,1,0,0,0,2,0.0,2,0,0,0,1,2,0,0
1929,Ximo Navarro,26.4,54,30,36,17,1,14,30,46.7,16,14,4,10,47,101,75,3
1930,Jesus Navas,31.4,27,21,15,11,1,15,22,68.2,7,10,3,7,37,64,62,1
1932,Raul Navas,1.9,6,3,5,1,0,4,6,66.7,2,0,0,0,3,9,13,0
1933,Papa Ndiaga Yade,11.1,15,8,9,2,4,7,20,35.0,13,9,0,9,4,19,6,0
1934,Iliman Ndiaye,0.1,1,1,0,1,0,1,1,100.0,0,0,0,0,0,1,0,0
1935,Wilfred Ndidi,24.2,96,63,45,44,7,26,66,39.4,40,38,11,27,61,157,55,0
1936,Bridge Ndilu,0.5,0,0,0,0,0,0,2,0.0,2,2,0,2,0,0,0,0
1937,Tanguy Ndombele,23.2,41,20,11,21,9,18,44,40.9,26,28,4,24,19,60,15,0
1938,Dan Ndoye,6.1,7,6,3,4,0,1,8,12.5,7,4,0,4,7,14,4,0
1939,Paul Nebel,0.6,1,1,0,1,0,0,1,0.0,1,0,0,0,2,3,0,0
1940,Alvaro Negredo,24.4,11,5,3,4,4,5,11,45.5,6,7,2,5,3,14,19,0
1942,Ilija Nestorovski,7.8,6,4,2,3,1,2,13,15.4,11,5,0,5,1,7,7,0
1943,Neto,7.0,0,0,0,0,0,0,1,0.0,1,0,0,0,0,0,3,1
1944,Pedro Neto,28.3,16,9,4,6,6,6,28,21.4,22,18,2,16,31,47,8,0
1945,Luca Netz,3.4,14,8,12,2,0,6,17,35.3,11,3,0,3,6,20,8,0
1946,Manuel Neuer,33.0,0,0,0,0,0,0,1,0.0,1,0,0,0,2,2,12,3
1947,Florian Neuhaus,29.1,48,28,19,26,3,19,63,30.2,44,35,7,28,50,98,20,1
1948,Carlos Neva,20.0,12,6,6,6,0,6,11,54.5,5,16,4,12,27,39,58,0
1950,Ruben Neves,29.7,86,46,42,38,6,36,88,40.9,52,55,11,44,65,151,46,2
1951,Neymar,15.7,14,11,1,6,7,8,37,21.6,29,8,0,8,9,23,0,0
1952,Yvan Neyou,27.1,58,31,24,33,1,25,60,41.7,35,34,5,29,31,89,13,1
1953,Jessic Ngankam,3.3,5,2,1,2,2,1,3,33.3,2,6,1,5,0,5,1,0
1954,Muzinga Ngonda,25.6,59,40,37,21,1,30,50,60.0,20,28,3,25,72,131,58,0
1955,Ahmad Ngouyamsa,1.7,6,4,5,1,0,4,8,50.0,4,2,1,1,2,8,8,0
1956,Opa Nguette,12.6,15,8,2,8,5,3,10,30.0,7,14,2,12,1,16,1,0
1957,Moussa Niakhate,31.8,42,22,28,13,1,14,29,48.3,15,31,15,16,49,91,79,0
1958,Ibrahima Niane,7.4,1,1,0,0,1,1,2,50.0,1,3,0,3,0,1,8,0
1961,Tanguy Nianzou,1.3,3,1,3,0,0,1,1,100.0,0,0,0,0,3,6,1,0
1962,Florian Niederlechner,19.3,7,5,1,4,2,0,10,0.0,10,8,3,5,10,17,18,0
1964,Saul Niguez,22.6,57,34,27,23,7,30,59,50.8,29,35,2,33,19,76,43,0
1965,Joakim Nilsson,24.0,36,24,23,12,1,14,23,60.9,9,29,22,7,39,75,111,0
1967,Nino,3.2,0,0,0,0,0,0,1,0.0,1,1,0,1,0,0,0,0
1968,Fernando Nino,6.6,8,3,0,4,4,2,9,22.2,7,1,0,1,2,10,2,0
1969,Eddie Nketiah,4.7,3,1,0,2,1,0,2,0.0,2,6,0,6,0,3,5,0
1970,Nicolas Nkoulou,15.1,14,9,11,3,0,7,12,58.3,5,28,14,14,33,47,71,1
1971,Niels Nkounkou,0.9,4,3,1,2,1,3,8,37.5,5,4,0,4,0,4,4,0
1972,Christopher Nkunku,21.0,16,11,3,7,6,8,18,44.4,10,27,1,26,9,25,14,0
1973,Dan Nlundulu,1.2,0,0,0,0,0,0,1,0.0,1,2,0,2,0,0,2,0
1974,Mark Noble,7.9,8,4,2,5,1,4,14,28.6,10,7,3,4,13,21,3,0
1976,Nolito,28.9,70,36,30,30,10,32,92,34.8,60,46,2,44,22,92,19,0
1977,Arnaud Nordin,19.7,14,8,5,5,4,6,21,28.6,15,13,2,11,9,23,10,0
1978,Havard Nordtveit,7.8,6,2,5,1,0,6,8,75.0,2,4,2,2,13,19,42,0
1980,Oliver Norwood,24.7,49,22,16,28,5,21,72,29.2,51,29,12,17,36,85,51,1
1981,Olivier Ntcham,1.3,1,0,0,1,0,1,3,33.3,2,3,1,2,2,3,3,0
1983,Kasim Nuhu,11.0,13,7,9,4,0,6,10,60.0,4,8,3,5,15,28,38,0
1984,Unai Nunez,23.4,23,12,16,7,0,10,15,66.7,5,19,14,5,32,55,110,0
1985,Bram Nuytinck,18.2,21,15,10,9,2,13,20,65.0,7,30,17,13,25,46,77,0
1986,Kelechi Nwakali,1.6,4,3,1,2,1,0,4,0.0,4,1,0,1,1,5,1,0
1987,Simeon Nwankwo,32.7,9,2,2,6,1,3,22,13.6,19,21,5,16,6,15,51,0
1988,Gerzino Nyamsi,9.7,12,10,2,8,2,4,6,66.7,2,8,5,3,10,22,32,1
1989,Allan Nyom,25.8,38,23,14,19,5,15,30,50.0,15,16,2,14,22,60,42,0
1990,M'Bala Nzola,21.1,12,5,2,6,4,4,7,57.1,3,15,1,14,3,15,20,0
1991,Steven Nzonzi,32.3,34,16,15,16,3,12,31,38.7,19,24,10,14,16,50,26,0
1992,Jack O'Connell,2.0,3,1,1,1,1,0,1,0.0,1,4,3,1,2,5,7,0
1993,Dara O'Shea,23.4,45,25,30,13,2,21,45,46.7,24,32,17,15,45,90,108,0
1994,Michael Obafemi,0.7,1,0,0,1,0,0,1,0.0,1,1,0,1,0,1,0,0
1995,Pedro Obiang,16.3,35,22,17,15,3,12,35,34.3,23,26,7,19,22,57,27,0
1997,Lucas Ocampos,29.2,36,24,12,16,8,13,37,35.1,24,33,1,32,19,55,30,1
1998,Bastian Oczipka,21.4,33,20,22,10,1,7,21,33.3,14,22,4,18,24,57,41,0
1999,Brian Oddei,0.5,2,1,1,1,0,2,3,66.7,1,1,0,1,0,2,1,0
2000,Denis Odoi,3.0,3,3,2,1,0,1,4,25.0,3,3,1,2,5,8,5,0
2002,Alvaro Odriozola,9.2,14,7,5,8,1,3,5,60.0,2,6,3,3,6,20,12,1
2003,Angelo Ogbonna,27.7,26,13,20,5,1,9,17,52.9,8,25,11,14,30,56,119,0
2004,Stefano Okaka,16.5,10,7,2,5,3,2,10,20.0,8,7,1,6,2,12,19,0
2005,Shinji Okazaki,12.5,7,5,5,0,2,0,5,0.0,5,5,0,5,4,11,6,0
2006,Masaya Okugawa,10.2,17,8,5,11,1,6,14,42.9,8,17,2,15,8,25,5,0
2007,Lucas Olaza,14.0,20,9,11,7,2,9,17,52.9,8,15,7,8,15,35,38,0
2008,Lucas Olaza,17.9,25,16,12,12,1,10,18,55.6,8,15,1,14,24,49,34,0
2009,Christian Oliva,4.3,10,4,6,3,1,6,17,35.3,11,11,1,10,8,18,7,0
2010,Christian Oliva,2.2,2,0,1,1,0,1,6,16.7,5,1,0,1,6,8,0,0
2011,Kiko Olivas,2.0,3,2,2,1,0,3,5,60.0,2,2,2,0,7,10,3,0
2012,Paulo Oliveira,29.3,42,21,32,8,2,19,36,52.8,17,39,14,25,59,101,112,0
2013,Mathias Olivera,29.0,61,33,31,21,9,32,56,57.1,24,33,3,30,31,92,55,0
2014,Maximiliano Olivera,1.0,2,0,1,1,0,1,1,100.0,0,3,1,2,0,2,8,0
2015,Dani Olmo,24.4,23,14,6,13,4,4,23,17.4,19,15,0,15,13,36,21,0
2017,Jonas Omlin,29.7,1,1,1,0,0,1,4,25.0,3,0,0,0,0,1,9,1
2018,Jerome Onguene,2.0,2,1,2,0,0,2,7,28.6,5,2,0,2,2,4,8,0
2019,Karim Onisiwo,20.5,31,20,7,15,9,14,23,60.9,9,20,1,19,5,36,12,0
2020,Josh Onomah,4.2,11,8,1,6,4,0,5,0.0,5,4,2,2,2,13,1,0
2021,Javier Ontiveros,10.2,21,14,10,10,1,9,26,34.6,17,12,0,12,9,30,6,0
2022,Henry Onyekuru,1.6,1,0,1,0,0,1,4,25.0,3,1,0,1,0,1,0,0
2023,Willi Orban,26.3,40,26,19,15,6,23,37,62.2,14,29,20,9,40,80,74,0
2024,Fabian Orellana,23.8,33,19,12,14,7,12,55,21.8,43,18,0,18,15,48,9,0
2025,Divock Origi,2.1,3,2,0,2,1,1,3,33.3,2,5,1,4,1,4,2,0
2026,Riccardo Orsolini,19.5,37,18,13,12,12,16,39,41.0,23,22,3,19,10,47,22,0
2028,Stefan Ortega,34.0,2,1,2,0,0,2,6,33.3,4,0,0,0,0,2,12,3
2029,Yuya Osako,8.5,12,8,2,5,5,2,9,22.2,7,6,1,5,5,17,7,0
2030,Ben Osborn,17.8,33,18,15,10,8,13,40,32.5,27,20,3,17,12,45,17,0
2031,Victor Osimhen,17.5,22,15,2,6,14,3,15,20.0,12,6,0,6,7,29,10,0
2032,Yordan Osorio,20.1,22,14,13,9,0,9,24,37.5,15,30,18,12,53,75,77,1
2034,Owen Otasowie,2.1,5,5,3,2,0,1,2,50.0,1,1,1,0,3,8,4,0
2035,Otavio,17.3,54,31,33,19,2,26,55,47.3,29,20,5,15,26,80,36,0
2036,Paulo Otavio,19.3,60,40,32,22,6,34,62,54.8,28,51,7,44,42,102,59,0
2037,Remi Oudin,26.9,34,16,22,7,5,15,36,41.7,21,22,2,20,51,85,40,1
2038,Alexandre Oukidja,34.0,0,0,0,0,0,0,1,0.0,1,1,0,1,0,0,17,3
2040,Adam Ounas,13.3,9,4,4,4,1,0,7,0.0,7,12,1,11,3,12,4,0
2041,Adam Ounas,3.4,3,2,3,0,0,0,11,0.0,11,5,0,5,3,6,0,0
2042,Thomas Ouwejan,4.6,4,1,0,3,1,2,9,22.2,7,4,0,4,5,9,6,0
2043,Reece Oxford,15.1,26,18,15,11,0,10,17,58.8,7,28,22,6,29,55,89,0
2044,Alex Oxlade-Chamberlain,2.8,4,0,0,3,1,0,2,0.0,2,1,0,1,2,6,0,0
2045,Mikel Oyarzabal,26.8,30,17,14,12,4,10,31,32.3,21,30,5,25,15,45,17,0
2046,Ambroise Oyongo,6.2,13,6,10,3,0,9,15,60.0,6,3,2,1,8,21,26,1
2047,Salih Ozcan,15.2,21,13,11,10,0,12,33,36.4,21,11,2,9,20,41,14,1
2048,Levin Oztunali,8.4,24,18,14,8,2,8,17,47.1,9,15,0,15,15,39,16,0
2049,Pablo,12.0,17,11,13,4,0,8,14,57.1,6,17,12,5,25,42,46,1
2050,Fernando Pacheco,37.2,2,0,2,0,0,2,4,50.0,2,0,0,0,2,4,19,0
2052,Goncalo Paciencia,8.3,8,3,4,1,3,4,16,25.0,12,4,1,3,1,9,3,0
2056,Vincent Pajot,10.2,35,20,19,11,5,10,18,55.6,8,9,2,7,42,77,11,0
2057,Rodrigo Palacio,27.8,13,6,2,3,8,1,15,6.7,14,18,0,18,7,20,29,0
2058,Exequiel Palacios,6.4,31,17,12,16,3,17,30,56.7,13,13,0,13,12,43,7,0
2059,Helibelton Palacios,8.3,20,10,16,3,1,8,13,61.5,5,9,1,8,5,25,21,0
2060,Ante Palaversa,0.1,0,0,0,0,0,0,1,0.0,1,0,0,0,0,0,0,0
2062,Nicolas Pallois,30.8,58,36,42,14,2,38,72,52.8,34,44,20,24,37,95,155,1
2063,Emerson Palmieri,1.0,3,3,2,0,1,1,3,33.3,2,0,0,0,1,4,6,0
2064,Antonio Palumbo,0.1,0,0,0,0,0,0,1,0.0,1,0,0,0,0,0,0,0
2066,Goran Pandev,15.6,9,5,1,6,2,4,10,40.0,6,6,0,6,2,11,7,1
2068,Jonathan Panzo,20.0,17,12,13,4,0,8,11,72.7,3,27,13,14,59,76,91,2
2069,Matondo-Merveille Papela,0.0,0,0,0,0,0,0,1,0.0,1,0,0,0,0,0,0,0
2070,Lucas Paqueta,25.3,70,36,30,28,12,23,66,34.8,43,28,3,25,20,90,16,1
2071,Gaetan Paquiez,11.6,21,12,12,7,2,12,29,41.4,17,10,3,7,16,37,28,0
2073,Leandro Paredes,14.5,30,18,12,15,3,19,39,48.7,20,17,5,12,17,47,13,1
2074,Daniel Parejo,34.6,65,40,32,23,10,33,81,40.7,48,35,8,27,45,110,21,3
2075,Vittorio Parigini,0.6,5,2,4,0,1,0,1,0.0,1,0,0,0,0,5,0,0
2076,Marco Parolo,7.3,21,8,8,11,2,8,20,40.0,12,20,6,14,14,35,31,0
2077,Thomas Partey,17.0,44,21,16,24,4,24,56,42.9,32,17,5,12,23,67,18,0
2078,Thomas Partey,2.2,7,4,4,3,0,5,8,62.5,3,4,1,3,2,9,1,0
2080,Mario Pasalic,12.5,26,15,5,17,4,12,19,63.2,7,12,1,11,8,34,6,0
2081,Felix Passlack,4.0,9,6,4,2,3,4,8,50.0,4,11,1,10,3,12,2,0
2082,Christian Pastina,1.3,0,0,0,0,0,0,1,0.0,1,1,0,1,1,1,8,0
2083,Javier Pastore,0.9,2,2,2,0,0,2,2,100.0,0,0,0,0,0,2,0,0
2084,Patric,17.7,30,16,15,11,4,13,24,54.2,11,13,3,10,18,48,51,1
2085,Rui Patricio,37.0,0,0,0,0,0,0,1,0.0,1,0,0,0,1,1,3,3
2087,Gabriel Paulista,30.2,17,11,9,5,3,6,17,35.3,11,32,27,5,59,76,132,3
2088,Benjamin Pavard,21.6,44,27,20,16,8,23,40,57.5,17,29,5,24,48,92,31,1
2089,Jiri Pavlenka,34.0,2,0,2,0,0,2,2,100.0,0,0,0,0,1,3,17,4
2091,Mateo Pavlovic,12.3,11,6,8,3,0,8,23,34.8,15,13,11,2,21,32,40,0
2093,Leonardo Pavoletti,17.6,7,3,2,5,0,1,20,5.0,19,4,2,2,4,11,32,0
2094,Dimitri Payet,26.9,27,17,4,16,7,17,40,42.5,23,19,2,17,8,35,10,0
2095,Nehuen Paz,4.0,9,4,4,5,0,6,7,85.7,1,4,2,2,11,20,16,0
2097,Mads Pedersen,9.9,25,16,20,3,2,10,22,45.5,12,13,3,10,15,40,32,0
2098,Alfonso Pedraza,23.3,35,19,16,11,8,11,31,35.5,20,21,5,16,34,69,47,1
2099,Pedri,26.8,44,27,16,16,12,17,71,23.9,54,46,1,45,33,77,7,0
2100,Pedro,17.7,22,14,6,11,5,7,35,20.0,28,10,0,10,9,31,2,1
2101,Joao Pedro,36.1,13,6,2,6,5,2,27,7.4,25,32,6,26,13,26,28,0
2103,Peter Pekarik,18.8,24,18,17,7,0,17,31,54.8,14,19,8,11,27,51,41,0
2106,Graziano Pelle,6.8,2,2,0,1,1,1,8,12.5,7,3,0,3,2,4,8,0
2108,Lorenzo Pellegrini,28.9,40,24,13,20,7,21,60,35.0,39,37,2,35,42,82,23,1
2109,Luca Pellegrini,7.1,9,6,6,2,1,4,10,40.0,6,11,2,9,8,17,13,1
2110,Facundo Pellistri,6.0,8,5,2,4,2,3,13,23.1,10,0,0,0,4,12,3,0
2111,Andy Pelmard,13.4,18,12,12,5,1,9,12,75.0,3,11,3,8,20,38,35,0
2112,Lee Peltier,2.5,9,4,8,1,0,4,4,100.0,0,1,1,0,1,10,11,0
2113,Federico Peluso,2.3,1,1,1,0,0,1,2,50.0,1,2,2,0,3,4,12,0
2114,Timothee Pembele,4.3,8,7,4,4,0,5,14,35.7,9,4,0,4,5,13,8,1
2115,Ruben Pena,12.4,25,14,8,15,2,19,33,57.6,14,20,1,19,13,38,19,0
2117,Nicolas Pepe,18.0,20,15,8,6,6,8,23,34.8,15,16,1,15,12,32,19,0
2118,Alberto Perea,17.2,28,17,12,10,6,9,35,25.7,26,26,1,25,21,49,9,0
2119,Andreas Pereira,6.0,5,0,1,3,1,2,12,16.7,10,6,0,6,1,6,4,0
2120,Danilo Pereira,15.9,21,11,6,11,4,6,14,42.9,8,14,6,8,29,50,33,4
2121,Mathias Pereira Lage,16.3,29,17,12,15,2,10,40,25.0,30,21,4,17,15,44,16,0
2122,Matheus Pereira,28.6,26,15,14,10,2,12,54,22.2,42,18,0,18,29,55,16,0
2123,Pedro Pereira,28.3,50,32,29,17,4,21,40,52.5,19,33,11,22,19,69,61,0
2124,Ricardo Pereira,10.7,31,22,16,8,7,14,35,40.0,21,24,1,23,15,46,23,0
2125,Gaston Pereiro,3.0,3,1,2,1,0,1,2,50.0,1,2,0,2,1,4,2,1
2126,Bruno Peres,15.9,21,11,11,7,3,13,24,54.2,11,18,4,14,27,48,11,0
2127,Roberto Pereyra,32.5,18,11,7,8,3,7,23,30.4,16,24,5,19,27,45,24,0
2128,Ayoze Perez,14.8,32,15,6,20,6,13,48,27.1,35,28,0,28,10,42,7,0
2129,Carles Perez,8.6,9,4,3,6,0,6,31,19.4,25,9,0,9,6,15,1,0
2130,Inigo Perez,15.0,20,10,9,6,5,10,16,62.5,6,12,0,12,15,35,8,1
2133,Kike Perez,12.9,26,19,8,14,4,7,33,21.2,26,10,1,9,17,43,18,0
2134,Lucas Perez,19.5,6,2,3,3,0,2,10,20.0,8,6,1,5,2,8,5,0
2135,Luis Perez,14.4,33,17,16,17,0,18,30,60.0,12,26,8,18,14,47,54,1
2136,Manuel Perez,1.4,1,0,1,0,0,0,8,0.0,8,2,0,2,2,3,2,0
2137,Nehuen Perez,8.2,6,3,6,0,0,4,6,66.7,2,5,4,1,12,18,33,0
2139,Ivan Perisic,19.9,22,13,11,6,5,12,33,36.4,21,33,4,29,19,41,36,1
2140,Romain Perraud,34.9,60,34,42,16,2,24,45,53.3,21,36,3,33,45,105,76,0
2141,Lucas Perrin,3.4,7,4,4,3,0,5,12,41.7,7,5,4,1,8,15,16,0
2143,Matteo Pessina,18.3,14,7,4,6,4,7,24,29.2,17,17,2,15,17,31,7,1
2144,Andrea Petagna,10.7,2,0,0,2,0,2,7,28.6,5,4,0,4,1,3,7,0
2145,Nils Petersen,14.5,11,7,2,6,3,3,21,14.3,18,25,1,24,9,20,28,0
2147,Jacopo Petriccione,10.6,14,8,6,7,1,9,24,37.5,15,11,2,9,8,22,11,0
2148,Jens Petter Hauge,5.9,7,4,3,3,1,6,10,60.0,4,4,0,4,1,8,3,0
2149,German Pezzella,30.5,34,20,22,12,0,18,32,56.3,14,26,14,12,36,70,109,1
2150,Giuseppe Pezzella,20.3,34,19,23,9,2,22,41,53.7,19,22,9,13,12,46,52,3
2151,Maximilian Philipp,12.3,15,6,3,6,6,5,21,23.8,16,17,0,17,6,21,3,0
2152,Rayan Philippe,1.0,3,1,1,1,1,2,2,100.0,0,0,0,0,0,3,0,0
2153,Romain Philippoteaux,2.4,1,1,1,0,0,1,5,20.0,4,2,0,2,2,3,1,0
2154,Romain Philippoteaux,6.5,11,6,6,3,2,6,9,66.7,3,4,0,4,10,21,2,0
2155,Kalvin Phillips,27.0,74,38,38,29,7,26,62,41.9,36,49,14,35,45,119,53,3
2156,Matt Phillips,20.3,15,8,4,11,0,7,23,30.4,16,32,4,28,10,25,32,1
2158,Nathaniel Phillips,16.2,22,14,15,7,0,11,24,45.8,13,17,14,3,20,42,81,0
2160,Krzysztof Piatek,18.1,9,4,1,7,1,3,22,13.6,19,11,0,11,6,15,14,0
2161,Pablo Piatti,4.0,8,6,3,3,2,3,12,25.0,9,5,0,5,2,10,1,0
2162,Cristiano Piccini,0.7,1,1,1,0,0,0,1,0.0,1,1,0,1,0,1,0,0
2163,Cristiano Piccini,0.7,1,1,1,0,0,1,2,50.0,1,0,0,0,0,1,3,0
2164,Roberto Piccoli,7.8,7,3,0,4,3,2,4,50.0,2,4,0,4,2,9,5,0
2165,Jordan Pickford,30.5,0,0,0,0,0,0,2,0.0,2,2,0,2,3,3,16,4
2166,Jeremy Pied,3.5,7,0,3,3,1,4,9,44.4,5,3,1,2,6,13,8,0
2167,Amos Pieper,29.8,58,32,39,17,2,20,33,60.6,13,48,35,13,66,124,160,3
2168,Ronael Pierre-Gabriel,25.6,60,40,42,16,2,35,52,67.3,17,17,7,10,30,90,57,0
2169,Erik Pieters,14.1,30,21,18,9,3,19,39,48.7,20,30,9,21,12,42,34,0
2170,Tomas Pina Isla,28.6,39,18,18,16,5,16,42,38.1,26,28,8,20,37,76,42,0
2172,Yeremi Pino,8.9,19,11,10,7,2,8,28,28.6,20,20,1,19,9,28,8,0
2174,Gerard Pique,16.5,16,11,11,5,0,9,12,75.0,3,9,4,5,26,42,46,0
2175,Fabio Pisacane,2.5,3,2,2,1,0,3,7,42.9,4,8,5,3,1,4,9,1
2176,Lukasz Piszczek,5.1,10,7,6,4,0,5,12,41.7,7,5,1,4,5,15,12,0
2177,Marko Pjaca,15.8,13,6,6,3,4,4,16,25.0,12,7,2,5,7,20,12,0
2178,Miralem Pjanic,7.0,13,8,7,4,2,7,13,53.8,6,5,1,4,11,24,5,0
2179,Oscar Plano,28.0,42,24,24,12,6,14,46,30.4,32,35,6,29,34,76,43,0
2180,Marvin Plattenhardt,11.9,15,10,6,7,2,5,9,55.6,4,9,1,8,1,16,19,1
2181,Alassane Plea,20.0,19,9,4,10,5,5,20,25.0,15,1,0,1,5,24,7,0
2182,Dani Plomer,0.5,0,0,0,0,0,0,1,0.0,1,0,0,0,0,0,1,0
2184,Tommaso Pobega,13.7,24,13,7,13,4,11,31,35.5,20,10,2,8,9,33,22,0
2185,Daniel Podence,18.5,12,6,5,5,2,2,19,10.5,17,5,1,4,13,25,2,0
2186,Paul Pogba,21.1,36,26,15,16,5,11,33,33.3,22,24,2,22,26,62,37,0
2187,Joel Pohjanpalo,9.5,5,1,0,3,2,1,6,16.7,5,1,0,1,1,6,12,0
2189,Andrea Poli,4.3,9,7,4,2,3,6,12,50.0,6,7,1,6,7,16,7,0
2190,Matteo Politano,21.2,24,16,13,9,2,11,47,23.4,36,14,1,13,14,38,18,0
2191,Jorge Pombo,5.8,7,3,3,2,2,1,8,12.5,7,2,0,2,2,9,3,0
2192,Marin Pongracic,6.4,13,9,9,3,1,6,8,75.0,2,12,5,7,11,24,27,0
2193,Pere Pons,13.2,20,10,8,8,4,5,16,31.3,11,15,2,13,7,27,10,0
2194,Nick Pope,32.0,1,1,1,0,0,0,1,0.0,1,0,0,0,2,3,29,2
2195,Manolo Portanova,0.7,3,3,1,1,1,0,2,0.0,2,3,1,2,1,4,2,0
2196,Manolo Portanova,0.8,2,0,2,0,0,0,2,0.0,2,4,1,3,0,2,1,0
2197,Francisco Portillo,4.6,5,3,1,4,0,2,14,14.3,12,3,0,3,5,10,1,0
2198,Portu,24.3,18,8,4,10,4,7,36,19.4,29,24,2,22,8,26,5,0
2199,Stefan Posch,23.5,52,24,29,17,6,27,47,57.4,20,27,8,19,37,89,73,1
2200,Sergio Postigo,18.0,16,12,12,3,1,7,18,38.9,11,21,10,11,33,49,84,1
2201,Yussuf Poulsen,15.0,10,6,1,6,3,1,17,5.9,16,16,0,16,6,16,13,0
2202,Maxime Poundje,5.5,10,7,9,1,0,2,6,33.3,4,7,3,4,11,21,5,0
2204,Alejandro Pozo Pozo,24.3,38,22,17,15,6,17,38,44.7,21,35,2,33,27,65,40,1
2205,Dennis Praet,8.0,14,7,4,7,3,6,15,40.0,9,12,2,10,7,21,3,0
2206,Sanjin Prcic,3.9,3,2,0,3,0,2,5,40.0,3,4,3,1,4,7,2,1
2207,Nicolas de Preville,17.9,19,14,7,6,6,9,42,21.4,33,15,0,15,13,32,7,0
2208,Manuel Prietl,28.0,65,44,33,28,4,12,73,16.4,61,34,7,27,45,110,24,0
2210,Grischa Promel,20.2,39,23,14,23,2,18,34,52.9,16,20,2,18,24,63,22,0
2211,Davy Propper,2.4,6,5,0,6,0,2,5,40.0,3,3,0,3,1,7,0,0
2212,Ivan Provedel,29.0,2,0,2,0,0,2,6,33.3,4,0,0,0,2,4,20,1
2213,Antonio Puertas,24.1,27,13,9,12,6,10,32,31.3,22,24,5,19,12,39,25,0
2214,Riqui Puig,3.2,5,3,1,3,1,4,8,50.0,4,0,0,0,1,6,0,0
2215,Erick Pulgar,22.2,41,18,17,23,1,22,49,44.9,27,24,10,14,41,82,45,1
2216,Jorge Pulido,32.1,39,24,31,8,0,17,29,58.6,12,32,18,14,52,91,98,0
2217,Christian Pulisic,19.3,19,11,8,10,1,8,21,38.1,13,25,2,23,12,31,9,0
2218,Ignacio Pussetto,8.4,16,8,5,6,5,6,17,35.3,11,14,0,14,13,29,6,0
2219,Fabio Quagliarella,24.5,12,8,4,4,4,2,19,10.5,17,14,1,13,7,19,10,0
2220,Robin Quaison,16.4,14,6,3,6,5,7,14,50.0,7,10,0,10,13,27,10,0
2221,Domingos Quina,3.8,5,5,1,3,1,3,6,50.0,3,8,0,8,2,7,0,0
2222,Quini,13.2,33,22,23,7,3,19,36,52.8,17,15,6,9,15,48,39,0
2223,Quique,1.9,0,0,0,0,0,0,1,0.0,1,2,0,2,0,0,0,0
2224,Dani Raba,1.7,2,1,0,1,1,2,8,25.0,6,1,0,1,0,2,0,0
2225,Simone Rabbi,0.4,0,0,0,0,0,0,1,0.0,1,0,0,0,0,0,0,0
2226,Adrien Rabiot,25.7,72,42,24,41,7,28,60,46.7,32,32,11,21,43,115,29,1
2227,Uros Racic,24.3,38,22,16,16,6,16,54,29.6,38,33,11,22,26,64,54,0
2228,Anthony Racioppi,21.0,0,0,0,0,0,0,2,0.0,2,0,0,0,2,2,12,4
2229,Nemanja Radoja,12.5,23,15,12,10,1,5,19,26.3,14,9,3,6,19,42,12,1
2230,Nemanja Radonjic,4.4,6,5,1,2,3,2,12,16.7,10,8,0,8,3,9,1,0
2231,Nemanja Radonjic,6.8,5,3,2,2,1,1,5,20.0,4,1,0,1,2,7,1,0
2233,Ivan Radovanovic,24.8,18,15,13,5,0,12,31,38.7,19,39,21,18,37,55,114,2
2236,Stefan Radu,27.3,43,24,20,19,4,25,40,62.5,15,27,14,13,45,88,73,1
2238,Rafinha,15.1,54,26,18,28,8,28,49,57.1,21,18,3,15,13,67,6,0
2240,Predrag Rajkovic,36.5,2,1,2,0,0,2,5,40.0,3,1,0,1,2,4,17,3
2241,Ivan Rakitic,24.8,32,18,18,10,4,12,41,29.3,29,19,4,15,26,58,29,1
2242,Jonas Ramalho,3.4,5,4,4,0,1,1,3,33.3,2,3,0,3,2,7,7,0
2243,Benito Raman,13.8,19,13,11,6,2,6,29,20.7,23,11,0,11,5,24,5,0
2244,Gaston Ramirez,10.8,31,15,10,17,4,8,27,29.6,19,19,3,16,4,35,13,0
2245,Sandro Ramirez,14.3,13,9,3,8,2,4,11,36.4,7,11,1,10,10,23,2,0
2246,Sergio Ramos,14.2,15,12,8,6,1,6,10,60.0,4,9,5,4,19,34,39,1
2247,Aaron Ramsdale,38.0,1,1,1,0,0,1,1,100.0,0,0,0,0,2,3,22,6
2248,Aaron Ramsey,12.1,22,14,8,13,1,8,25,32.0,17,13,2,11,7,29,8,2
2249,Jacob Ramsey,7.0,10,5,3,4,3,2,12,16.7,10,13,6,7,4,14,5,0
2250,Kayne Ramsey,1.0,5,2,4,1,0,3,3,100.0,0,0,0,0,0,5,3,0
2252,Andrea Ranocchia,7.8,13,10,6,6,1,7,8,87.5,1,5,3,2,12,25,19,0
2253,Raphinha,26.2,34,17,13,16,5,12,58,20.7,46,31,1,30,29,63,27,0
2254,Raphinha,4.5,5,2,1,3,1,1,4,25.0,3,5,0,5,3,8,4,0
2255,Marcus Rashford,32.4,18,9,2,8,8,7,27,25.9,20,22,2,20,8,26,10,0
2256,Milot Rashica,16.2,24,12,11,11,2,12,23,52.2,11,7,0,7,4,28,6,0
2257,Giacomo Raspadori,13.7,5,3,1,1,3,0,4,0.0,4,13,5,8,2,7,9,0
2258,Federico Ravaglia,4.0,0,0,0,0,0,0,1,0.0,1,0,0,0,0,0,2,0
2259,Tim Ream,7.0,12,5,9,3,0,8,11,72.7,3,8,5,3,6,18,26,1
2260,Ante Rebic,19.7,26,9,4,8,14,8,37,21.6,29,21,1,20,7,33,17,0
2262,Arkadiusz Reca,25.7,34,16,15,11,8,10,45,22.2,35,30,3,27,50,84,64,0
2263,Recio,8.2,17,5,4,8,5,8,18,44.4,10,6,0,6,4,21,1,0
2265,Nathan Redmond,19.3,30,17,14,12,4,8,24,33.3,16,24,2,22,11,41,9,0
2266,Harrison Reed,25.0,63,38,28,28,7,29,73,39.7,44,34,11,23,50,113,31,1
2267,Vasco Regini,1.0,2,2,2,0,0,2,2,100.0,0,1,1,0,1,3,5,0
2268,Sergio Reguilon,24.9,47,25,30,13,4,23,48,47.9,25,39,7,32,32,79,50,1
2269,Bobby Reid,26.4,31,15,17,10,4,18,39,46.2,21,19,5,14,21,52,39,0
2270,Pepe Reina,29.0,0,0,0,0,0,0,1,0.0,1,0,0,0,1,1,6,0
2271,Jeff Reine-Adelaide,11.8,7,4,1,4,2,2,9,22.2,7,10,1,9,4,11,6,0
2273,Reinier,2.9,9,4,6,1,2,2,4,50.0,2,4,1,3,2,11,0,0
2274,Francisco Reis Ferreira,2.0,1,1,1,0,0,0,3,0.0,3,0,0,0,0,1,6,0
2275,Rocco Reitz,0.7,3,2,0,3,0,2,2,100.0,0,3,1,2,1,4,1,0
2276,Karim Rekik,7.3,7,5,2,5,0,1,4,25.0,3,8,3,5,6,13,17,0
2277,Alex Remiro,38.0,0,0,0,0,0,0,1,0.0,1,0,0,0,3,3,14,0
2278,Panagiotis Retsos,3.0,5,3,5,0,0,3,7,42.9,4,1,1,0,3,8,12,0
2279,Marco Reus,25.3,33,16,9,16,8,9,33,27.3,24,22,2,20,14,47,13,0
2280,Elvis Rexhbecaj,20.4,53,32,17,27,9,19,53,35.8,34,32,7,25,26,79,18,0
2282,Gio Reyna,22.0,24,13,9,8,7,9,25,36.0,16,14,1,13,10,34,11,0
2283,Baptiste Reynet,38.0,2,1,2,0,0,2,4,50.0,2,1,0,1,1,3,9,2
2284,Bryan Reynolds,3.1,4,2,1,1,2,1,5,20.0,4,4,0,4,6,10,4,0
2285,Franck Ribery,23.9,24,11,4,9,11,5,29,17.2,24,11,2,9,3,27,1,0
2289,Matteo Ricci,24.8,40,23,14,24,2,27,52,51.9,25,24,4,20,34,74,13,0
2290,Declan Rice,32.0,59,35,33,25,1,21,51,41.2,30,39,11,28,59,118,41,0
2291,Chris Richards,10.5,19,8,12,6,1,10,16,62.5,6,13,4,9,21,40,40,1
2294,Richarlison,31.8,50,32,21,22,7,16,51,31.4,35,28,3,25,14,64,36,1
2295,Marco Richter,15.7,17,9,3,12,2,7,23,30.4,16,10,0,10,6,23,9,0
2296,Mikel Rico,24.3,24,12,14,8,2,11,34,32.4,23,20,3,17,23,47,22,0
2298,Jairo Riedewald,20.2,34,15,13,17,4,16,36,44.4,20,39,7,32,29,63,25,0
2299,Emiliano Rigoni,12.7,12,7,3,8,1,3,15,20.0,12,16,1,15,6,18,9,0
2300,Tomas Rincon,31.6,68,38,27,33,8,36,71,50.7,35,32,7,25,31,99,44,0
2301,Luis Rioja,23.2,21,14,11,7,3,7,39,17.9,32,23,1,22,20,41,30,0
2302,Renaud Ripart,33.9,52,30,25,19,8,26,84,31.0,58,58,12,46,36,88,53,0
2303,Andrea Rispoli,7.2,6,3,2,3,1,2,7,28.6,5,12,3,9,5,11,15,1
2304,Mihailo Ristic,24.8,45,22,25,13,7,28,44,63.6,16,30,9,21,26,71,57,0
2305,Matt Ritchie,15.0,10,3,5,3,2,3,17,17.6,14,17,2,15,12,22,47,0
2306,Maxence Rivera,2.7,12,10,6,4,2,4,10,40.0,6,5,0,5,1,13,0,0
2307,Emmanuel Riviere,7.1,2,1,2,0,0,0,3,0.0,3,5,1,4,1,3,0,0
2308,Rober,15.8,14,7,8,3,3,8,18,44.4,10,24,16,8,35,49,52,1
2309,Roberto,13.0,0,0,0,0,0,0,1,0.0,1,0,0,0,0,0,7,0
2310,Sergi Roberto,10.5,9,6,5,2,2,7,13,53.8,6,12,6,6,10,19,20,0
2311,Tyler Roberts,14.9,15,13,1,11,3,5,22,22.7,17,17,2,15,9,24,12,0
2312,Andrew Robertson,37.6,46,34,23,18,5,28,57,49.1,29,39,9,30,21,67,79,1
2314,Antonee Robinson,24.0,45,28,24,16,5,27,44,61.4,17,21,4,17,37,82,68,0
2315,Callum Robinson,17.3,7,5,5,1,1,3,19,15.8,16,9,0,9,7,14,8,0
2316,Jack Robinson,9.7,14,6,8,5,1,6,11,54.5,5,10,4,6,9,23,42,0
2317,Joel Robles,18.0,0,0,0,0,0,0,1,0.0,1,1,0,1,0,0,11,2
2318,Hal Robson-Kanu,6.2,2,1,1,0,1,0,1,0.0,1,2,0,2,2,4,7,0
2319,Marc Roca,2.0,2,2,0,0,2,0,4,0.0,4,4,1,3,2,4,1,0
2320,Christopher Rocchia,0.2,1,0,1,0,0,0,2,0.0,2,0,0,0,0,1,1,0
2321,Ruben Rochina,15.6,38,28,12,23,3,12,35,34.3,23,22,2,20,22,60,7,0
2323,Sebastian Rode,18.1,44,25,21,16,7,14,46,30.4,32,30,3,27,47,91,18,0
2324,Joe Rodon,8.1,14,9,11,2,1,3,4,75.0,1,10,8,2,21,35,36,2
2325,Rodri,30.5,72,40,24,40,8,33,66,50.0,33,23,9,14,36,108,54,3
2326,Rodri,6.0,3,3,1,2,0,1,6,16.7,5,7,0,7,2,5,0,0
2327,Rodrigo,14.3,14,7,8,3,3,4,22,18.2,18,7,0,7,5,19,16,0
2328,Kevin Rodrigues,12.2,16,8,8,5,3,7,23,30.4,16,10,1,9,20,36,15,1
2329,Angel Rodriguez,15.3,7,4,1,4,2,1,16,6.3,15,7,0,7,2,9,8,0
2330,Oscar Rodriguez Arnaiz,5.7,15,9,3,8,4,6,13,46.2,7,2,0,2,10,25,1,0
2331,Guido Rodriguez,31.8,98,56,52,40,6,40,85,47.1,45,52,14,38,68,166,58,2
2332,James Rodriguez,19.6,28,17,8,15,5,11,46,23.9,35,17,0,17,15,43,3,0
2333,Jay Rodriguez,14.1,25,16,5,15,5,13,28,46.4,15,25,4,21,2,27,7,0
2335,Ricardo Rodriguez,13.8,21,14,11,8,2,13,22,59.1,9,16,5,11,20,41,43,0
2336,Victor Rodriguez,4.7,4,3,3,1,0,0,9,0.0,9,5,1,4,5,9,4,0
2337,Rodrygo,10.9,15,6,10,4,1,2,17,11.8,15,15,0,15,7,22,4,0
2338,Marko Rog,12.9,40,24,15,22,3,16,37,43.2,21,17,6,11,19,59,15,0
2340,Rogerio,20.9,26,13,19,5,2,19,27,70.4,8,26,5,21,31,57,53,0
2341,Luis Rojas,1.2,1,0,0,1,0,1,2,50.0,1,2,0,2,1,2,0,0
2342,Alessio Romagnoli,21.2,17,7,8,7,2,8,19,42.1,11,29,22,7,24,41,80,0
2343,Cristian Romero,28.3,63,32,41,19,3,27,49,55.1,22,31,13,18,96,159,71,2
2344,Oriol Romeu,19.6,69,35,25,39,5,26,68,38.2,42,28,7,21,30,99,18,0
2345,Cristiano Ronaldo,31.1,6,3,1,3,2,3,15,20.0,12,11,3,8,5,11,15,1
2346,Facundo Roncaglia,13.7,25,14,14,11,0,11,20,55.0,9,11,6,5,25,50,26,0
2347,Valentin Rongier,21.0,93,59,31,55,7,43,85,50.6,42,32,2,30,28,121,21,1
2348,Marten de Roon,33.6,80,48,30,36,14,36,84,42.9,48,44,9,35,69,149,40,0
2349,Jerome Roussillon,13.7,24,12,14,8,2,11,20,55.0,9,10,1,9,19,43,28,0
2350,Nolan Roux,7.2,7,3,1,4,2,3,8,37.5,5,6,0,6,5,12,4,0
2351,Nicolo Rovella,13.2,29,16,15,11,3,9,32,28.1,23,11,0,11,20,49,19,1
2352,Amir Rrahmani,12.2,13,8,7,6,0,6,9,66.7,3,17,14,3,8,21,39,1
2354,Waldo Rubio,4.2,6,4,2,2,2,1,14,7.1,13,6,0,6,3,9,3,0
2356,Antonio Rudiger,19.0,31,23,16,14,1,12,15,80.0,3,17,10,7,18,49,51,0
2357,Sebastian Rudy,18.6,35,26,15,15,5,16,45,35.6,29,24,4,20,13,48,21,1
2358,Sebastian Rudy,2.0,4,2,2,0,2,4,7,57.1,3,6,4,2,1,5,4,0
2360,Daniele Rugani,11.1,24,11,10,12,2,10,20,50.0,10,15,10,5,15,39,46,0
2361,Daniele Rugani,1.0,0,0,0,0,0,0,1,0.0,1,1,1,0,1,1,1,0
2362,Matteo Ruggeri,2.3,3,0,1,2,0,2,3,66.7,1,2,0,2,4,7,2,0
2363,Mario Rui,18.5,24,13,17,6,1,17,33,51.5,16,17,4,13,28,52,29,1
2364,Aitor Ruibal,17.7,32,18,14,14,4,10,35,28.6,25,26,0,26,11,43,8,0
2366,Isma Ruiz,0.7,1,0,0,1,0,0,1,0.0,1,0,0,0,0,1,3,0
2367,Kays Ruiz,2.1,1,1,0,1,0,0,4,0.0,4,1,0,1,3,4,2,0
2368,Fabian Ruiz Pena,28.5,58,31,26,21,11,25,70,35.7,45,33,3,30,36,94,32,1
2369,Victor Ruiz,24.0,11,7,7,4,0,4,13,30.8,9,17,13,4,44,55,85,0
2371,Georginio Rutter,0.5,2,2,0,1,1,1,3,33.3,2,2,0,2,0,2,0,0
2372,Georginio Rutter,2.7,4,4,2,2,0,1,2,50.0,1,2,0,2,0,4,2,0
2375,Julian Ryerson,11.9,22,15,4,14,4,12,15,80.0,3,13,0,13,11,33,17,0
2377,Joao Victor Santos Sa,5.2,9,6,2,6,1,6,11,54.5,5,11,0,11,8,17,2,0
2378,Roli Pereira de Sa,0.6,4,3,1,3,0,3,4,75.0,1,2,0,2,0,4,0,0
2379,Idriss Saadi,1.4,0,0,0,0,0,0,2,0.0,2,0,0,0,0,0,0,0
2380,Youssouf Sabaly,32.3,47,33,24,17,6,27,45,60.0,18,31,8,23,49,96,57,2
2382,Marcel Sabitzer,22.5,29,21,12,16,1,12,37,32.4,25,7,2,5,35,64,27,0
2383,Alexis Saelemaekers,22.4,43,26,20,18,5,19,60,31.7,41,29,1,28,25,68,6,0
2384,Modibo Sagnan,6.9,12,7,6,6,0,4,6,66.7,2,7,2,5,6,18,25,1
2385,Allan Saint-Maximin,17.3,16,9,6,9,1,4,9,44.4,5,10,0,10,4,20,2,0
2386,Borja Sainz,5.0,7,3,3,2,2,4,16,25.0,12,4,0,4,6,13,1,0
2387,Romain Saiss,26.7,35,24,23,12,0,19,33,57.6,14,28,13,15,52,87,115,1
2388,Bukayo Saka,28.4,25,16,10,13,2,11,40,27.5,29,21,2,19,25,50,24,0
2389,Hiroki Sakai,26.5,81,48,34,35,12,39,51,76.5,12,21,5,16,54,135,65,0
2392,Mamadou Sakho,3.1,3,2,1,2,0,3,3,100.0,0,3,2,1,3,6,11,0
2393,Jacopo Sala,4.2,17,9,14,1,2,8,22,36.4,14,5,2,3,5,22,6,0
2394,Mohamed Salah,34.2,18,9,4,4,10,7,16,43.8,9,10,0,10,1,19,10,1
2395,Eddie Salcedo,8.4,6,2,3,2,1,3,3,100.0,0,6,0,6,6,12,6,0
2396,William Saliba,20.0,15,9,8,5,2,5,6,83.3,1,17,16,1,26,41,80,2
2397,Romain Salin,15.0,0,0,0,0,0,0,1,0.0,1,0,0,0,1,1,6,3
2398,Mohammed Salisu,9.4,38,21,20,16,2,25,34,73.5,9,22,5,17,17,55,30,0
2399,Roland Sallai,18.5,18,14,7,9,2,5,13,38.5,8,11,1,10,11,29,8,0
2400,Salvi,21.5,18,10,14,3,1,8,26,30.8,18,14,1,13,20,38,24,0
2401,Lazar Samardzic,2.2,10,7,4,6,0,5,13,38.5,8,6,0,6,2,12,1,0
2402,Diadie Samassekou,28.5,71,41,22,42,7,33,90,36.7,57,41,12,29,78,149,50,0
2403,Mama Samba Balde,24.0,23,9,4,13,6,9,22,40.9,13,16,1,15,4,27,26,0
2404,Junior Sambia,27.2,41,29,20,14,7,26,38,68.4,12,27,14,13,39,80,46,0
2405,Frederic Sammaritano,12.6,15,10,9,5,1,9,26,34.6,17,6,0,6,9,24,3,0
2406,Fede San Emeterio,16.2,25,14,15,7,3,11,31,35.5,20,23,8,15,28,53,33,0
2407,Antonio Sanabria,10.9,8,3,0,4,4,2,9,22.2,7,5,0,5,5,13,8,0
2408,Antonio Sanabria,10.4,5,5,0,4,1,0,2,0.0,2,8,1,7,3,8,9,0
2409,Oihan Sancet,11.5,8,2,3,4,1,2,7,28.6,5,4,0,4,5,13,7,0
2410,Renato Sanches,14.1,13,7,4,8,1,5,25,20.0,20,13,2,11,13,26,8,0
2412,Alexis Sanchez,12.7,14,8,4,4,6,5,18,27.8,13,11,0,11,7,21,1,1
2413,Davinson Sanchez,16.5,40,20,31,9,0,21,32,65.6,11,18,13,5,14,54,85,2
2414,German Sanchez,29.3,24,11,13,9,2,11,23,47.8,12,28,26,2,38,62,130,1
2415,Javi Sanchez,10.2,15,10,10,4,1,9,10,90.0,1,15,7,8,15,30,37,0
2416,Manu Sanchez,10.8,27,15,10,10,7,11,25,44.0,14,8,0,8,8,35,14,0
2418,Manu Sanchez,0.5,0,0,0,0,0,0,1,0.0,1,1,0,1,0,0,1,0
2419,Juan Sanchez Mino,5.5,8,5,5,3,0,6,14,42.9,8,4,0,4,4,12,7,0
2420,Pepe Sanchez,2.8,4,2,2,2,0,3,4,75.0,1,5,2,3,4,8,9,0
2421,Robert Sanchez,27.0,1,0,1,0,0,1,1,100.0,0,1,0,1,1,2,11,2
2422,Jadon Sancho,22.9,18,11,4,10,4,7,16,43.8,9,20,1,19,16,34,9,0
2423,Alex Sandro,20.6,37,23,19,13,5,13,25,52.0,12,20,4,16,31,68,57,0
2424,Leroy Sane,20.1,18,10,2,10,6,13,30,43.3,17,23,1,22,9,27,8,1
2425,Salif Sane,11.9,17,9,9,7,1,13,23,56.5,10,25,13,12,25,42,66,0
2426,Oier Sanjurjo,23.2,39,16,8,27,4,17,60,28.3,43,24,6,18,29,68,41,0
2429,Morgan Sanson,3.3,7,4,4,2,1,1,4,25.0,3,5,0,5,4,11,1,0
2430,Morgan Sanson,9.2,21,12,6,12,3,9,28,32.1,19,12,0,12,9,30,5,0
2431,Nicola Sansone,13.0,22,11,7,12,3,10,31,32.3,21,15,0,15,9,31,7,0
2432,Baptiste Santamaria,3.0,9,6,3,5,1,2,7,28.6,5,4,0,4,7,16,8,0
2433,Baptiste Santamaria,24.5,51,38,19,24,8,20,54,37.0,34,36,7,29,52,103,34,1
2435,Davide Santon,6.5,4,3,2,2,0,3,7,42.9,4,10,1,9,4,8,12,0
2436,Samir Santos,24.6,40,23,26,12,2,13,29,44.8,16,33,17,16,58,98,60,1
2437,Riccardo Saponara,0.6,2,1,0,2,0,1,3,33.3,2,0,0,0,1,3,0,0
2438,Riccardo Saponara,4.3,4,1,1,0,3,1,3,33.3,2,1,0,1,1,5,4,0
2439,Ivan Saponjic,4.3,1,0,0,1,0,0,2,0.0,2,2,0,2,1,2,4,0
2440,Pablo Sarabia,14.7,15,11,6,6,3,10,38,26.3,28,9,1,8,5,20,8,0
2441,Josh Sargent,27.8,32,19,13,13,6,13,27,48.1,14,39,4,35,17,49,36,0
2442,Bouna Sarr,0.8,1,1,0,0,1,1,1,100.0,0,1,1,0,1,2,1,0
2444,Bouna Sarr,5.0,9,8,4,3,2,3,6,50.0,3,7,0,7,10,19,7,1
2445,Sidy Sarr,5.1,10,6,4,6,0,2,5,40.0,3,1,1,0,7,17,4,0
2446,Marco Sau,8.7,6,2,0,6,0,1,16,6.3,15,7,0,7,5,11,3,0
2447,Teji Savanier,24.1,49,33,16,25,8,22,73,30.1,51,28,6,22,38,87,15,0
2448,Stefan Savic,32.8,40,25,32,7,1,21,34,61.8,13,33,19,14,42,82,110,0
2449,Romaine Sawyers,16.5,30,18,16,12,2,14,43,32.6,29,20,4,16,18,48,12,3
2450,Gianluca Scamacca,15.0,19,10,6,7,6,7,19,36.8,12,21,4,17,9,28,12,0
2452,Fabian Schar,13.8,13,4,8,5,0,7,19,36.8,12,19,12,7,27,40,52,1
2453,Aurelien Scheidler,3.8,2,0,0,2,0,0,2,0.0,2,0,0,0,1,3,5,0
2455,Pasquale Schiattarella,25.0,37,22,25,12,0,19,47,40.4,28,19,5,14,32,69,29,2
2456,Patrik Schick,20.7,7,2,0,5,2,1,4,25.0,3,5,2,3,3,10,20,0
2457,Sven Schipplock,8.3,15,8,7,6,2,6,27,22.2,21,13,2,11,6,21,8,0
2458,Xaver Schlager,29.2,66,40,20,38,8,22,68,32.4,46,50,6,44,54,120,38,0
2459,Keven Schlotterbeck,18.4,31,10,16,15,0,10,23,43.5,13,26,18,8,36,67,89,2
2460,Nico Schlotterbeck,14.3,34,19,14,19,1,18,28,64.3,10,13,6,7,31,65,29,1
2461,Jeffrey Schlupp,15.9,29,16,14,12,3,6,23,26.1,17,24,8,16,22,51,16,0
2463,Jonathan Schmid,26.6,37,19,17,13,7,16,30,53.3,14,26,10,16,28,65,38,0
2464,Romano Schmid,13.1,22,16,8,10,4,8,35,22.9,27,21,0,21,8,30,6,0
2465,Benno Schmitz,4.6,14,7,6,7,1,7,13,53.8,6,8,2,6,6,20,7,0
2466,Morgan Schneiderlin,24.4,51,31,21,24,6,20,54,37.0,34,21,11,10,53,104,46,0
2467,Alessandro Schopf,10.5,11,9,3,7,1,1,6,16.7,5,15,1,14,6,17,6,0
2468,Jerdy Schouten,27.9,50,25,23,25,2,16,37,43.2,21,36,13,23,79,129,37,6
2470,Nico Schulz,6.8,9,6,4,3,2,2,11,18.2,9,12,4,8,6,15,10,0
2472,Christopher Scott,0.4,2,1,0,1,1,2,2,100.0,0,0,0,0,0,2,1,0
2473,Matteo Scozzarella,1.7,4,0,3,1,0,2,3,66.7,1,3,1,2,6,10,0,0
2475,Jacopo Segre,2.1,5,2,2,1,2,2,5,40.0,3,0,0,0,0,5,1,0
2476,Davie Selke,9.0,3,2,1,1,1,0,6,0.0,6,3,2,1,1,4,7,0
2477,Malik Sellouki,0.7,0,0,0,0,0,0,1,0.0,1,2,0,2,2,2,0,0
2479,Nelson Semedo,33.1,85,48,53,23,9,42,72,58.3,30,30,10,20,41,126,78,2
2480,Leo Sena,9.8,22,12,7,10,5,12,26,46.2,14,19,4,15,11,33,5,0
2481,Stefano Sensi,6.7,9,6,3,5,1,4,11,36.4,7,6,1,5,7,16,1,0
2482,Jaime Seoane,22.9,50,30,20,23,7,24,65,36.9,41,27,6,21,17,67,14,0
2483,Luigi Sepe,36.0,0,0,0,0,0,0,2,0.0,2,0,0,0,2,2,13,2
2484,Suat Serdar,21.7,55,35,18,33,4,17,52,32.7,35,29,4,25,23,78,21,0
2485,Jean Seri,7.9,17,9,3,12,2,4,15,26.7,11,8,2,6,12,29,7,0
2487,Ryan Sessegnon,17.5,47,25,26,13,8,15,34,44.1,19,26,3,23,30,77,46,0
2488,Nils Seufert,3.8,12,9,2,5,5,2,8,25.0,6,3,1,2,5,17,6,0
2490,Stephan El Shaarawy,6.4,4,3,0,3,1,2,9,22.2,7,3,1,2,3,7,2,0
2491,Jamie Shackleton,5.1,10,6,6,4,0,4,11,36.4,7,3,1,2,9,19,3,0
2492,Xherdan Shaqiri,6.2,7,4,3,1,3,2,7,28.6,5,4,0,4,2,9,0,0
2493,Billy Sharp,8.2,5,1,0,3,2,2,9,22.2,7,2,0,2,0,5,2,0
2494,Luke Shaw,29.5,44,28,21,16,7,21,36,58.3,15,34,9,25,20,64,44,2
2496,Jonjo Shelvey,29.1,39,14,18,19,2,10,37,27.0,27,26,14,12,36,75,42,0
2497,Eldor Shomurodov,18.6,28,14,7,13,8,9,37,24.3,28,17,2,15,6,34,11,0
2499,Mahame Siby,0.2,0,0,0,0,0,0,1,0.0,1,0,0,0,0,0,1,0
2500,Abdoulaye Sidibe,0.1,1,1,1,0,0,1,2,50.0,1,0,0,0,0,1,0,0
2501,Djibril Sidibe,22.0,58,34,26,29,3,37,52,71.2,15,20,5,15,50,108,37,2
2502,Sidnei,7.7,9,3,6,3,0,4,9,44.4,5,6,4,2,16,25,28,0
2503,Kaj Sierhuis,7.2,7,2,1,2,4,2,9,22.2,7,2,1,1,2,9,5,0
2504,Tim Siersleben,0.4,2,2,2,0,0,1,1,100.0,0,1,0,1,0,2,0,0
2505,Gylfi Sigurdsson,25.0,30,20,9,14,7,13,44,29.5,31,31,2,29,34,64,21,1
2506,Luca Siligardi,0.5,4,2,0,3,1,1,5,20.0,4,0,0,0,0,4,0,0
2507,Luca Siligardi,0.4,0,0,0,0,0,0,2,0.0,2,0,0,0,0,0,0,0
2508,Adrien Silva,17.8,49,22,21,22,6,18,54,33.3,36,34,1,33,30,79,10,1
2509,Andre Silva,30.7,11,2,0,7,4,6,13,46.2,7,11,1,10,3,14,15,0
2510,Bernardo Silva,22.9,26,14,7,12,7,11,52,21.2,41,17,1,16,17,43,8,0
2511,Caio Henrique Oliveira Silva,26.3,50,34,25,20,5,31,51,60.8,20,20,3,17,16,66,37,0
2512,David Silva,15.5,19,12,2,14,3,8,21,38.1,13,14,1,13,13,32,8,2
2513,Fabio Silva,15.2,6,4,1,4,1,4,12,33.3,8,12,1,11,4,10,5,1
2515,Gabriel Silva,3.9,7,6,7,0,0,1,2,50.0,1,4,1,3,6,13,8,0
2516,Gaston Silva,6.7,16,12,11,5,0,8,14,57.1,6,10,4,6,11,27,16,0
2517,Rui Silva,32.0,1,0,1,0,0,1,3,33.3,2,0,0,0,2,3,14,0
2518,Thiago Silva,21.5,20,12,11,8,1,14,21,66.7,7,21,13,8,33,53,86,1
2520,Mohamed Simakan,17.9,32,22,21,6,5,9,18,50.0,9,17,11,6,31,63,41,0
2522,Giovanni Simeone,19.3,24,11,2,15,7,7,31,22.6,24,23,1,22,10,34,18,0
2523,Moses Simon,25.8,27,14,11,9,7,17,36,47.2,19,24,1,23,15,42,15,1
2524,Unai Simon,37.0,1,0,1,0,0,1,2,50.0,1,0,0,0,0,1,7,7
2527,Wilfried Singo,20.6,29,14,16,6,7,17,33,51.5,16,13,3,10,29,58,40,0
2528,Daley Sinkgraven,17.4,32,17,13,16,3,18,35,51.4,17,22,5,17,23,55,23,0
2529,Dimitris Siovas,34.1,46,24,34,10,2,20,30,66.7,10,38,17,21,62,108,125,2
2531,Salvatore Sirigu,32.0,1,0,1,0,0,1,2,50.0,1,0,0,0,0,1,6,2
2532,Issouf Sissokho,0.9,6,4,4,2,0,3,6,50.0,3,2,0,2,1,7,0,0
2533,Ibrahima Sissoko,28.7,68,48,25,35,8,28,68,41.2,40,22,5,17,48,116,44,0
2534,Moussa Sissoko,17.6,22,16,19,3,0,8,20,40.0,12,11,4,7,23,45,25,0
2535,Nelson Sissoko,5.3,12,6,6,3,3,7,12,58.3,5,2,1,1,12,24,16,1
2537,Jacques Siwe,1.9,4,1,1,1,2,0,1,0.0,1,1,0,1,1,5,1,0
2538,Ellyes Skhiri,30.9,83,48,44,31,8,33,65,50.8,32,49,13,36,82,165,38,2
2539,Lukasz Skorupski,28.0,1,1,1,0,0,1,4,25.0,3,0,0,0,0,1,23,5
2540,Andreas Skov Olsen,13.1,19,10,11,4,4,11,21,52.4,10,15,0,15,3,22,25,0
2541,Robert Skov,12.9,19,10,9,7,3,7,16,43.8,9,9,2,7,15,34,10,1
2542,Milan Skriniar,30.9,48,32,29,16,3,23,34,67.6,11,30,19,11,30,78,89,1
2543,Steven Skrzybski,4.7,5,4,0,5,0,1,7,14.3,6,13,1,12,5,10,1,1
2544,Petar Skuletic,2.6,3,2,1,2,0,0,5,0.0,5,4,2,2,0,3,4,0
2546,Islam Slimani,6.4,7,5,3,1,3,3,12,25.0,9,4,1,3,1,8,6,0
2548,William Smallbone,1.9,6,3,2,4,0,1,3,33.3,2,5,0,5,2,8,1,0
2549,Chris Smalling,12.3,14,8,5,7,2,6,10,60.0,4,17,11,6,28,42,46,1
2550,Emile Smith Rowe,16.0,14,7,5,5,4,6,17,35.3,11,15,1,14,10,24,12,0
2551,Robert Snodgrass,5.8,17,12,12,4,1,10,16,62.5,6,11,2,9,1,18,12,0
2553,Cedric Soares,8.3,12,8,6,4,2,6,21,28.6,15,6,1,5,8,20,16,1
2554,Rafa Soares,12.6,28,17,16,8,4,15,21,71.4,6,14,4,10,20,48,32,0
2555,Ruben Sobrino,0.5,1,1,1,0,0,0,1,0.0,1,0,0,0,0,1,1,0
2556,Ruben Sobrino,12.4,29,13,8,16,5,8,18,44.4,10,19,0,19,15,44,11,0
2557,Simon Sohm,10.0,18,12,11,6,1,11,26,42.3,15,8,0,8,5,23,7,0
2558,Augusto Solari,5.4,18,13,9,8,1,6,26,23.1,20,13,1,12,6,24,5,0
2559,Roberto Soldado,16.0,7,4,1,4,2,2,11,18.2,9,8,0,8,4,11,13,1
2560,Carlos Soler,30.4,41,24,14,24,3,19,52,36.5,33,35,11,24,23,64,41,0
2561,Yann Sommer,30.1,1,1,1,0,0,1,1,100.0,0,0,0,0,2,3,9,2
2562,Son,12.3,18,10,11,6,1,9,19,47.4,10,11,2,9,12,30,20,0
2563,Brandon Soppy,6.2,21,15,16,5,0,10,16,62.5,6,3,0,3,6,27,12,0
2564,David Soria,28.0,2,2,2,0,0,1,3,33.3,2,0,0,0,1,3,12,0
2565,Roberto Soriano,36.1,48,26,15,20,13,15,64,23.4,49,31,8,23,18,66,43,0
2566,Alberto Soro,4.4,7,2,2,4,1,4,10,40.0,6,7,0,7,1,8,2,0
2567,Borna Sosa,22.7,14,10,6,6,2,8,25,32.0,17,23,4,19,31,45,74,0
2569,Florian Sotoca,26.8,31,20,3,20,8,6,22,27.3,16,27,0,27,9,40,24,0
2570,Riccardo Sottil,13.2,7,3,2,3,2,0,7,0.0,7,4,0,4,5,12,3,0
2572,Tomas Soucek,38.0,78,41,37,36,5,28,77,36.4,49,43,18,25,62,140,107,0
2575,Cebio Soukou,5.1,12,8,5,5,2,6,11,54.5,5,3,0,3,3,15,4,0
2576,Adama Soumaoro,19.5,24,14,17,7,0,6,12,50.0,6,28,23,5,20,44,72,0
2578,Boubakary Soumare,21.3,44,29,16,25,3,14,29,48.3,15,14,6,8,39,83,21,0
2579,Yaya Soumare,0.0,1,1,1,0,0,1,2,50.0,1,0,0,0,2,3,0,0
2580,Arnaud Souquet,13.6,50,33,35,13,2,27,48,56.3,21,15,6,9,17,67,34,0
2582,Djibril Sow,24.2,58,33,19,32,7,18,41,43.9,23,31,8,23,51,109,17,0
2583,Saidou Sow,11.1,23,12,17,6,0,13,19,68.4,6,12,8,4,14,37,39,1
2584,Caglar Soyuncu,20.2,27,17,13,14,0,17,30,56.7,13,12,9,3,28,55,80,1
2585,Leonardo Spinazzola,23.6,12,6,3,9,0,8,20,40.0,12,16,1,15,25,37,31,0
2586,Marco Sportiello,14.0,2,2,2,0,0,1,3,33.3,2,0,0,0,2,4,5,1
2587,Mattia Sprocati,0.2,1,0,0,1,0,1,1,100.0,0,0,0,0,1,2,0,0
2588,Jerry St. Juste,32.0,65,38,37,26,2,20,36,55.6,16,46,27,19,64,129,82,1
2589,Benjamin Stambouli,21.7,45,29,24,18,3,15,37,40.5,22,42,14,28,49,94,45,1
2590,Josip Stanisic,1.0,2,2,1,1,0,1,1,100.0,0,3,0,3,2,4,2,0
2591,Niklas Stark,31.0,49,28,20,27,2,13,31,41.9,18,43,16,27,42,91,101,0
2592,Renato Steffen,17.4,24,15,6,12,6,13,24,54.2,11,21,2,19,22,46,15,0
2594,Pascal Stenzel,14.2,33,14,15,17,1,22,50,44.0,28,19,4,15,26,59,39,1
2595,Dale Stephens,2.9,11,6,2,7,2,3,6,50.0,3,3,0,3,8,19,2,0
2596,Jack Stephens,17.1,34,19,19,15,0,17,38,44.7,21,25,14,11,28,62,64,2
2597,Raheem Sterling,28.2,21,10,5,12,4,5,12,41.7,7,15,0,15,15,36,4,0
2598,Enda Stevens,30.0,59,26,32,19,8,33,58,56.9,25,41,12,29,22,81,81,1
2600,Lars Stindl,21.8,24,17,3,16,5,7,32,21.9,25,26,3,23,13,37,14,0
2601,Kevin Stoger,6.0,12,6,2,9,1,5,16,31.3,11,5,0,5,6,18,4,0
2602,John Stones,21.5,21,10,13,5,3,9,14,64.3,5,23,15,8,18,39,56,1
2604,Tobias Strobl,20.5,21,10,12,9,0,10,30,33.3,20,21,8,13,28,49,27,0
2605,Kevin Strootman,14.6,30,18,13,15,2,14,32,43.8,18,35,3,32,25,55,18,0
2606,Kevin Strootman,2.6,9,6,5,4,0,4,8,50.0,4,5,2,3,5,14,7,0
2607,Pascal Struijk,23.1,49,30,28,19,2,17,28,60.7,11,35,21,14,47,96,92,0
2608,Jens Stryger Larsen,29.3,17,11,14,3,0,8,25,32.0,17,26,11,15,24,41,65,0
2609,Stefano Sturaro,4.7,4,3,3,0,1,2,8,25.0,6,5,1,4,5,9,10,0
2610,Stefano Sturaro,4.9,11,5,3,6,2,3,15,20.0,12,5,0,5,7,18,2,0
2611,Damian Suarez,27.0,59,39,29,23,7,30,81,37.0,51,43,2,41,31,90,42,0
2612,Denis Suarez,31.7,64,32,22,30,12,21,94,22.3,73,30,2,28,22,86,15,2
2613,Luis Suarez,27.9,11,7,0,4,7,3,12,25.0,9,7,0,7,5,16,13,0
2614,Marek Suchy,3.4,4,2,1,3,0,1,2,50.0,1,3,3,0,4,8,9,0
2615,Niklas Sule,16.7,32,21,15,14,3,13,21,61.9,8,24,12,12,21,53,36,1
2616,Suso,24.6,20,10,8,6,6,10,41,24.4,31,12,0,12,8,28,8,0
2617,Bosko Sutalo,2.6,5,5,0,3,2,4,5,80.0,1,2,1,1,2,7,7,1
2618,Mattias Svanberg,20.6,38,17,21,9,8,16,45,35.6,29,25,4,21,30,68,25,1
2619,Abdoulaye Sylla,0.1,2,1,2,0,0,1,1,100.0,0,1,0,1,0,2,1,0
2620,Issiaga Sylla,12.4,28,20,11,17,0,11,21,52.4,10,13,3,10,16,44,21,0
2621,Eddy Sylvestre,1.1,1,1,1,0,0,0,1,0.0,1,1,0,1,1,2,0,0
2622,Adam Szalai,8.1,7,6,3,2,2,2,8,25.0,6,4,1,3,2,9,4,0
2624,Frederik Sorensen,1.1,2,1,0,2,0,1,1,100.0,0,2,0,2,0,2,0,0
2626,Alexander Sorloth,16.0,7,5,0,5,2,2,14,14.3,12,13,2,11,3,10,13,0
2627,Tachi,9.4,11,9,9,2,0,6,14,42.9,8,9,6,3,11,22,32,0
2628,Jonathan Tah,24.7,30,17,19,9,2,11,21,52.4,10,19,12,7,33,63,89,1
2629,Waniss Taibi,0.4,0,0,0,0,0,0,2,0.0,2,1,0,1,0,0,0,0
2630,Flavien Tait,15.2,26,11,11,12,3,10,32,31.3,22,17,3,14,13,39,2,0
2631,Adrien Tameze,25.6,39,25,23,15,1,11,27,40.7,16,31,8,23,32,71,46,2
2632,Japhet Tanganga,5.4,5,4,3,2,0,1,3,33.3,2,6,5,1,3,8,15,0
2633,Renato Tapia,30.0,93,44,50,34,9,32,83,38.6,51,56,13,43,53,146,75,2
2634,Edmond Tapsoba,29.5,54,28,35,18,1,21,45,46.7,24,55,29,26,48,102,96,0
2635,Matt Targett,37.8,83,39,52,20,11,56,88,63.6,32,40,14,26,55,138,102,1
2636,James Tarkowski,36.0,66,39,52,11,3,25,49,51.0,24,54,42,12,44,110,163,1
2638,Percy Tau,1.1,1,1,1,0,0,0,2,0.0,2,1,0,1,0,1,1,0
2639,Niklas Tauer,0.8,1,1,0,1,0,1,2,50.0,1,3,1,2,3,4,1,0
2640,Heriberto Tavares,0.5,2,0,0,0,2,1,3,33.3,2,0,0,0,1,3,1,0
2642,Tomas Tavares,0.7,2,1,2,0,0,2,2,100.0,0,1,0,1,0,2,1,0
2643,Charlie Taylor,27.0,48,28,30,15,3,25,46,54.3,21,36,19,17,29,77,87,2
2646,Warren Tchimbembe,5.5,7,4,4,3,0,3,9,33.3,6,6,1,5,2,9,3,0
2647,Aurelien Tchouameni,34.0,127,68,47,62,18,48,92,52.2,44,39,11,28,60,187,47,0
2648,Alvaro Tejero,1.2,1,1,0,0,1,1,3,33.3,2,1,0,1,3,4,6,0
2649,Nathan Tella,8.3,8,5,1,4,3,6,15,40.0,9,13,0,13,3,11,2,0
2650,Alex Telles,7.7,14,7,10,3,1,8,17,47.1,9,7,2,5,16,30,20,0
2652,Andres Tello,4.6,9,6,8,0,1,5,20,25.0,15,8,1,7,6,15,6,0
2653,Cristian Tello,14.3,16,10,5,9,2,4,22,18.2,18,14,0,14,11,27,8,0
2654,Lino Tempelmann,3.0,5,3,2,2,1,0,4,0.0,4,6,1,5,2,7,6,0
2655,Hidde ter Avest,3.9,5,2,3,2,0,2,5,40.0,3,3,1,2,2,7,5,0
2656,Marc-Andre ter Stegen,31.0,0,0,0,0,0,0,2,0.0,2,0,0,0,0,0,12,2
2658,Martin Terrier,27.1,33,15,5,15,13,10,36,27.8,26,23,0,23,16,49,7,0
2659,Claudio Terzi,20.8,34,21,19,14,1,19,28,67.9,9,23,12,11,35,69,55,1
2660,Kenny Tete,16.5,48,30,27,16,5,10,18,55.6,8,14,5,9,27,75,49,0
2662,Cedric Teuchert,8.4,7,5,2,4,1,3,16,18.8,13,12,0,12,5,12,6,0
2663,Florian Thauvin,30.4,40,22,14,21,5,20,54,37.0,34,26,2,24,14,54,11,0
2664,Malick Thiaw,16.1,42,27,24,17,1,15,26,57.7,11,17,12,5,33,75,70,0
2665,Jan Thielmann,11.4,11,6,1,8,2,5,9,55.6,4,10,1,9,9,20,2,0
2666,Sada Thioub,14.0,17,14,7,6,4,7,23,30.4,16,10,0,10,9,26,3,0
2668,Luke Thomas,10.8,23,14,11,5,7,14,21,66.7,7,15,2,13,17,40,21,0
2669,Romain Thomas,33.6,47,25,34,11,2,20,35,57.1,15,35,20,15,50,97,138,0
2670,Adrien Thomasson,29.2,36,17,8,16,12,12,58,20.7,46,44,5,39,22,58,2,0
2671,Erik Thommy,3.5,3,1,0,3,0,0,3,0.0,3,3,0,3,3,6,4,0
2672,Morten Thorsby,29.4,76,42,32,36,8,20,60,33.3,40,51,16,35,25,101,30,0
2673,Khephren Thuram,16.6,32,16,5,21,6,9,27,33.3,18,21,9,12,18,50,22,1
2674,Marcus Thuram,19.2,24,14,9,10,5,10,23,43.5,13,27,4,23,15,39,13,1
2676,Youri Tielemans,37.3,86,45,32,38,16,45,108,41.7,63,35,8,27,46,132,20,1
2678,Kieran Tierney,25.5,27,15,5,14,8,11,31,35.5,20,31,10,21,16,43,63,0
2679,Steffen Tigges,0.6,4,4,0,1,3,2,3,66.7,1,1,0,1,0,4,1,0
2680,Guus Til,1.4,4,3,2,1,1,2,3,66.7,1,2,0,2,2,6,2,0
2681,David Timor,15.5,13,9,5,6,2,9,21,42.9,12,5,1,4,19,32,32,1
2682,Jean-Clair Todibo,14.8,25,15,16,9,0,16,31,51.6,15,13,7,6,19,44,48,1
2683,Karl Toko Ekambi,31.2,16,10,5,3,8,8,32,25.0,24,20,1,19,26,42,8,0
2684,Corentin Tolisso,8.7,19,19,4,11,4,9,29,31.0,20,15,2,13,6,25,8,0
2685,Jeremy Toljan,16.6,21,12,16,3,2,12,27,44.4,15,15,7,8,13,34,28,0
2686,Rafael Toloi,28.2,51,23,21,26,4,26,48,54.2,22,37,7,30,33,84,66,0
2687,Takehiro Tomiyasu,30.2,47,31,27,14,6,21,34,61.8,13,37,19,18,54,101,106,0
2688,James Tomkins,6.1,4,2,4,0,0,3,4,75.0,1,4,3,1,4,8,45,0
2690,Fikayo Tomori,16.3,28,18,17,9,2,8,14,57.1,6,32,20,12,18,46,61,1
2691,Sandro Tonali,14.8,28,19,14,13,1,13,28,46.4,15,18,5,13,22,50,18,0
2692,Lorenzo Tonelli,19.8,33,18,20,11,2,10,21,47.6,11,21,14,7,25,58,94,1
2693,Tono,8.1,4,0,4,0,0,0,2,0.0,2,10,1,9,7,11,12,0
2694,Omer Toprak,21.6,23,16,15,6,2,12,24,50.0,12,27,16,11,36,59,115,1
2696,Ernesto Torregrossa,1.9,1,1,0,0,1,0,2,0.0,2,4,0,4,1,2,1,0
2697,Lucas Torreira,5.8,8,4,2,3,3,0,3,0.0,3,5,3,2,12,20,8,0
2698,Ferran Torres,14.5,12,5,4,6,2,5,16,31.3,11,16,0,16,3,15,8,0
2699,Oliver Torres,15.6,34,22,13,15,6,19,53,35.8,34,15,0,15,15,49,9,0
2700,Pau Torres,33.0,17,11,10,5,2,11,18,61.1,7,33,25,8,23,40,111,1
2701,Roberto Torres,21.0,15,8,6,5,4,8,29,27.6,21,12,0,12,16,31,13,0
2702,Lucas Torro,17.2,32,15,11,19,2,21,34,61.8,13,16,7,9,27,59,43,0
2704,Jordan Torunarigha,10.8,7,4,7,0,0,5,8,62.5,3,8,2,6,15,22,54,1
2705,Cenk Tosun,0.5,0,0,0,0,0,0,1,0.0,1,0,0,0,0,0,0,0
2706,Abdoulaye Toure,18.7,28,12,10,16,2,14,31,45.2,17,17,2,15,22,50,19,0
2707,Almamy Toure,7.8,18,12,8,7,3,10,14,71.4,4,5,1,4,8,26,22,0
2708,Lucas Tousart,23.2,33,18,16,15,2,13,27,48.1,14,33,6,27,40,73,52,0
2709,Andros Townsend,25.1,78,41,45,20,13,30,79,38.0,49,48,2,46,41,119,19,0
2710,Conor Townsend,24.8,44,28,32,9,3,30,49,61.2,19,38,15,23,36,80,55,2
2711,Matteo Tramoni,0.8,4,2,2,1,1,1,2,50.0,1,5,0,5,1,5,2,0
2712,Adama Traore,29.4,28,16,11,13,4,13,21,61.9,8,23,1,22,7,35,12,1
2713,Amadou Traore,3.4,6,1,2,2,2,2,9,22.2,7,9,0,9,1,7,2,0
2714,Bertrand Traore,25.7,26,10,8,10,8,10,34,29.4,24,23,1,22,15,41,14,1
2715,Boubacar Traore,0.6,3,2,1,2,0,1,1,100.0,0,1,0,1,0,3,0,0
2717,Charles Traore,18.9,53,34,30,17,6,27,54,50.0,27,26,5,21,36,89,65,0
2718,Cheick Traore,0.4,2,2,1,1,0,2,4,50.0,2,1,0,1,2,4,1,0
2719,Hamari Traore,33.3,56,38,23,27,6,22,59,37.3,37,31,5,26,76,132,50,0
2721,Ismael Traore,33.3,32,14,23,9,0,20,37,54.1,17,27,13,14,40,72,107,0
2722,Kevin Trapp,33.0,0,0,0,0,0,0,1,0.0,1,1,0,1,3,3,11,3
2723,Miguel Trauco,22.6,47,29,25,14,8,23,43,53.5,20,19,4,15,30,77,34,1
2724,Trezeguet,13.0,33,18,14,15,4,13,45,28.9,32,13,1,12,19,52,17,0
2725,Manu Trigueros,28.1,51,30,25,21,5,21,77,27.3,56,32,2,30,17,68,19,0
2726,Christopher Trimmel,28.6,50,25,28,18,4,28,54,51.9,26,32,7,25,50,100,99,0
2727,Francisco Trincao,7.8,4,2,0,3,1,2,5,40.0,3,4,0,4,1,5,2,0
2728,Alessandro Tripaldelli,3.3,13,6,5,6,2,5,6,83.3,1,6,1,5,3,16,15,0
2730,Kieran Trippier,27.5,61,39,30,25,6,26,52,50.0,26,22,4,18,40,101,58,1
2731,Leandro Trossard,29.0,33,14,11,16,6,10,36,27.8,26,34,2,32,26,59,7,1
2732,Alexis Trouillet,1.2,5,4,1,4,0,4,5,80.0,1,0,0,0,3,8,0,0
2733,Adrien Truffert,21.7,38,18,18,12,8,13,24,54.2,11,26,5,21,18,56,38,1
2736,Axel Tuanzebe,4.5,13,7,5,7,1,8,9,88.9,1,7,5,2,3,16,18,0
2737,Alessandro Tuia,19.6,39,17,34,4,1,15,25,60.0,10,22,10,12,36,75,91,1
2739,Tuta,16.2,35,20,22,13,0,24,43,55.8,19,19,2,17,29,64,53,0
2740,Destiny Udogie,1.9,6,4,2,2,2,2,2,100.0,0,3,0,3,2,8,4,0
2741,Matthieu Udol,19.2,34,21,18,12,4,17,39,43.6,22,25,5,20,39,73,30,0
2742,Naomichi Ueda,7.9,4,2,3,1,0,4,6,66.7,2,5,4,1,6,10,30,1
2743,Lesley Ugochukwu,0.7,3,1,0,3,0,2,3,66.7,1,1,0,1,0,3,0,0
2744,Hwang Ui-jo,27.8,14,6,5,8,1,6,25,24.0,19,17,2,15,8,22,14,0
2746,Samuel Umtiti,7.2,5,1,3,2,0,1,2,50.0,1,11,6,5,9,14,15,0
2747,Enes Unal,14.6,11,3,0,8,3,4,15,26.7,11,11,0,11,2,13,14,0
2748,Cengiz Under,3.1,4,1,0,3,1,3,5,60.0,2,3,0,3,2,6,0,0
2749,Dayot Upamecano,25.9,37,30,18,19,0,14,20,70.0,6,25,14,11,33,70,74,2
2751,Mark Uth,16.6,25,13,13,10,2,5,23,21.7,18,21,0,21,5,30,10,0
2752,Tomas Vaclik,5.0,0,0,0,0,0,0,1,0.0,1,0,0,0,0,0,0,1
2753,Eugeni Valderrama,1.3,2,2,1,0,1,0,1,0.0,1,0,0,0,5,7,3,0
2754,Lautaro Valenti,5.5,10,4,7,2,1,6,15,40.0,9,11,3,8,11,21,30,0
2756,Antoine Valerio,0.8,0,0,0,0,0,0,1,0.0,1,1,0,1,2,2,0,0
2757,Borja Valero,5.5,13,9,7,4,2,3,15,20.0,12,6,1,5,6,19,2,0
2758,Yan Valery,1.1,5,3,2,3,0,1,5,20.0,4,2,0,2,2,7,5,0
2759,Jesus Vallejo,15.0,11,6,7,3,1,7,18,38.9,11,21,11,10,13,24,55,0
2760,Manu Vallejo,10.6,18,8,5,8,5,5,26,19.2,21,8,0,8,3,21,3,0
2761,Federico Valverde,14.8,25,16,9,8,8,10,26,38.5,16,16,2,14,22,47,4,0
2763,Raphael Varane,30.2,22,14,16,5,1,10,19,52.6,9,26,18,8,36,58,114,2
2764,Jamie Vardy,31.6,18,12,1,8,9,2,15,13.3,13,14,5,9,4,22,32,0
2765,Ruben Vargas,17.9,18,12,6,9,3,1,16,6.3,15,26,2,24,18,36,27,0
2766,Denis Vavro,0.4,0,0,0,0,0,0,1,0.0,1,0,0,0,1,1,3,0
2767,Denis Vavro,6.8,7,4,2,4,1,2,5,40.0,3,2,0,2,11,18,21,0
2768,Franco Vazquez,1.8,5,1,0,3,2,1,5,20.0,4,2,1,1,1,6,1,0
2769,Kevin Vazquez,6.2,11,5,9,2,0,3,9,33.3,6,8,0,8,9,20,18,0
2770,Lucas Vazquez,20.5,61,37,30,22,9,22,52,42.3,30,14,1,13,19,80,31,1
2771,Matias Vecino,3.1,1,1,0,0,1,0,5,0.0,5,7,1,6,4,5,3,0
2773,Gabriel Veiga,1.3,3,0,3,0,0,1,4,25.0,3,3,0,3,3,6,0,0
2774,Milos Veljkovic,19.1,24,14,17,6,1,15,31,48.4,16,22,9,13,29,53,94,1
2775,Miguel Veloso,14.6,24,17,10,10,4,12,34,35.3,22,12,1,11,12,36,25,0
2776,Joel Veltman,25.3,67,33,34,25,8,29,57,50.9,28,24,5,19,33,100,64,0
2777,Unai Vencedor Paris,18.9,31,21,10,15,6,11,42,26.2,31,17,6,11,18,49,14,0
2778,Lorenzo Venuti,19.5,24,11,14,7,3,14,28,50.0,14,18,3,15,17,41,24,0
2779,Daniele Verde,10.9,5,4,2,2,1,4,10,40.0,6,5,0,5,9,14,7,0
2780,Simone Verdi,18.0,19,12,10,6,3,6,19,31.6,13,8,0,8,8,27,2,2
2782,Gonzalo Verdu,32.7,34,19,26,8,0,16,28,57.1,12,40,30,10,52,86,113,0
2783,Jordan Veretout,22.8,20,12,8,12,0,9,33,27.3,24,14,3,11,14,34,21,3
2785,Marco Verratti,16.6,53,30,17,25,11,24,72,33.3,48,22,5,17,26,79,4,1
2786,Valerio Verre,11.1,11,7,2,7,2,4,19,21.1,15,14,2,12,9,20,3,0
2787,Mikel Vesga,19.1,28,14,8,16,4,12,50,24.0,38,28,8,20,27,55,35,1
2788,Jannik Vestergaard,28.6,50,31,31,15,4,35,52,67.3,17,29,16,13,42,92,122,0
2789,Ruben Vezo,25.7,34,19,26,7,1,12,29,41.4,17,22,11,11,46,80,106,3
2791,Inigo Vicente,0.6,1,1,1,0,0,1,1,100.0,0,0,0,0,0,1,0,0
2792,Fede Vico,8.5,10,6,5,5,0,3,10,30.0,7,15,1,14,12,22,5,0
2793,Aleix Vidal,6.6,9,5,5,3,1,5,12,41.7,7,10,1,9,12,21,9,0
2794,Arturo Vidal,12.6,27,14,8,13,6,12,41,29.3,29,23,3,20,29,56,11,0
2795,Clement Vidal,1.0,2,1,1,1,0,2,4,50.0,2,4,4,0,1,3,6,1
2796,Nacho Vidal,26.1,56,28,27,22,7,22,31,71.0,9,39,10,29,43,99,68,0
2797,Ronaldo Vieira,2.5,5,3,1,3,1,0,2,0.0,2,4,3,1,0,5,2,0
2798,Luca Vignali,17.7,19,9,10,6,3,7,25,28.0,18,13,5,8,22,41,25,0
2799,Emanuel Vignato,13.4,18,9,9,6,3,3,15,20.0,12,6,1,5,10,28,7,0
2800,Toni Villa,10.8,31,16,11,14,6,15,42,35.7,27,15,1,14,5,36,3,0
2801,Asier Villalibre,17.7,3,2,0,2,1,2,8,25.0,6,4,0,4,2,5,16,0
2802,Gonzalo Villar,20.7,44,18,14,24,6,18,61,29.5,43,25,3,22,22,66,14,1
2803,Ivan Villar,19.8,0,0,0,0,0,0,1,0.0,1,0,0,0,0,0,18,0
2804,Ruben Vinagre,1.9,7,5,5,2,0,3,4,75.0,1,3,0,3,2,9,4,0
2805,Carlos Vinicius,3.4,3,1,2,1,0,1,1,100.0,0,0,0,0,2,5,5,0
2806,Nicolas Viola,11.5,16,9,2,11,3,6,28,21.4,22,10,3,7,9,25,7,0
2809,Vitinha,5.8,7,3,2,5,0,3,8,37.5,5,3,0,3,3,10,1,0
2810,Vitolo,3.3,4,1,2,0,2,1,6,16.7,5,3,0,3,3,7,2,0
2811,Dusan Vlahovic,32.5,13,4,3,4,6,5,16,31.3,11,16,2,14,4,17,15,0
2812,Michel Vlap,4.1,1,1,0,1,0,0,8,0.0,8,4,0,4,5,6,3,0
2813,Andreas Voglsammer,11.1,12,8,6,6,0,8,17,47.1,9,11,0,11,3,15,11,0
2814,Kevin Vogt,20.5,18,12,11,6,1,12,21,57.1,9,21,12,9,16,34,71,0
2815,Mergim Vojvoda,15.1,24,14,18,5,1,12,22,54.5,10,19,4,15,18,42,35,1
2816,Jake Vokins,0.7,0,0,0,0,0,0,1,0.0,1,0,0,0,0,0,0,0
2817,Kevin Volland,30.8,33,16,11,19,3,8,34,23.5,26,23,0,23,4,37,4,0
2818,Stefan de Vrij,30.4,28,16,15,12,1,15,24,62.5,9,24,18,6,41,69,95,0
2820,Sime Vrsaljko,5.8,18,12,13,5,0,8,12,66.7,4,5,0,5,8,26,14,0
2821,Nikola Vukcevic,9.0,14,7,5,8,1,9,18,50.0,9,8,5,3,8,22,12,1
2822,Milos Vulic,14.5,15,8,9,1,5,8,21,38.1,13,10,1,9,8,23,8,0
2823,Matej Vydra,15.2,9,5,2,4,3,1,8,12.5,7,8,1,7,6,15,5,0
2824,Franklin Wadja,0.4,4,2,0,2,2,2,2,100.0,0,0,0,0,2,6,1,0
2825,Elye Wahi,6.2,4,3,2,1,1,1,6,16.7,5,4,0,4,2,6,5,0
2826,Walace,22.8,50,23,28,19,3,21,60,35.0,39,36,3,33,34,84,23,0
2827,Theo Walcott,18.0,23,11,8,9,6,11,32,34.4,21,16,0,16,14,37,5,0
2829,Kyle Walker,21.6,29,19,15,12,2,16,24,66.7,8,19,7,12,14,43,28,0
2830,Kyle Walker-Peters,29.4,83,53,56,25,2,34,57,59.6,23,41,10,31,38,121,66,2
2831,Sebastian Walukiewicz,18.0,27,19,11,13,3,12,30,40.0,18,22,14,8,36,63,60,0
2832,Aaron Wan-Bissaka,34.0,88,54,53,29,6,32,45,71.1,13,65,17,48,62,150,84,2
2834,Joel Ward,25.1,43,25,29,14,0,24,42,57.1,18,27,8,19,41,84,87,2
2835,James Ward-Prowse,38.0,75,49,30,41,4,29,70,41.4,41,36,4,32,42,117,60,0
2836,Daniel Wass,33.1,52,31,21,29,2,22,55,40.0,33,33,13,20,47,99,69,0
2837,Ollie Watkins,37.0,29,17,5,16,8,10,33,30.3,23,21,2,19,7,36,24,0
2838,Caleb Watts,0.4,2,1,2,0,0,1,2,50.0,1,0,0,0,0,2,0,0
2839,Timothy Weah,9.8,15,7,3,9,3,7,14,50.0,7,7,0,7,4,19,5,0
2840,Adam Webster,28.8,29,16,15,10,4,12,25,48.0,13,29,16,13,47,76,92,3
2841,Wout Weghorst,32.7,13,8,2,8,3,4,20,20.0,16,17,3,14,4,17,26,0
2842,Mitchell Weiser,2.5,4,1,1,2,1,2,4,50.0,2,1,0,1,3,7,4,0
2843,Shon Weissman,23.7,12,9,4,5,3,2,23,8.7,21,17,3,14,8,20,7,0
2844,Danny Welbeck,17.2,12,6,2,6,4,7,19,36.8,12,17,0,17,7,19,13,0
2845,Wendell,16.2,53,35,27,18,8,23,49,46.9,26,26,3,23,25,78,39,1
2846,Oscar Wendt,13.9,12,6,2,9,1,4,12,33.3,8,18,4,14,14,26,23,0
2847,Timo Werner,28.9,20,9,6,11,3,7,43,16.3,36,23,1,22,8,28,8,0
2848,Ashley Westwood,37.9,23,15,6,12,5,10,42,23.8,32,26,9,17,44,67,33,0
2849,Ben White,35.5,49,26,21,24,4,24,57,42.1,33,46,22,24,62,111,56,0
2850,Georginio Wijnaldum,32.7,23,7,6,14,3,7,31,22.6,24,18,3,15,26,49,18,1
2852,William,5.3,14,10,10,4,0,5,15,33.3,10,16,5,11,11,25,15,1
2853,Brandon Williams,2.1,0,0,0,0,0,0,1,0.0,1,1,0,1,1,1,7,0
2854,Inaki Williams,26.5,11,7,0,4,7,2,14,14.3,12,13,1,12,5,16,22,0
2855,Neco Williams,2.8,6,5,4,2,0,5,9,55.6,4,3,1,2,6,12,6,0
2856,Nico Williams,0.6,1,0,1,0,0,0,2,0.0,2,0,0,0,1,2,0,0
2857,Rhys Williams,7.3,6,4,3,3,0,3,3,100.0,0,4,3,1,6,12,27,1
2858,Willian,15.6,13,7,6,6,1,6,16,37.5,10,13,0,13,8,21,8,0
2860,Joe Willock,2.6,6,3,1,4,1,3,7,42.9,4,6,1,5,3,9,0,0
2861,Joe Willock,10.9,26,13,16,7,3,9,42,21.4,33,21,3,18,17,43,15,1
2862,Callum Wilson,23.2,12,5,1,6,5,2,12,16.7,10,10,3,7,7,19,14,0
2864,Harry Winks,9.6,16,9,11,5,0,5,20,25.0,15,16,4,12,11,27,12,1
2865,Florian Wirtz,24.7,35,18,8,22,5,11,37,29.7,26,27,1,26,9,44,8,0
2866,Yoane Wissa,29.7,35,20,12,14,9,11,34,32.4,23,25,3,22,20,55,14,0
2867,Axel Witsel,12.6,18,12,6,11,1,8,16,50.0,8,13,3,10,22,40,13,0
2868,Hannes Wolf,15.3,26,13,8,10,8,8,36,22.2,28,18,1,17,9,35,4,0
2869,Marius Wolf,28.3,35,19,19,13,3,13,38,34.2,25,29,3,26,28,63,47,1
2870,Nick Woltemade,1.6,3,2,1,1,1,2,4,50.0,2,1,0,1,0,3,0,0
2871,Jeong Woo-yeong,9.1,9,5,1,6,2,2,11,18.2,9,8,1,7,11,20,11,0
2872,Chris Wood,30.5,12,7,2,4,6,5,18,27.8,13,14,3,11,1,13,21,0
2874,Xeka,13.3,33,17,14,15,4,16,43,37.2,27,14,2,12,20,53,18,0
2875,Granit Xhaka,28.0,50,26,18,17,15,30,58,51.7,28,23,7,16,24,74,38,3
2876,Reinhold Yabo,7.2,5,2,2,2,1,2,9,22.2,7,6,1,5,4,9,1,0
2877,Jawad El Yamiq,15.3,21,14,14,7,0,8,11,72.7,3,15,10,5,46,67,100,0
2878,Ruben Yanez,10.0,0,0,0,0,0,0,1,0.0,1,0,0,0,2,2,2,0
2879,Andriy Yarmolenko,4.2,5,4,2,2,1,2,8,25.0,6,1,0,1,1,6,2,0
2880,Yusuf Yazici,12.1,12,5,6,2,4,1,24,4.2,23,5,1,4,2,14,2,0
2881,DeAndre Yedlin,4.8,9,4,8,1,0,4,10,40.0,6,5,1,4,7,16,17,0
2882,Burak Yilmaz,22.8,13,6,3,7,3,4,30,13.3,26,7,0,7,5,18,22,0
2884,Okay Yokuslu,14.6,38,25,21,13,4,17,35,48.6,18,15,3,12,35,73,33,1
2886,Okay Yokuslu,5.1,14,8,8,4,2,5,9,55.6,4,5,2,3,10,24,9,0
2887,Maya Yoshida,25.3,17,4,10,7,0,7,13,53.8,6,45,34,11,57,74,93,1
2888,Amin Younes,15.5,25,14,8,10,7,6,32,18.8,26,19,1,18,13,38,4,0
2889,Ashley Young,15.8,15,7,8,4,3,3,13,23.1,10,13,0,13,6,21,31,0
2890,Wilitty Younoussa,0.9,6,3,3,3,0,3,7,42.9,4,3,0,3,2,8,0,0
2891,Zaydou Youssouf,13.7,30,15,19,10,1,16,40,40.0,24,15,0,15,25,55,12,1
2892,Mattia Zaccagni,29.0,27,13,8,11,8,8,25,32.0,17,28,4,24,27,54,13,1
2895,Arthur Zagre,1.4,3,1,2,1,0,2,2,100.0,0,1,1,0,3,6,1,0
2896,Wilfried Zaha,29.0,26,18,8,15,3,11,30,36.7,19,21,0,21,9,35,4,0
2897,Miha Zajc,20.7,22,14,9,10,3,13,39,33.3,26,30,4,26,27,49,19,0
2898,Denis Zakaria,15.8,30,15,12,15,3,11,20,55.0,9,20,7,13,23,53,29,1
2899,Joseba Zaldua,7.1,15,12,7,5,3,6,18,33.3,12,6,2,4,6,21,13,0
2900,Nicola Zalewski,0.1,1,1,0,1,0,1,1,100.0,0,0,0,0,0,1,0,0
2901,Andre-Frank Zambo Anguissa,28.7,78,37,27,38,13,27,68,39.7,41,35,6,29,56,134,17,2
2902,Niccolo Zanellato,18.2,24,14,16,6,2,13,36,36.1,23,19,5,14,16,40,12,2
2903,Cristian Zapata,10.8,18,12,11,7,0,10,14,71.4,4,15,11,4,15,33,56,0
2904,Duvan Zapata,26.4,12,5,2,3,7,4,13,30.8,9,19,5,14,6,18,19,0
2905,Gabriele Zappa,26.6,34,17,16,15,3,22,49,44.9,27,36,4,32,24,58,50,0
2906,Davide Zappacosta,22.7,33,16,15,13,5,15,30,50.0,15,17,1,16,18,51,41,0
2907,Oier Zarraga,1.1,1,1,0,1,0,1,2,50.0,1,1,0,1,0,1,0,0
2908,Simone Zaza,16.6,15,9,4,6,5,6,20,30.0,14,14,0,14,3,18,5,1
2909,Deyovaisio Zeefuik,10.1,13,9,8,3,2,8,19,42.1,11,15,3,12,12,25,36,0
2910,Marvin Zeegelaar,19.3,40,18,23,16,1,20,39,51.3,19,21,9,12,24,64,43,0
2912,Arber Zeneli,14.3,20,10,11,1,8,8,22,36.4,14,12,1,11,3,23,8,0
2913,Robin Zentner,31.0,1,1,1,0,0,1,3,33.3,2,0,0,0,3,4,9,2
2914,Andi Zeqiri,1.9,3,2,0,2,1,1,2,50.0,1,1,0,1,0,3,2,0
2915,Mehdi Zerkane,13.2,23,15,7,10,6,5,18,27.8,13,15,2,13,9,32,5,0
2917,Piotr Zielinski,28.0,18,10,8,7,3,7,20,35.0,13,23,4,19,18,36,12,0
2918,Oleksandr Zinchenko,16.4,25,15,12,9,4,14,24,58.3,10,17,4,13,23,48,28,0
2919,Joshua Zirkzee,1.3,2,2,1,1,0,1,3,33.3,2,1,1,0,0,2,1,0
2920,Joshua Zirkzee,1.0,1,0,0,1,0,1,2,50.0,1,0,0,0,0,1,0,0
2921,Hakim Ziyech,13.0,14,10,5,7,2,5,19,26.3,14,9,1,8,10,24,2,0
2922,Jeroen Zoet,6.7,0,0,0,0,0,0,1,0.0,1,0,0,0,0,0,4,2
2923,Kevin Zohi,4.8,9,5,3,4,2,2,6,33.3,4,6,0,6,6,15,3,0
2924,Kurt Zouma,22.5,16,10,8,6,2,4,8,50.0,4,13,9,4,28,44,93,0
2925,Igor Zubeldia,21.8,23,16,15,8,0,8,14,57.1,6,20,13,7,12,35,46,0
2926,Steven Zuber,6.5,24,12,8,13,3,8,16,50.0,8,4,1,3,4,28,1,0
2927,Martin Zubimendi,20.9,41,22,18,20,3,20,34,58.8,14,22,10,12,40,81,39,0
2928,Martin Odegaard,9.6,9,3,2,6,1,4,14,28.6,10,2,0,2,2,11,5,0
2929,Martin Odegaard,2.6,1,0,0,1,0,1,2,50.0,1,1,0,1,1,2,0,0
2930,Filip Duricic,23.1,32,23,6,16,10,12,30,40.0,18,20,2,18,9,41,12,0
