,Player,90s,Tackles - Tkl,Tackles - TklW,Tackles - Def 3rd,Tackles - Mid 3rd,Tackles - Att 3rd,Challenges - Tkl,Challenges - Att,Challenges - Tkl%,Challenges - Lost,Blocks - Blocks,Blocks - Sh,Blocks - Pass,Int,Tkl+Int,Clr,Err
0,Max Aarons,32.0,64,44,49,15,0,37,55,67.3,18,39,19,20,28,92,96,1
1,Yunis Abdelhamid,33.1,48,27,34,14,0,16,32,50.0,16,50,25,25,68,116,104,0
2,Salis Abdul Samed,27.4,43,23,25,16,2,20,57,35.1,37,18,1,17,42,85,15,0
3,Laurent Abergel,32.8,110,60,44,53,13,71,166,42.8,95,58,1,57,55,165,13,0
4,Charles Abi,0.5,0,0,0,0,0,0,1,0.0,1,2,0,2,0,0,0,0
5,Dickson Abiama,8.1,11,7,4,5,2,2,10,20.0,8,12,1,11,4,15,8,0
7,Tammy Abraham,34.3,27,13,7,14,6,9,22,40.9,13,17,3,14,5,32,27,0
8,Luis Abram,6.2,6,3,3,3,0,2,4,50.0,2,6,5,1,5,11,37,1
9,Francesco Acerbi,28.2,25,12,15,9,1,12,19,63.2,7,37,28,9,34,59,92,0
10,Ragnar Ache,2.9,2,0,0,1,1,1,4,25.0,3,3,0,3,0,2,1,0
12,Marcos Acuna,25.1,50,29,27,14,9,30,46,65.2,16,22,5,17,14,64,25,1
13,Che Adams,22.7,13,6,5,5,3,2,16,12.5,14,18,2,16,8,21,18,0
14,Tyler Adams,15.0,23,7,5,16,2,7,25,28.0,18,24,1,23,16,39,19,2
15,Sargis Adamyan,3.7,8,6,3,4,1,3,11,27.3,8,4,0,4,1,9,2,0
16,Martin Adeline,3.9,15,11,5,8,2,8,16,50.0,8,0,0,0,11,26,6,0
17,Amine Adli,14.0,27,14,10,14,3,8,15,53.3,7,26,2,24,11,38,12,0
18,Yacine Adli,25.1,43,27,22,14,7,19,68,27.9,49,33,3,30,37,80,11,2
19,Michel Aebischer,4.9,14,5,5,8,1,6,11,54.5,5,4,1,3,6,20,3,0
20,Felix Afena-Gyan,7.4,10,3,1,6,3,4,7,57.1,3,4,0,4,3,13,0,0
21,Martin Agirregabiria,18.0,34,22,17,11,6,18,37,48.6,19,20,3,17,25,59,38,0
23,Lucien Agoume,20.8,51,31,24,20,7,23,45,51.1,22,30,9,21,52,103,27,1
24,Kevin Agudelo,13.7,44,26,13,26,5,7,20,35.0,13,22,0,22,8,52,6,0
26,Nayef Aguerd,30.4,27,18,16,11,0,14,24,58.3,10,24,14,10,24,51,127,1
27,Sergio Aguero,1.7,1,1,0,0,1,0,2,0.0,2,0,0,0,0,1,0,0
28,Ruben Aguilar,23.8,78,53,39,32,7,43,68,63.2,25,19,4,15,44,122,57,0
30,Naouirou Ahamada,0.7,1,0,1,0,0,1,3,33.3,2,0,0,0,0,1,0,0
31,Anel Ahmedhodzic,15.0,38,26,27,9,2,20,31,64.5,11,16,8,8,22,60,44,0
32,Jean-Eudes Aholou,11.2,16,9,4,9,3,5,19,26.3,14,8,1,7,19,35,7,0
33,Joseph Aidoo,29.3,39,26,28,10,1,17,31,54.8,14,23,13,10,38,77,96,3
34,Ola Aina,16.0,27,19,11,10,6,15,23,65.2,8,17,3,14,28,55,30,0
35,Rayan Ait Nouri,20.3,64,36,46,15,3,22,44,50.0,22,24,2,22,22,86,39,1
36,Kristoffer Ajer,22.2,29,18,21,6,2,13,21,61.9,8,19,11,8,26,55,74,0
37,Ludovic Ajorque,30.4,36,25,5,19,12,7,40,17.5,33,28,3,25,8,44,31,1
38,Manuel Akanji,25.1,33,23,20,11,2,22,32,68.8,10,26,15,11,35,68,58,0
39,Carlos Akapo,20.5,43,31,26,15,2,21,37,56.8,16,26,7,19,51,94,61,0
40,Marley Ake,0.9,0,0,0,0,0,0,2,0.0,2,0,0,0,1,1,0,0
41,Nathan Ake,10.3,16,9,7,8,1,6,8,75.0,2,7,5,2,8,24,23,0
43,Maghnes Akliouche,0.6,2,0,0,2,0,0,1,0.0,1,2,0,2,0,2,0,0
44,Paul Akouokou,5.7,14,9,5,7,2,8,12,66.7,4,6,0,6,11,25,6,0
45,Jean-Daniel Akpa-Akpro,3.5,17,10,7,9,1,7,12,58.3,5,4,2,2,2,19,6,0
46,Kevin Akpoguma,17.0,33,19,16,11,6,16,28,57.1,12,32,2,30,20,53,29,2
47,David Alaba,29.4,23,13,15,6,2,9,19,47.4,10,26,15,11,22,45,70,1
48,Sofiane Alakouch,1.8,7,4,3,4,0,2,5,40.0,3,4,0,4,1,8,4,0
49,Tomas Alarcon,15.8,31,20,17,10,4,10,31,32.3,21,19,7,12,30,61,31,0
50,Lucas Alario,7.3,6,5,0,2,4,2,5,40.0,3,5,0,5,1,7,6,0
52,Jordi Alba,29.4,47,34,12,26,9,27,47,57.4,20,26,6,20,33,80,41,1
54,Luis Alberto,26.1,29,17,8,11,10,8,52,15.4,44,32,4,28,13,42,7,0
55,Raul Albiol,27.4,26,15,20,5,1,14,18,77.8,4,24,15,9,21,47,126,1
56,Marc Albrighton,12.6,31,19,16,9,6,10,47,21.3,37,15,3,12,14,45,20,0
57,Paco Alcacer,8.7,9,3,2,4,3,1,5,20.0,4,7,0,7,6,15,1,0
58,Thiago Alcantara,17.0,48,29,14,24,10,10,42,23.8,32,22,2,20,26,74,13,2
59,Ruben Alcaraz,12.3,41,20,14,24,3,22,45,48.9,23,10,2,8,13,54,14,0
60,Omar Alderete,26.7,53,34,34,17,2,34,53,64.2,19,30,18,12,35,88,153,0
61,Ivan Alejo,11.8,33,15,21,10,2,15,44,34.1,29,12,0,12,8,41,17,0
63,Carles Alena,25.8,27,19,11,13,3,9,48,18.8,39,21,2,19,15,42,16,0
64,Trent Alexander-Arnold,31.7,40,23,19,13,8,27,60,45.0,33,22,4,18,43,83,40,0
65,Mohamed Ali Cho,20.4,10,5,1,4,5,5,17,29.4,12,17,1,16,8,18,0,1
66,Alisson,36.0,3,1,3,0,0,3,5,60.0,2,1,0,1,0,3,28,1
67,Allan,24.3,74,44,28,39,7,34,105,32.4,71,40,9,31,23,97,39,1
68,Jim Allevinah,16.5,18,13,8,8,2,5,18,27.8,13,11,0,11,6,24,4,0
69,Dele Alli,7.3,14,8,10,3,1,5,17,29.4,12,22,5,17,6,20,16,0
70,Dele Alli,3.8,7,2,3,4,0,0,4,0.0,4,7,2,5,6,13,10,0
71,Miguel Almiron,19.1,47,29,23,17,7,11,44,25.0,33,14,1,13,20,67,13,0
72,Marcos Alonso,24.1,41,29,20,12,9,17,36,47.2,19,29,5,24,43,84,53,0
73,Giorgio Altare,16.3,39,28,18,18,3,21,26,80.8,5,17,5,12,30,69,70,0
75,Yeray Alvarez,20.7,24,14,15,8,1,10,18,55.6,8,21,16,5,45,69,97,0
76,Dani Alves,12.2,30,19,13,13,4,14,26,53.8,12,10,3,7,11,41,10,2
78,Steven Alzate,4.5,10,4,4,5,1,4,7,57.1,3,2,1,1,10,20,10,0
79,Ibrahim Amadou,9.0,16,8,10,6,0,8,15,53.3,7,4,2,2,14,30,26,0
80,Emmanuel Amankwaa Akurugu,0.9,0,0,0,0,0,0,2,0.0,2,1,0,1,0,0,0,0
81,Daniel Amartey,23.6,26,13,19,7,0,19,29,65.5,10,30,22,8,21,47,93,4
82,Amath,9.8,21,11,11,6,4,7,17,41.2,10,12,0,12,7,28,7,0
83,Jordan Amavi,4.6,16,10,8,7,1,10,17,58.8,7,3,1,2,15,31,7,0
84,Jordan Amavi,1.4,6,5,3,1,2,5,10,50.0,5,1,0,1,1,7,3,0
85,Wisdom Amey,0.8,3,2,1,1,1,2,3,66.7,1,2,0,2,3,6,1,0
86,Kelvin Amian,29.4,66,42,43,18,5,30,41,73.2,11,39,21,18,32,98,75,0
87,Nadiem Amiri,7.6,6,4,2,2,2,2,9,22.2,7,7,0,7,0,6,0,0
88,Nadiem Amiri,4.1,8,4,3,2,3,4,8,50.0,4,4,2,2,5,13,0,0
89,Ethan Ampadu,25.4,67,43,37,27,3,24,58,41.4,34,49,19,30,51,118,76,0
90,Sofyan Amrabat,10.5,24,13,9,13,2,11,19,57.9,8,25,8,17,5,29,6,1
91,Joachim Andersen,32.4,30,23,21,9,0,16,27,59.3,11,29,19,10,37,67,125,3
92,Felipe Anderson,32.1,71,45,30,33,8,27,99,27.3,72,65,6,59,20,91,16,0
93,Sebastian Andersson,14.0,11,7,0,3,8,3,9,33.3,6,8,0,8,3,14,14,0
94,Florin Andone,2.0,1,1,1,0,0,0,1,0.0,1,2,0,2,0,1,1,0
95,Andres Andrade Cedeno,11.6,27,16,18,8,1,17,35,48.6,18,16,7,9,19,46,44,0
96,Benjamin Andre,30.6,123,69,49,65,9,51,113,45.1,62,49,11,38,50,173,56,0
97,Fredrik Andre Bjorkan,3.9,12,10,7,4,1,7,9,77.8,2,6,2,4,6,18,8,0
98,Marcos Andre,10.8,15,11,4,6,5,5,16,31.3,11,15,0,15,7,22,13,0
99,Robert Andrich,20.2,33,17,18,14,1,14,28,50.0,14,19,7,12,31,64,46,0
100,Jose Angel,12.0,20,13,9,9,2,9,14,64.3,5,6,1,5,10,30,21,0
101,Angelino,25.5,28,21,14,13,1,14,30,46.7,16,24,3,21,29,57,40,0
104,Cristian Ansaldi,7.7,20,9,11,7,2,10,13,76.9,3,9,1,8,6,26,10,0
105,Janis Antiste,8.8,18,11,6,6,6,5,13,38.5,8,7,1,6,4,22,6,0
106,Waldemar Anton,28.8,40,26,22,15,3,19,32,59.4,13,27,16,11,32,72,116,1
108,Michail Antonio,33.0,23,17,5,9,9,7,18,38.9,11,19,1,18,3,26,13,0
109,Christopher Antwi-Adjei,12.6,21,18,7,8,6,6,26,23.1,20,12,0,12,1,22,8,0
110,Houssem Aouar,27.8,46,30,9,25,12,27,54,50.0,27,26,1,25,20,66,5,0
111,Adil Aouchiche,12.0,13,6,5,5,3,5,33,15.2,28,18,1,17,17,30,4,0
112,Dennis Appiah,23.3,55,34,35,18,2,28,48,58.3,20,30,13,17,27,82,74,0
113,Mauro Arambarri,29.6,62,37,19,32,11,20,68,29.4,48,35,5,30,32,94,18,0
114,Mattia Aramu,23.3,20,15,5,9,6,8,33,24.2,25,20,2,18,8,28,19,0
115,Charles Aranguiz,17.5,45,25,18,21,6,22,52,42.3,30,24,4,20,33,78,21,0
116,Nestor Araujo,29.1,22,14,17,5,0,9,21,42.9,12,17,10,7,27,49,105,2
117,Ronald Araujo,25.2,41,23,29,12,0,21,25,84.0,4,37,20,17,23,64,66,1
120,Jesus Areso,2.1,3,3,2,1,0,0,2,0.0,2,0,0,0,0,3,2,1
121,Matias Arezo,1.8,5,3,2,1,2,4,9,44.4,5,1,0,1,1,6,1,0
122,Santiago Arias,4.9,12,5,8,3,1,4,9,44.4,5,8,4,4,5,17,10,0
123,Adam Armstrong,15.7,10,4,2,2,6,0,6,0.0,6,13,1,12,3,13,6,0
124,Stuart Armstrong,16.4,27,19,15,6,6,9,23,39.1,14,10,1,9,8,35,15,0
125,Marko Arnautovic,29.9,17,9,1,11,5,7,30,23.3,23,13,2,11,7,24,17,0
126,Maximilian Arnold,33.3,37,20,19,16,2,20,50,40.0,30,43,15,28,37,74,55,0
128,Tolgay Arslan,18.4,35,20,15,16,4,19,50,38.0,31,17,4,13,13,48,23,1
130,Arthur,8.3,9,5,2,5,2,4,7,57.1,3,4,1,3,1,10,8,0
131,Santiago Arzamendia,5.2,14,6,6,5,3,6,13,46.2,7,6,0,6,4,18,7,0
132,Takuma Asano,17.9,11,6,3,6,2,5,19,26.3,14,14,1,13,7,18,7,0
133,Santiago Ascacibar,26.4,93,54,50,37,6,38,89,42.7,51,31,6,25,41,134,42,0
134,Sergio Asenjo,6.0,0,0,0,0,0,0,1,0.0,1,0,0,0,1,1,6,0
136,Marco Asensio,19.2,12,8,6,4,2,4,18,22.2,14,8,1,7,12,24,6,1
138,Kristoffer Askildsen,8.4,18,6,7,11,0,9,19,47.4,10,14,7,7,15,33,15,0
139,Fisnik Asllani,0.1,0,0,0,0,0,0,1,0.0,1,0,0,0,0,0,0,0
140,Kristjan Asllani,15.0,18,9,9,8,1,11,29,37.9,18,16,7,9,19,37,15,1
141,Iago Aspas,34.3,14,7,1,5,8,4,24,16.7,20,23,2,21,11,25,19,0
142,Lorenz Assignon,6.8,15,10,11,3,1,5,9,55.6,4,3,1,2,11,26,19,0
143,Simon Asta,8.7,13,6,4,5,4,4,8,50.0,4,14,2,12,8,21,16,0
144,Youcef Atal,12.7,29,19,17,10,2,14,25,56.0,11,13,2,11,32,61,21,0
145,Pierre-Emerick Aubameyang,11.5,11,5,6,4,1,3,10,30.0,7,12,1,11,0,11,4,0
146,Pierre-Emerick Aubameyang,12.0,2,2,0,1,1,0,5,0.0,5,9,1,8,2,4,4,0
147,Emil Audero,28.4,3,1,3,0,0,3,5,60.0,2,0,0,0,2,5,17,2
148,Tommaso Augello,26.6,36,20,22,8,6,17,29,58.6,12,19,4,15,29,65,68,1
149,Jean-Kevin Augustin,0.9,1,0,0,0,1,0,3,0.0,3,1,0,1,0,1,0,0
150,Ludwig Augustinsson,8.8,18,14,11,3,4,8,13,61.5,5,10,3,7,5,23,21,0
151,Serge Aurier,11.2,14,9,11,2,1,4,7,57.1,3,14,7,7,11,25,25,0
152,Ezequiel Avila,20.8,17,7,6,7,4,7,21,33.3,14,14,2,12,13,30,15,1
153,Taiwo Awoniyi,24.2,11,7,3,6,2,1,9,11.1,8,11,2,9,2,13,29,0
154,Ramzi Aya,1.5,1,1,1,0,0,1,1,100.0,0,0,0,0,0,1,4,0
156,Jordan Ayew,22.4,47,30,20,20,7,17,31,54.8,14,33,3,30,15,62,15,0
157,Kaan Ayhan,15.0,20,12,14,6,0,7,15,46.7,8,20,14,6,13,33,57,0
158,Luke Ayling,25.2,74,42,46,23,5,51,97,52.6,46,46,25,21,28,102,52,1
159,Karim Azamoum,4.3,6,5,4,2,0,3,5,60.0,2,4,2,2,1,7,10,0
160,Sardar Azmoun,4.0,3,1,0,2,1,0,5,0.0,5,2,0,2,0,3,8,0
161,Cesar Azpilicueta,23.0,51,28,18,27,6,16,35,45.7,19,32,9,23,23,74,65,1
162,Iddrisu Baba,21.5,57,30,31,23,3,25,43,58.1,18,19,5,14,24,81,34,1
163,Carlos Bacca,5.7,4,4,2,0,2,0,3,0.0,3,5,0,5,1,5,5,0
165,Loic Bade,10.9,6,5,4,2,0,3,5,60.0,2,12,10,2,12,18,48,0
166,Milan Badelj,31.6,64,37,25,30,9,34,80,42.5,46,39,7,32,85,149,43,0
168,Benoit Badiashile,20.4,36,19,21,15,0,14,23,60.9,9,18,12,6,28,64,68,1
169,Youssouph Badji,1.5,1,0,0,1,0,0,1,0.0,1,0,0,0,0,1,0,0
173,Stephane Bahoken,12.2,13,8,2,7,4,1,9,11.1,8,15,0,15,3,16,3,0
174,Leon Bailey,8.5,17,11,6,8,3,6,13,46.2,7,10,1,9,1,18,2,0
175,Eric Bailly,2.4,5,4,4,0,1,3,4,75.0,1,4,2,2,3,8,11,0
176,Denys Bain,2.0,3,3,1,2,0,1,1,100.0,0,3,1,2,3,6,5,0
178,Nedim Bajrami,22.8,21,14,5,13,3,4,14,28.6,10,11,0,11,3,24,8,0
179,Cedric Bakambu,4.0,2,0,1,0,1,0,3,0.0,3,2,0,2,0,2,1,0
180,Abdoulaye Bakayoko,3.4,15,9,13,2,0,8,12,66.7,4,5,4,1,12,27,15,0
182,Tiemoue Bakayoko,5.6,19,13,9,7,3,5,16,31.3,11,8,1,7,9,28,10,2
183,Mitchel Bakker,20.2,33,22,16,12,5,20,34,58.8,14,13,2,11,23,56,42,3
184,Ridle Baku,27.2,62,37,30,24,8,25,65,38.5,40,43,1,42,21,83,52,1
185,Dilane Bakwa,0.5,1,1,0,1,0,1,2,50.0,1,0,0,0,0,1,1,0
189,Keita Balde,13.7,8,4,1,5,2,1,10,10.0,9,6,0,6,4,12,6,0
190,Gareth Bale,3.1,2,1,1,0,1,1,4,25.0,3,2,0,2,2,4,1,0
191,Mikel Balenziaga,22.5,33,24,15,15,3,25,43,58.1,18,27,4,23,21,54,79,0
192,Leonardo Balerdi,10.6,9,6,9,0,0,5,14,35.7,9,11,4,7,19,28,30,0
193,Ivan Balliu,35.0,45,22,25,11,9,19,31,61.3,12,24,5,19,39,84,64,0
194,Fode Ballo-Toure,5.0,18,14,5,13,0,4,9,44.4,5,6,2,4,3,21,5,0
196,Abdoulaye Bamba,5.1,6,5,6,0,0,4,11,36.4,7,5,1,4,9,15,13,0
197,Jonathan Bamba,27.0,30,12,13,9,8,13,36,36.1,23,24,1,23,21,51,10,0
198,Patrick Bamford,6.2,1,0,0,1,0,0,3,0.0,3,8,2,6,2,3,8,0
199,Filippo Bandinelli,21.7,33,20,10,17,6,15,31,48.4,16,22,5,17,10,43,37,2
200,Mattia Bani,13.5,23,13,17,6,0,14,18,77.8,4,19,11,8,20,43,76,0
201,Simon Banza,1.4,2,1,0,0,2,0,2,0.0,2,1,0,1,1,3,2,0
202,Shandon Baptiste,10.1,14,4,9,4,1,6,15,40.0,9,10,0,10,11,25,12,0
203,Antonin Barak,26.0,18,8,9,8,1,5,17,29.4,12,32,5,27,6,24,26,0
208,Bradley Barcola,2.9,7,4,2,3,2,1,8,12.5,7,7,1,6,2,9,1,0
209,Melvin Bard,28.8,59,37,38,17,4,41,63,65.1,22,33,10,23,51,110,56,0
210,Enis Bardhi,18.9,29,12,12,14,3,12,35,34.3,23,13,2,11,10,39,7,0
212,Keidi Bare,16.5,27,17,14,12,1,11,31,35.5,20,20,10,10,15,42,26,1
213,Nicolo Barella,32.4,63,42,17,35,11,29,55,52.7,26,26,2,24,21,84,8,2
214,Kike Barja,9.6,15,11,4,7,4,8,22,36.4,14,10,1,9,9,24,4,0
215,Ross Barkley,2.0,0,0,0,0,0,0,1,0.0,1,1,0,1,1,1,0,0
216,Aymen Barkok,1.8,6,2,2,3,1,2,7,28.6,5,4,1,3,5,11,6,0
217,Ashley Barnes,9.0,11,2,2,7,2,2,9,22.2,7,8,1,7,2,13,5,0
218,Harvey Barnes,23.3,31,16,9,11,11,7,23,30.4,16,24,1,23,5,36,7,0
219,Antonio Barragan,11.3,21,14,13,7,1,11,17,64.7,6,5,3,2,17,38,34,0
220,Leandro Barreiro Martins,19.9,63,32,23,27,13,29,50,58.0,21,23,6,17,32,95,23,0
221,Ander Barrenetxea,6.1,15,10,9,6,0,8,18,44.4,10,7,0,7,2,17,2,0
222,Jacob Barrett Laursen,18.1,16,12,10,6,0,8,21,38.1,13,19,7,12,28,44,43,0
223,Musa Barrow,23.7,12,4,4,4,4,6,20,30.0,14,20,1,19,6,18,8,0
224,Abdourahmane Barry,2.3,6,4,3,3,0,5,7,71.4,2,5,2,3,4,10,1,0
225,Marc Bartra,22.1,39,14,18,17,4,19,35,54.3,16,39,22,17,33,72,105,1
226,Daniele Baselli,1.7,3,3,2,0,1,2,6,33.3,4,0,0,0,1,4,2,0
227,Daniele Baselli,3.2,6,5,3,1,2,1,5,20.0,4,2,0,2,2,8,5,0
228,Toma Basic,10.9,12,8,3,9,0,5,17,29.4,12,13,4,9,4,16,21,0
229,Toma Basic,2.3,2,2,1,0,1,0,4,0.0,4,4,1,3,2,4,0,0
230,Amine Bassi,2.0,6,3,2,3,1,1,3,33.3,2,5,0,5,0,6,0,0
231,Alvaro Bastida,2.2,7,4,2,4,1,4,5,80.0,1,1,0,1,3,10,1,0
232,Alessandro Bastoni,25.7,44,25,28,13,3,17,34,50.0,17,22,12,10,35,79,59,1
234,Simone Bastoni,25.4,52,34,28,17,7,21,65,32.3,44,38,11,27,30,82,31,0
235,Lewis Bate,1.6,1,0,0,0,1,0,8,0.0,8,1,0,1,1,2,1,0
236,Rodrigo Battaglia,13.1,32,16,13,19,0,15,30,50.0,15,21,10,11,10,42,36,0
237,Maximilian Bauer,18.8,28,15,17,10,1,11,28,39.3,17,24,14,10,29,57,99,0
238,Oliver Baumann,33.0,0,0,0,0,0,0,3,0.0,3,0,0,0,0,0,19,1
239,Timo Baumgartl,24.1,59,28,34,21,4,31,47,66.0,16,27,11,16,37,96,58,0
240,Julian Baumgartlinger,1.0,3,1,2,1,0,1,2,50.0,1,1,0,1,2,5,0,0
241,Christoph Baumgartner,21.0,28,15,14,7,7,13,32,40.6,19,24,3,21,8,36,16,0
242,Jon Bautista,0.5,3,0,0,3,0,0,1,0.0,1,1,0,1,1,4,1,0
244,Noah Joel Sarenren Bazee,2.7,5,2,2,2,1,3,4,75.0,1,8,2,6,1,6,4,0
245,Bebe,9.6,6,5,1,3,2,4,16,25.0,12,18,0,18,3,9,6,0
246,Ihlas Bebou,23.2,22,14,5,12,5,7,21,33.3,14,20,3,17,12,34,25,0
247,Rodrigo Becao,34.8,81,46,49,30,2,34,60,56.7,26,45,20,25,42,123,89,3
248,Mads Bech Sorensen,9.3,8,7,6,2,0,6,7,85.7,1,9,6,3,6,14,25,0
249,Sheraldo Becker,19.5,9,6,3,4,2,6,18,33.3,12,11,0,11,2,11,4,0
250,Jan Bednarek,29.2,32,15,18,13,1,19,33,57.6,14,48,27,21,72,104,141,0
251,Donny van de Beek,0.8,6,4,4,1,1,1,2,50.0,1,5,1,4,2,8,1,0
252,Donny van de Beek,5.4,15,7,8,6,1,6,13,46.2,7,6,2,4,6,21,4,0
254,Valon Behrami,3.5,3,1,0,2,1,0,7,0.0,7,4,1,3,1,4,4,0
255,Kevin Behrens,5.5,3,2,1,1,1,0,4,0.0,4,3,0,3,3,6,7,0
256,Youcef Belaili,9.2,2,1,0,0,2,2,9,22.2,7,5,1,4,7,9,4,0
258,Ishak Belfodil,18.2,9,6,4,4,1,4,8,50.0,4,9,1,8,5,14,16,0
260,Haris Belkebla,25.7,46,23,21,21,4,18,39,46.2,21,26,6,20,48,94,30,1
261,Stefan Bell,31.8,54,23,37,16,1,30,63,47.6,33,26,15,11,41,95,112,1
262,Armel Bella Kotchap,19.6,34,20,25,9,0,18,28,64.3,10,21,16,5,42,76,84,2
263,Raoul Bellanova,27.7,29,15,14,12,3,6,27,22.2,21,39,8,31,21,50,51,0
264,Karim Bellarabi,7.6,9,4,4,4,1,3,13,23.1,10,5,0,5,9,18,4,0
265,Jean-Ricner Bellegarde,25.9,51,32,21,21,9,17,41,41.5,24,29,4,25,27,78,19,0
266,Hector Bellerin,22.0,52,32,29,20,3,31,44,70.5,13,11,2,9,23,75,57,1
267,Jude Bellingham,31.0,52,34,15,31,6,21,53,39.6,32,50,4,46,42,94,32,0
268,George Bello,4.8,7,7,7,0,0,4,4,100.0,0,5,4,1,6,13,11,0
270,Andrea Belotti,15.2,7,3,2,2,3,3,12,25.0,9,12,4,8,2,9,9,0
271,Fran Beltran,28.9,56,41,27,23,6,28,68,41.2,40,29,5,24,32,88,39,0
272,Hatem Ben Arfa,3.5,4,2,2,1,1,2,4,50.0,2,3,0,3,0,4,1,0
274,Wissam Ben Yedder,28.1,18,8,1,11,6,6,15,40.0,9,12,1,11,0,18,1,0
275,Marco Benassi,1.8,1,0,1,0,0,1,2,50.0,1,3,0,3,3,4,3,0
276,Marco Benassi,4.2,6,3,3,2,1,1,10,10.0,9,4,0,4,3,9,6,0
277,Dario Benedetto,6.6,5,1,2,2,1,3,6,50.0,3,4,0,4,1,6,1,0
279,Laszlo Benes,2.7,5,3,1,3,1,1,6,16.7,5,5,2,3,2,7,5,0
280,Walter Benitez,37.0,0,0,0,0,0,0,2,0.0,2,1,0,1,0,0,12,2
281,Iker Benito,1.3,2,1,1,0,1,0,1,0.0,1,2,0,2,0,2,2,0
283,Pedro Benito,0.3,0,0,0,0,0,0,1,0.0,1,0,0,0,0,0,0,0
286,Ismael Bennacer,16.9,44,30,22,15,7,21,50,42.0,29,20,4,16,25,69,15,0
287,Keanan Bennetts,0.6,2,0,1,1,0,1,1,100.0,0,1,0,1,0,2,0,0
288,Said Benrahma,24.1,28,17,16,9,3,15,38,39.5,23,17,1,16,9,37,8,0
289,Ramy Bensebaini,22.4,42,30,24,15,3,27,44,61.4,17,33,7,26,39,81,77,1
290,Nabil Bentaleb,16.8,42,24,15,20,7,16,29,55.2,13,24,9,15,28,70,13,0
291,Rodrigo Bentancur,15.1,36,18,14,14,8,16,32,50.0,16,24,9,15,20,56,35,0
292,Rodrigo Bentancur,12.8,32,18,11,18,3,7,20,35.0,13,15,2,13,26,58,15,1
293,Christian Benteke,12.7,3,2,1,2,0,2,6,33.3,4,7,3,4,2,5,33,0
294,Karim Benzema,28.8,11,9,5,3,3,2,9,22.2,7,10,0,10,4,15,13,0
296,Domenico Berardi,31.3,32,19,9,16,7,15,57,26.3,42,39,2,37,31,63,23,0
297,Yuri Berchiche,11.3,25,11,10,11,4,7,14,50.0,7,19,6,13,13,38,25,0
298,Alex Berenguer,24.1,45,26,23,14,8,11,51,21.6,40,40,2,38,16,61,20,0
299,Bartosz Bereszynski,32.7,64,38,34,25,5,37,80,46.3,43,38,12,26,42,106,73,1
300,Johann Berg Gudmundsson,12.2,16,6,7,7,2,5,20,25.0,15,11,2,9,12,28,22,0
301,Patrick Berg,3.4,14,6,6,8,0,0,4,0.0,4,2,1,1,4,18,3,0
302,Mitchell van Bergen,10.9,8,5,7,0,1,6,15,40.0,9,9,0,9,4,12,7,0
303,Steven Bergwijn,6.3,3,2,2,1,0,1,10,10.0,9,3,0,3,1,4,8,0
305,Valon Berisha,5.1,10,7,2,5,3,2,10,20.0,8,9,0,9,4,14,3,0
306,Federico Bernardeschi,16.4,16,10,7,4,5,6,13,46.2,7,12,4,8,5,21,15,0
307,Paul Bernardoni,13.0,3,2,3,0,0,3,4,75.0,1,0,0,0,0,3,8,1
309,Juan Bernat,10.6,24,14,10,10,4,13,18,72.2,5,8,0,8,8,32,16,0
310,Dimitry Bertaud,9.3,0,0,0,0,0,0,1,0.0,1,0,0,0,0,0,5,1
312,Jason Berthomier,19.2,29,14,5,17,7,12,34,35.3,22,14,2,12,8,37,4,1
313,Nicolo Bertola,0.4,3,2,3,0,0,3,4,75.0,1,0,0,0,3,6,1,0
314,Ryan Bertrand,3.7,8,5,3,4,1,2,5,40.0,3,8,3,5,1,9,7,0
315,Daniel Bessa,8.5,7,2,3,3,1,4,15,26.7,11,13,3,10,5,12,11,0
316,Beto,24.1,21,6,2,14,5,9,19,47.4,10,16,1,15,5,26,25,1
317,Jordan Beyer,15.4,46,27,32,13,1,23,39,59.0,16,18,5,13,15,61,52,2
318,Giulian Biancone,25.5,70,42,44,22,4,40,69,58.0,29,23,8,15,53,123,71,1
319,Bartosz Bialek,2.0,0,0,0,0,0,0,1,0.0,1,1,0,1,0,0,2,0
321,Mads Bidstrup,0.5,1,0,0,1,0,0,3,0.0,3,0,0,0,1,2,2,0
322,Pedro Bigas,17.2,24,10,16,8,0,9,20,45.0,11,21,16,5,18,42,77,1
323,El Bilal Toure,13.3,13,6,4,6,3,2,7,28.6,5,10,3,7,6,19,19,0
324,Jean-Claude Billong,10.9,17,8,14,1,2,8,11,72.7,3,9,1,8,10,27,35,0
325,Luis Binks,7.2,8,4,7,1,0,4,6,66.7,2,6,5,1,17,25,33,1
326,Cristiano Biraghi,35.0,37,24,17,15,5,22,53,41.5,31,28,10,18,19,56,31,1
327,Davide Biraschi,10.3,31,16,19,9,3,17,24,70.8,7,16,9,7,16,47,26,0
329,Yves Bissouma,23.5,76,49,35,37,4,21,37,56.8,16,33,3,30,50,126,49,0
331,Marco Bizot,38.0,3,1,3,0,0,3,5,60.0,2,1,0,1,0,3,24,1
333,Ludovic Blas,32.9,33,18,7,20,6,15,44,34.1,29,33,3,30,31,64,6,1
334,Danny Blum,3.8,2,1,0,0,2,0,2,0.0,2,4,0,4,2,4,1,0
335,Myron Boadu,10.7,9,7,2,3,4,1,5,20.0,4,6,0,6,2,11,1,0
336,Jerome Boateng,18.0,20,15,11,9,0,9,17,52.9,8,20,10,10,20,40,73,0
338,Kevin-Prince Boateng,7.7,6,5,1,4,1,3,9,33.3,6,7,2,5,6,12,11,0
340,Herbert Bockhorn,9.4,20,14,13,4,3,12,20,60.0,8,10,1,9,14,34,18,0
341,Jean-Paul Boetius,20.0,40,23,18,17,5,22,53,41.5,31,41,3,38,25,65,11,0
342,Jeremie Boga,8.5,7,3,0,4,3,4,6,66.7,2,6,0,6,1,8,3,1
343,Jeremie Boga,7.4,7,4,1,2,4,2,3,66.7,1,3,0,3,2,9,1,1
344,Luka Bogdan,4.4,6,3,6,0,0,4,8,50.0,4,3,2,1,6,12,21,0
345,Emil Bohinen,7.8,15,9,4,9,2,10,20,50.0,10,17,3,14,12,27,14,0
346,Quentin Boisgard,10.6,19,11,6,10,3,8,17,47.1,9,15,0,15,6,25,5,0
348,Willy Boly,10.0,25,19,18,7,0,8,15,53.3,7,14,6,8,14,39,35,0
349,Giacomo Bonaventura,25.2,33,17,12,16,5,21,46,45.7,25,20,2,18,14,47,9,1
350,Federico Bonazzoli,20.7,24,12,9,8,7,6,25,24.0,19,17,1,16,6,30,7,0
352,Kevin Bonifazi,13.4,25,16,16,7,2,13,14,92.9,1,22,7,15,16,41,35,0
354,Leonardo Bonucci,22.3,14,5,4,10,0,8,13,61.5,5,22,17,5,26,40,82,0
355,Sebastiaan Bornauw,22.3,30,19,23,5,2,16,25,64.0,9,29,8,21,42,72,97,1
356,Rafael Borre,26.4,31,22,4,13,14,7,33,21.2,26,24,4,20,5,36,9,0
357,Sven Botman,25.0,24,11,13,11,0,12,18,66.7,6,32,21,11,26,50,116,0
358,Denis Bouanga,27.1,46,25,14,13,19,22,63,34.9,41,30,0,30,8,54,34,1
359,Hicham Boudaoui,18.0,31,18,15,10,6,13,36,36.1,23,17,4,13,18,49,15,0
360,Ryad Boudebouz,25.0,27,15,11,12,4,12,29,41.4,17,17,2,15,10,37,5,0
361,Sofiane Boufal,25.9,44,29,19,16,9,18,38,47.4,20,19,2,17,7,51,1,0
362,Farid Boulaya,17.0,18,10,7,9,2,14,38,36.8,24,8,2,6,12,30,5,0
366,Mehdi Bourabia,3.1,5,1,2,3,0,3,11,27.3,8,7,6,1,3,8,10,0
367,Benjamin Bourigeaud,35.5,46,24,16,18,12,24,67,35.8,43,33,3,30,30,76,44,0
369,Edoardo Bove,0.8,1,1,1,0,0,0,2,0.0,2,1,0,1,1,2,0,0
370,Jarrod Bowen,33.1,36,20,20,11,5,17,44,38.6,27,29,2,27,21,57,14,0
371,Dedryck Boyata,21.1,15,13,11,3,1,8,11,72.7,3,17,13,4,17,32,134,1
372,Lucas Boye,19.0,27,13,5,15,7,9,24,37.5,15,24,1,23,2,29,23,0
373,Domagoj Bradaric,4.6,11,9,8,2,1,7,12,58.3,5,5,2,3,10,21,7,1
374,Bilal Brahimi,4.2,1,1,0,1,0,0,2,0.0,2,1,0,1,2,3,1,0
375,Bilal Brahimi,3.8,1,1,0,1,0,0,3,0.0,3,0,0,0,1,2,1,0
377,Julian Brandt,23.1,37,19,13,20,4,17,54,31.5,37,19,2,17,24,61,14,1
378,Jarrad Branthwaite,4.3,4,1,3,1,0,3,8,37.5,5,3,2,1,1,5,20,0
379,Darko Brasanac,26.7,35,22,19,14,2,14,40,35.0,26,25,8,17,25,60,15,0
380,Lilian Brassier,25.1,40,24,23,13,4,10,21,47.6,11,31,21,10,32,72,86,0
384,Josip Brekalo,25.4,9,5,5,1,3,3,21,14.3,18,16,1,15,4,13,7,1
386,Gleison Bremer,32.1,49,24,27,22,0,18,28,64.3,10,54,23,31,105,154,137,0
387,Jimmy Briand,2.5,2,0,2,0,0,0,2,0.0,2,0,0,0,1,3,2,0
388,Yan Brice Eteki,3.8,6,3,3,2,1,3,7,42.9,4,7,3,4,4,10,6,1
390,Brian Brobbey,1.5,1,0,0,1,0,1,1,100.0,0,1,0,1,0,1,0,0
391,Armando Broja,21.9,12,5,2,7,3,2,9,22.2,7,17,1,16,3,15,11,0
392,Dylan Bronn,28.3,47,29,33,13,1,20,31,64.5,11,32,19,13,40,87,78,1
393,John Brooks,29.1,47,25,25,18,4,36,60,60.0,24,33,19,14,41,88,125,1
394,Daniel Brosinski,4.3,2,1,1,1,0,1,1,100.0,0,6,0,6,3,5,9,0
395,Josh Brownhill,32.8,73,37,25,42,6,21,53,39.6,32,37,12,25,68,141,42,1
396,Marcelo Brozovic,32.6,77,45,34,35,8,34,68,50.0,34,28,10,18,37,114,36,2
397,Cedric Brunner,24.3,51,35,29,20,2,25,49,51.0,24,27,10,17,43,94,84,0
399,Jacob Bruun Larsen,9.0,2,1,1,1,0,0,5,0.0,5,14,3,11,5,7,5,2
400,Ante Budimir,19.3,24,10,3,15,6,6,19,31.6,13,22,4,18,3,27,16,0
401,Emi Buendia,21.1,38,18,16,13,9,21,51,41.2,30,21,3,18,9,47,11,0
402,Osman Bukari,11.2,18,8,7,6,5,8,22,36.4,14,8,0,8,8,26,1,0
403,Aleksander Buksa,0.7,0,0,0,0,0,0,1,0.0,1,0,0,0,0,0,1,0
404,Alessandro Buongiorno,13.1,20,9,9,8,3,9,13,69.2,4,12,6,6,31,51,44,0
405,Sascha Burchert,14.0,1,1,1,0,0,1,2,50.0,1,0,0,0,0,1,11,1
406,Delano Burgzorg,0.3,1,1,1,0,0,0,1,0.0,1,0,0,0,0,1,0,0
407,Jonathan Burkardt,29.0,17,8,0,10,7,6,25,24.0,19,31,5,26,8,25,16,0
409,Dan Burn,16.0,16,11,11,4,1,7,11,63.6,4,22,14,8,20,36,101,0
410,Dan Burn,11.4,22,12,13,8,1,6,15,40.0,9,14,10,4,24,46,51,0
411,Maxime Busi,14.4,26,15,20,5,1,19,36,52.8,17,19,5,14,17,43,28,0
412,Gianluca Busio,21.7,53,28,27,20,6,28,63,44.4,35,45,13,32,21,74,30,1
413,Oriol Busquets,2.2,3,3,0,3,0,2,6,33.3,4,7,4,3,1,4,2,0
414,Sergio Busquets,35.5,93,49,31,48,14,46,83,55.4,37,44,8,36,45,138,31,0
419,Jamie Bynoe-Gittens,1.5,3,2,0,2,1,2,5,40.0,3,4,1,3,1,4,1,0
420,Sam Byram,11.4,24,15,17,6,1,19,27,70.4,8,21,11,10,22,46,48,0
421,Erick Cabaco,4.5,2,1,1,1,0,2,5,40.0,3,5,2,3,4,6,10,0
423,Remy Cabella,3.5,15,7,4,8,3,5,15,33.3,10,7,0,7,5,20,1,0
424,Jimmy Cabot,22.3,81,44,59,15,7,47,83,56.6,36,29,0,29,32,113,30,0
426,Leandro Cabrera,37.0,37,24,27,10,0,21,34,61.8,13,32,23,9,44,81,222,2
427,Liberato Cacace,5.2,15,6,8,4,3,8,8,100.0,0,7,2,5,8,23,9,0
428,Martin Caceres,9.2,13,7,5,5,3,4,12,33.3,8,12,3,9,14,27,21,0
429,Martin Caceres,7.4,2,2,2,0,0,1,5,20.0,4,2,2,0,11,13,16,1
430,Anthony Caci,26.6,65,34,35,24,6,33,55,60.0,22,22,3,19,33,98,49,1
431,Mathieu Cafaro,2.1,4,2,3,1,0,0,7,0.0,7,2,0,2,3,7,1,0
432,Yannick Cahuzac,6.9,5,2,2,3,0,0,5,0.0,5,8,2,6,9,14,12,0
433,Felipe Caicedo,3.2,3,3,0,2,1,0,1,0.0,1,1,0,1,0,3,4,0
435,Moises Caicedo,7.3,16,10,7,7,2,5,12,41.7,7,18,4,14,10,26,7,0
436,Marc-Aurele Caillard,17.1,0,0,0,0,0,0,2,0.0,2,0,0,0,2,2,9,1
437,Jens Cajuste,4.0,10,6,6,2,2,6,17,35.3,11,7,2,5,5,15,6,0
438,Cala,10.5,9,4,9,0,0,8,17,47.1,9,12,6,6,12,21,56,0
439,Davide Calabria,23.5,62,37,31,23,8,37,72,51.4,35,25,5,20,23,85,40,1
440,Riccardo Calafiori,0.9,1,0,0,0,1,1,2,50.0,1,2,1,1,2,3,4,0
442,Riccardo Calafiori,1.9,5,4,2,2,1,1,5,20.0,4,3,0,3,3,8,1,0
443,Mattia Caldara,30.0,48,28,30,15,3,20,34,58.8,14,49,37,12,62,110,147,1
444,Calderon,0.7,2,0,1,0,1,1,3,33.3,2,0,0,0,0,2,2,0
445,Fernando Calero,12.1,17,10,12,5,0,8,13,61.5,5,7,2,5,16,33,63,1
446,Duje Caleta-Car,22.9,21,8,15,6,0,11,14,78.6,3,11,7,4,24,45,55,2
447,Hakan Calhanoglu,27.6,41,23,16,19,6,11,40,27.5,29,29,5,24,25,66,12,0
448,Daniel Caligiuri,22.3,46,30,17,26,3,27,72,37.5,45,36,5,31,18,64,33,0
449,Jose Callejon,14.4,15,6,6,6,3,13,31,41.9,18,6,0,6,3,18,1,1
451,Dominic Calvert-Lewin,14.3,11,8,1,6,4,3,8,37.5,5,5,2,3,3,14,12,0
452,Mahdi Camara,34.1,101,57,39,50,12,39,70,55.7,31,44,8,36,57,158,35,1
454,Victor Camarasa,1.2,2,1,1,1,0,0,1,0.0,1,2,1,1,2,4,2,0
455,Eduardo Camavinga,13.7,52,35,22,20,10,20,38,52.6,18,20,2,18,17,69,14,1
456,Eduardo Camavinga,1.6,4,1,2,1,1,2,5,40.0,3,1,1,0,1,5,3,0
457,Andrea Cambiaso,19.9,46,20,28,14,4,18,32,56.3,14,33,8,25,23,69,37,1
458,Jose Campana,15.8,27,16,13,10,4,12,32,37.5,20,13,2,11,21,48,19,1
460,Emre Can,18.8,36,22,20,16,0,15,30,50.0,15,26,10,16,36,72,40,2
461,Sergio Canales,31.0,24,14,8,12,4,10,35,28.6,25,16,1,15,10,34,12,0
462,Matteo Cancellieri,2.5,4,4,2,2,0,0,5,0.0,5,2,0,2,1,5,0,0
463,Joao Cancelo,35.9,83,54,33,35,15,46,91,50.5,45,25,3,22,59,142,45,1
464,Fali Cande,10.8,30,18,13,15,2,13,31,41.9,18,11,2,9,6,36,21,0
465,Antonio Candreva,34.7,27,16,9,11,7,19,55,34.5,36,23,2,21,33,60,19,0
466,Sergi Canos,23.1,56,25,32,15,9,33,60,55.0,27,32,3,29,22,78,38,0
468,Alex Cantero,6.8,6,4,2,3,1,1,8,12.5,7,2,0,2,1,7,0,0
469,Todd Cantwell,4.9,15,13,8,6,1,6,17,35.3,11,2,0,2,3,18,2,0
471,Pierrick Capelle,13.3,36,24,16,17,3,18,52,34.6,34,12,1,11,16,52,20,0
472,Leonardo Capezzi,1.9,3,1,0,3,0,1,4,25.0,3,8,4,4,0,3,2,0
473,Etienne Capoue,25.4,44,26,18,23,3,15,28,53.6,13,17,5,12,35,79,51,0
474,Gianluca Caprari,30.4,43,25,10,22,11,17,51,33.3,34,32,0,32,4,47,7,0
475,Francesco Caputo,31.0,5,2,1,3,1,1,6,16.7,5,5,0,5,2,7,10,0
477,Maxence Caqueret,25.9,73,40,29,36,8,30,80,37.5,50,38,10,28,43,116,26,2
478,Andrea Carboni,24.6,53,24,33,16,4,19,42,45.2,23,42,15,27,27,80,87,0
479,Isaac Carcelen,17.2,43,29,29,12,2,28,56,50.0,28,25,6,19,34,77,42,0
480,Cardenas,24.0,1,1,1,0,0,0,3,0.0,3,0,0,0,1,2,19,0
481,Irvin Cardona,14.8,13,7,5,4,4,3,16,18.8,13,10,0,10,5,18,17,0
482,Igor Carioca,17.5,27,16,16,8,3,15,43,34.9,28,17,2,15,25,52,28,0
484,Diego Carlos,32.9,35,24,20,13,2,16,24,66.7,8,48,33,15,24,59,120,5
486,Yannick Carrasco,28.7,34,19,16,12,6,19,44,43.2,25,26,5,21,19,53,12,2
487,Guido Carrillo,13.0,7,4,2,4,1,3,13,23.1,10,9,2,7,1,8,27,0
488,Dani Carvajal,17.2,43,28,21,15,7,15,26,57.7,11,22,8,14,20,63,38,2
489,William Carvalho,20.1,49,33,20,25,4,15,40,37.5,25,18,7,11,16,65,20,0
490,Nicolo Casale,28.7,46,30,25,19,2,21,37,56.8,16,31,12,19,49,95,95,0
491,Casemiro,28.5,79,51,45,30,4,30,67,44.8,37,65,19,46,38,117,65,3
492,Matty Cash,37.5,89,50,52,34,3,47,78,60.3,31,54,16,38,49,138,100,2
494,Kiko Casilla,14.0,0,0,0,0,0,0,1,0.0,1,0,0,0,1,1,2,2
495,Moreto Cassama,8.9,12,6,7,4,1,3,19,15.8,16,10,5,5,9,21,5,0
497,Timothy Castagne,23.6,67,31,38,22,7,27,43,62.8,16,28,9,19,29,96,54,1
498,Koen Casteels,28.0,0,0,0,0,0,0,1,0.0,1,0,0,0,0,0,9,2
499,Jean-Charles Castelletto,27.9,45,24,27,17,1,25,35,71.4,10,38,27,11,30,75,73,0
500,Samu Castillejo,1.4,4,2,0,2,2,1,8,12.5,7,4,1,3,2,6,1,0
501,Gonzalo Castro,4.8,8,3,4,4,0,1,5,20.0,4,3,0,3,3,11,3,0
502,Jonny Castro,11.4,25,15,13,11,1,11,20,55.0,9,14,3,11,13,38,11,0
503,Gaetano Castrovilli,15.5,25,17,15,6,4,12,23,52.2,11,18,4,14,11,36,6,0
504,Danilo Cataldi,19.0,36,17,15,17,4,12,38,31.6,26,24,12,12,17,53,19,1
505,Catena,36.0,39,23,24,15,0,25,42,59.5,17,26,19,7,30,69,168,3
506,Craig Cathcart,26.6,32,15,25,6,1,16,30,53.3,14,39,29,10,28,60,132,3
507,Edinson Cavani,8.5,4,1,0,3,1,2,8,25.0,6,6,0,6,2,6,8,0
508,Dani Ceballos,3.1,7,5,4,3,0,1,5,20.0,4,8,2,6,4,11,2,0
509,Pietro Ceccaroni,34.7,55,31,33,18,4,25,36,69.4,11,45,32,13,30,85,143,0
510,Federico Ceccherini,26.2,32,16,19,10,3,19,33,57.6,14,13,8,5,50,82,76,1
511,Emil Ceide,0.6,1,1,0,1,0,1,2,50.0,1,1,0,1,0,1,0,0
512,Zeki Celik,30.0,64,37,43,17,4,36,63,57.1,27,32,9,23,43,107,62,2
513,Fabien Centonze,17.6,33,21,22,9,2,13,32,40.6,19,37,8,29,32,65,51,0
514,Luca Ceppitelli,16.1,23,12,13,10,0,16,27,59.3,11,21,14,7,25,48,54,0
515,Franco Cervi,20.0,73,41,35,22,16,33,77,42.9,44,38,2,36,21,94,19,0
517,Julian Chabot,5.4,12,10,8,4,0,8,10,80.0,2,7,4,3,9,21,28,1
518,Julian Chabot,2.3,8,3,4,4,0,2,5,40.0,3,4,2,2,3,11,5,1
521,Nassim Chadli,1.1,5,3,3,0,2,2,4,50.0,2,1,0,1,0,5,0,0
523,Mehdi Chahiri,0.2,1,1,1,0,0,1,1,100.0,0,0,0,0,0,1,0,0
524,Trevoh Chalobah,16.1,40,27,22,18,0,24,31,77.4,7,16,6,10,19,59,43,2
525,Calum Chambers,1.9,5,3,3,1,1,3,4,75.0,1,6,3,3,0,5,10,0
526,Calum Chambers,9.2,16,8,10,6,0,4,6,66.7,2,14,8,6,5,21,42,0
527,Dylan Chambost,8.4,16,11,6,9,1,4,25,16.0,21,9,2,7,8,24,4,0
528,Timothy Chandler,13.5,18,12,10,8,0,11,24,45.8,13,10,3,7,19,37,28,1
529,Chapela,4.4,4,2,1,0,3,2,4,50.0,2,6,1,5,4,8,5,0
530,Brendan Chardonnet,29.8,44,25,32,11,1,29,40,72.5,11,42,29,13,55,99,141,0
531,Xavier Chavalerin,30.2,49,26,19,25,5,12,55,21.8,43,32,5,27,39,88,36,0
532,Xavier Chavalerin,2.4,4,4,2,1,1,1,3,33.3,2,2,0,2,5,9,2,1
533,Justin Che,0.5,2,0,1,0,1,1,2,50.0,1,0,0,0,1,3,0,0
534,Chema,0.5,0,0,0,0,0,0,1,0.0,1,0,0,0,0,0,0,0
535,Rayan Cherki,4.9,6,2,1,3,2,4,9,44.4,5,2,0,2,1,7,0,0
536,Denis Cheryshev,6.3,14,5,6,1,7,6,15,40.0,9,9,1,8,9,23,9,0
538,Giorgio Chiellini,15.0,22,13,17,4,1,7,13,53.8,6,24,18,6,22,44,59,0
539,Federico Chiesa,9.6,26,19,9,9,8,12,26,46.2,14,7,0,7,4,30,3,0
540,Ben Chilwell,6.0,8,3,2,6,0,2,5,40.0,3,7,0,7,4,12,14,1
541,Chiquinho,2.3,9,6,4,5,0,4,5,80.0,1,5,0,5,2,11,1,0
542,Vlad Chiriches,25.6,28,15,19,9,0,10,21,47.6,11,34,21,13,41,69,71,4
543,Pedro Chirivella,29.3,49,31,14,26,9,25,70,35.7,45,23,2,21,37,86,11,0
544,Joris Chotard,32.6,59,30,33,23,3,36,78,46.2,42,27,15,12,42,101,56,0
546,Hamza Choudhury,3.2,9,3,4,4,1,3,5,60.0,2,0,0,0,12,21,10,0
547,Andreas Christensen,16.6,14,8,9,4,1,4,7,57.1,3,14,6,8,29,43,57,1
548,Max Christiansen,22.8,46,25,19,22,5,18,43,41.9,25,52,16,36,68,114,56,0
549,Carney Chukwuemeka,3.3,7,1,2,5,0,3,5,60.0,2,3,0,3,1,8,2,1
550,Samuel Chukwueze,14.8,13,9,6,5,2,3,6,50.0,3,7,0,7,5,18,4,0
551,Victor Chust,20.3,19,10,14,4,1,11,17,64.7,6,20,8,12,16,35,87,0
552,Riccardo Ciervo,2.5,8,3,4,3,1,2,6,33.3,4,1,0,1,2,10,2,0
553,Jasper Cillessen,16.2,0,0,0,0,0,0,1,0.0,1,0,0,0,1,1,6,0
554,Pathe Ciss,12.2,31,15,20,8,3,12,26,46.2,14,16,6,10,30,61,27,0
555,Moustapha Cisse,0.4,1,0,0,1,0,0,3,0.0,3,0,0,0,0,1,0,0
557,Ciaran Clark,11.3,13,10,4,7,2,9,14,64.3,5,14,11,3,13,26,43,1
558,Alexis Claude-Maurice,2.3,2,0,1,0,1,1,4,25.0,3,7,0,7,3,5,1,0
559,Jonathan Clauss,33.8,63,34,33,20,10,22,55,40.0,33,43,1,42,73,136,51,0
560,Carlos Clerc,16.8,35,17,21,10,4,7,19,36.8,12,8,3,5,26,61,32,1
561,Tom Cleverley,18.0,37,20,19,17,1,18,33,54.5,15,23,6,17,18,55,19,3
562,Nathaniel Clyne,15.0,21,10,11,9,1,10,20,50.0,10,7,2,5,15,36,32,0
563,Conor Coady,37.3,31,14,23,7,1,16,28,57.1,12,46,40,6,28,59,140,0
564,Marcus Coco,10.3,34,14,17,11,6,8,18,44.4,10,11,1,10,10,44,15,0
565,Coke,1.3,3,2,1,1,1,3,4,75.0,1,1,0,1,2,5,7,0
566,Seamus Coleman,29.5,61,36,35,16,10,33,51,64.7,18,30,11,19,32,93,80,2
567,Alex Collado,11.3,27,12,6,16,5,12,31,38.7,19,28,2,26,6,33,11,0
568,Ebrima Colley,4.4,6,1,3,2,1,1,7,14.3,6,8,0,8,3,9,2,0
569,Omar Colley,30.5,47,36,32,14,1,22,32,68.8,10,31,19,12,80,127,135,2
570,Nathan Collins,18.6,37,15,27,8,2,17,27,63.0,10,38,25,13,24,61,83,2
572,Kingsley Coman,15.1,14,8,1,9,4,5,16,31.3,11,14,0,14,8,22,5,0
573,Eray Comert,4.5,5,3,4,1,0,3,6,50.0,3,3,2,1,2,7,6,0
574,Santi Comesana,29.8,87,56,45,33,9,40,104,38.5,64,46,6,40,33,120,30,0
576,Aaron Connolly,1.7,0,0,0,0,0,0,1,0.0,1,2,0,2,0,0,0,0
577,Andrea Consigli,36.9,0,0,0,0,0,0,2,0.0,2,0,0,0,0,0,23,3
578,Abdu Conte,15.0,22,12,16,5,1,12,24,50.0,12,12,2,10,4,26,10,0
579,Andrea Conti,2.6,4,2,2,1,1,3,6,50.0,3,4,0,4,7,11,4,0
581,Liam Cooper,20.2,41,23,27,13,1,23,33,69.7,10,29,18,11,43,84,72,2
582,Lucas Copado,0.2,1,0,1,0,0,1,1,100.0,0,0,0,0,0,1,0,0
583,Diego Coppola,2.8,8,4,4,4,0,3,3,100.0,0,5,1,4,4,12,5,0
584,Francis Coquelin,9.2,26,17,9,11,6,11,20,55.0,9,15,5,10,19,45,11,0
585,Sebastien Corchia,14.7,33,20,17,11,5,24,42,57.1,18,24,3,21,13,46,36,0
586,Sergio Cordova,3.6,4,3,2,2,0,1,2,50.0,1,4,0,4,0,4,4,0
587,Jack Cork,18.6,20,6,6,11,3,7,20,35.0,13,17,4,13,17,37,29,1
588,Maxwel Cornet,19.6,16,9,7,5,4,7,15,46.7,8,13,4,9,10,26,14,0
589,Maxwel Cornet,0.7,3,1,1,0,2,3,4,75.0,1,0,0,0,1,4,1,0
590,Jesus Corona,12.9,12,7,7,5,0,3,6,50.0,3,4,0,4,8,20,6,0
591,Angel Correa,20.6,16,8,5,10,1,7,29,24.1,22,25,2,23,10,26,4,0
592,Joaquin Correa,11.4,11,5,2,6,3,1,13,7.7,12,8,1,7,3,14,2,0
593,Thierry Correia,15.7,35,23,26,6,3,14,29,48.3,15,20,5,15,19,54,27,0
594,Danny da Costa,8.1,15,4,6,7,2,6,18,33.3,12,14,1,13,11,26,18,1
595,David Pereira da Costa,16.3,22,12,9,6,7,11,26,42.3,15,12,0,12,13,35,5,0
598,Helder Costa,12.4,27,16,11,9,7,14,41,34.1,27,12,1,11,3,30,9,0
599,Jaume Costa,20.3,35,26,23,7,5,23,31,74.2,8,22,7,15,23,58,55,0
600,Benoit Costil,25.0,1,0,1,0,0,1,2,50.0,1,0,0,0,0,1,6,3
601,Vladimir Coufal,24.5,45,25,24,14,7,18,36,50.0,18,31,9,22,22,67,64,1
602,Kalifa Coulibaly,9.4,5,1,1,1,3,0,4,0.0,4,2,2,0,0,5,11,0
603,Lassana Coulibaly,25.9,58,32,29,26,3,24,62,38.7,38,40,13,27,22,80,27,0
604,Mamadou Coulibaly,9.0,15,12,8,5,2,7,20,35.0,13,9,0,9,11,26,9,0
605,Tanguy Coulibaly,12.0,27,15,14,11,2,9,19,47.4,10,14,2,12,4,31,10,0
606,Thibaut Courtois,36.0,1,0,1,0,0,1,2,50.0,1,0,0,0,0,1,9,1
607,Philippe Coutinho,14.8,17,12,4,11,2,6,21,28.6,15,11,1,10,7,24,4,0
608,Philippe Coutinho,5.6,6,3,3,3,0,3,11,27.3,8,3,0,3,4,10,3,0
609,Nicolas Cozza,30.8,80,47,50,23,7,35,65,53.8,30,35,19,16,38,118,82,1
610,Alessio Cragno,35.0,3,3,2,1,0,3,3,100.0,0,0,0,0,1,4,14,1
611,Aaron Cresswell,30.3,28,18,18,6,4,13,25,52.0,12,31,18,13,35,63,66,0
612,Charlie Cresswell,1.6,5,2,1,4,0,3,3,100.0,0,1,1,0,2,7,6,0
613,Domenico Criscito,18.0,37,21,19,14,4,16,25,64.0,9,22,12,10,39,76,57,0
614,Bryan Cristante,29.8,79,39,31,39,9,37,69,53.6,32,31,5,26,40,119,45,0
617,Domen Crnigoj,20.9,21,13,7,11,3,11,29,37.9,18,27,8,19,24,45,42,0
618,Giovanni Crociata,0.2,0,0,0,0,0,0,1,0.0,1,0,0,0,0,0,0,0
619,Juan Cruz Armada,21.5,28,21,15,12,1,8,16,50.0,8,15,12,3,16,44,58,1
620,Juan Cuadrado,27.6,48,23,30,13,5,30,55,54.5,25,23,5,18,29,77,34,0
621,Cucho,12.7,13,5,5,5,3,5,27,18.5,22,13,1,12,5,18,9,0
622,Marc Cucurella,34.3,93,62,43,32,18,44,71,62.0,27,42,14,28,30,123,74,0
625,Jorge Cuenca,29.8,46,32,30,15,1,21,28,75.0,7,29,14,15,39,85,155,0
626,Mickael Cuisance,10.2,23,9,7,12,4,10,28,35.7,18,14,0,14,12,35,5,0
628,Luke Cundle,2.0,4,3,0,4,0,1,1,100.0,0,0,0,0,1,5,1,0
629,Matheus Cunha,11.8,19,12,3,11,5,5,20,25.0,15,18,2,16,6,25,9,0
631,Patrick Cutrone,15.6,5,2,0,3,2,1,9,11.1,8,11,1,10,5,10,1,0
632,Wylan Cyprien,16.6,33,17,12,18,3,13,32,40.6,19,16,6,10,10,43,14,2
633,Rafael Czichos,15.6,29,18,18,9,2,14,28,50.0,14,23,13,10,19,48,53,2
634,Lennart-Marten Czyborra,1.5,0,0,0,0,0,0,2,0.0,2,0,0,0,3,3,3,1
635,Danilo D'Ambrosio,11.1,30,15,21,8,1,11,22,50.0,11,21,10,11,8,38,20,0
636,Lucas Da Cunha,4.4,13,7,2,7,4,6,11,54.5,5,2,0,2,1,14,2,0
637,Lucas Da Cunha,9.3,17,11,5,8,4,9,18,50.0,9,13,0,13,1,18,3,0
638,Damien Da Silva,12.5,13,9,7,5,1,5,9,55.6,4,15,10,5,22,35,53,1
639,Moanes Dabbur,14.6,18,10,3,5,10,4,17,23.5,13,10,0,10,5,23,4,0
640,Colin Dagba,1.8,4,2,2,2,0,3,6,50.0,3,4,2,2,2,6,1,0
642,Mahmoud Dahoud,18.4,42,19,10,24,8,20,46,43.5,26,18,3,15,17,59,16,0
643,Patson Daka,12.9,15,10,2,8,5,2,19,10.5,17,7,0,7,2,17,8,0
644,Stuart Dallas,32.4,93,55,58,31,4,56,105,53.3,49,45,14,31,57,150,63,2
645,Diogo Dalot,20.0,55,41,35,12,8,31,57,54.4,26,24,13,11,29,84,59,0
646,Mikkel Damsgaard,6.4,27,13,12,11,4,20,36,55.6,16,16,1,15,7,34,7,0
647,Flavius Daniliuc,14.4,46,31,26,17,3,34,43,79.1,9,13,7,6,14,60,34,1
648,Danilo,21.0,37,26,20,13,4,18,28,64.3,10,21,12,9,32,69,53,1
650,Arnaut Danjuma,16.4,7,6,3,0,4,2,4,50.0,2,5,0,5,2,9,3,0
651,Kevin Danso,31.0,41,29,29,12,0,23,34,67.6,11,38,25,13,40,81,111,0
652,Dante,31.9,42,29,30,12,0,23,33,69.7,10,43,27,16,49,91,96,1
654,Marton Dardai,8.4,10,4,8,2,0,8,18,44.4,10,16,6,10,20,30,33,2
655,Sergi Darder,34.7,45,22,16,19,10,18,54,33.3,36,16,1,15,26,71,32,1
656,Vladimir Darida,19.8,32,18,15,13,4,13,32,40.6,19,22,3,19,20,52,17,2
658,Matteo Darmian,16.7,32,16,17,9,6,16,41,39.0,25,16,1,15,19,51,25,0
659,Josh Dasilva,2.9,2,1,0,1,1,1,2,50.0,1,3,0,3,1,3,7,0
660,Jonathan David,31.2,24,9,7,11,6,9,30,30.0,21,14,4,10,5,29,15,0
661,Alphonso Davies,19.3,34,17,17,8,9,13,31,41.9,18,27,1,26,23,57,26,1
662,Ben Davies,28.2,36,21,20,12,4,13,26,50.0,13,32,19,13,30,66,75,1
663,Tom Davies,2.6,3,1,1,1,1,2,5,40.0,3,2,1,1,2,5,9,0
665,Pawel Dawidowicz,13.3,30,18,16,10,4,16,25,64.0,9,14,11,3,21,51,53,0
666,Craig Dawson,30.6,29,17,20,8,1,14,25,56.0,11,59,52,7,29,58,139,0
667,Kevin De Bruyne,24.5,32,16,4,15,13,12,37,32.4,25,32,2,30,6,38,16,0
668,Konrad De La Fuente,8.7,11,7,8,2,1,7,11,63.6,4,5,0,5,2,13,4,0
669,Sebastien De Maio,2.0,5,1,4,1,0,1,9,11.1,8,6,5,1,1,6,9,0
671,Rodrigo De Paul,23.9,55,30,22,25,8,30,60,50.0,30,24,3,21,21,76,17,2
672,Mattia De Sciglio,13.0,24,12,7,9,8,11,24,45.8,13,10,0,10,10,34,30,0
673,Lorenzo De Silvestri,25.5,23,14,13,8,2,9,31,29.0,22,25,7,18,26,49,52,0
676,Troy Deeney,0.3,0,0,0,0,0,0,1,0.0,1,0,0,0,0,0,2,0
677,Gregoire Defrel,15.1,15,9,4,8,3,6,16,37.5,10,11,1,10,4,19,11,0
678,Alessandro Deiola,23.7,47,22,15,25,7,23,58,39.7,35,28,10,18,26,73,45,0
679,Romain Del Castillo,0.3,2,1,0,1,1,2,2,100.0,0,0,0,0,1,3,0,0
680,Romain Del Castillo,10.8,27,16,3,17,7,12,31,38.7,19,12,0,12,7,34,3,0
681,Thomas Delaine,25.7,48,35,34,12,2,22,42,52.4,20,20,7,13,27,75,31,0
682,Thomas Delaney,17.2,41,24,17,21,3,16,30,53.3,14,19,10,9,13,54,35,0
685,Sacha Delaye,2.9,8,6,3,2,3,2,8,25.0,6,1,0,1,1,9,1,1
686,Filippo Delli Carri,3.7,6,4,4,2,0,5,14,35.7,9,6,2,4,4,10,14,0
687,Andy Delort,27.2,15,9,3,5,7,7,12,58.3,5,13,4,9,9,24,14,0
688,Andy Delort,3.0,2,0,0,1,1,0,1,0.0,1,1,0,1,0,2,4,0
689,Fabian Delph,7.4,18,15,10,7,1,8,21,38.1,13,12,5,7,14,32,10,0
690,Moussa Dembele,24.5,18,9,5,5,8,6,15,40.0,9,13,0,13,8,26,30,1
691,Ousmane Dembele,15.7,24,16,6,10,8,7,23,30.4,16,8,0,8,8,32,3,0
692,Yusuf Demir,2.1,3,1,1,1,1,2,5,40.0,3,1,0,1,2,5,1,0
693,Merih Demiral,21.3,31,17,18,12,1,15,28,53.6,13,26,14,12,58,89,68,1
694,Kerem Demirbay,22.8,52,31,19,30,3,16,41,39.0,25,32,9,23,33,85,21,0
695,Ermedin Demirovic,9.7,12,6,4,4,4,1,10,10.0,9,14,1,13,1,13,7,0
696,Diego Demme,7.7,21,12,4,13,4,10,21,47.6,11,11,2,9,9,30,2,0
697,Jason Denayer,11.1,11,4,8,3,0,6,7,85.7,1,8,7,1,16,27,52,0
698,Leander Dendoncker,21.7,42,17,25,14,3,22,50,44.0,28,37,10,27,9,51,38,1
699,Emmanuel Dennis,28.7,51,35,20,22,9,17,52,32.7,35,36,2,34,15,66,13,0
700,Fabio Depaoli,7.8,12,7,6,4,2,1,7,14.3,6,9,2,7,8,20,14,0
702,Fabio Depaoli,1.2,3,1,1,2,0,0,2,0.0,2,2,1,1,1,4,2,0
704,Arthur Desmas,14.5,0,0,0,0,0,0,3,0.0,3,0,0,0,0,0,1,3
705,Sergino Dest,16.8,32,15,21,10,1,13,18,72.2,5,22,4,18,2,34,18,0
706,Mattia Destro,19.4,9,4,1,4,4,1,6,16.7,5,14,1,13,2,11,16,0
707,Gerard Deulofeu,29.1,11,6,2,3,6,7,29,24.1,22,14,0,14,9,20,4,0
708,Kiernan Dewsbury-Hall,23.4,39,24,20,14,5,19,40,47.5,21,37,8,29,21,60,26,1
709,Jacopo Dezi,0.2,0,0,0,0,0,0,1,0.0,1,0,0,0,1,1,0,0
711,Federico Di Francesco,15.2,16,5,2,8,6,9,23,39.1,14,17,1,16,9,25,11,0
712,Giovanni Di Lorenzo,31.9,58,36,30,20,8,33,58,56.9,25,28,10,18,38,96,46,1
713,Angel Di Maria,18.3,29,18,6,13,10,14,37,37.8,23,17,0,17,6,35,3,0
715,Francesco Di Tacchio,13.9,17,7,5,10,2,9,25,36.0,16,16,8,8,22,39,25,0
716,Boulaye Dia,14.1,8,6,3,4,1,2,5,40.0,3,6,1,5,5,13,4,0
717,Moussa Diaby,30.7,20,11,8,9,3,5,38,13.2,33,11,0,11,8,28,2,0
718,Yadaly Diaby,0.7,0,0,0,0,0,0,1,0.0,1,0,0,0,2,2,2,0
719,Mouctar Diakhaby,21.6,35,24,18,15,2,13,23,56.5,10,29,17,12,30,65,87,3
720,Ibrahim Diakite,0.0,0,0,0,0,0,0,1,0.0,1,0,0,0,0,0,0,0
721,Abdou Diallo,9.7,22,14,10,9,3,8,14,57.1,6,6,2,4,10,32,19,1
722,Habib Diallo,17.1,9,5,0,8,1,0,8,0.0,8,13,4,9,4,13,11,0
723,Ibrahima Diallo,11.4,22,11,10,9,3,10,24,41.7,14,7,0,7,9,31,10,0
724,Mouhamadou Diarra,1.2,2,1,1,1,0,1,1,100.0,0,0,0,0,0,2,0,0
725,Stephane Diarra,5.8,11,9,7,3,1,5,10,50.0,5,4,0,4,7,18,1,0
726,Ruben Dias,26.7,26,19,11,12,3,8,15,53.3,7,19,13,6,23,49,66,0
728,Krepin Diatta,3.2,3,2,1,0,2,1,3,33.3,2,2,0,2,1,4,0,0
729,Amadou Diawara,1.9,7,2,5,2,0,1,3,33.3,2,2,0,2,0,7,1,0
730,Brahim Diaz,20.6,23,17,3,11,9,8,22,36.4,14,11,0,11,8,31,4,0
732,Luis Diaz,10.6,9,7,3,5,1,2,8,25.0,6,7,0,7,4,13,2,0
733,Victor Diaz,16.7,23,15,14,9,0,12,25,48.0,13,19,11,8,17,40,71,1
734,Daniel Didavi,3.1,6,2,0,4,2,4,7,57.1,3,4,1,3,1,7,1,0
735,Bamba Dieng,10.8,17,11,5,5,7,4,14,28.6,10,7,0,7,5,22,8,0
736,Eric Dier,34.1,15,9,6,8,1,7,14,50.0,7,37,32,5,27,42,142,1
737,Elhadji Dieye,0.4,3,2,2,1,0,0,1,0.0,1,2,0,2,1,4,0,0
738,Lucas Digne,14.1,13,10,8,3,2,9,19,47.4,10,15,8,7,23,36,40,0
739,Lucas Digne,13.0,33,19,26,4,3,21,28,75.0,7,16,5,11,14,47,30,0
740,Mitchell Dijks,7.7,15,6,6,6,3,5,12,41.7,7,11,2,9,3,18,10,1
741,Javairo Dilrosun,19.2,13,4,2,8,3,7,24,29.2,17,14,1,13,11,24,5,0
742,Javairo Dilrosun,1.5,3,1,1,2,0,1,1,100.0,0,1,0,1,0,3,0,0
743,Federico Dimarco,15.9,28,15,10,15,3,13,24,54.2,11,6,1,5,19,47,19,0
744,Landry Dimata,6.0,2,2,1,1,0,1,4,25.0,3,0,0,0,1,3,7,0
746,Junior Dina Ebimbe,3.5,9,4,3,4,2,2,3,66.7,1,5,3,2,2,11,1,0
747,Tristan Dingome,12.0,23,11,10,12,1,10,18,55.6,8,7,1,6,9,32,3,0
748,Sinaly Diomande,6.4,6,3,4,2,0,5,6,83.3,1,6,6,0,12,18,26,0
749,Issa Diop,10.7,10,8,5,5,0,4,11,36.4,7,14,13,1,7,17,44,0
750,Sofiane Diop,21.6,38,20,12,19,7,15,47,31.9,32,10,0,10,23,61,4,0
751,Andy Diouf,0.2,1,1,1,0,0,1,1,100.0,0,1,0,1,0,1,0,0
752,Assane Diousse,0.3,1,1,1,0,0,1,1,100.0,0,0,0,0,0,1,0,0
754,Axel Disasi,30.2,42,27,20,21,1,23,39,59.0,16,40,30,10,26,68,75,0
757,Tiago Djalo,25.9,60,39,39,19,2,26,39,66.7,13,26,10,16,24,84,71,0
758,Djene,34.6,44,26,24,16,4,23,34,67.6,11,24,5,19,59,103,109,2
759,Moussa Djenepo,5.1,9,3,3,5,1,3,11,27.3,8,6,1,5,2,11,6,1
760,Koffi Djidji,19.3,48,29,21,23,4,14,18,77.8,4,20,9,11,34,82,60,0
761,Alexander Djiku,29.9,50,37,33,13,4,18,35,51.4,17,30,13,17,61,111,90,2
762,Bryan Djile Nokoue,0.6,3,3,1,2,0,2,2,100.0,0,1,0,1,1,4,2,0
763,Berat Djimsiti,25.1,43,24,21,20,2,29,46,63.0,17,21,11,10,31,74,56,0
765,Nais Djouahra,2.4,7,3,2,2,3,4,8,50.0,4,3,0,3,2,9,2,0
767,Lewis Dobbin,0.4,2,1,0,1,1,1,2,50.0,1,0,0,0,0,2,0,0
768,Matt Doherty,9.7,18,12,5,11,2,8,14,57.1,6,11,2,9,13,31,20,0
769,Jeremy Doku,5.2,10,5,3,5,2,3,6,50.0,3,4,0,4,3,13,0,0
770,Kasper Dolberg,16.6,9,4,4,3,2,3,9,33.3,6,15,1,14,6,15,17,0
772,Brandon Domingues,2.6,6,2,2,4,0,2,3,66.7,1,3,0,3,3,9,0,0
773,Carlos Dominguez,3.8,4,1,4,0,0,4,6,66.7,2,2,1,1,4,8,21,0
775,Nicolas Dominguez,22.4,76,45,36,32,8,32,76,42.1,44,38,9,29,32,108,34,1
776,John Donald,2.0,7,4,4,2,1,5,8,62.5,3,5,3,2,3,10,3,0
777,Lee Dongjun,1.3,2,1,0,2,0,1,3,33.3,2,2,0,2,2,4,1,0
778,Anastasios Donis,4.1,8,7,4,2,2,2,6,33.3,4,3,0,3,0,8,1,0
781,Niklas Dorsch,25.8,76,47,47,23,6,30,60,50.0,30,34,12,22,35,111,36,3
782,Gabriel Dos Santos,34.0,50,30,36,12,2,30,41,73.2,11,34,26,8,13,63,112,4
783,Jodel Dossou,22.3,36,17,15,14,7,15,43,34.9,28,14,0,14,5,41,7,0
785,Abdoulaye Doucoure,28.2,75,43,30,37,8,32,71,45.1,39,33,8,25,28,103,32,0
786,Cheick Doucoure,32.7,75,43,34,34,7,35,79,44.3,44,30,7,23,68,143,24,0
787,Fode Doucoure,1.7,12,9,9,3,0,9,11,81.8,2,1,0,1,4,16,6,0
789,Kamory Doumbia,3.9,8,2,2,5,1,5,13,38.5,8,9,3,6,3,11,3,0
790,Moussa Doumbia,1.0,0,0,0,0,0,0,1,0.0,1,0,0,0,0,0,0,0
791,Souleyman Doumbia,24.7,30,20,16,9,5,13,27,48.1,14,25,4,21,39,69,51,0
792,Kieran Dowell,10.1,18,7,8,7,3,9,32,28.1,23,10,1,9,7,25,4,0
794,Radu Dragusin,6.9,4,3,2,2,0,2,6,33.3,4,8,4,4,10,14,33,0
795,Radu Dragusin,5.4,5,4,2,3,0,4,10,40.0,6,7,3,4,13,18,17,0
796,Cody Drameh,1.4,4,2,3,1,0,1,3,33.3,2,0,0,0,1,5,4,0
797,Julian Draxler,6.1,3,2,0,3,0,0,4,0.0,4,3,0,3,5,8,3,0
798,Matthieu Dreyer,16.0,1,1,1,0,0,1,1,100.0,0,0,0,0,0,1,9,0
799,Domingos Duarte,18.7,18,14,9,9,0,6,11,54.5,5,27,20,7,22,40,82,0
800,Oscar Duarte,19.7,18,8,12,6,0,8,23,34.8,15,18,9,9,24,42,102,0
801,Ruben Duarte,29.1,76,47,43,27,6,43,85,50.6,42,40,6,34,57,133,82,0
802,Leo Dubois,19.4,43,27,22,14,7,27,46,58.7,19,27,3,24,22,65,35,1
803,Martin Dubravka,26.0,1,1,1,0,0,0,1,0.0,1,0,0,0,0,1,8,2
804,Ondrej Duda,17.9,23,16,4,12,7,6,23,26.1,17,14,2,12,17,40,9,0
806,Jeremy Dudziak,12.6,17,6,5,8,4,3,14,21.4,11,8,0,8,10,27,4,0
807,Shane Duffy,16.0,15,12,12,3,0,8,14,57.1,6,24,18,6,16,31,76,1
809,Denzel Dumfries,22.5,32,12,9,14,9,16,32,50.0,16,15,6,9,9,41,26,0
810,Paul Dummett,2.2,7,3,3,4,0,5,8,62.5,3,5,0,5,3,10,5,0
811,Alfred Duncan,21.5,34,19,13,16,5,11,32,34.4,21,32,3,29,10,44,7,0
812,Lewis Dunk,28.6,10,8,5,5,0,5,11,45.5,6,32,28,4,27,37,113,3
813,Erik Durm,5.3,13,7,6,5,2,10,13,76.9,3,8,1,7,10,23,7,0
815,Hugo Duro,20.4,25,19,11,13,1,15,38,39.5,23,24,2,22,4,29,20,1
816,Jean-Kevin Duverne,33.4,71,44,43,21,7,42,90,46.7,48,40,5,35,53,124,92,0
817,Paulo Dybala,22.9,30,13,7,14,9,8,35,22.9,27,19,0,19,9,39,4,3
818,Edin Dzeko,27.4,14,8,7,4,3,8,25,32.0,17,22,5,17,4,18,35,0
819,Enzo Ebosse,21.0,25,14,19,6,0,11,19,57.9,8,19,9,10,15,40,42,0
820,Tyronne Ebuehi,12.6,28,12,16,8,4,10,18,55.6,8,13,3,10,16,44,38,1
821,Ederson,37.0,2,1,2,0,0,0,2,0.0,2,0,0,0,0,2,12,0
822,Ederson,12.7,29,18,11,14,4,14,26,53.8,12,11,2,9,19,48,8,0
823,Odsonne Edouard,17.4,16,10,2,7,7,7,21,33.3,14,20,5,15,0,16,18,0
824,CJ Egan-Riley,0.0,1,1,1,0,0,1,1,100.0,0,0,0,0,0,1,0,0
825,Maximilian Eggestein,24.4,48,28,17,25,6,22,50,44.0,28,35,11,24,30,78,32,1
827,Kingsley Ehizibue,7.6,32,18,27,5,0,15,24,62.5,9,13,4,9,9,41,26,0
828,Julian Eitschberger,0.5,0,0,0,0,0,0,1,0.0,1,1,1,0,2,2,2,0
829,Albin Ekdal,18.2,43,28,17,21,5,26,56,46.4,30,27,7,20,29,72,25,0
830,Hugo Ekitike,14.1,18,10,8,6,4,4,11,36.4,7,9,2,7,6,24,15,0
832,Jurgen Ekkelenkamp,8.0,8,3,2,6,0,2,7,28.6,5,9,2,7,4,12,5,0
833,Caleb Ekuban,19.1,19,12,2,12,5,7,23,30.4,16,19,5,14,9,28,6,0
834,Anthony Elanga,13.5,26,20,12,12,2,15,29,51.7,14,17,1,16,9,35,7,0
835,Alberth Elis,15.7,19,10,5,5,9,11,25,44.0,14,9,0,9,7,26,10,0
836,Harvey Elliott,3.8,3,0,1,1,1,0,6,0.0,6,8,1,7,4,7,2,0
837,Elif Elmas,18.0,25,15,10,10,5,12,28,42.9,16,13,2,11,8,33,17,0
838,Mohamed Elneny,9.0,16,8,10,5,1,7,12,58.3,5,7,1,6,14,30,13,0
839,Aritz Elustondo,23.4,21,14,16,5,0,10,20,50.0,10,19,13,6,29,50,86,0
840,Nico Elvedi,27.0,40,24,23,17,0,22,36,61.1,14,33,22,11,34,74,83,1
841,Mohamed Elyounoussi,22.7,36,17,14,15,7,11,39,28.2,28,23,2,21,12,48,28,0
842,Adri Embarba,22.1,44,29,22,15,7,26,69,37.7,43,35,3,32,19,63,30,0
843,Breel Embolo,24.1,16,11,1,12,3,3,8,37.5,5,14,2,12,6,22,7,0
844,Emerson,25.4,72,47,50,16,6,36,67,53.7,31,25,2,23,22,94,92,1
845,Emerson,1.0,3,3,2,1,0,1,2,50.0,1,1,0,1,2,5,1,0
846,Renaud Emond,2.1,1,0,0,1,0,0,4,0.0,4,2,1,1,0,1,1,0
847,Youssef En-Nesyri,14.2,10,5,5,2,3,4,11,36.4,7,9,1,8,4,14,18,0
849,Wataru Endo,32.2,73,41,34,34,5,31,72,43.1,41,43,12,31,30,103,64,0
850,Christian Eriksen,10.4,13,6,4,5,4,8,17,47.1,9,9,1,8,9,22,14,0
851,Martin Erlic,28.6,28,16,18,10,0,10,18,55.6,8,54,39,15,28,56,122,1
852,Gonzalo Escalante,0.1,1,0,1,0,0,1,1,100.0,0,2,1,1,1,2,0,0
853,Gonzalo Escalante,14.4,30,14,9,20,1,13,34,38.2,21,27,2,25,21,51,28,0
854,Aaron Escandell,3.2,0,0,0,0,0,0,1,0.0,1,0,0,0,0,0,4,0
855,Sergio Escudero,15.9,46,24,25,17,4,26,54,48.1,28,18,3,15,26,72,35,0
856,Alfonso Espino,37.0,107,63,58,39,10,44,112,39.3,68,45,10,35,54,161,87,1
858,Michael Esser,3.0,0,0,0,0,0,0,1,0.0,1,0,0,0,0,0,2,0
859,Estanis,0.1,1,1,0,1,0,1,1,100.0,0,0,0,0,0,1,0,0
860,Maxime Esteve,20.6,27,18,22,4,1,15,27,55.6,12,31,24,7,22,49,69,1
861,Pervis Estupinan,17.5,36,22,20,11,5,17,24,70.8,7,13,5,8,25,61,29,2
862,Oghenekaro Etebo,4.5,11,8,7,4,0,3,8,37.5,5,3,1,2,5,16,5,0
863,Jonny Evans,15.0,24,14,14,8,2,14,22,63.6,8,17,13,4,20,44,59,0
864,Eberechi Eze,6.7,10,6,5,2,3,6,11,54.5,5,4,1,3,5,15,1,0
865,Abdessamad Ezzalzouli,6.4,17,9,9,5,3,5,8,62.5,3,3,0,3,9,26,0,0
867,Fabinho,25.7,46,25,17,23,6,24,70,34.3,46,33,10,23,39,85,25,1
868,Fabio,18.5,61,40,31,23,7,36,74,48.6,38,29,7,22,35,96,31,1
869,Cesc Fabregas,0.4,1,0,0,1,0,1,1,100.0,0,0,0,0,1,2,0,0
870,Wout Faes,37.0,40,24,30,9,1,25,33,75.8,8,47,37,10,53,93,169,2
871,Wahid Faghir,1.4,0,0,0,0,0,0,1,0.0,1,2,0,2,0,0,0,0
872,Romain Faivre,9.9,10,4,2,6,2,4,13,30.8,9,4,0,4,3,13,2,0
873,Romain Faivre,19.9,30,18,12,13,5,12,30,40.0,18,11,0,11,13,43,10,0
874,Radamel Falcao,9.3,2,1,0,1,1,1,4,25.0,3,4,1,3,2,4,11,0
877,Fali,20.0,32,19,24,8,0,17,32,53.1,15,26,16,10,24,56,82,0
879,Omar Faraj,0.0,1,0,1,0,0,1,1,100.0,0,0,0,0,0,1,0,0
880,Davide Faraoni,28.6,62,40,38,21,3,29,62,46.8,33,38,5,33,23,85,62,1
881,Mohamed Fares,6.5,4,2,1,3,0,0,4,0.0,4,8,3,5,8,12,11,0
882,Diego Farias,0.7,1,1,0,1,0,1,3,33.3,2,0,0,0,0,1,0,0
885,Omer Faruk Beyaz,0.8,4,3,1,3,0,1,5,20.0,4,0,0,0,2,6,0,0
886,Noah Fatar,0.1,1,0,0,0,1,0,1,0.0,1,0,0,0,1,2,0,0
887,Ansu Fati,3.7,3,2,0,2,1,1,1,100.0,0,4,0,4,1,4,0,0
888,Julien Faussurier,5.4,10,6,3,3,4,6,13,46.2,7,12,1,11,5,15,6,0
890,Federico Fazio,15.9,17,11,10,6,1,9,12,75.0,3,21,16,5,27,44,67,1
891,Aleix Febas,1.3,4,1,0,4,0,2,4,50.0,2,0,0,0,0,4,0,0
892,Adrian Fein,0.4,0,0,0,0,0,0,1,0.0,1,0,0,0,2,2,0,0
893,Nabil Fekir,31.0,43,29,5,25,13,7,36,19.4,29,14,0,14,7,50,7,0
894,Felipe,16.7,20,15,11,8,1,8,18,44.4,10,17,11,6,28,48,77,0
895,Luiz Felipe,27.7,41,23,21,16,4,20,34,58.8,14,40,33,7,33,74,102,1
896,Joao Felix,14.0,5,2,1,4,0,1,5,20.0,4,4,1,3,7,12,8,0
897,Ohis Felix Uduokhai,8.7,9,6,6,3,0,6,11,54.5,5,13,8,5,9,18,33,0
898,Kiko Femenia,23.8,35,22,23,10,2,21,37,56.8,16,24,8,16,37,72,51,0
901,Bruno Fernandes,34.6,54,28,26,22,6,26,91,28.6,65,36,0,36,17,71,42,2
902,Edimilson Fernandes,3.1,2,0,1,1,0,1,4,25.0,3,2,2,0,2,4,6,0
903,Aitor Fernandez,13.0,2,1,2,0,0,2,2,100.0,0,0,0,0,0,2,7,0
904,Alex Fernandez,22.8,47,31,22,17,8,21,61,34.4,40,30,7,23,30,77,31,0
906,Federico Fernandez,5.8,3,0,3,0,0,2,5,40.0,3,10,10,0,4,7,28,0
907,Fernandinho,10.7,21,10,7,10,4,9,27,33.3,18,8,2,6,8,29,13,1
908,Fernando,20.6,24,17,14,9,1,12,33,36.4,21,21,13,8,29,53,32,2
910,Alex Ferrari,18.3,40,22,28,9,3,19,33,57.6,14,31,22,9,39,79,63,1
911,Salvador Ferrer,16.6,32,18,15,9,8,12,25,48.0,13,24,12,12,18,50,46,0
912,Jordan Ferri,32.3,55,35,28,23,4,29,87,33.3,58,21,5,16,30,85,35,0
913,Riccardo Fiamozzi,6.9,7,5,2,2,3,2,4,50.0,2,6,5,1,7,14,12,0
914,Fidel,25.1,44,23,18,17,9,14,57,24.6,43,9,1,8,7,51,20,0
915,Karol Fila,6.2,10,8,5,4,1,4,8,50.0,4,7,2,5,4,14,6,0
916,Alfred Finnbogason,3.2,3,1,0,2,1,2,4,50.0,2,5,1,4,2,5,8,0
917,Luca Fiordilino,7.3,21,13,11,6,4,13,27,48.1,14,14,4,10,11,32,12,0
919,Roberto Firmino,11.0,23,14,5,8,10,3,16,18.8,13,20,0,20,4,27,3,0
920,Junior Firpo,19.0,61,29,30,26,5,31,59,52.5,28,22,6,16,24,85,37,0
921,Mark Flekken,32.0,0,0,0,0,0,0,2,0.0,2,1,0,1,2,2,10,1
922,Ashley Fletcher,0.3,2,1,1,1,0,1,1,100.0,0,1,1,0,0,2,0,0
923,Alexis Flips,11.7,37,21,21,9,7,22,45,48.9,23,21,0,21,24,61,17,0
924,Alessandro Florenzi,12.8,28,14,14,7,7,14,32,43.8,18,9,2,7,27,55,10,1
925,Phil Foden,23.6,16,8,10,4,2,7,17,41.2,10,9,0,9,11,27,5,0
926,Mamadou Fofana,0.4,1,1,0,1,0,1,2,50.0,1,2,1,1,1,2,2,0
927,Seko Fofana,37.3,27,19,11,13,3,12,58,20.7,46,24,2,22,26,53,17,1
928,Wesley Fofana,7.0,12,8,11,1,0,7,11,63.6,4,5,2,3,12,24,26,1
929,Youssouf Fofana,24.3,69,43,19,41,9,29,56,51.8,27,29,7,22,32,101,22,2
930,Thomas Foket,24.8,28,19,12,13,3,18,40,45.0,22,26,4,22,33,61,35,0
931,Thomas Fontaine,1.9,2,0,1,0,1,0,1,0.0,1,3,3,0,2,4,4,0
932,Jose Fontan,3.1,5,3,3,2,0,1,5,20.0,4,3,1,2,10,15,10,0
933,Jose Fonte,38.0,23,12,14,7,2,11,25,44.0,14,39,32,7,44,67,159,1
934,Fernando Forestieri,0.6,0,0,0,0,0,0,1,0.0,1,1,0,1,0,0,1,0
936,Pablo Fornals,31.1,54,28,21,21,12,22,84,26.2,62,49,2,47,27,81,16,1
937,Emil Forsberg,19.0,21,12,2,11,8,7,22,31.8,15,18,0,18,2,23,2,1
938,Adam Forshaw,17.0,53,23,21,27,5,21,54,38.9,33,17,1,16,19,72,12,2
939,Marcus Forss,2.3,3,3,0,2,1,2,4,50.0,2,5,0,5,1,4,0,0
940,Fraser Forster,19.0,1,0,1,0,0,0,1,0.0,1,0,0,0,0,1,23,2
941,Philipp Forster,10.7,20,13,4,12,4,11,26,42.3,15,12,1,11,3,23,2,0
942,Francesco Forte,4.7,3,2,0,2,1,2,5,40.0,3,1,0,1,0,3,2,0
943,Steven Fortes,1.0,2,0,2,0,0,1,2,50.0,1,2,1,1,0,2,4,0
944,Ben Foster,26.0,0,0,0,0,0,0,3,0.0,3,0,0,0,0,0,9,4
946,Timothy Fosu-Mensah,1.6,5,3,3,1,1,4,4,100.0,0,1,0,1,2,7,2,0
947,Dimitri Foulquier,2.0,0,0,0,0,0,0,1,0.0,1,2,1,1,1,1,2,0
948,Dimitri Foulquier,26.0,36,17,17,15,4,21,34,61.8,13,19,3,16,29,65,49,0
949,Juan Foyth,21.4,69,49,35,28,6,35,47,74.5,12,29,7,22,20,89,50,0
950,Gianluca Frabotta,0.2,0,0,0,0,0,0,1,0.0,1,1,0,1,1,1,0,0
951,Raphael Framberger,9.4,26,19,12,10,4,13,27,48.1,14,8,2,6,9,35,25,0
952,Przemyslaw Frankowski,27.2,57,39,22,27,8,36,74,48.6,38,27,0,27,28,85,52,0
953,Enric Franquesa,6.9,5,3,4,0,1,0,1,0.0,1,4,0,4,7,12,11,0
954,Fransergio,14.0,24,10,8,12,4,12,43,27.9,31,18,6,12,23,47,23,0
955,Ryan Fraser,16.3,10,3,5,3,2,5,13,38.5,8,11,1,10,11,21,11,0
956,Davide Frattesi,31.7,46,16,26,18,2,26,52,50.0,26,44,12,32,29,75,62,1
957,Fred,22.5,63,27,32,24,7,22,79,27.8,57,38,11,27,32,95,24,0
958,Ryan Fredericks,3.4,2,2,2,0,0,0,1,0.0,1,2,1,1,4,6,6,0
959,Morten Frendrup,7.7,40,24,19,13,8,13,29,44.8,16,19,2,17,17,57,7,1
960,Remo Freuler,26.3,69,39,22,33,14,30,70,42.9,40,48,8,40,35,104,26,1
962,Marvin Friedrich,6.7,14,8,10,4,0,9,11,81.8,2,5,3,2,5,19,26,0
963,Marvin Friedrich,13.0,17,5,14,3,0,10,16,62.5,6,13,7,6,23,40,47,0
964,Jeremie Frimpong,22.8,32,18,19,12,1,12,23,52.2,11,24,6,18,17,49,40,2
966,Jorge de Frutos,19.6,33,15,14,11,8,10,51,19.6,41,11,1,10,12,45,13,0
967,Leo Fuhr Hjelde,1.7,5,4,3,2,0,3,3,100.0,0,3,3,0,4,9,7,0
968,Chris Fuhrich,19.0,28,16,10,10,8,18,39,46.2,21,31,2,29,8,36,9,0
969,Angelo Fulgini,32.5,35,25,8,18,9,14,44,31.8,30,21,5,16,22,57,5,1
971,Stephan Furstner,0.1,0,0,0,0,0,0,2,0.0,2,0,0,0,0,0,1,0
972,Matteo Gabbia,6.0,4,3,1,3,0,0,4,0.0,4,2,2,0,8,12,12,0
973,Manolo Gabbiadini,12.7,6,4,3,2,1,1,7,14.3,6,5,2,3,3,9,10,0
974,Mijat Gacinovic,1.2,3,3,1,1,1,3,3,100.0,0,1,0,1,1,4,2,0
975,Gianluca Gaetano,0.2,1,1,1,0,0,1,2,50.0,1,0,0,0,2,3,0,0
977,Roberto Gagliardini,7.2,12,6,7,4,1,1,13,7.7,12,14,5,9,9,21,7,0
978,Riccardo Gagliolo,12.6,23,12,16,4,3,16,27,59.3,11,15,8,7,28,51,52,0
979,Javi Galan,36.6,108,66,60,37,11,42,99,42.4,57,48,8,40,45,153,52,0
980,Inigo Ruiz de Galarreta,15.3,40,21,14,21,5,14,30,46.7,16,16,2,14,20,60,21,0
981,Nicolas Galazzi,0.2,2,1,1,0,1,0,1,0.0,1,0,0,0,0,2,0,0
982,Pablo Galdames Millan,11.4,28,12,6,16,6,12,35,34.3,23,16,2,14,8,36,9,1
983,Thiago Galhardo,12.8,12,6,3,3,6,2,12,16.7,10,15,2,13,6,18,9,0
984,Conor Gallagher,31.6,69,38,35,20,14,21,69,30.4,48,58,9,49,29,98,26,0
985,Gauthier Gallon,31.0,3,0,3,0,0,1,1,100.0,0,0,0,0,2,5,12,1
986,Cristian Gamboa,19.1,59,36,40,16,3,30,61,49.2,31,22,7,15,32,91,35,1
988,Kevin Gameiro,26.5,19,10,5,9,5,6,18,33.3,12,22,1,21,6,25,1,0
989,Idrissa Gana Gueye,18.2,60,36,24,24,12,18,44,40.9,26,23,4,19,24,84,13,0
990,Ignatius Ganago,11.4,3,2,1,2,0,2,6,33.3,4,4,0,4,2,5,3,0
991,Silvere Ganvoula M'Boussy,1.7,0,0,0,0,0,0,1,0.0,1,0,0,0,0,0,1,0
992,Alvaro Garcia,33.3,42,23,15,18,9,8,35,22.9,27,27,3,24,42,84,24,0
993,Dani Garcia,24.2,36,22,15,17,4,14,47,29.8,33,27,10,17,24,60,41,1
994,David Garcia,34.5,28,14,15,11,2,12,22,54.5,10,27,21,6,52,80,168,0
995,Eric Garcia,22.7,27,18,13,13,1,11,26,42.3,15,22,12,10,44,71,53,3
996,Fran Garcia,33.6,60,35,44,12,4,39,73,53.4,34,34,8,26,45,105,53,0
998,Manu Garcia,12.0,18,9,6,9,3,9,27,33.3,18,8,2,6,13,31,4,0
999,Raul Garcia,20.0,27,17,6,11,10,8,36,22.2,28,30,4,26,9,36,21,0
1000,Ruben Garcia,26.4,43,26,12,23,8,16,49,32.7,33,31,4,27,24,67,16,0
1002,Unai Garcia,15.6,21,12,14,6,1,14,17,82.4,3,19,11,8,22,43,78,0
1003,Alejandro Garnacho,0.1,0,0,0,0,0,0,1,0.0,1,0,0,0,0,0,0,0
1004,Mario Gaspar,6.9,10,4,2,5,3,6,10,60.0,4,6,3,3,6,16,15,0
1006,Johan Gastien,30.5,56,34,26,25,5,27,74,36.5,47,45,11,34,53,109,49,1
1007,Gavi,25.7,38,18,13,18,7,9,33,27.3,24,36,0,36,25,63,13,0
1008,Dwight Gayle,0.4,1,0,0,1,0,0,1,0.0,1,0,0,0,1,2,0,0
1009,Jean-Philippe Gbamin,0.7,1,1,1,0,0,0,2,0.0,2,0,0,0,1,2,1,0
1011,Linus Gechter,8.0,15,8,13,2,0,7,14,50.0,7,12,7,5,11,26,29,0
1012,Dennis Geiger,15.3,34,23,9,20,5,17,30,56.7,13,15,1,14,14,48,7,1
1014,Joe Gelhardt,8.3,4,3,1,0,3,2,10,20.0,8,9,0,9,0,4,3,0
1016,Yannick Gerhardt,17.5,42,20,18,17,7,22,36,61.1,14,24,1,23,25,67,25,1
1017,Valere Germain,21.9,23,14,6,11,6,8,31,25.8,23,13,1,12,9,32,27,0
1018,Gerson,28.3,42,17,16,20,6,8,35,22.9,27,26,4,22,16,58,16,2
1019,Willem Geubbels,6.0,8,5,4,2,2,5,12,41.7,7,5,0,5,6,14,5,0
1020,Hamadi Al Ghaddioui,5.5,5,4,2,1,2,0,4,0.0,4,3,1,2,0,5,4,0
1022,Anwar El Ghazi,4.3,4,4,2,2,0,2,7,28.6,5,6,0,6,1,5,2,0
1023,Anwar El Ghazi,0.1,1,1,1,0,0,1,1,100.0,0,3,0,3,0,1,0,0
1025,Paolo Ghiglione,6.7,17,12,8,6,3,9,14,64.3,5,11,5,6,10,27,12,1
1026,Saman Ghoddos,6.0,17,10,8,6,3,9,15,60.0,6,2,0,2,3,20,16,0
1027,Faouzi Ghoulam,3.7,3,1,1,2,0,0,3,0.0,3,2,1,1,3,6,10,0
1028,Dimitris Giannoulis,13.0,36,21,17,17,2,24,36,66.7,12,22,6,16,19,55,41,1
1030,Ben Gibson,27.7,23,16,17,6,0,7,12,58.3,5,36,30,6,27,50,139,2
1031,Niko Giesselmann,23.1,24,17,10,11,3,15,38,39.5,23,26,4,22,18,42,29,1
1032,Rafal Gikiewicz,34.0,2,0,2,0,0,2,7,28.6,5,0,0,0,3,5,11,5
1033,Bryan Gil,1.0,3,0,1,0,2,1,2,50.0,1,2,0,2,0,3,0,0
1034,Bryan Gil,8.4,13,8,6,3,4,2,13,15.4,11,13,0,13,1,14,4,0
1035,Oscar Gil,18.8,52,35,27,20,5,25,46,54.3,21,33,9,24,19,71,33,2
1036,Mario Gila,0.3,1,0,1,0,0,0,1,0.0,1,0,0,0,1,2,1,0
1037,Billy Gilmour,20.6,41,21,16,21,4,14,52,26.9,38,21,4,17,17,58,29,0
1040,Matthias Ginter,26.2,36,22,20,13,3,27,40,67.5,13,21,10,11,33,69,76,0
1041,Nicholas Gioacchini,5.5,7,5,3,2,2,4,10,40.0,6,8,0,8,4,11,5,0
1042,Sebastian Giovinco,0.4,0,0,0,0,0,0,1,0.0,1,0,0,0,0,0,0,0
1043,Jimmy Giraudon,18.0,14,6,10,4,0,7,22,31.8,15,24,14,10,37,51,68,1
1044,Andrei Girotto,35.0,85,52,49,32,4,52,103,50.5,51,67,33,34,69,154,143,0
1045,Olivier Giroud,21.0,15,11,4,6,5,3,17,17.6,14,13,4,9,3,18,19,0
1046,Serge Gnabry,24.3,47,31,16,20,11,22,57,38.6,35,26,0,26,14,61,3,0
1047,Ben Godfrey,22.5,47,32,29,14,4,24,39,61.5,15,41,19,22,15,62,100,2
1048,Diego Godin,9.1,18,7,13,3,2,10,15,66.7,5,7,5,2,13,31,46,0
1049,Edoardo Goldaniga,10.4,12,5,7,5,0,4,11,36.4,7,8,5,3,22,34,23,0
1051,Aleksandr Golovin,16.7,40,22,10,18,12,18,41,43.9,23,26,1,25,12,52,8,0
1052,Andre Gomes,6.9,16,4,6,6,4,8,32,25.0,24,8,2,6,1,17,7,1
1053,Angel Gomes,10.6,23,13,6,12,5,10,15,66.7,5,4,0,4,3,26,4,0
1054,Toti Gomes,4.0,11,7,10,1,0,7,9,77.8,2,6,3,3,8,19,15,0
1055,Dani Gomez,11.8,7,4,3,2,2,4,12,33.3,8,3,0,3,3,10,5,0
1056,Joe Gomez,3.7,10,6,5,2,3,5,9,55.6,4,4,1,3,5,15,6,0
1057,Maxi Gomez,21.7,5,3,1,2,2,5,8,62.5,3,5,1,4,3,8,22,0
1058,Moi Gomez,14.3,15,7,8,3,4,5,17,29.4,12,5,0,5,6,21,6,0
1059,Papu Gomez,19.8,19,11,9,5,5,9,35,25.7,26,15,2,13,7,26,12,2
1060,Sergi Gomez,30.2,33,24,29,3,1,18,27,66.7,9,33,23,10,40,73,125,2
1062,Alfred Gomis,25.0,1,0,1,0,0,1,2,50.0,1,0,0,0,1,2,8,2
1063,Maxime Gonalons,17.2,43,28,17,22,4,14,39,35.9,25,33,10,23,18,61,29,0
1064,Vagner Goncalves,1.0,2,1,0,2,0,1,1,100.0,0,0,0,0,1,3,0,0
1066,Cedric Gondo,7.8,5,2,2,2,1,2,5,40.0,3,2,0,2,3,8,2,0
1067,Alvaro Gonzalez,5.0,1,1,1,0,0,1,1,100.0,0,0,0,0,1,2,9,0
1068,Diego Gonzalez,19.9,25,16,18,7,0,9,16,56.3,7,21,13,8,19,44,87,0
1069,Edgar Gonzalez,16.3,25,19,15,8,2,17,24,70.8,7,17,11,6,23,48,82,0
1070,Giovanni Gonzalez,4.1,9,3,4,4,1,3,5,60.0,2,7,2,5,4,13,14,0
1071,Nicolas Gonzalez,26.2,21,16,6,8,7,9,28,32.1,19,26,2,24,21,42,4,1
1072,Nicolas Gonzalez,12.4,31,20,5,23,3,11,27,40.7,16,12,0,12,6,37,12,0
1074,Roberto Gonzalez,1.5,5,4,3,2,0,4,6,66.7,2,5,0,5,1,6,1,0
1075,Charlie Goode,5.0,7,5,5,2,0,4,4,100.0,0,4,2,2,2,9,8,0
1076,Anthony Gordon,25.4,54,32,20,30,4,21,59,35.6,38,49,3,46,22,76,17,0
1078,Leon Goretzka,15.5,25,15,12,9,4,11,26,42.3,15,11,1,10,17,42,23,2
1080,Andoni Gorosabel,25.4,47,31,32,9,6,25,47,53.2,22,16,3,13,18,65,49,0
1081,Robin Gosens,5.1,7,3,3,4,0,4,8,50.0,4,4,0,4,9,16,1,0
1083,Dan Gosling,1.8,2,1,1,1,0,2,6,33.3,4,2,0,2,0,2,3,0
1084,Amine Gouiri,30.6,22,13,2,13,7,10,32,31.3,22,22,5,17,11,33,17,1
1085,Lucas Gourna-Douath,20.0,45,26,22,18,5,21,36,58.3,15,22,3,19,13,58,9,2
1086,Jeffrey Gouweleeuw,28.6,50,27,33,17,0,22,36,61.1,14,35,18,17,49,99,116,0
1087,Jonathan Gradit,34.1,60,28,24,28,8,25,45,55.6,20,39,27,12,65,125,106,0
1089,Alberto Grassi,24.2,47,26,13,30,4,16,38,42.1,22,27,9,18,63,110,33,1
1090,Jaume Grau,0.0,1,1,1,0,0,0,1,0.0,1,0,0,0,0,1,0,0
1092,Andrew Gravillon,23.7,32,24,19,13,0,17,27,63.0,10,25,15,10,33,65,83,1
1093,Demarai Gray,26.0,30,19,13,10,7,10,22,45.5,12,30,2,28,15,45,21,1
1094,Adrian Grbic,5.8,2,1,0,2,0,2,6,33.3,4,3,1,2,0,2,7,0
1096,Jack Grealish,21.3,18,17,4,10,4,5,13,38.5,8,11,1,10,8,26,7,0
1098,Julian Green,11.7,9,5,0,8,1,2,8,25.0,6,10,2,8,7,16,10,0
1099,Mason Greenwood,14.1,15,9,9,1,5,3,9,33.3,6,5,0,5,1,16,6,0
1100,Sam Greenwood,2.6,8,5,0,5,3,4,7,57.1,3,3,0,3,2,10,1,0
1101,Michael Gregoritsch,15.5,19,8,4,10,5,2,15,13.3,13,18,2,16,6,25,29,0
1104,Sebastian Griesbeck,27.1,60,31,38,19,3,39,62,62.9,23,38,13,25,43,103,100,1
1105,Sebastian Griesbeck,0.1,1,1,0,1,0,1,1,100.0,0,0,0,0,0,1,0,0
1106,Antoine Griezmann,2.9,13,5,3,10,0,2,6,33.3,4,4,0,4,3,16,5,0
1107,Antoine Griezmann,18.8,30,14,11,15,4,12,32,37.5,20,18,1,17,7,37,18,0
1108,Vincenzo Grifo,30.8,27,15,9,13,5,9,26,34.6,17,12,2,10,13,40,28,0
1110,Florian Grillitsch,16.6,37,19,15,21,1,17,31,54.8,14,18,7,11,29,66,36,1
1111,Pascal Gross,22.6,28,15,15,11,2,12,33,36.4,21,34,8,26,18,46,23,0
1112,Carlos Gruezo,10.8,22,11,10,10,2,8,21,38.1,13,11,2,9,9,31,15,0
1113,Vicente Guaita,29.5,1,0,1,0,0,1,1,100.0,0,0,0,0,1,2,8,1
1114,Andres Guardado,15.5,30,13,12,17,1,13,34,38.2,21,18,4,14,21,51,29,1
1115,Sergi Guardiola,19.0,10,9,3,5,2,1,21,4.8,20,14,2,12,4,14,17,0
1116,Nemanja Gudelj,11.6,16,7,10,4,2,5,8,62.5,3,14,9,5,22,38,37,0
1118,Gabriel Gudmundsson,14.9,43,31,24,16,3,17,35,48.6,18,15,3,12,20,63,13,0
1120,Goncalo Guedes,29.0,21,14,6,7,8,2,22,9.1,20,14,0,14,9,30,1,0
1121,Marc Guehi,35.8,35,17,24,10,1,15,16,93.8,1,34,26,8,30,65,127,0
1122,Matteo Guendouzi,35.0,45,30,10,26,9,13,47,27.7,34,15,1,14,16,61,18,0
1123,Yanis Guermouche,0.1,2,1,0,1,1,1,1,100.0,0,0,0,0,0,2,0,0
1124,Raphael Guerreiro,19.9,35,19,19,12,4,16,31,51.6,15,18,2,16,25,60,14,1
1125,Evann Guessand,4.9,9,8,2,5,2,3,8,37.5,5,4,0,4,0,9,1,0
1126,Ander Guevara,9.6,18,13,6,10,2,10,17,58.8,7,12,6,6,12,30,8,0
1127,Lamine Gueye,6.2,5,5,1,1,3,3,7,42.9,4,4,0,4,6,11,1,0
1128,Pape Gueye,17.0,38,19,15,22,1,16,31,51.6,15,15,3,12,24,62,16,0
1129,John Guidetti,3.1,2,1,0,0,2,0,1,0.0,1,1,0,1,0,2,0,0
1130,Josuha Guilavogui,14.8,39,16,18,17,4,14,29,48.3,15,16,8,8,36,75,23,0
1131,Josuha Guilavogui,10.5,23,14,13,9,1,7,18,38.9,11,11,6,5,25,48,42,0
1132,Frederic Guilbert,28.0,69,39,33,24,12,32,62,51.6,30,37,11,26,55,124,39,0
1133,Bruno Guimaraes,11.5,44,23,18,22,4,21,38,55.3,17,25,6,19,9,53,13,0
1134,Bruno Guimaraes,18.2,50,31,20,25,5,23,59,39.0,36,21,4,17,21,71,11,1
1135,Serhou Guirassy,11.3,4,2,1,2,1,1,7,14.3,6,4,0,4,1,5,8,0
1137,Manuel Gulde,13.6,18,10,14,3,1,8,11,72.7,3,16,8,8,17,35,37,0
1138,Gerard Gumbau,21.0,46,19,22,19,5,22,51,43.1,29,18,4,14,23,69,25,0
1139,Robert Gumny,25.2,48,29,25,20,3,25,43,58.1,18,24,7,17,28,76,57,3
1140,Ilkay Gundogan,20.6,23,9,10,12,1,12,31,38.7,19,11,1,10,15,38,10,0
1142,Christian Gunter,34.0,34,20,16,15,3,18,50,36.0,32,23,6,17,17,51,49,2
1144,Koray Gunter,26.8,32,18,19,11,2,16,32,50.0,16,27,21,6,69,101,110,1
1145,Lasse Gunther,1.8,8,5,4,3,1,5,9,55.6,4,0,0,0,2,10,2,0
1146,Jon Guridi,2.3,5,3,2,3,0,1,4,25.0,3,3,1,2,3,8,4,0
1147,Malo Gusto,20.9,55,35,29,21,5,24,40,60.0,16,21,6,15,33,88,41,1
1148,Raul Guti,18.1,25,15,7,14,4,10,30,33.3,20,9,3,6,25,50,7,0
1149,Marcos Mauro Lopez Gutierrez,1.5,1,0,0,1,0,0,2,0.0,2,2,1,1,1,2,9,0
1150,Miguel Gutierrez,2.9,7,5,5,0,2,3,5,60.0,2,0,0,0,2,9,2,0
1151,Albert Gudmundsson,6.7,5,3,2,1,2,3,8,37.5,5,2,0,2,5,10,4,0
1152,Josko Gvardiol,26.8,47,31,28,17,2,22,39,56.4,17,30,11,19,51,98,62,2
1153,Emmanuel Gyasi,33.7,47,30,31,9,7,21,41,51.2,20,22,4,18,16,63,43,1
1154,Norbert Gyomber,28.5,53,32,40,11,2,33,50,66.0,17,38,24,14,44,97,126,1
1155,Erling Haaland,21.2,2,1,0,1,1,0,1,0.0,1,8,1,7,1,3,31,0
1156,Nicolas Haas,11.1,35,22,15,10,10,17,39,43.6,22,24,4,20,9,44,17,1
1157,Janik Haberer,9.1,14,8,5,6,3,7,19,36.8,12,11,4,7,16,30,11,0
1158,Alexander Hack,23.0,52,26,35,17,0,29,46,63.0,17,31,14,17,51,103,95,1
1159,Robin Hack,15.2,14,8,6,5,3,3,21,14.3,18,18,1,17,5,19,4,0
1160,Munir El Haddadi,5.3,8,4,1,6,1,2,8,25.0,6,7,1,6,5,13,2,0
1161,Andre Hahn,23.3,36,20,9,15,12,17,50,34.0,33,38,5,33,15,51,43,0
1162,Amadou Haidara,14.7,30,14,11,19,0,17,37,45.9,20,22,6,16,16,46,8,1
1163,Massadio Haidara,12.0,28,21,18,7,3,15,24,62.5,9,18,4,14,22,50,31,0
1164,Oualid El Hajjam,11.9,22,11,12,6,4,15,23,65.2,8,12,6,6,22,44,28,0
1165,Achraf Hakimi,27.5,74,51,38,27,9,40,72,55.6,32,26,5,21,28,102,23,2
1166,Marcel Halstenberg,5.6,10,7,6,4,0,6,11,54.5,5,6,0,6,7,17,11,0
1167,Pierre-Yves Hamel,0.3,0,0,0,0,0,0,1,0.0,1,0,0,0,2,2,0,0
1168,Pierre-Yves Hamel,5.8,11,6,0,5,6,5,6,83.3,1,2,1,1,0,11,0,0
1170,Romain Hamouma,9.8,10,7,1,5,4,2,13,15.4,11,8,0,8,4,14,1,0
1171,Samir Handanovic,37.0,1,0,1,0,0,1,2,50.0,1,1,0,1,0,1,6,3
1172,Grant Hanley,32.2,44,25,28,14,2,18,35,51.4,17,56,45,11,56,100,176,2
1173,Ridgeciano Haps,22.8,36,20,26,4,6,11,21,52.4,10,34,12,22,29,65,57,1
1174,Genki Haraguchi,19.5,37,20,12,22,3,15,48,31.3,33,25,3,22,26,63,15,0
1175,Amine Harit,12.9,18,11,9,9,0,9,17,52.9,8,10,0,10,4,22,2,0
1176,Varazdat Haroyan,16.0,31,21,20,10,1,19,29,65.5,10,22,12,10,15,46,62,0
1177,Jack Harrison,29.3,57,37,22,22,13,31,76,40.8,45,35,1,34,21,78,19,0
1178,Abdou Harroui,5.0,11,4,4,7,0,8,11,72.7,3,14,0,14,4,15,5,0
1180,Makoto Hasebe,13.2,27,12,15,11,1,13,29,44.8,16,24,8,16,22,49,36,0
1181,Hans Hateboer,15.4,22,14,10,8,4,11,26,42.3,15,11,1,10,7,29,20,0
1182,Kortney Hause,4.4,3,3,2,0,1,3,4,75.0,1,8,5,3,6,9,13,0
1183,Kai Havertz,20.1,17,8,5,7,5,4,14,28.6,10,28,1,27,4,21,32,1
1184,Isaac Hayden,11.1,28,14,11,14,3,12,29,41.4,17,17,8,9,14,42,24,0
1185,Eden Hazard,8.0,6,3,3,2,1,3,7,42.9,4,3,0,3,2,8,0,0
1186,Thorgan Hazard,14.9,23,13,8,10,5,15,40,37.5,25,23,1,22,6,29,4,0
1187,Jonas Hector,28.4,76,39,36,26,14,29,74,39.2,45,59,8,51,50,126,68,1
1188,Hwang Hee-chan,20.2,27,13,9,16,2,14,44,31.8,30,10,0,10,13,40,7,1
1190,Silvan Hefti,14.3,50,30,23,22,5,32,58,55.2,26,20,4,16,20,70,34,1
1191,Dominique Heintz,5.2,8,5,5,3,0,3,6,50.0,3,7,4,3,7,15,14,0
1193,Jordan Henderson,28.9,36,20,9,25,2,17,44,38.6,27,25,1,24,23,59,14,0
1194,Liam Henderson,22.4,22,13,7,8,7,9,31,29.0,22,14,4,10,9,31,13,0
1196,Jeff Hendrick,0.8,1,1,0,1,0,1,1,100.0,0,0,0,0,0,1,1,0
1198,Benjamin Henrichs,12.7,30,21,18,6,6,12,22,54.5,10,16,1,15,19,49,14,0
1199,Henrique,12.3,13,7,10,1,2,5,16,31.3,11,13,1,12,22,35,14,0
1200,Dalbert Henrique,23.1,43,23,23,16,4,11,35,31.4,24,28,5,23,24,67,34,0
1201,Luis Henrique,7.8,4,3,2,1,1,2,5,40.0,3,2,0,2,5,9,1,0
1202,Matheus Henrique,12.0,10,3,6,3,1,6,24,25.0,18,14,2,12,7,17,12,1
1203,Rico Henry,30.8,28,20,18,8,2,12,34,35.3,22,31,10,21,26,54,76,1
1204,Thomas Henry,23.5,9,4,2,3,4,5,13,38.5,8,11,5,6,2,11,25,0
1205,Christophe Herelle,21.5,48,28,30,16,2,17,26,65.4,9,20,15,5,44,92,84,1
1206,Jerome Hergault,3.9,3,1,1,2,0,2,5,40.0,3,4,1,3,4,7,7,0
1207,Kike Hermoso,1.0,2,1,2,0,0,2,2,100.0,0,2,1,1,0,2,5,1
1208,Mario Hermoso,20.7,30,15,23,4,3,20,38,52.6,18,18,3,15,29,59,49,2
1209,Aridane Hernandez,12.9,12,9,10,2,0,3,13,23.1,10,11,9,2,20,32,71,0
1210,Lucas Hernandez,22.6,50,31,20,24,6,26,42,61.9,16,22,11,11,28,78,54,1
1211,Luis Hernandez,15.2,9,5,9,0,0,5,8,62.5,3,5,3,2,16,25,34,0
1212,Mario Hernandez,4.4,10,4,7,3,0,5,9,55.6,4,1,0,1,4,14,7,0
1213,Theo Hernandez,30.1,53,35,34,14,5,29,40,72.5,11,16,3,13,23,76,29,3
1214,Hernani,7.6,20,10,8,9,3,13,32,40.6,19,17,4,13,13,33,5,1
1215,Ander Herrera,12.1,29,17,7,16,6,14,39,35.9,25,22,8,14,14,43,8,0
1216,Hector Herrera,9.5,16,8,11,4,1,7,20,35.0,13,13,2,11,12,28,16,0
1217,Sergio Herrera,36.0,3,2,3,0,0,3,6,50.0,3,1,0,1,1,4,18,0
1218,Yangel Herrera,18.3,41,31,19,19,3,18,39,46.2,21,27,5,22,19,60,33,1
1219,Patrick Herrmann,8.4,15,7,5,6,4,9,24,37.5,15,10,1,9,6,21,8,0
1220,Son Heung-min,33.4,15,6,5,7,3,5,23,21.7,18,27,6,21,13,28,8,0
1222,Daan Heymans,2.8,3,1,1,2,0,1,5,20.0,4,7,3,4,4,7,3,0
1223,Aaron Hickey,31.3,46,29,24,15,7,20,30,66.7,10,36,13,23,29,75,44,0
1224,Piero Hincapie,19.5,33,23,23,8,2,19,25,76.0,6,34,15,19,33,66,56,2
1225,Martin Hinteregger,24.7,45,28,28,16,1,28,43,65.1,15,36,16,20,42,87,78,3
1227,Ki-Jana Hoever,3.4,10,6,5,5,0,7,12,58.3,5,6,0,6,6,16,8,0
1228,Nicolas Hofler,28.9,73,42,37,29,7,28,62,45.2,34,50,21,29,46,119,42,0
1229,Jonas Hofmann,23.1,30,20,6,17,7,17,42,40.5,25,23,0,23,12,42,10,0
1230,Rob Holding,9.4,13,9,11,1,1,5,6,83.3,1,23,18,5,10,23,42,1
1231,Lucas Holer,28.7,41,25,10,17,14,13,28,46.4,15,25,4,21,17,58,39,2
1232,Mason Holgate,23.7,35,18,26,9,0,11,26,42.3,15,25,17,8,26,61,95,1
1233,Gerrit Holtmann,20.4,15,9,5,3,7,6,22,27.3,16,26,2,24,8,23,6,0
1234,Martin Hongla,7.2,14,8,5,6,3,4,8,50.0,4,6,2,4,4,18,16,1
1235,Franck Honorat,32.2,54,38,25,13,16,27,47,57.4,20,24,2,22,15,69,25,0
1236,Justin Hoogma,3.0,6,5,4,2,0,4,6,66.7,2,5,5,0,4,10,4,0
1237,Sydney van Hooijdonk,0.4,0,0,0,0,0,0,1,0.0,1,1,0,1,0,0,0,0
1238,Matthew Hoppe,1.5,1,0,0,0,1,0,3,0.0,3,0,0,0,0,1,0,0
1239,Jannes Horn,5.3,6,4,4,2,0,4,8,50.0,4,1,1,0,3,9,9,0
1240,Timo Horn,13.0,0,0,0,0,0,0,1,0.0,1,0,0,0,0,0,5,0
1241,Fraser Hornby,3.9,3,1,1,2,0,0,2,0.0,2,3,0,3,4,7,5,0
1242,Cedric Hountondji,22.6,33,17,20,12,1,16,24,66.7,8,23,12,11,34,67,76,0
1243,Lukas Hradecky,32.0,1,1,1,0,0,1,1,100.0,0,0,0,0,0,1,10,1
1244,Branimir Hrgota,30.9,46,29,10,31,5,21,72,29.2,51,27,1,26,11,57,3,1
1245,Petko Hristov,13.9,17,10,11,6,0,10,16,62.5,6,29,23,6,19,36,47,0
1246,Ajdin Hrustic,10.7,16,11,5,7,4,11,32,34.4,21,18,1,17,10,26,7,0
1248,Timo Hubers,19.3,45,27,28,17,0,27,45,60.0,18,31,19,12,52,97,95,0
1249,Benjamin Hubner,4.2,9,5,0,7,2,3,5,60.0,2,2,2,0,9,18,7,0
1250,Callum Hudson-Odoi,10.7,14,10,5,6,3,8,23,34.8,15,8,0,8,2,16,6,1
1251,Will Hughes,11.7,29,14,10,16,3,7,16,43.8,9,13,7,6,8,37,10,0
1252,Mats Hummels,19.6,34,22,20,13,1,20,36,55.6,16,18,13,5,32,66,66,1
1253,Elseid Hysaj,22.5,46,30,25,17,4,29,45,64.4,16,18,6,12,24,70,34,1
1255,Pierre Hojbjerg,35.5,78,45,31,38,9,38,85,44.7,47,61,13,48,48,126,54,0
1256,Iago,24.2,49,29,25,19,5,15,34,44.1,19,28,6,22,27,76,62,0
1257,Robert Ibanez,1.0,3,3,2,0,1,1,2,50.0,1,1,0,1,1,4,1,0
1258,Roger Ibanez,32.1,54,32,31,19,4,26,43,60.5,17,26,7,19,62,116,104,2
1259,Vicente Iborra,11.5,19,10,9,7,3,12,24,50.0,12,11,5,6,11,30,27,1
1260,Zlatan Ibrahimovic,11.3,0,0,0,0,0,0,2,0.0,2,2,1,1,3,3,9,0
1261,Mauro Icardi,11.4,5,3,1,3,1,3,7,42.9,4,3,0,3,5,10,12,0
1262,Adam Idah,6.9,9,6,2,5,2,2,3,66.7,1,4,2,2,3,12,7,0
1263,Oussama Idrissi,1.4,1,0,0,1,0,0,1,0.0,1,1,0,1,1,2,1,0
1264,Oussama Idrissi,10.0,8,4,3,4,1,4,15,26.7,11,8,0,8,3,11,5,0
1265,Iglesias,8.0,19,10,11,8,0,7,17,41.2,10,8,2,6,10,29,28,0
1266,Borja Iglesias,17.5,6,4,1,2,3,0,8,0.0,8,11,1,10,4,10,7,0
1267,Jonathan Iglesias,6.4,18,11,6,10,2,10,18,55.6,8,8,2,6,5,23,2,1
1269,Igor,24.9,53,31,34,16,3,30,40,75.0,10,37,19,18,31,84,46,4
1270,Kelechi Iheanacho,14.0,10,7,2,5,3,3,14,21.4,11,19,0,19,4,14,10,0
1271,Danylo Ihnatenko,7.7,17,9,8,7,2,10,24,41.7,14,9,2,7,6,23,17,1
1272,Jonathan Ikone,7.2,7,3,2,3,2,3,10,30.0,7,10,2,8,1,8,2,0
1274,Jonathan Ikone,11.8,11,3,6,4,1,4,11,36.4,7,13,1,12,5,16,4,0
1275,Ivan Ilic,28.1,39,18,16,19,4,20,54,37.0,34,34,12,22,22,61,55,0
1276,Josip Ilicic,9.3,7,7,3,2,2,4,17,23.5,13,6,1,5,3,10,1,0
1277,Asier Illarramendi,4.2,9,5,5,3,1,1,10,10.0,9,5,1,4,4,13,12,0
1278,Stefan Ilsanker,3.0,14,8,7,6,1,5,10,50.0,5,6,2,4,6,20,15,1
1279,Ciro Immobile,30.1,10,5,4,4,2,1,15,6.7,14,7,1,6,3,13,16,0
1280,Burak Ince,1.5,1,1,1,0,0,1,2,50.0,1,1,0,1,0,1,0,0
1281,Danny Ings,21.1,23,16,2,16,5,13,37,35.1,24,31,2,29,6,29,22,0
1282,Marcus Ingvartsen,1.4,0,0,0,0,0,0,2,0.0,2,0,0,0,2,2,1,0
1283,Marcus Ingvartsen,7.6,3,2,2,0,1,3,9,33.3,6,6,0,6,6,9,7,1
1284,Bonke Innocent,9.7,27,16,10,16,1,11,26,42.3,15,11,3,8,16,43,14,0
1285,Lorenzo Insigne,25.4,23,14,8,12,3,8,44,18.2,36,30,1,29,20,43,3,1
1287,Tim Iroegbunam,1.0,5,4,2,3,0,1,1,100.0,0,0,0,0,2,7,1,0
1288,Alexander Isak,23.8,7,4,1,3,3,2,12,16.7,10,14,2,12,3,10,10,0
1289,Isco,3.7,9,5,4,4,1,5,12,41.7,7,1,0,1,2,11,1,0
1290,Wilson Isidor,0.6,0,0,0,0,0,0,4,0.0,4,1,0,1,0,0,0,0
1291,Ardian Ismajli,14.1,13,9,8,4,1,5,14,35.7,9,21,11,10,24,37,80,0
1292,Hiroki Ito,26.1,43,31,21,19,3,25,43,58.1,18,40,19,21,53,96,95,0
1293,Cedric Itten,7.1,5,2,1,2,2,1,6,16.7,5,3,0,3,2,7,4,0
1294,Gian-Luca Itter,16.2,44,26,30,11,3,21,38,55.3,17,24,9,15,13,57,51,0
1295,Alex Iwobi,22.6,40,19,23,12,5,21,52,40.4,31,39,3,36,20,60,25,2
1296,Armando Izzo,5.8,16,9,14,2,0,9,11,81.8,2,5,4,1,17,33,21,0
1298,Lee Jae-sung,16.0,30,12,8,14,8,6,27,22.2,21,20,2,18,18,48,18,0
1300,Paul Jaeckel,22.7,51,29,27,24,0,29,51,56.9,22,34,10,24,57,108,81,0
1301,Mato Jajalo,7.0,24,14,14,7,3,11,23,47.8,12,7,0,7,11,35,5,0
1302,Kristijan Jakic,20.9,37,22,10,21,6,15,62,24.2,47,33,3,30,21,58,25,1
1303,Ismail Jakobs,13.4,32,16,14,15,3,16,35,45.7,19,16,1,15,17,49,31,0
1304,Marin Jakolis,2.5,2,1,0,1,1,0,6,0.0,6,0,0,0,1,3,0,0
1305,Abdel Jalil Medioub,6.9,9,5,5,3,1,3,4,75.0,1,8,4,4,12,21,34,0
1307,Daniel James,26.3,24,14,8,8,8,10,23,43.5,13,18,1,17,8,32,12,0
1308,Reece James,20.7,33,25,14,18,1,9,22,40.9,13,20,2,18,17,50,22,0
1309,Vitaly Janelt,25.5,61,32,26,27,8,27,53,50.9,26,23,7,16,28,89,35,0
1310,Jakub Jankto,6.5,11,7,5,5,1,10,17,58.8,7,4,0,4,4,15,7,0
1311,Pontus Jansson,36.9,40,21,32,8,0,22,34,64.7,12,37,27,10,52,92,187,0
1312,Tony Jantschke,2.5,6,5,2,4,0,3,6,50.0,3,3,2,1,5,11,8,0
1313,Adnan Januzaj,18.1,17,11,5,8,4,9,24,37.5,15,15,3,12,12,29,15,0
1315,Pawel Jaroszynski,5.7,10,5,7,3,0,5,7,71.4,2,4,0,4,10,20,19,0
1316,Jason,7.5,11,7,6,4,1,7,20,35.0,13,7,0,7,7,18,5,0
1317,Jason,0.8,4,1,2,1,1,0,1,0.0,1,2,0,2,1,5,1,0
1318,Dennis Jastrzembski,2.5,2,1,1,1,0,2,8,25.0,6,1,0,1,5,7,3,0
1319,Luis Javier Suarez,31.6,26,14,9,9,8,8,27,29.6,19,25,3,22,6,32,23,0
1320,Corentin Jean,2.8,9,6,4,4,1,3,6,50.0,3,5,0,5,1,10,0,0
1321,Jemerson,13.4,37,25,30,7,0,18,26,69.2,8,23,8,15,25,62,33,1
1322,Fredrik Jensen,4.6,5,4,1,3,1,4,7,57.1,3,5,1,4,2,7,4,0
1323,Mathias Jensen,17.8,33,18,12,16,5,22,63,34.9,41,32,3,29,22,55,13,0
1324,Moritz Jenz,15.3,26,12,18,6,2,11,24,45.8,13,19,11,8,28,54,55,0
1326,Gabriel Jesus,20.9,18,12,2,4,12,6,26,23.1,20,18,0,18,15,33,8,0
1327,Juan Jesus,14.2,25,17,14,11,0,12,18,66.7,6,21,16,5,9,34,34,0
1328,Alvaro Jimenez,2.6,6,3,3,2,1,4,7,57.1,3,3,0,3,3,9,0,0
1329,Raul Jimenez,29.2,29,14,6,16,7,6,30,20.0,24,31,5,26,13,42,26,0
1330,Joao Pedro,18.3,20,14,7,8,5,6,23,26.1,17,23,3,20,15,35,17,0
1331,Joaquin,5.2,6,2,4,2,0,3,8,37.5,5,5,2,3,3,9,10,0
1332,Joelinton,28.4,72,38,30,33,9,26,61,42.6,35,46,11,35,34,106,50,2
1333,Jofre,0.2,1,1,0,0,1,1,1,100.0,0,0,0,0,0,1,0,0
1334,Marco John,0.5,0,0,0,0,0,0,1,0.0,1,1,0,1,1,1,1,0
1335,Dennis Johnsen,16.1,14,10,8,4,2,6,18,33.3,12,14,1,13,5,19,3,0
1336,Ben Johnson,15.5,33,16,15,15,3,21,28,75.0,7,16,8,8,22,55,55,0
1337,Curtis Jones,9.5,11,9,3,6,2,1,10,10.0,9,4,0,4,6,17,4,0
1338,Phil Jones,1.8,5,5,3,1,1,2,3,66.7,1,4,4,0,3,8,8,0
1339,Frenkie de Jong,27.5,35,19,12,18,5,12,23,52.2,11,19,5,14,20,55,16,0
1340,Luuk de Jong,7.3,9,7,1,5,3,1,2,50.0,1,4,0,4,0,9,12,0
1341,Joan Jordan,27.9,61,30,22,31,8,28,65,43.1,37,27,6,21,30,91,18,1
1342,Kaio Jorge,1.3,2,1,0,2,0,1,3,33.3,2,1,0,1,0,2,2,0
1343,Jorginho,25.3,64,33,27,31,6,29,83,34.9,54,27,4,23,36,100,21,1
1344,Josan,13.5,36,22,23,9,4,26,44,59.1,18,11,4,7,10,46,21,0
1345,Willian Jose,17.8,15,13,2,10,3,2,8,25.0,6,10,2,8,3,18,16,0
1346,Joselu,34.7,16,11,1,9,6,7,25,28.0,18,21,4,17,7,23,45,0
1347,Josema,2.0,3,2,1,1,1,0,2,0.0,2,1,1,0,0,3,11,0
1349,Diogo Jota,26.3,39,18,12,18,9,13,55,23.6,42,19,2,17,6,45,6,0
1350,Stevan Jovetic,11.3,5,2,0,2,3,1,6,16.7,5,3,0,3,1,6,6,0
1352,Luka Jovic,4.1,1,1,0,1,0,0,1,0.0,1,3,0,3,1,2,4,0
1354,Jose Juan Macias,2.2,1,0,0,0,1,0,1,0.0,1,1,0,1,1,2,0,0
1355,Juanmi,23.7,39,25,11,19,9,19,49,38.8,30,24,1,23,9,48,10,1
1356,Gideon Jung,1.6,3,1,1,2,0,2,4,50.0,2,1,1,0,2,5,5,0
1357,Flavio Junior Bianchi,3.5,2,2,1,0,1,0,2,0.0,2,0,0,0,0,2,0,0
1358,Lago Junior,2.0,3,2,3,0,0,3,5,60.0,2,0,0,0,2,5,2,0
1359,Hamed Junior Traore,19.7,32,18,8,14,10,10,46,21.7,36,22,2,20,12,44,6,1
1360,Vinicius Junior,29.9,46,24,23,19,4,15,50,30.0,35,25,0,25,6,52,6,0
1361,James Justin,11.1,22,13,11,8,3,7,15,46.7,8,16,4,12,17,39,34,0
1362,Jutgla,3.3,2,1,0,1,1,0,1,0.0,1,2,0,2,1,3,1,0
1363,Jens Jonsson,14.5,40,29,22,17,1,17,35,48.6,18,17,7,10,34,74,32,0
1364,Mathias Jorgensen,5.8,10,4,3,5,2,7,10,70.0,3,6,1,5,10,20,13,0
1365,Ozan Kabak,10.2,10,5,4,6,0,5,9,55.6,4,19,11,8,16,26,26,0
1366,Christian Kabasele,13.3,11,5,10,1,0,7,10,70.0,3,20,16,4,14,25,67,1
1367,Issa Kabore,25.0,45,22,22,14,9,20,38,52.6,18,27,2,25,20,65,38,1
1368,Anton Kade,0.9,4,2,3,1,0,2,8,25.0,6,3,0,3,3,7,1,0
1369,Pavel Kaderabek,13.3,11,10,6,3,2,5,16,31.3,11,18,6,12,13,24,22,0
1370,Tino Kadewere,5.6,7,5,2,2,3,4,13,30.8,9,7,0,7,4,11,1,1
1371,Florian Kainz,25.8,41,26,9,25,7,23,51,45.1,28,27,3,24,32,73,24,0
1372,Gael Kakuta,18.6,22,14,2,13,7,4,20,20.0,16,10,0,10,4,26,3,0
1373,Sasa Kalajdzic,13.6,10,6,2,5,3,3,11,27.3,8,5,0,5,2,12,14,0
1374,Arnaud Kalimuendo,23.9,9,8,1,3,5,2,7,28.6,5,6,1,5,8,17,0,0
1376,Nikola Kalinic,4.5,2,0,0,1,1,1,2,50.0,1,2,0,2,0,2,2,0
1378,Yayah Kallon,7.1,15,11,5,6,4,3,11,27.3,8,7,1,6,1,16,5,0
1379,Samuel Kalu,2.5,2,2,0,2,0,1,1,100.0,0,2,0,2,3,5,3,0
1380,Samuel Kalu,3.6,8,5,3,4,1,2,5,40.0,3,2,0,2,3,11,1,0
1381,Pierre Kalulu,21.6,61,36,36,21,4,17,22,77.3,5,36,15,21,26,87,54,0
1382,Daichi Kamada,23.8,40,21,7,26,7,11,40,27.5,29,18,0,18,8,48,10,0
1383,Boubacar Kamara,30.9,68,38,27,36,5,26,47,55.3,21,29,10,19,46,114,44,1
1384,Hassane Kamara,18.0,53,34,31,16,6,27,43,62.8,16,20,4,16,69,122,67,0
1385,Hassane Kamara,6.0,13,10,4,6,3,5,8,62.5,3,10,2,8,9,22,4,0
1386,Dimitrije Kamenovic,0.5,1,1,1,0,0,1,1,100.0,0,0,0,0,2,3,1,0
1387,Kevin Kampl,21.1,41,19,16,20,5,10,42,23.8,32,24,5,19,24,65,17,0
1388,Jean-Armel Kana-Biyik,7.4,10,6,8,2,0,4,9,44.4,5,11,4,7,16,26,22,1
1389,Nordine Kandil,1.0,2,1,2,0,0,1,1,100.0,0,1,1,0,0,2,0,0
1390,Harry Kane,35.9,15,5,2,10,3,7,18,38.9,11,26,8,18,3,18,39,0
1391,Lee Kang-in,15.7,13,6,2,9,2,5,29,17.2,24,11,1,10,5,18,7,0
1392,N'Golo Kante,19.7,59,31,20,27,12,25,40,62.5,15,37,2,35,31,90,8,0
1394,Atakan Karazor,21.1,48,24,18,27,3,18,36,50.0,18,37,14,23,34,82,47,0
1395,Rick Karsdorp,32.0,53,38,33,13,7,28,50,56.0,22,22,5,17,34,87,26,1
1396,Denso Kasius,2.0,9,7,5,3,1,2,5,40.0,3,4,0,4,3,12,4,0
1397,Grigoris Kastanos,15.0,30,19,9,19,2,7,23,30.4,16,21,5,16,22,52,8,0
1398,Silas Katompa,3.1,5,4,4,0,1,3,7,42.9,4,5,0,5,2,7,1,0
1399,Noah Katterbach,0.2,1,1,1,0,0,1,1,100.0,0,0,0,0,0,1,1,0
1401,Edo Kayembe,8.9,21,13,11,9,1,8,16,50.0,8,6,1,5,9,30,13,0
1404,Moise Kean,12.2,9,4,2,5,2,6,16,37.5,10,5,0,5,3,12,8,1
1405,Michael Keane,31.0,46,25,32,13,1,28,45,62.2,17,33,28,5,62,108,128,2
1406,Ilan Kebbal,19.7,31,15,13,10,8,12,44,27.3,32,16,0,16,13,44,3,0
1407,Wajdi Kechrida,10.6,9,6,6,3,0,8,13,61.5,5,10,2,8,8,17,15,0
1408,Thilo Kehrer,16.8,21,14,9,11,1,9,21,42.9,12,19,11,8,24,45,29,0
1410,Naby Keita,13.0,46,23,17,19,10,26,42,61.9,16,33,2,31,14,60,8,0
1411,Yannik Keitel,5.6,11,4,5,4,2,5,15,33.3,10,7,1,6,1,12,8,0
1412,Caoimhin Kelleher,2.0,1,1,1,0,0,1,1,100.0,0,0,0,0,0,1,1,0
1413,Marc-Oliver Kempf,11.7,10,9,9,1,0,5,14,35.7,9,14,7,7,25,35,49,1
1414,Marc-Oliver Kempf,9.3,13,8,7,4,2,3,10,30.0,7,16,14,2,16,29,26,2
1415,Kenedy,0.6,5,2,1,2,2,2,3,66.7,1,0,0,0,0,5,0,0
1416,Jonjoe Kenny,11.3,17,7,11,6,0,13,21,61.9,8,8,1,7,20,37,31,0
1418,Franck Kessie,25.6,41,23,12,24,5,17,26,65.4,9,39,10,29,23,64,22,0
1419,Saif-Eddine Khaoui,10.3,19,10,5,10,4,9,18,50.0,9,9,0,9,14,33,5,0
1420,Wahbi Khazri,24.7,33,18,7,17,9,9,34,26.5,25,21,0,21,12,45,7,0
1421,Rani Khedira,30.6,75,38,25,42,8,32,66,48.5,34,21,8,13,50,125,27,1
1422,Kike,20.7,11,7,3,4,4,3,23,13.0,20,10,1,9,3,14,12,0
1424,Luca Kilian,25.3,42,24,30,9,3,21,41,51.2,20,31,13,18,46,88,109,3
1425,Max Kilman,29.9,50,26,38,10,2,24,37,64.9,13,36,21,15,45,95,113,3
1426,Joshua Kimmich,27.5,39,20,14,17,8,18,58,31.0,40,34,8,26,52,91,29,1
1427,Presnel Kimpembe,28.6,34,19,18,15,1,14,23,60.9,9,20,14,6,38,72,73,1
1428,Joshua King,25.0,19,15,7,6,6,4,17,23.5,13,15,4,11,8,27,31,0
1430,Jakub Kiwior,21.8,50,27,25,19,6,26,57,45.6,31,38,15,23,40,90,53,0
1431,Sofian Kiyine,13.8,24,14,9,11,4,12,32,37.5,20,15,1,14,10,34,9,0
1432,Simon Kjaer,8.9,20,12,9,8,3,6,12,50.0,6,17,13,4,9,29,39,0
1434,Philipp Klement,3.8,7,3,1,4,2,3,3,100.0,0,6,1,5,1,8,0,0
1435,Mateusz Klich,23.0,47,25,18,23,6,25,66,37.9,41,22,4,18,11,58,20,0
1436,Thibault Klidje,1.0,0,0,0,0,0,0,1,0.0,1,1,1,0,2,2,0,0
1437,Mateo Klimowicz,6.7,13,6,6,7,0,5,16,31.3,11,2,0,2,4,17,3,0
1438,Fabian Klos,15.8,7,5,0,5,2,2,10,20.0,8,17,4,13,0,7,31,0
1439,Lukas Klostermann,18.3,29,16,11,15,3,13,19,68.4,6,16,3,13,26,55,58,0
1440,Justin Kluivert,20.8,19,9,6,12,1,5,21,23.8,16,13,1,12,14,33,6,0
1441,Lukas Klunter,2.2,1,1,1,0,0,1,5,20.0,4,1,0,1,2,3,2,0
1442,Ansgar Knauff,1.3,3,1,1,1,1,0,4,0.0,4,2,0,2,0,3,4,0
1443,Ansgar Knauff,8.4,18,14,8,5,5,8,15,53.3,7,11,1,10,8,26,6,0
1444,Robin Knoche,33.0,50,24,38,12,0,30,53,56.6,23,45,26,19,49,99,151,1
1445,Gregor Kobel,28.5,0,0,0,0,0,0,2,0.0,2,0,0,0,1,1,20,0
1446,Robin Koch,17.5,21,13,9,10,2,9,34,26.5,25,26,10,16,20,41,44,0
1448,Philippe Koffi,4.2,4,0,0,3,1,0,2,0.0,2,2,1,1,3,7,3,0
1449,Dominik Kohr,17.9,40,20,18,19,3,16,42,38.1,26,21,2,19,35,75,22,0
1450,Koba Koindredi,2.0,4,3,2,1,1,2,6,33.3,4,3,0,3,4,8,5,0
1451,Koke,27.9,55,30,19,29,7,26,63,41.3,37,21,5,16,24,79,31,1
1453,Aleksandar Kolarov,0.5,1,1,1,0,0,1,1,100.0,0,0,0,0,1,2,2,0
1456,Sead Kolasinac,4.9,7,6,2,3,2,5,8,62.5,3,4,0,4,0,7,7,1
1458,Randal Kolo Muani,32.8,28,14,7,10,11,10,25,40.0,15,14,3,11,6,34,31,0
1459,Timothee Kolodziejczak,28.5,43,24,22,14,7,20,36,55.6,16,29,7,22,60,103,72,1
1460,Ghislain Konan,26.9,35,19,19,15,1,16,30,53.3,14,35,8,27,28,63,45,0
1461,Ibrahima Konate,11.0,16,10,9,6,1,7,10,70.0,3,13,9,4,16,32,37,1
1462,Geoffrey Kondogbia,20.9,74,44,25,40,9,21,49,42.9,28,16,5,11,44,118,24,0
1463,Ibrahima Kone,8.1,7,4,0,3,4,2,3,66.7,1,8,3,5,1,8,3,0
1464,Kouadio Kone,24.3,60,37,29,28,3,25,42,59.5,17,27,4,23,34,94,12,0
1465,Youssouf Kone,10.9,30,18,21,8,1,19,30,63.3,11,8,3,5,10,40,25,0
1466,Ezri Konsa,27.5,25,15,13,11,1,10,13,76.9,3,31,22,9,15,40,86,2
1467,Teun Koopmeiners,23.6,40,24,10,19,11,22,54,40.7,32,31,2,29,15,55,19,0
1468,Laurent Koscielny,10.4,14,9,10,3,1,8,13,61.5,5,17,12,5,12,26,39,0
1469,Odilon Kossonou,19.9,23,17,16,6,1,15,25,60.0,10,36,14,22,26,49,66,0
1470,Filip Kostic,28.0,44,17,26,9,9,20,53,37.7,33,24,1,23,15,59,24,0
1471,Rominigue Kouame,33.0,47,22,24,20,3,19,58,32.8,39,33,5,28,46,93,22,2
1472,Kalidou Koulibaly,26.7,39,23,31,6,2,25,38,65.8,13,41,25,16,29,68,90,1
1473,Jules Kounde,30.4,40,17,27,10,3,18,28,64.3,10,33,18,15,21,61,101,2
1474,Christos Kourfalidis,0.2,0,0,0,0,0,0,1,0.0,1,1,0,1,0,0,0,0
1475,Boubakar Kouyate,29.6,84,50,56,28,0,48,77,62.3,29,63,33,30,79,163,217,3
1476,Cheikhou Kouyate,21.9,52,38,28,22,2,18,39,46.2,21,40,14,26,38,90,39,0
1477,Mateo Kovacic,17.3,51,31,14,26,11,17,35,48.6,18,19,4,15,7,58,9,1
1478,Viktor Kovalenko,14.7,16,10,7,8,1,9,21,42.9,12,16,3,13,13,29,8,0
1479,Emil Krafth,18.2,37,16,25,11,1,27,36,75.0,9,16,10,6,25,62,56,0
1482,Andrej Kramaric,30.1,8,4,1,5,2,7,17,41.2,10,10,0,10,9,17,7,1
1483,Christoph Kramer,8.3,28,11,15,10,3,12,28,42.9,16,18,5,13,12,40,9,0
1484,Jean-Philippe Krasso,5.0,7,5,0,5,2,2,10,20.0,8,7,1,6,0,7,1,0
1486,Toni Kroos,23.4,34,26,13,17,4,14,36,38.9,22,16,3,13,12,46,13,1
1487,Florian Kruger,12.5,3,1,0,3,0,2,10,20.0,8,12,1,11,2,5,13,0
1488,Tim Krul,29.0,1,1,1,0,0,1,4,25.0,3,0,0,0,0,1,10,4
1489,Rade Krunic,15.7,33,18,16,14,3,15,31,48.4,16,19,2,17,16,49,17,0
1490,Max Kruse,12.5,9,3,4,4,1,5,12,41.7,7,2,0,2,3,12,4,0
1491,Max Kruse,14.1,4,1,0,3,1,2,16,12.5,14,12,0,12,3,7,2,0
1492,Lukas Kubler,25.9,62,35,38,16,8,28,49,57.1,21,24,8,16,44,106,70,0
1493,Takefusa Kubo,17.8,31,19,12,14,5,10,24,41.7,14,24,3,21,8,39,4,0
1494,Juraj Kucka,21.3,59,39,32,25,2,27,73,37.0,46,30,9,21,27,86,46,2
1496,Dejan Kulusevski,14.0,19,13,7,10,2,5,23,21.7,18,14,0,14,13,32,3,0
1497,Dejan Kulusevski,8.6,15,12,9,6,0,8,21,38.1,13,14,0,14,5,20,5,0
1498,Marash Kumbulla,11.4,21,13,13,7,1,8,15,53.3,7,17,8,9,16,37,26,0
1499,Fabian Kunze,14.0,35,21,14,20,1,15,32,46.9,17,17,2,15,19,54,27,1
1500,Enock Kwateng,22.2,54,35,31,19,4,33,72,45.8,39,17,4,13,43,97,48,1
1501,Grejohn Kyei,4.4,3,2,1,1,1,0,6,0.0,6,6,0,6,0,3,1,0
1502,Giorgos Kyriakopoulos,21.9,30,14,19,7,4,19,38,50.0,19,32,9,23,11,41,52,0
1503,Andrea La Mantia,5.4,2,0,0,0,2,1,2,50.0,1,3,1,2,1,3,6,0
1504,Gaetan Laborde,3.8,2,2,1,1,0,2,4,50.0,2,3,0,3,5,7,5,0
1505,Gaetan Laborde,30.3,19,7,5,8,6,3,22,13.6,19,29,3,26,8,27,16,0
1506,Alexandre Lacazette,19.8,27,10,8,13,6,7,21,33.3,14,12,1,11,5,32,6,0
1508,Tom Lacoux,10.1,18,13,11,5,2,9,24,37.5,15,14,4,10,9,27,20,1
1509,Lenny Lacroix,2.2,9,7,8,1,0,5,8,62.5,3,5,1,4,10,19,5,0
1510,Maxence Lacroix,27.7,59,33,41,16,2,29,40,72.5,11,35,16,19,60,119,144,0
1511,Alban Lafont,38.0,3,3,3,0,0,3,8,37.5,5,1,0,1,1,4,25,2
1512,Victor Laguardia,33.8,29,16,21,8,0,19,30,63.3,11,36,24,12,27,56,151,1
1513,Konrad Laimer,13.8,38,24,11,22,5,24,53,45.3,29,29,3,26,4,42,9,0
1514,Stefan Lainer,16.3,19,11,9,7,3,12,28,42.9,16,24,5,19,14,33,31,0
1515,Diego Lainez,1.6,1,1,0,1,0,0,3,0.0,3,3,0,3,1,2,0,0
1516,Adam Lallana,17.3,34,17,14,14,6,12,41,29.3,29,16,6,10,16,50,13,1
1517,Vassilis Lambropoulos,13.0,18,12,13,3,2,11,25,44.0,14,21,10,11,17,35,56,0
1518,Erik Lamela,11.3,31,18,12,14,5,10,29,34.5,19,11,0,11,5,36,3,0
1519,Mohamed Lamine Bayo,26.8,12,5,4,3,5,3,24,12.5,21,7,1,6,7,19,14,0
1520,Didier Lamkel Ze,6.7,3,1,1,0,2,1,3,33.3,2,3,1,2,1,4,7,0
1522,Sam Lammers,5.7,4,4,0,2,2,2,6,33.3,4,9,2,7,2,6,4,0
1523,Tariq Lamptey,17.3,36,25,14,17,5,15,25,60.0,10,13,3,10,21,57,23,0
1524,Manuel Lanzini,19.8,28,15,10,11,7,10,35,28.6,25,16,0,16,19,47,10,0
1525,Aymeric Laporte,31.4,33,15,22,10,1,14,20,70.0,6,15,10,5,20,53,64,2
1526,Julien Laporte,32.1,63,45,35,26,2,32,64,50.0,32,37,22,15,54,117,174,0
1527,Yasser Larouci,3.8,6,5,2,4,0,3,3,100.0,0,1,0,1,7,13,5,0
1528,Kevin Lasagna,13.2,13,7,4,5,4,4,15,26.7,11,16,0,16,3,16,7,0
1529,Jamaal Lascelles,22.9,15,7,9,5,1,4,12,33.3,8,38,28,10,22,37,121,1
1530,Bryan Lasme,9.7,6,6,1,2,3,0,3,0.0,3,7,0,7,1,7,9,0
1531,Paul Lasne,9.4,26,12,6,16,4,8,18,44.4,10,11,2,9,24,50,10,0
1534,Toni Lato,6.6,17,12,12,3,2,9,16,56.3,7,6,0,6,8,25,14,0
1535,Armand Lauriente,27.5,33,18,9,16,8,11,30,36.7,19,27,2,25,15,48,3,0
1536,Darko Lazovic,30.7,36,23,20,8,8,21,39,53.8,18,28,4,24,19,55,49,1
1537,Manuel Lazzari,18.5,28,14,13,15,0,16,26,61.5,10,10,2,8,12,40,16,1
1538,Theo Le Bris,0.7,2,1,1,1,0,1,2,50.0,1,2,0,2,0,2,1,0
1539,Jeremy Le Douaron,16.1,11,5,4,4,3,1,17,5.9,16,15,0,15,4,15,14,0
1540,Enzo Le Fee,24.4,70,44,25,36,9,41,90,45.6,49,25,1,24,29,99,18,0
1541,Vincent Le Goff,34.0,61,38,38,19,4,37,62,59.7,25,18,3,15,37,98,50,0
1542,Maxime Le Marchand,9.6,17,8,16,1,0,8,10,80.0,2,9,5,4,14,31,32,0
1543,Robin Le Normand,37.0,49,32,36,8,5,28,36,77.8,8,34,22,12,48,97,125,0
1544,Patrick Leal,0.0,0,0,0,0,0,0,1,0.0,1,0,0,0,0,0,0,0
1545,Rafael Leao,28.9,17,7,3,9,5,10,20,50.0,10,12,1,11,12,29,8,0
1547,Jeremias Ledesma,38.0,3,1,3,0,0,3,4,75.0,1,0,0,0,1,4,21,4
1548,Pierre Lees-Melou,25.2,58,36,23,29,6,25,92,27.2,67,37,11,26,25,83,23,0
1549,Wu Lei,5.3,3,2,1,2,0,3,8,37.5,5,4,0,4,4,7,3,0
1550,Maxim Leitsch,17.1,18,10,9,7,2,10,15,66.7,5,31,19,12,31,49,74,1
1551,Lucas Leiva,18.9,55,30,26,25,4,15,53,28.3,38,27,10,17,28,83,37,0
1552,Florian Lejeune,30.0,33,24,22,10,1,12,20,60.0,8,30,19,11,31,64,158,0
1553,Inigo Lekue,21.4,32,23,16,12,4,22,44,50.0,22,37,12,25,23,55,63,0
1554,Thomas Lemar,16.0,24,14,9,12,3,8,23,34.8,15,18,0,18,8,32,11,0
1555,Felix Lemarechal,0.1,0,0,0,0,0,0,1,0.0,1,0,0,0,0,0,0,0
1556,Mario Lemina,21.9,62,35,25,33,4,28,38,73.7,10,32,9,23,48,110,37,0
1557,Fabien Lemoine,12.4,35,22,20,14,1,17,41,41.5,24,21,4,17,14,49,24,1
1558,Tim Lemperle,1.7,4,1,2,1,1,1,3,33.3,2,1,0,1,2,6,2,0
1560,Ruben Lendinez,1.5,3,3,1,2,0,3,8,37.5,5,4,0,4,2,5,6,0
1561,Clement Lenglet,9.2,20,11,11,7,2,8,13,61.5,5,7,3,4,13,33,21,0
1562,Aaron Lennon,17.2,33,17,10,13,10,10,34,29.4,24,26,4,22,9,42,14,0
1563,Bernd Leno,4.0,1,1,1,0,0,1,1,100.0,0,0,0,0,0,1,1,0
1564,Christopher Lenz,7.4,29,15,22,6,1,12,21,57.1,9,9,4,5,7,36,21,0
1565,Leo Leroy,7.0,31,21,17,11,3,12,34,35.3,22,20,4,16,8,39,8,0
1567,Robert Lewandowski,32.7,10,3,0,6,4,5,17,29.4,12,17,2,15,6,16,8,0
1568,Jamie Leweling,21.8,13,8,3,7,3,3,16,18.8,13,9,0,9,13,26,5,0
1569,Jamal Lewis,2.9,8,6,6,1,1,3,4,75.0,1,3,2,1,3,11,8,0
1571,Ben Lhassine Kone,0.9,3,3,1,2,0,1,2,50.0,1,0,0,0,1,4,1,0
1573,Dimitri Lienard,22.7,71,43,40,21,10,46,77,59.7,31,12,0,12,21,92,28,0
1574,Philipp Lienhart,31.9,24,13,17,6,1,13,24,54.2,11,33,23,10,50,74,158,1
1575,Matthijs de Ligt,29.7,34,19,21,13,0,15,18,83.3,3,31,21,10,26,60,103,0
1576,Isaac Lihadji,2.6,3,3,1,1,1,1,5,20.0,4,1,0,1,2,5,0,0
1577,Anderson Lima,0.7,2,0,1,1,0,0,2,0.0,2,1,0,1,2,4,1,0
1579,Victor Lindelof,26.2,16,11,9,7,0,9,14,64.3,5,26,17,9,25,41,96,0
1580,Jesper Lindstrom,22.0,28,13,6,13,9,12,36,33.3,24,30,0,30,24,52,11,1
1581,Karol Linetty,10.0,14,8,3,4,7,6,18,33.3,12,8,0,8,3,17,2,0
1582,Jesse Lingard,4.1,9,7,4,3,2,2,6,33.3,4,4,0,4,0,9,1,0
1583,Pol Lirola,19.7,28,16,15,9,4,13,28,46.4,15,15,0,15,13,41,22,0
1584,Valentino Livramento,24.5,54,28,30,18,6,27,45,60.0,18,23,9,14,47,101,50,1
1586,Dejan Ljubicic,21.9,33,19,12,13,8,13,49,26.5,36,19,1,18,15,48,11,0
1587,Javier Llabres,1.5,2,1,0,1,1,1,2,50.0,1,1,0,1,0,2,0,0
1588,Diego Llorente,26.0,53,31,32,19,2,33,47,70.2,14,35,17,18,40,93,77,2
1589,Marcos Llorente,27.2,51,23,25,22,4,28,43,65.1,15,33,10,23,27,78,44,0
1590,Hugo Lloris,38.0,1,1,1,0,0,1,2,50.0,1,0,0,0,1,2,24,3
1591,Giovani Lo Celso,2.6,8,4,4,2,2,4,10,40.0,6,6,1,5,1,9,0,1
1592,Giovani Lo Celso,11.0,22,12,8,10,4,9,22,40.9,13,4,0,4,5,27,3,0
1593,Julen Lobete,3.2,4,3,3,0,1,1,2,50.0,1,6,1,5,1,5,1,0
1594,Stanislav Lobotka,18.7,39,24,16,20,3,14,36,38.9,22,9,1,8,12,51,13,1
1596,Jurgen Locadia,4.9,4,2,1,0,3,1,1,100.0,0,1,0,1,1,5,2,0
1597,Manuel Locatelli,24.0,44,25,21,16,7,21,47,44.7,26,43,21,22,22,66,33,0
1598,Bradley Locko,11.2,28,19,13,11,4,14,24,58.3,10,20,8,12,14,42,15,0
1599,Renan Lodi,13.1,31,18,14,13,4,11,27,40.7,16,22,4,18,13,44,19,1
1600,Ruben Loftus-Cheek,15.5,29,10,16,11,2,10,19,52.6,9,15,6,9,11,40,17,0
1601,Kevin Long,4.6,3,2,1,2,0,1,2,50.0,1,4,1,3,1,4,20,0
1602,Shane Long,3.4,9,5,2,4,3,1,1,100.0,0,4,0,4,0,9,2,0
1603,Sean Longstaff,16.3,54,34,18,31,5,24,65,36.9,41,18,6,12,9,63,18,0
1604,Ademola Lookman,16.1,32,14,10,13,9,10,28,35.7,18,19,1,18,10,42,4,0
1606,David Lopez,8.3,18,13,9,8,1,9,16,56.3,7,10,8,2,10,28,25,2
1607,Diego Lopez,35.3,0,0,0,0,0,0,2,0.0,2,0,0,0,1,1,21,1
1608,Javi Lopez,5.1,8,6,6,2,0,4,6,66.7,2,7,1,6,4,12,15,0
1609,Maxime Lopez,32.6,69,36,40,27,2,35,87,40.2,52,33,7,26,42,111,38,1
1610,Pau Lopez,29.0,0,0,0,0,0,0,1,0.0,1,0,0,0,0,0,12,1
1612,Unai Lopez,12.9,19,9,6,10,3,10,33,30.3,23,7,0,7,10,29,8,1
1613,Dion Lopy,18.2,53,29,22,24,7,21,53,39.6,32,20,4,16,22,75,17,0
1614,Samuel Loric,3.0,7,5,2,3,2,5,8,62.5,3,2,0,2,5,12,9,0
1615,Anthony Losilla,32.6,65,39,29,30,6,34,69,49.3,35,32,9,23,70,135,53,1
1617,Marcel Lotka,9.8,1,0,1,0,0,1,1,100.0,0,0,0,0,1,2,3,3
1618,Jordan Lotomba,19.8,33,17,21,9,3,16,30,53.3,14,17,4,13,12,45,28,0
1620,Imran Louza,15.7,41,21,18,20,3,16,38,42.1,22,28,6,22,42,83,20,1
1621,Matteo Lovato,3.4,5,4,4,1,0,0,1,0.0,1,4,2,2,7,12,8,0
1622,Matteo Lovato,13.8,23,15,13,10,0,8,20,40.0,12,21,10,11,28,51,43,0
1623,Eduard Lowen,15.7,28,22,12,11,5,10,43,23.3,33,17,2,15,9,37,15,1
1624,Matthew Lowton,19.7,38,24,20,10,8,20,37,54.1,17,25,11,14,26,64,68,0
1625,Anthony Lozano,18.6,8,4,2,3,3,5,18,27.8,13,16,2,14,2,10,7,0
1626,Hirving Lozano,17.9,28,20,12,11,5,8,30,26.7,22,24,0,24,9,37,9,0
1627,Jean Lucas,16.1,43,25,14,24,5,17,40,42.5,23,15,5,10,13,56,4,1
1628,Anderson Lucoqui,8.3,22,10,11,6,5,11,22,50.0,11,15,3,12,11,33,10,0
1629,Florentino Luis,11.0,42,25,22,17,3,17,35,48.6,18,21,2,19,21,63,11,1
1630,Jose Luis Gaya,20.8,35,21,24,10,1,16,34,47.1,18,17,3,14,19,54,37,0
1631,Jose Luis Morales,30.2,27,17,6,9,12,12,42,28.6,30,29,0,29,4,31,7,0
1632,Jose Luis Palomino,29.7,78,40,42,33,3,32,50,64.0,18,43,21,22,100,178,80,2
1634,Douglas Luiz,30.2,59,39,30,24,5,21,72,29.2,51,30,7,23,34,93,28,1
1635,Romelu Lukaku,17.7,2,1,0,1,1,1,5,20.0,4,11,1,10,0,2,20,0
1636,Castello Lukeba,23.3,34,19,27,7,0,15,23,65.2,8,18,9,9,38,72,64,2
1638,Dodi Lukebakio,2.0,2,1,2,0,0,1,3,33.3,2,2,0,2,2,4,0,0
1639,Dodi Lukebakio,9.8,7,4,3,2,2,1,10,10.0,9,5,0,5,13,20,4,0
1640,Sasa Lukic,33.1,51,34,17,27,7,19,43,44.2,24,34,6,28,24,75,41,0
1641,Levi Lumeka,0.7,0,0,0,0,0,0,2,0.0,2,0,0,0,0,0,2,0
1644,Sebastiano Luperto,21.8,29,17,17,10,2,10,20,50.0,10,32,26,6,45,74,132,0
1645,Andreas Luthe,27.0,0,0,0,0,0,0,1,0.0,1,0,0,0,0,0,11,4
1646,Lyanco,10.1,18,15,11,7,0,10,18,55.6,8,18,13,5,13,31,50,1
1647,Charalambos Lykogiannis,20.2,19,12,16,1,2,11,20,55.0,9,18,8,10,31,50,73,0
1649,Alexis Mac Allister,23.6,65,40,23,30,12,29,68,42.6,39,37,7,30,13,78,22,0
1650,Deiver Machado,5.8,16,14,11,1,4,12,14,85.7,2,9,1,8,3,19,12,1
1651,Darwin Machis,15.3,23,13,11,8,4,9,23,39.1,14,10,0,10,15,38,17,0
1652,Yvann Macon,17.0,41,22,24,14,3,16,42,38.1,26,18,4,14,18,59,27,0
1653,James Maddison,27.3,40,20,8,24,8,14,46,30.4,32,18,3,15,11,51,12,0
1655,Pablo Maffeo,32.7,84,47,48,28,8,38,69,55.1,31,30,13,17,46,130,74,0
1656,Louis Mafouta,5.8,0,0,0,0,0,0,5,0.0,5,1,0,1,0,0,4,0
1657,Giulio Maggiore,31.3,58,32,20,32,6,31,77,40.3,46,30,5,25,29,87,33,0
1658,Matej Maglica,0.1,0,0,0,0,0,0,1,0.0,1,0,0,0,0,0,0,0
1659,Francesco Magnanelli,3.0,5,4,4,1,0,1,9,11.1,8,3,1,2,1,6,3,0
1660,Giangiacomo Magnani,5.9,10,7,5,5,0,8,16,50.0,8,5,3,2,10,20,46,0
1661,Giangiacomo Magnani,2.7,4,2,4,0,0,1,1,100.0,0,2,2,0,7,11,12,0
1662,Hugo Magnetti,16.3,50,34,27,20,3,22,50,44.0,28,14,3,11,25,75,13,0
1664,Yohann Magnin,19.1,53,31,22,26,5,24,42,57.1,18,17,7,10,20,73,36,0
1665,Harry Maguire,27.9,34,21,22,8,4,19,31,61.3,12,36,29,7,32,66,101,3
1666,Riyad Mahrez,16.6,11,3,5,4,2,5,19,26.3,14,15,1,14,6,17,6,0
1667,Arne Maier,20.7,20,13,6,10,4,8,26,30.8,18,18,1,17,15,35,13,0
1668,Habib Maiga,14.1,47,28,29,13,5,24,48,50.0,24,20,7,13,14,61,18,0
1669,Mike Maignan,32.0,2,1,2,0,0,2,2,100.0,0,0,0,0,1,3,4,2
1670,Ainsley Maitland-Niles,3.0,8,4,5,3,0,2,4,50.0,2,2,0,2,4,12,4,0
1671,Ainsley Maitland-Niles,5.4,8,6,5,0,3,5,14,35.7,9,7,0,7,6,14,7,0
1673,Abdul Majeed Waris,3.6,5,3,2,3,0,5,10,50.0,5,2,0,2,0,5,1,0
1674,Lovro Majer,20.4,32,21,9,14,9,11,42,26.2,31,26,2,24,11,43,9,0
1675,Jean-Victor Makengo,26.1,30,21,7,17,6,15,29,51.7,14,26,6,20,19,49,17,0
1676,Beni Makouana,3.6,2,2,0,0,2,0,1,0.0,1,1,0,1,3,5,2,0
1677,Nemanja Maksimovic,32.6,56,32,24,26,6,18,49,36.7,31,42,13,29,71,127,41,0
1678,Nikola Maksimovic,12.4,14,6,10,4,0,7,9,77.8,2,17,11,6,12,26,61,1
1679,Kevin Malcuit,3.2,4,2,4,0,0,2,2,100.0,0,3,0,3,8,12,6,0
1680,Daniel Maldini,1.6,8,3,4,3,1,2,6,33.3,4,4,0,4,1,9,0,0
1681,Youssef Maleh,11.3,27,16,8,13,6,12,25,48.0,13,14,1,13,6,33,2,0
1682,Donyell Malen,18.7,13,10,4,5,4,7,13,53.8,6,10,0,10,10,23,11,0
1683,Ruslan Malinovskyi,17.7,18,10,3,10,5,5,19,26.3,14,27,3,24,5,23,1,0
1684,Hugo Mallo,20.3,45,25,24,19,2,16,31,51.6,15,23,9,14,20,65,53,0
1685,Lennard Maloney,0.1,1,0,1,0,0,1,1,100.0,0,0,0,0,0,1,0,0
1686,Mickael Malsa,12.7,37,17,16,18,3,15,42,35.7,27,20,8,12,18,55,15,0
1688,Rey Manaj,19.6,19,12,3,11,5,6,26,23.1,20,16,0,16,4,23,13,0
1690,Hianga Mananga Mbock,8.9,18,12,8,7,3,9,21,42.9,12,5,2,3,5,23,6,0
1691,Vincent Manceau,26.2,32,19,18,13,1,14,37,37.8,23,23,6,17,32,64,72,0
1692,Gianluca Mancini,32.0,41,25,22,18,1,18,33,54.5,15,38,19,19,39,80,69,0
1693,Leonardo Mancuso,4.7,1,1,0,1,0,0,6,0.0,6,2,0,2,1,2,2,0
1694,Steve Mandanda,9.0,0,0,0,0,0,0,1,0.0,1,1,0,1,1,1,4,1
1695,Reinildo Mandava,14.4,45,25,30,14,1,22,30,73.3,8,18,9,9,21,66,38,0
1696,Reinildo Mandava,16.9,43,23,29,11,3,32,51,62.7,19,13,4,9,37,80,55,0
1697,Aissa Mandi,15.3,11,5,2,8,1,3,6,50.0,3,17,14,3,13,24,49,3
1698,Rolando Mandragora,14.7,21,10,3,16,2,12,21,57.1,9,18,4,14,10,31,13,0
1700,Sadio Mane,31.3,33,20,7,14,12,8,26,30.8,18,30,1,29,8,41,15,0
1701,Eliaquim Mangala,13.1,17,12,12,5,0,8,12,66.7,4,11,8,3,17,34,61,1
1702,Orel Mangala,20.6,17,10,5,7,5,11,22,50.0,11,11,4,7,12,29,19,1
1703,Thomas Mangani,24.4,58,30,23,34,1,31,68,45.6,37,38,11,27,36,94,29,0
1704,Ricardo Mangas,26.1,35,22,22,8,5,26,41,63.4,15,18,4,14,25,60,47,3
1705,Kostas Manolas,3.5,2,2,1,1,0,2,3,66.7,1,2,1,1,4,6,10,1
1706,Javier Manquillo,14.0,39,29,28,10,1,21,36,58.3,15,15,6,9,10,49,32,0
1708,Myziane Maolida,8.6,7,4,5,1,1,3,9,33.3,6,5,0,5,1,8,6,0
1709,Sekou Mara,10.1,8,4,1,1,6,1,8,12.5,7,7,0,7,2,10,6,0
1710,Nikola Maras,11.6,13,9,12,1,0,9,15,60.0,6,17,13,4,15,28,51,0
1711,Fernando Marcal,16.1,42,22,27,14,1,21,37,56.8,16,25,4,21,28,70,52,0
1712,Marcelo,5.8,8,4,2,3,3,5,10,50.0,5,7,2,5,1,9,11,0
1713,Marcelo,10.0,9,5,7,2,0,4,6,66.7,2,4,3,1,13,22,46,1
1714,Marcelo,2.0,4,3,0,4,0,4,6,66.7,2,3,2,1,4,8,10,0
1716,Solly March,19.4,30,17,11,9,10,7,22,31.8,15,22,3,19,17,47,25,0
1717,Riccardo Marchizza,15.0,21,15,11,8,2,11,16,68.8,5,15,6,9,10,31,24,0
1718,Gian Marco Ferrari,34.7,16,11,10,6,0,10,23,43.5,13,37,27,10,43,59,114,2
1719,Ivan Marcone,9.0,24,14,17,6,1,12,24,50.0,12,8,3,5,12,36,13,0
1720,Oscar de Marcos,18.7,50,37,24,19,7,28,43,65.1,15,20,3,17,19,69,27,0
1722,Jose Mari,4.3,14,7,3,10,1,7,8,87.5,1,4,1,3,7,21,2,0
1723,Pablo Mari,2.0,5,3,1,3,1,3,6,50.0,3,5,4,1,3,8,10,0
1724,Pablo Mari,14.9,16,8,8,6,2,8,16,50.0,8,18,12,6,21,37,72,0
1725,Jose Maria Gimenez,22.7,18,12,12,6,0,8,16,50.0,8,25,19,6,25,43,96,1
1727,Razvan Marin,31.3,42,21,16,22,4,24,54,44.4,30,23,5,18,10,52,17,1
1728,Guillermo Maripan,20.4,36,24,27,9,0,20,40,50.0,20,21,14,7,25,61,66,1
1732,Marquinhos,31.8,37,14,25,11,1,20,35,57.1,15,35,19,16,16,53,102,0
1733,Roger Marti,23.5,23,14,3,13,7,8,30,26.7,22,14,0,14,2,25,8,0
1734,Anthony Martial,2.4,0,0,0,0,0,0,1,0.0,1,1,0,1,0,0,1,0
1735,Anthony Martial,5.4,2,1,0,0,2,2,6,33.3,4,4,0,4,0,2,3,0
1737,Aaron Martin,25.5,54,33,32,18,4,24,55,43.6,31,24,4,20,20,74,35,0
1738,Ander Martin,1.0,1,0,0,1,0,1,1,100.0,0,0,0,0,3,4,1,0
1739,Andres Martin,2.1,0,0,0,0,0,0,1,0.0,1,1,0,1,0,0,0,0
1742,Ivan Martin,1.8,1,1,1,0,0,0,1,0.0,1,2,0,2,1,2,1,0
1743,Jonas Martin,23.4,35,20,12,21,2,19,53,35.8,34,17,3,14,22,57,28,1
1744,Gabriel Martinelli,20.7,27,19,7,14,6,10,29,34.5,19,26,1,25,20,47,15,0
1745,Emiliano Martinez,36.0,1,1,1,0,0,1,3,33.3,2,0,0,0,0,1,6,1
1746,Inigo Martinez,26.0,28,13,18,7,3,14,23,60.9,9,22,10,12,39,67,143,0
1747,Javi Martinez,9.8,21,14,8,11,2,10,29,34.5,19,6,0,6,9,30,10,0
1749,Lautaro Martinez,25.4,20,10,3,10,7,6,11,54.5,5,21,1,20,18,38,6,0
1750,Pablo Martinez,7.3,15,8,7,8,0,4,13,30.8,9,6,3,3,15,30,5,0
1751,Lucas Martinez Quarta,15.9,36,25,23,11,2,21,34,61.8,13,22,9,13,19,55,46,0
1752,Gelson Martins,21.2,42,27,10,26,6,21,59,35.6,38,26,1,25,17,59,4,0
1753,Adam Marusic,30.2,30,18,16,12,2,13,32,40.6,19,19,8,11,41,71,71,0
1754,Omar Mascarell,27.7,46,26,16,23,7,24,60,40.0,36,42,14,28,48,94,52,2
1755,Andrea Masiello,5.7,5,3,4,1,0,4,7,57.1,3,8,4,4,11,16,20,1
1756,Adam Masina,12.0,24,13,11,10,3,12,29,41.4,17,18,6,12,18,42,45,0
1757,Erhan Masovic,17.2,35,20,21,13,1,21,33,63.6,12,28,19,9,34,69,64,1
1758,Roberto Massimo,9.7,14,5,6,7,1,4,16,25.0,12,9,0,9,3,17,6,0
1759,Arthur Masuaku,7.2,31,23,19,11,1,14,23,60.9,9,9,1,8,9,40,17,0
1760,Jaime Mata,7.5,7,5,3,1,3,1,9,11.1,8,4,1,3,1,8,5,0
1761,Juan Mata,2.6,6,4,2,3,1,3,5,60.0,2,1,0,1,1,7,1,0
1762,Pape Matar Sarr,23.7,45,26,21,23,1,18,39,46.2,21,33,3,30,29,74,22,0
1763,Eliot Matazo,8.8,8,7,4,4,0,2,11,18.2,9,11,3,8,13,21,9,0
1764,Ales Mateju,8.1,16,12,10,5,1,13,29,44.8,16,10,6,4,9,25,15,0
1765,Jean-Philippe Mateta,12.7,8,4,2,5,1,3,18,16.7,15,11,3,8,4,12,13,0
1766,Nemanja Matic,15.4,31,18,19,11,1,15,31,48.4,16,21,6,15,31,62,21,3
1768,Joel Matip,31.0,47,34,23,19,5,20,31,64.5,11,26,14,12,44,91,93,1
1769,Chrislain Matsima,1.5,3,2,1,2,0,2,7,28.6,5,3,3,0,1,4,6,1
1770,Azor Matusiwa,27.4,58,32,28,26,4,26,55,47.3,29,49,19,30,62,120,43,0
1771,Neal Maupay,25.3,17,10,2,6,9,4,18,22.2,14,21,2,19,2,19,2,0
1772,Stephy Mavididi,25.5,24,13,11,7,6,14,39,35.9,25,23,2,21,8,32,11,0
1773,Konstantinos Mavropanos,30.1,57,39,35,21,1,30,51,58.8,21,46,23,23,69,126,174,2
1774,Eric Maxim Choupo-Moting,4.2,10,9,3,6,1,3,10,30.0,7,1,0,1,5,15,2,0
1775,Luis Maximiano,34.8,3,1,3,0,0,3,6,50.0,3,0,0,0,1,4,16,2
1777,Borja Mayoral,11.6,7,5,2,3,2,1,2,50.0,1,10,4,6,4,11,3,0
1778,Derek Mazou-Sacko,0.0,1,0,0,0,1,1,1,100.0,0,0,0,0,0,1,1,0
1779,Pasquale Mazzocchi,13.8,18,8,11,4,3,10,26,38.5,16,11,8,3,21,39,31,1
1780,Pasquale Mazzocchi,14.1,28,19,15,11,2,14,34,41.2,20,5,0,5,11,39,31,0
1781,Kevin Mbabu,15.5,31,20,21,5,5,12,23,52.2,11,25,8,17,35,66,35,0
1782,Kylian Mbappe,33.6,11,8,1,4,6,7,13,53.8,6,6,0,6,5,16,13,0
1783,Ibrahima Mbaye,1.2,1,1,1,0,0,1,2,50.0,1,1,1,0,1,2,6,0
1784,Amadou Mbengue,6.8,19,10,10,9,0,11,22,50.0,11,7,2,5,10,29,19,0
1785,Bryan Mbeumo,32.3,28,16,1,12,15,6,20,30.0,14,21,6,15,11,39,20,0
1787,Jordi Mboula,4.8,8,2,3,3,2,5,9,55.6,4,7,1,6,3,11,3,0
1788,Moustapha Mbow,1.0,6,6,3,2,1,3,3,100.0,0,0,0,0,1,7,6,0
1789,Nathanael Mbuku,15.8,14,13,4,7,3,2,8,25.0,6,14,0,14,11,25,4,0
1790,James McArthur,16.0,33,23,13,19,1,16,44,36.4,28,23,9,14,30,63,27,0
1791,James Mcatee,0.2,0,0,0,0,0,0,2,0.0,2,0,0,0,0,0,0,0
1796,John McGinn,34.3,106,64,35,55,16,54,104,51.9,50,53,6,47,35,141,34,0
1797,Weston McKennie,15.2,20,11,11,7,2,8,26,30.8,18,17,8,9,23,43,20,0
1799,Kenny McLean,30.1,42,22,18,20,4,17,59,28.8,42,29,7,22,34,76,54,0
1800,Dwight McNeil,34.5,78,49,27,38,13,33,73,45.2,40,64,11,53,35,113,31,1
1801,Scott McTominay,26.5,65,33,32,24,9,30,61,49.2,31,45,10,35,31,96,60,1
1802,Gary Medel,31.4,39,23,27,11,1,16,36,44.4,20,30,21,9,44,83,112,0
1803,Facundo Medina,28.8,61,42,34,23,4,38,62,61.3,24,24,8,16,37,98,78,3
1804,Nathan de Medina,8.6,17,10,11,6,0,6,10,60.0,4,14,3,11,10,27,28,0
1805,Ben Mee,20.4,26,12,16,7,3,12,19,63.2,7,28,22,6,24,50,94,1
1807,Hannibal Mejbri,0.8,2,1,1,1,0,1,1,100.0,0,0,0,0,0,2,0,0
1808,Farid El Melali,0.2,0,0,0,0,0,0,1,0.0,1,1,0,1,0,0,1,0
1809,Filippo Melegoni,10.9,20,12,5,8,7,8,16,50.0,8,10,1,9,11,31,8,1
1810,Oscar Melendo,11.0,11,5,4,4,3,3,13,23.1,10,4,1,3,1,12,10,0
1811,Gonzalo Melero,18.8,29,16,10,15,4,16,36,44.4,20,21,8,13,7,36,22,0
1812,Birger Meling,20.3,43,27,25,11,7,23,31,74.2,8,23,7,16,22,65,40,0
1813,Arthur Melo,10.7,25,12,10,14,1,13,24,54.2,11,11,2,9,7,32,8,1
1814,Memphis,20.6,10,4,2,4,4,3,13,23.1,10,9,1,8,3,13,4,0
1815,Houboulang Mendes,35.8,58,28,37,18,3,40,57,70.2,17,41,21,20,41,99,128,4
1816,Nuno Mendes,18.4,48,29,23,18,7,25,47,53.2,22,27,5,22,21,69,17,1
1818,Thiago Mendes,20.7,36,22,18,16,2,12,30,40.0,18,24,5,19,34,70,56,1
1821,Brais Mendez,33.6,68,35,24,35,9,26,87,29.9,61,52,6,46,37,105,30,0
1822,Edgar Mendez,17.9,25,14,11,10,4,11,34,32.4,23,16,0,16,4,29,17,0
1823,Arial Mendy,8.8,6,4,4,2,0,2,11,18.2,9,6,1,5,7,13,17,0
1824,Batista Mendy,26.8,49,28,21,22,6,23,45,51.1,22,37,6,31,34,83,40,0
1825,Benjamin Mendy,0.9,2,2,1,1,0,2,6,33.3,4,0,0,0,0,2,0,0
1826,Edouard Mendy,34.0,1,0,1,0,0,1,3,33.3,2,0,0,0,0,1,13,4
1827,Ferland Mendy,19.3,24,14,11,10,3,8,14,57.1,6,8,2,6,18,42,27,3
1828,Nampalys Mendy,11.5,12,6,8,4,0,6,17,35.3,11,7,4,3,11,23,11,1
1829,Gideon Mensah,13.4,37,24,19,12,6,18,38,47.4,20,11,2,9,16,53,21,0
1830,Jorge Mere,5.4,9,6,3,6,0,4,7,57.1,3,6,4,2,10,19,19,0
1832,Fran Merida,3.0,7,3,5,2,0,4,10,40.0,6,1,0,1,6,13,1,0
1833,Mikel Merino,32.1,71,38,21,40,10,26,67,38.8,41,50,10,40,21,92,56,2
1834,Quentin Merlin,21.4,45,28,19,20,6,26,49,53.1,23,25,4,21,27,72,29,2
1835,Martin Merquelanz,1.9,2,1,2,0,0,2,6,33.3,4,2,0,2,0,2,1,0
1836,Yildirim Mert Cetin,0.5,1,0,1,0,0,1,1,100.0,0,0,0,0,0,1,2,0
1837,Dries Mertens,15.4,16,7,1,11,4,3,16,18.8,13,8,2,6,9,25,2,0
1838,Illan Meslier,37.6,1,1,1,0,0,1,1,100.0,0,0,0,0,0,1,27,1
1839,Lionel Messi,23.9,10,3,1,5,4,3,13,23.1,10,5,0,5,4,14,0,0
1840,Junior Messias,15.9,34,18,11,14,9,15,34,44.1,19,11,1,10,17,51,17,0
1841,Thomas Meunier,15.6,29,19,13,12,4,16,33,48.5,17,10,2,8,12,41,25,1
1842,Mexer,13.6,14,10,11,3,0,11,17,64.7,6,12,7,5,21,35,60,2
1843,Marco Meyerhofer,25.3,53,35,22,22,9,24,37,64.9,13,38,19,19,47,100,64,1
1844,Matt Miazga,9.3,7,7,3,4,0,2,7,28.6,5,14,12,2,11,18,55,1
1846,Kingsley Michael,0.8,4,1,2,2,0,1,2,50.0,1,2,1,1,1,5,1,1
1847,Sven Michel,3.8,10,6,5,3,2,2,8,25.0,6,3,0,3,1,11,1,0
1848,Edouard Michut,0.8,0,0,0,0,0,0,2,0.0,2,2,0,2,1,1,2,0
1849,Miguel,9.2,7,3,1,5,1,2,15,13.3,13,6,0,6,1,8,7,0
1850,Valentin Mihaila,0.8,1,1,0,1,0,0,1,0.0,1,2,0,2,0,1,0,0
1854,William Mikelbrencis,6.8,11,5,6,4,1,6,9,66.7,3,6,3,3,5,16,9,0
1855,Nikola Milenkovic,32.5,54,32,31,20,3,29,34,85.3,5,30,15,15,39,93,94,0
1856,Arkadiusz Milik,15.7,9,2,0,5,4,4,18,22.2,14,9,1,8,3,12,10,1
1857,Sergej Milinkovic-Savic,34.4,67,44,20,32,15,29,67,43.3,38,50,9,41,34,101,43,1
1858,Vanja Milinkovic-Savic,27.0,0,0,0,0,0,0,1,0.0,1,0,0,0,0,0,7,2
1859,Eder Militao,33.7,50,32,30,12,8,20,39,51.3,19,42,20,22,52,102,107,3
1860,Luka Milivojevic,8.6,18,9,9,6,3,10,16,62.5,6,6,1,5,11,29,15,0
1861,Luis Milla,30.8,59,29,25,30,4,25,64,39.1,39,28,4,24,25,84,34,0
1862,Pere Milla,18.3,20,15,14,5,1,8,44,18.2,36,21,1,20,5,25,21,0
1863,Enzo Millot,0.6,2,0,0,2,0,0,1,0.0,1,0,0,0,1,3,1,0
1864,James Milner,9.5,28,16,12,11,5,12,29,41.4,17,19,5,14,17,45,20,0
1865,Santi Mina,26.3,27,17,8,15,4,5,32,15.6,27,28,2,26,6,33,22,0
1866,Yerry Mina,9.4,12,10,12,0,0,10,13,76.9,3,13,9,4,11,23,38,1
1867,Takumi Minamino,2.1,3,2,1,1,1,2,8,25.0,6,2,0,2,1,4,2,0
1868,Tyrone Mings,35.4,23,12,17,3,3,14,22,63.6,8,47,30,17,46,69,153,2
1869,Oscar Mingueza,9.9,25,11,12,11,2,16,23,69.6,7,5,0,5,9,34,22,1
1870,Rafa Mir,20.1,4,3,1,1,2,0,11,0.0,11,4,3,1,0,4,17,0
1872,Jorge Miramon,22.0,36,19,16,12,8,15,44,34.1,29,15,3,12,35,71,58,0
1873,Aleksei Miranchuk,8.6,11,7,3,7,1,4,12,33.3,8,3,0,3,1,12,7,0
1874,Juan Miranda,8.7,21,11,16,4,1,12,22,54.5,10,10,4,6,15,36,22,0
1875,Fabio Miretti,3.6,4,2,2,2,0,2,9,22.2,7,3,1,2,2,6,3,0
1876,Tyrick Mitchell,34.5,104,57,67,26,11,46,67,68.7,21,47,5,42,41,145,101,0
1877,Stefan Mitrovic,29.6,16,8,12,4,0,8,13,61.5,5,28,18,10,22,38,114,1
1878,Maximilian Mittelstadt,16.6,52,33,30,12,10,26,50,52.0,24,28,5,23,46,98,37,0
1879,Henrikh Mkhitaryan,27.7,45,29,11,27,7,17,52,32.7,35,33,2,31,22,67,33,0
1880,Jakub Moder,18.9,42,25,18,17,7,23,42,54.8,19,25,2,23,10,52,22,1
1881,Anthony Modeste,29.0,10,6,4,5,1,3,18,16.7,15,11,2,9,4,14,29,0
1882,Marco Modolo,4.4,6,3,4,2,0,2,5,40.0,3,6,6,0,4,10,26,0
1883,Luka Modric,22.6,18,10,8,7,3,6,27,22.2,21,10,4,6,20,38,9,0
1884,Terem Moffi,30.1,17,10,3,12,2,9,32,28.1,23,11,2,9,4,21,22,0
1885,Kevin Mohwald,3.9,7,1,3,3,1,1,7,14.3,6,3,0,3,3,10,6,0
1887,Johan Mojica,31.7,46,25,34,7,5,23,31,74.2,8,22,3,19,25,71,61,3
1888,Clinton Mola,1.3,3,1,2,1,0,2,4,50.0,2,5,5,0,3,6,2,0
1889,Jorge Molina,21.8,4,2,2,1,1,2,18,11.1,16,13,2,11,6,10,11,0
1890,Nahuel Molina,29.3,41,24,17,21,3,16,48,33.3,32,24,3,21,22,63,44,2
1891,Cristian Molinaro,6.1,12,9,10,2,0,5,7,71.4,2,7,2,5,6,18,20,0
1892,Florent Mollet,29.2,31,22,14,12,5,14,57,24.6,43,27,4,23,24,55,13,0
1893,Jon Moncayola,32.4,40,20,18,18,4,17,44,38.6,27,26,9,17,20,60,43,0
1894,Monchu,7.4,15,6,5,9,1,5,10,50.0,5,8,3,5,4,19,4,0
1895,Thomas Monconduit,25.0,41,25,19,17,5,20,57,35.1,37,21,10,11,22,63,51,1
1896,Gonzalo Montiel,11.8,15,4,8,5,2,12,24,50.0,12,8,2,6,10,25,22,0
1899,Angel Montoro,14.8,26,13,16,7,3,17,27,63.0,10,11,1,10,11,37,29,1
1900,Martin Montoya,5.8,20,12,11,7,2,15,26,57.7,11,6,0,6,11,31,20,0
1902,Alvaro Morata,25.6,18,9,4,9,5,8,31,25.8,23,26,1,25,5,23,24,0
1903,Jan Moravek,5.2,11,6,3,7,1,6,18,33.3,12,11,2,9,6,17,8,0
1904,Jon Morcillo,0.6,3,0,1,2,0,3,4,75.0,1,1,0,1,0,3,0,0
1905,Jeremy Morel,6.7,13,9,8,4,1,6,6,100.0,0,9,7,2,7,20,31,0
1906,Alberto Moreno,13.6,13,7,5,7,1,5,18,27.8,13,13,1,12,27,40,15,0
1907,Alex Moreno,26.7,76,40,53,15,8,33,60,55.0,27,28,6,22,34,110,82,1
1908,Gerard Moreno,13.2,5,2,2,2,1,1,7,14.3,6,6,1,5,6,11,14,0
1909,Tete Morente,18.1,21,14,13,7,1,7,28,25.0,21,30,1,29,12,33,12,0
1910,Ilaix Moriba,9.1,26,18,10,13,3,14,35,40.0,21,15,0,15,12,38,14,0
1911,Ilaix Moriba,0.4,0,0,0,0,0,0,4,0.0,4,2,0,2,1,1,0,0
1912,Manu Morlanes,12.7,36,15,16,17,3,18,43,41.9,25,24,5,19,13,49,17,0
1913,Raul Moro,2.2,3,3,0,2,1,1,5,20.0,4,2,0,2,0,3,0,0
1914,Loren Moron,6.3,6,4,1,3,2,0,12,0.0,12,11,1,10,2,8,9,0
1915,Loren Moron,0.0,1,1,1,0,0,1,1,100.0,0,0,0,0,0,1,0,0
1916,Tyler Morton,0.7,0,0,0,0,0,0,2,0.0,2,0,0,0,3,3,0,0
1917,Cristhian Mosquera,2.4,4,2,3,0,1,3,6,50.0,3,1,0,1,3,7,1,1
1918,Lebo Mothiba,5.8,8,4,4,3,1,2,5,40.0,3,3,0,3,2,10,0,0
1921,Baptiste Mouazan,1.1,4,3,2,2,0,1,3,33.3,2,3,0,3,1,5,1,0
1922,Aimen Moueffek,4.8,7,4,2,3,2,2,8,25.0,6,3,0,3,2,9,4,0
1924,Youssoufa Moukoko,2.5,1,0,0,1,0,0,1,0.0,1,5,0,5,3,4,0,0
1925,Harold Moukoudi,18.5,25,12,17,8,0,14,25,56.0,11,27,14,13,35,60,48,0
1927,Steve Mounie,25.7,17,6,3,12,2,4,27,14.8,23,13,1,12,6,23,12,0
1928,Mason Mount,26.3,41,16,10,17,14,10,34,29.4,24,18,1,17,13,54,12,0
1929,Lucas Moura,19.7,25,10,7,14,4,8,35,22.9,27,19,0,19,18,43,19,0
1931,Joao Moutinho,33.0,74,39,34,27,13,30,106,28.3,76,48,8,40,34,108,36,2
1932,Samuel Moutoussamy,16.8,48,32,20,20,8,23,62,37.1,39,14,2,12,17,65,16,0
1933,Toni Moya,15.4,23,10,7,13,3,13,43,30.2,30,18,5,13,20,43,18,0
1935,Nordi Mukiele,20.5,35,22,23,9,3,14,27,51.9,13,31,5,26,31,66,44,2
1936,Mert Muldur,22.7,52,35,43,7,2,27,49,55.1,22,25,6,19,24,76,44,1
1937,Florian Muller,30.0,0,0,0,0,0,0,1,0.0,1,1,0,1,0,0,13,2
1938,Thomas Muller,28.4,35,20,7,16,12,16,54,29.6,38,32,1,31,15,50,12,0
1940,Marshall Munetsi,20.9,34,17,21,11,2,17,39,43.6,22,39,13,26,43,77,72,2
1941,Iker Muniain,30.9,32,10,8,19,5,12,40,30.0,28,20,1,19,17,49,8,1
1942,Aihen Munoz,14.9,28,17,14,13,1,18,29,62.1,11,11,1,10,17,45,34,0
1943,Luis Muriel,17.1,15,4,2,7,6,3,19,15.8,16,12,0,12,4,19,5,0
1944,Jeison Murillo,12.4,15,10,13,2,0,9,13,69.2,4,11,8,3,17,32,37,0
1945,Vedat Muriqi,2.4,1,0,1,0,0,0,5,0.0,5,0,0,0,0,1,2,0
1946,Vedat Muriqi,16.0,6,3,1,3,2,1,7,14.3,6,12,0,12,6,12,29,0
1947,Jacob Murphy,16.4,49,26,34,11,4,26,41,63.4,15,20,2,18,23,72,17,0
1948,Nicola Murru,10.9,22,17,10,11,1,8,13,61.5,5,17,3,14,7,29,20,1
1950,Yunus Musah,14.0,23,13,8,8,7,6,20,30.0,14,19,1,18,14,37,11,0
1952,Jamal Musiala,16.3,40,26,11,16,13,15,36,41.7,21,25,0,25,19,59,2,1
1954,Shkodran Mustafi,7.3,9,6,6,3,0,5,9,55.6,4,6,3,3,15,24,40,0
1955,Junior Mwanga,1.0,5,2,4,1,0,3,3,100.0,0,1,0,1,0,5,1,0
1956,Enock Mwepu,11.1,22,12,10,10,2,5,27,18.5,22,20,2,18,12,34,19,0
1957,Vitaliy Mykolenko,11.7,25,15,15,7,3,12,21,57.1,9,15,2,13,16,41,37,0
1958,Joakim Maehle,16.3,21,11,6,9,6,12,27,44.4,15,18,2,16,14,35,13,0
1960,Obite N'Dicka,31.7,60,34,29,27,4,44,59,74.6,15,46,20,26,48,108,137,0
1961,Kevin N'Doram,13.7,10,8,3,5,2,3,20,15.0,17,24,5,19,19,29,21,0
1962,Eric N'Jo,1.1,0,0,0,0,0,0,1,0.0,1,1,1,0,2,2,1,0
1963,Vital N'Simba,31.0,66,45,38,23,5,36,63,57.1,27,28,7,21,29,95,30,0
1964,Nacho,17.3,18,14,9,9,0,12,22,54.5,10,22,15,7,34,52,50,0
1965,Mickael Nade,28.5,57,35,37,18,2,23,38,60.5,15,29,15,14,60,117,84,0
1966,Marvelous Nakamba,10.0,32,19,18,14,0,12,34,35.3,22,14,4,10,12,44,17,1
1967,Nahitan Nandez,16.9,39,21,16,15,8,18,33,54.5,15,16,1,15,9,48,15,1
1968,Nani,3.2,2,1,1,1,0,0,1,0.0,1,1,0,1,2,4,0,1
1969,Paul Nardi,22.0,1,0,1,0,0,1,2,50.0,1,0,0,0,0,1,10,2
1970,Nikolas Nartey,4.5,6,3,0,5,1,3,9,33.3,6,4,2,2,7,13,5,0
1971,Matija Nastasic,2.4,1,1,1,0,0,1,1,100.0,0,1,1,0,5,6,11,0
1972,Roberto Navarro,2.2,5,3,1,1,3,3,5,60.0,2,2,0,2,2,7,2,0
1973,Ximo Navarro,15.0,28,19,21,6,1,13,27,48.1,14,11,5,6,22,50,56,2
1974,Jesus Navas,19.8,18,13,11,5,2,9,17,52.9,8,15,2,13,17,35,26,1
1977,Papa Ndiaga Yade,7.7,15,10,8,7,0,8,18,44.4,10,4,1,3,10,25,9,0
1978,Wilfred Ndidi,18.0,60,32,32,27,1,22,55,40.0,33,36,8,28,42,102,54,1
1979,Tanguy Ndombele,5.4,10,7,3,5,2,1,8,12.5,7,5,0,5,1,11,1,0
1980,Tanguy Ndombele,7.8,25,14,5,17,3,12,19,63.2,7,8,3,5,3,28,6,2
1981,Dan Ndoye,2.3,0,0,0,0,0,0,2,0.0,2,4,0,4,0,0,0,0
1982,Paul Nebel,2.5,5,3,3,1,1,2,3,66.7,1,0,0,0,0,5,1,0
1983,Alvaro Negredo,24.0,5,3,1,4,0,3,6,50.0,3,11,5,6,2,7,23,0
1984,Reiss Nelson,0.2,1,0,0,0,1,0,1,0.0,1,1,0,1,0,1,0,0
1985,David Nemeth,3.5,3,2,2,1,0,1,3,33.3,2,5,1,4,6,9,11,1
1986,Ilija Nestorovski,2.1,0,0,0,0,0,0,3,0.0,3,0,0,0,0,0,4,0
1988,Pedro Neto,5.2,4,4,2,0,2,0,9,0.0,9,0,0,0,6,10,1,0
1989,Luca Netz,15.5,24,11,12,10,2,11,40,27.5,29,24,4,20,13,37,33,1
1990,Manuel Neuer,27.9,2,1,2,0,0,1,2,50.0,1,0,0,0,0,2,7,1
1991,Florian Neuhaus,23.6,55,28,24,26,5,27,64,42.2,37,38,6,32,31,86,19,4
1992,Carlos Neva,23.4,31,19,24,7,0,16,28,57.1,12,27,9,18,32,63,81,0
1993,Ruben Neves,29.6,68,37,23,41,4,24,87,27.6,63,39,5,34,41,109,49,3
1994,Neymar,20.6,29,19,5,12,12,12,36,33.3,24,9,1,8,4,33,2,1
1995,Yvan Neyou,10.4,29,13,14,12,3,9,27,33.3,18,8,3,5,23,52,13,0
1996,Jeremy Ngakia,10.0,31,18,23,5,3,11,26,42.3,15,11,4,7,12,43,32,0
1997,Jessic Ngankam,3.8,3,1,1,1,1,1,2,50.0,1,3,0,3,0,3,1,0
1998,Opa Nguette,11.6,21,14,9,6,6,5,14,35.7,9,13,3,10,2,23,9,0
1999,Aurelien Nguiamba,0.6,3,2,1,2,0,2,3,66.7,1,2,1,1,0,3,1,0
2000,Sikou Niakate,7.3,8,7,8,0,0,4,11,36.4,7,5,3,2,27,35,34,0
2002,Moussa Niakhate,28.5,40,23,25,13,2,20,33,60.6,13,37,11,26,50,90,69,1
2003,Ibrahima Niane,17.6,1,1,0,1,0,0,5,0.0,5,6,1,5,3,4,16,0
2004,M'Baye Niang,8.6,4,0,0,2,2,0,4,0.0,4,9,1,8,1,5,4,0
2005,Tanguy Nianzou,6.5,11,7,7,3,1,7,11,63.6,4,7,2,5,7,18,17,0
2006,Cheikh Niasse,0.5,2,2,0,2,0,2,3,66.7,1,1,1,0,1,3,2,0
2007,Florian Niederlechner,12.9,6,5,1,3,2,4,13,30.8,9,9,0,9,4,10,7,0
2008,Havard Nielsen,15.2,17,12,5,11,1,8,21,38.1,13,18,1,17,7,24,22,0
2009,Saul Niguez,5.3,20,9,11,9,0,9,16,56.3,7,14,3,11,7,27,10,1
2010,Saul Niguez,2.2,7,2,0,6,1,3,4,75.0,1,7,1,6,0,7,3,0
2011,Dimitris Nikolaou,36.0,39,26,29,7,3,22,34,64.7,12,48,24,24,49,88,132,1
2012,Joakim Nilsson,30.4,37,19,24,13,0,20,26,76.9,6,36,23,13,56,93,143,1
2013,Casimir Ninga,4.5,5,1,1,4,0,2,5,40.0,3,2,0,2,1,6,0,0
2014,Fernando Nino,9.8,10,4,3,2,5,2,12,16.7,10,9,2,7,3,13,15,0
2015,Eddie Nketiah,9.3,9,4,1,4,4,1,4,25.0,3,9,2,7,4,13,5,0
2017,Christopher Nkunku,30.3,23,10,10,11,2,9,35,25.7,26,23,2,21,15,38,15,0
2018,Felix Nmecha,3.6,3,1,1,1,1,0,2,0.0,2,2,0,2,7,10,6,0
2019,Lukas Nmecha,18.1,12,5,5,5,2,5,19,26.3,14,9,1,8,4,16,10,0
2020,Mark Noble,3.7,8,2,7,1,0,5,11,45.5,6,4,1,3,4,12,2,1
2022,Nolito,15.4,25,15,14,7,4,13,47,27.7,34,20,1,19,9,34,5,0
2023,Arnaud Nordin,20.8,21,11,8,8,5,8,22,36.4,14,19,0,19,6,27,8,0
2024,Havard Nordtveit,3.4,7,6,2,4,1,4,4,100.0,0,2,1,1,10,17,11,0
2025,Mathias Normann,18.3,34,21,19,14,1,17,46,37.0,29,17,8,9,19,53,43,1
2026,Connor Noss,0.6,1,0,0,1,0,0,1,0.0,1,1,1,0,0,1,0,0
2028,Hugo Novoa,1.5,4,4,2,0,2,2,7,28.6,5,2,0,2,1,5,0,0
2029,Soma Novothny,0.9,1,1,1,0,0,0,1,0.0,1,1,0,1,0,1,2,0
2031,Randy Ntekja,16.2,24,13,9,11,4,8,19,42.1,11,21,1,20,8,32,12,0
2032,Alexander Nubel,38.0,0,0,0,0,0,0,1,0.0,1,0,0,0,0,0,11,1
2033,Kasim Nuhu,0.1,0,0,0,0,0,0,1,0.0,1,0,0,0,0,0,1,0
2034,Unai Nunez,6.9,4,4,2,2,0,3,6,50.0,3,9,8,1,8,12,26,2
2035,Hans Nunoo Sarpei,7.1,16,11,9,7,0,10,14,71.4,4,8,5,3,14,30,21,0
2036,Bram Nuytinck,22.6,38,24,24,13,1,15,34,44.1,19,42,31,11,22,60,101,0
2037,Simeon Nwankwo,9.4,5,5,0,4,1,4,10,40.0,6,8,3,5,3,8,10,0
2038,Gerzino Nyamsi,33.2,35,21,24,9,2,20,27,74.1,7,25,16,9,25,60,90,1
2039,Allan Nyom,2.7,3,1,2,1,0,2,2,100.0,0,2,1,1,2,5,7,0
2040,M'Bala Nzola,11.9,2,2,0,0,2,1,6,16.7,5,8,0,8,0,2,13,0
2041,Christian Norgaard,33.9,109,60,42,58,9,52,101,51.5,49,48,9,39,64,173,58,1
2042,Adam Obert,3.0,8,5,6,2,0,5,6,83.3,1,6,4,2,4,12,11,0
2043,Joel Obi,12.7,23,14,5,14,4,5,12,41.7,7,17,6,11,10,33,7,0
2045,Lucas Ocampos,23.6,45,24,23,18,4,23,55,41.8,32,35,1,34,9,54,24,1
2046,Bastian Oczipka,10.4,24,15,15,7,2,10,13,76.9,3,10,2,8,12,36,21,0
2048,Alvaro Odriozola,19.3,25,15,12,6,7,15,32,46.9,17,17,6,11,8,33,25,2
2049,Angelo Ogbonna,10.2,7,4,5,2,0,3,7,42.9,4,5,4,1,11,18,29,0
2050,Florent Ogier,27.0,31,17,18,12,1,17,31,54.8,14,41,27,14,37,68,89,0
2052,David Okereke,22.8,16,10,4,9,3,3,20,15.0,17,19,3,16,10,26,20,0
2054,Masaya Okugawa,28.1,46,25,18,22,6,12,37,32.4,25,29,1,28,20,66,13,0
2055,Lucas Olaza,3.3,5,3,3,1,1,1,1,100.0,0,5,1,4,4,9,6,0
2058,Michael Olise,12.7,22,18,8,11,3,7,24,29.2,17,17,0,17,6,28,6,0
2059,Christian Oliva,0.5,2,2,2,0,0,1,4,25.0,3,0,0,0,0,2,0,0
2060,Brian Olivan,24.3,33,20,22,9,2,12,23,52.2,11,17,7,10,28,61,63,0
2061,Sergio Oliveira,9.9,27,14,11,14,2,15,30,50.0,15,13,0,13,10,37,7,0
2062,Mathias Olivera,31.1,79,47,39,34,6,40,69,58.0,29,45,4,41,55,134,67,1
2063,Dani Olmo,8.3,14,6,5,7,2,5,18,27.8,13,5,1,4,4,18,1,0
2065,Warmed Omari,31.1,33,17,22,10,1,15,23,65.2,8,20,13,7,31,64,94,5
2066,Jonas Omlin,28.7,2,1,2,0,0,2,3,66.7,1,0,0,0,0,2,12,3
2067,Andrew Omobamidele,4.2,8,6,5,3,0,5,11,45.5,6,8,8,0,5,13,13,0
2068,Amadou Onana,15.1,48,31,17,27,4,18,25,72.0,7,10,3,7,30,78,19,0
2069,Jean Onana,20.4,70,49,33,33,4,35,86,40.7,51,37,5,32,36,106,23,1
2070,Karim Onisiwo,26.2,18,10,4,6,8,7,22,31.8,15,27,2,25,7,25,8,0
2071,Javier Ontiveros,0.4,0,0,0,0,0,0,2,0.0,2,0,0,0,1,1,0,1
2073,Frank Onyeka,11.6,25,17,13,9,3,8,27,29.6,19,16,2,14,14,39,13,0
2074,Willi Orban,29.4,32,22,20,11,1,13,25,52.0,12,40,24,16,44,76,123,2
2075,Divock Origi,1.5,0,0,0,0,0,0,2,0.0,2,1,0,1,1,1,2,0
2076,Riccardo Orsolini,19.8,21,13,9,11,1,13,29,44.8,16,9,4,5,5,26,14,0
2077,Stefan Ortega,33.0,1,0,1,0,0,1,2,50.0,1,2,0,2,0,1,5,1
2080,Victor Osimhen,22.0,10,5,1,2,7,2,6,33.3,4,16,3,13,3,13,17,0
2083,Patrick Osterhage,6.7,9,6,3,5,1,3,7,42.9,4,7,1,6,11,20,8,0
2084,Tomas Ostrak,0.3,1,0,0,0,1,1,3,33.3,2,0,0,0,1,2,0,0
2085,Otavio,12.7,36,23,13,21,2,16,39,41.0,23,9,3,6,18,54,11,0
2086,Paulo Otavio,4.0,14,10,7,4,3,8,15,53.3,7,11,6,5,4,18,9,0
2087,Dango Ouattara,9.0,21,15,9,11,1,11,23,47.8,12,10,1,9,14,35,15,1
2088,Remi Oudin,19.3,34,18,19,13,2,18,32,56.3,14,14,3,11,27,61,21,0
2089,Alexandre Oukidja,20.8,0,0,0,0,0,0,1,0.0,1,1,0,1,1,1,17,2
2090,Azzedine Ounahi,18.1,39,22,16,22,1,11,40,27.5,29,19,1,18,26,65,13,0
2091,Adam Ounas,3.6,6,1,0,3,3,3,7,42.9,4,3,0,3,2,8,3,0
2093,Reece Oxford,29.9,27,14,16,9,2,15,31,48.4,16,42,33,9,72,99,172,1
2094,Alex Oxlade-Chamberlain,8.7,15,11,2,8,5,3,14,21.4,11,12,2,10,6,21,5,0
2095,Mikel Oyarzabal,18.6,18,10,7,7,4,7,21,33.3,14,18,2,16,10,28,16,1
2096,Ambroise Oyongo,7.3,13,4,7,4,2,9,15,60.0,6,5,1,4,6,19,17,0
2097,Salih Ozcan,25.7,42,30,14,23,5,22,51,43.1,29,37,5,32,51,93,35,1
2098,Levin Oztunali,6.4,14,11,6,5,3,7,17,41.2,10,3,0,3,4,18,12,0
2099,Fernando Pacheco,33.9,2,1,2,0,0,2,2,100.0,0,0,0,0,0,2,18,1
2100,Jon Pacheco,4.2,6,4,4,2,0,3,3,100.0,0,6,4,2,6,12,18,0
2101,Goncalo Paciencia,5.7,4,2,2,1,1,1,3,33.3,2,2,0,2,1,5,4,0
2103,Simone Pafundi,0.3,0,0,0,0,0,0,1,0.0,1,0,0,0,0,0,0,0
2104,Vincent Pajot,25.7,86,56,35,47,4,20,46,43.5,26,33,6,27,51,137,38,0
2106,Exequiel Palacios,12.2,30,19,12,14,4,15,38,39.5,23,20,1,19,28,58,11,2
2107,Helibelton Palacios,21.5,69,38,56,10,3,37,55,67.3,18,21,8,13,18,87,61,0
2108,Isaac Palazon Camacho,25.4,42,28,20,19,3,18,59,30.5,41,31,3,28,13,55,22,0
2109,Nicolas Pallois,27.2,51,33,40,11,0,34,59,57.6,25,40,19,21,53,104,116,1
2110,Cole Palmer,1.4,2,1,1,1,0,0,2,0.0,2,3,0,3,1,3,0,0
2111,Erik Palmer-Brown,19.3,37,22,29,8,0,20,26,76.9,6,26,18,8,34,71,87,1
2113,Emerson Palmieri,25.2,46,25,16,22,8,22,34,64.7,12,23,8,15,27,73,66,0
2114,Martin Palumbo,0.1,0,0,0,0,0,0,1,0.0,1,0,0,0,0,0,0,0
2115,Goran Pandev,9.4,2,0,1,0,1,0,9,0.0,9,3,1,2,2,4,0,0
2117,Milos Pantovic,17.0,19,10,8,7,4,6,25,24.0,19,26,4,22,18,37,14,0
2119,Matondo-Merveille Papela,0.9,3,2,2,1,0,2,3,66.7,1,2,0,2,2,5,0,0
2120,Lucas Paqueta,30.0,68,38,24,26,18,17,51,33.3,34,43,5,38,9,77,22,0
2123,Leandro Paredes,9.3,23,13,9,11,3,12,24,50.0,12,10,6,4,10,33,5,2
2124,Daniel Parejo,30.0,43,29,15,15,13,20,52,38.5,32,32,7,25,29,72,19,1
2125,Fabiano Parisi,16.4,35,19,25,5,5,13,31,41.9,18,30,10,20,22,57,42,0
2126,Raul Parra,1.0,2,1,2,0,0,1,3,33.3,2,0,0,0,0,2,5,0
2127,Thomas Partey,22.5,43,29,22,17,4,18,44,40.9,26,22,4,18,23,66,35,2
2128,Mario Pasalic,22.2,27,12,8,13,6,12,30,40.0,18,27,6,21,20,47,14,0
2129,Felix Passlack,5.2,13,9,8,4,1,6,12,50.0,6,5,1,4,4,17,7,0
2130,Javier Pastore,5.8,7,3,3,2,2,3,12,25.0,9,5,1,4,4,11,2,0
2132,Patric,18.3,21,15,17,4,0,9,20,45.0,11,22,11,11,12,33,44,2
2134,Paulinho,13.5,22,13,6,13,3,13,27,48.1,14,14,1,13,6,28,7,0
2135,Gabriel Paulista,17.7,21,12,16,5,0,14,20,70.0,6,18,12,6,39,60,88,0
2136,Benjamin Pavard,23.1,35,20,21,13,1,19,29,65.5,10,28,16,12,36,71,50,1
2137,Strahinja Pavlovic,5.0,23,16,8,13,2,8,12,66.7,4,5,3,2,9,32,15,0
2138,Leonardo Pavoletti,16.9,10,6,2,5,3,3,9,33.3,6,9,5,4,2,12,12,0
2139,Dimitri Payet,28.8,16,8,4,10,2,7,31,22.6,24,9,0,9,9,25,3,0
2140,Mads Pedersen,15.5,28,21,8,15,5,12,27,44.4,15,13,4,9,15,43,30,0
2141,Alfonso Pedraza,18.9,34,16,17,12,5,10,28,35.7,18,12,3,9,31,65,32,0
2142,Pedri,9.8,20,12,9,8,3,7,20,35.0,13,13,0,13,5,25,7,1
2143,Pedro,22.6,36,23,8,19,9,16,47,34.0,31,18,2,16,6,42,8,0
2144,Joao Pedro,36.9,15,12,2,8,5,4,18,22.2,14,23,5,18,8,23,18,1
2145,Adria Pedrosa,30.2,58,30,38,14,6,26,57,45.6,31,25,7,18,25,83,92,2
2147,Peter Pekarik,24.8,45,29,33,11,1,32,46,69.6,14,28,10,18,29,74,58,0
2148,Pietro Pellegri,2.4,1,1,0,1,0,0,4,0.0,4,0,0,0,0,1,5,0
2149,Pietro Pellegri,1.5,2,2,0,1,1,0,1,0.0,1,0,0,0,0,2,1,0
2150,Lorenzo Pellegrini,25.4,35,14,10,17,8,16,60,26.7,44,29,1,28,27,62,20,0
2151,Luca Pellegrini,12.3,23,10,13,5,5,12,19,63.2,7,9,1,8,5,28,23,0
2152,Facundo Pellistri,7.5,9,5,4,3,2,1,10,10.0,9,13,2,11,6,15,7,0
2153,Federico Peluso,0.1,1,1,0,1,0,1,1,100.0,0,0,0,0,0,1,0,0
2154,Timothee Pembele,15.7,20,8,8,10,2,10,29,34.5,19,12,3,9,16,36,24,0
2155,Ruben Pena,1.5,2,0,1,1,0,2,6,33.3,4,1,0,1,5,7,2,0
2158,Nicolas Pepe,7.7,8,5,3,5,0,3,9,33.3,6,9,1,8,8,16,2,0
2159,Ricardo Pepi,5.3,4,2,1,3,0,1,8,12.5,7,7,0,7,3,7,8,0
2160,Alberto Perea,8.6,19,9,7,9,3,6,20,30.0,14,15,1,14,9,28,4,0
2161,Brayann Pereira,0.2,1,1,1,0,0,1,1,100.0,0,0,0,0,0,1,1,0
2162,Danilo Pereira,22.6,33,17,10,20,3,14,28,50.0,14,19,10,9,37,70,29,1
2163,Mathias Pereira Lage,11.6,21,7,10,7,4,8,30,26.7,22,18,7,11,21,42,22,0
2164,Ricardo Pereira,11.0,37,20,19,13,5,21,40,52.5,19,13,1,12,17,54,39,0
2165,Gaston Pereiro,10.8,13,5,7,4,2,5,18,27.8,13,12,1,11,1,14,8,0
2166,Luan Peres Petroni,29.8,65,35,33,25,7,36,52,69.2,16,26,12,14,43,108,64,1
2167,Dor Peretz,6.5,27,18,8,16,3,13,25,52.0,12,8,4,4,8,35,11,0
2168,Roberto Pereyra,19.9,18,12,7,6,5,7,23,30.4,16,26,5,21,12,30,11,0
2169,Ayoze Perez,4.9,4,2,0,3,1,0,13,0.0,13,11,1,10,2,6,5,0
2170,Carles Perez,6.2,8,3,3,1,4,3,12,25.0,9,10,0,10,2,10,2,0
2171,Inigo Perez,3.8,3,2,2,1,0,2,4,50.0,2,1,0,1,0,3,3,0
2172,Juan Perez,2.0,0,0,0,0,0,0,1,0.0,1,0,0,0,0,0,1,1
2173,Kike Perez,5.8,8,6,1,3,4,0,10,0.0,10,6,1,5,3,11,4,0
2174,Lucas Perez,14.1,4,1,2,1,1,3,10,30.0,7,2,0,2,3,7,4,0
2175,Lucas Perez,11.8,3,3,2,1,0,0,10,0.0,10,3,1,2,0,3,1,0
2176,Nehuen Perez,18.8,44,21,21,21,2,16,25,64.0,9,27,9,18,21,65,47,0
2178,Ivan Perisic,31.3,38,22,18,11,9,28,50,56.0,22,39,7,32,47,85,42,0
2180,Diego Perotti,3.2,11,5,7,1,3,4,13,30.8,9,1,0,1,2,13,6,0
2181,Romain Perraud,18.0,34,22,18,14,2,16,29,55.2,13,24,6,18,17,51,42,0
2182,Lucas Perrin,27.8,43,32,24,17,2,26,45,57.8,19,28,11,17,42,85,67,0
2186,Matteo Pessina,16.0,27,14,10,11,6,14,33,42.4,19,22,3,19,13,40,7,0
2187,Andrea Petagna,6.5,3,3,0,3,0,1,4,25.0,3,1,0,1,0,3,5,0
2188,Nils Petersen,6.4,5,3,2,3,0,1,13,7.7,12,7,0,7,2,7,17,0
2189,Danijel Petkovic,15.0,0,0,0,0,0,0,1,0.0,1,0,0,0,1,1,9,5
2190,Leo Petrot,20.2,31,17,23,8,0,21,29,72.4,8,33,17,16,22,53,86,0
2191,Njegos Petrovic,10.2,24,11,4,19,1,8,14,57.1,6,16,4,12,9,33,11,0
2192,Jens Petter Hauge,11.6,14,5,6,7,1,7,23,30.4,16,7,0,7,3,17,5,0
2193,Alex Petxa,4.6,12,9,4,7,1,4,8,50.0,4,8,2,6,4,16,6,0
2194,German Pezzella,22.1,21,9,16,5,0,16,29,55.2,13,29,18,11,39,60,106,0
2195,Giuseppe Pezzella,11.9,28,13,15,7,6,8,18,44.4,10,13,5,8,9,37,16,0
2197,Maximilian Philipp,10.7,15,11,6,7,2,5,21,23.8,16,12,1,11,4,19,5,0
2199,Kalvin Phillips,17.7,54,25,24,25,5,24,57,42.1,33,37,9,28,24,78,18,0
2202,Krzysztof Piatek,8.1,5,4,1,1,3,2,3,66.7,1,6,0,6,2,7,8,0
2203,Krzysztof Piatek,3.9,2,2,0,1,1,0,1,0.0,1,0,0,0,0,2,6,0
2204,Pablo Piatti,3.5,9,4,5,3,1,3,8,37.5,5,5,1,4,2,11,3,0
2205,Cristiano Piccini,3.6,14,8,9,5,0,5,7,71.4,2,3,2,1,1,15,11,0
2207,Roberto Piccoli,2.2,2,0,0,0,2,0,2,0.0,2,1,0,1,0,2,0,0
2208,Jordan Pickford,35.0,1,1,1,0,0,0,1,0.0,1,1,0,1,1,2,14,1
2211,Amos Pieper,26.4,58,29,38,19,1,32,51,62.7,19,37,23,14,50,108,132,1
2212,Ronael Pierre-Gabriel,28.3,79,45,52,21,6,42,73,57.5,31,22,7,15,48,127,74,0
2213,Erik Pieters,8.1,28,15,15,11,2,17,28,60.7,11,18,7,11,10,38,38,0
2214,Tomas Pina Isla,16.0,28,16,13,11,4,14,29,48.3,15,12,3,9,22,50,23,0
2215,Andrea Pinamonti,31.9,11,6,0,7,4,2,18,11.1,16,24,3,21,7,18,23,0
2216,Orbelin Pineda,1.1,4,1,4,0,0,1,2,50.0,1,0,0,0,0,4,1,0
2217,Ethan Pinnock,29.9,51,35,37,12,2,25,38,65.8,13,30,11,19,44,95,154,1
2218,Yeremi Pino,18.6,32,14,14,8,10,10,24,41.7,14,33,4,29,6,38,12,1
2221,Gerard Pique,23.2,22,12,18,4,0,11,14,78.6,3,19,16,3,34,56,86,1
2222,Marko Pjaca,12.8,7,4,1,4,2,3,8,37.5,5,10,2,8,4,11,2,0
2223,Marvin Plattenhardt,18.2,25,11,18,6,1,15,27,55.6,12,18,3,15,17,42,52,0
2224,Alassane Plea,23.0,18,14,6,9,3,7,20,35.0,13,9,1,8,4,22,9,0
2225,Tommaso Pobega,24.9,48,30,17,20,11,21,40,52.5,19,32,3,29,25,73,38,0
2226,Daniel Podence,16.5,18,11,10,5,3,4,17,23.5,13,8,1,7,10,28,1,0
2227,Suf Podgoreanu,1.3,2,0,1,1,0,1,4,25.0,3,2,0,2,1,3,3,0
2228,Paul Pogba,15.0,13,9,5,7,1,6,28,21.4,22,11,0,11,13,26,16,0
2230,Matteo Politano,18.3,24,12,8,11,5,15,54,27.8,39,11,2,9,13,37,5,0
2232,Sebastian Polter,26.0,9,3,1,4,4,2,11,18.2,9,15,5,10,2,11,24,0
2233,Ezequiel Ponce,7.4,5,4,1,3,1,3,10,30.0,7,5,0,5,1,6,7,0
2234,Marin Pongracic,9.2,17,10,13,4,0,6,10,60.0,4,11,5,6,17,34,32,2
2236,Pere Pons,15.2,26,18,4,20,2,7,21,33.3,14,10,1,9,6,32,11,0
2237,Nick Pope,36.0,0,0,0,0,0,0,2,0.0,2,0,0,0,2,2,30,3
2238,Manolo Portanova,14.7,46,28,9,26,11,14,34,41.2,20,26,2,24,17,63,22,0
2239,Portu,17.7,16,7,2,6,8,3,19,15.8,16,21,3,18,7,23,8,0
2240,Stefan Posch,24.4,48,30,20,26,2,22,39,56.4,17,43,18,25,28,76,71,2
2241,Sergio Postigo,9.4,11,7,8,2,1,4,8,50.0,4,7,5,2,7,18,45,1
2242,Yussuf Poulsen,12.0,13,4,3,6,4,3,13,23.1,10,13,0,13,3,16,9,0
2243,Gaetan Poussin,13.0,1,1,1,0,0,1,1,100.0,0,0,0,0,0,1,15,1
2244,Dario Poveda,4.2,2,0,1,0,1,0,5,0.0,5,7,1,6,1,3,1,0
2245,Jose Pozo,0.8,2,2,0,2,0,2,3,66.7,1,1,0,1,0,2,1,0
2246,Dennis Praet,17.1,19,10,6,8,5,8,22,36.4,14,12,1,11,3,22,4,0
2248,Abdon Prats,7.1,2,2,1,0,1,1,5,20.0,4,5,0,5,1,3,6,0
2249,Sanjin Prcic,24.3,47,28,14,27,6,14,29,48.3,15,18,3,15,47,94,19,0
2250,Nicolas de Preville,21.9,17,8,7,8,2,3,19,15.8,16,12,4,8,5,22,11,0
2252,Manuel Prietl,23.6,59,26,23,31,5,23,60,38.3,37,28,3,25,39,98,33,0
2254,Grischa Promel,26.9,36,22,14,17,5,22,52,42.3,30,18,3,15,23,59,22,0
2256,Ivan Provedel,30.7,0,0,0,0,0,0,1,0.0,1,0,0,0,2,2,10,2
2257,Javi Puado,24.9,24,14,18,5,1,12,37,32.4,25,18,2,16,11,35,24,0
2258,Pubill,5.7,12,6,10,2,0,4,8,50.0,4,7,2,5,4,16,8,2
2259,Antonio Puertas,25.1,34,20,18,12,4,17,44,38.6,27,33,3,30,11,45,36,0
2260,Riqui Puig,5.4,6,3,2,4,0,2,14,14.3,12,5,0,5,3,9,0,0
2262,Teemu Pukki,36.1,23,11,2,14,7,6,29,20.7,23,21,1,20,4,27,3,0
2263,Erick Pulgar,3.8,6,6,4,2,0,4,9,44.4,5,5,1,4,5,11,2,1
2264,Christian Pulisic,14.3,10,7,6,3,1,3,17,17.6,14,12,0,12,5,15,10,0
2265,Afimico Pululu,0.8,1,0,1,0,0,1,2,50.0,1,1,0,1,0,1,0,0
2266,Ignacio Pussetto,13.4,17,9,2,9,6,2,10,20.0,8,18,2,16,4,21,13,0
2267,Niklas Pyyhtia,0.2,0,0,0,0,0,0,1,0.0,1,0,0,0,0,0,0,0
2268,Przemyslaw Placheta,5.6,4,3,3,1,0,2,7,28.6,5,3,1,2,2,6,5,1
2270,Fabio Quagliarella,18.5,6,2,2,2,2,2,15,13.3,13,14,1,13,3,9,12,0
2271,Quini,25.6,73,34,48,21,4,42,79,53.2,37,28,10,18,36,109,62,0
2272,Dani Raba,1.0,1,0,0,1,0,1,2,50.0,1,2,0,2,0,1,2,0
2273,Dani Raba,0.3,2,2,1,0,1,2,3,66.7,1,0,0,0,1,3,0,0
2274,Adrien Rabiot,25.4,64,43,32,24,8,15,34,44.1,19,34,8,26,20,84,41,1
2275,Uros Racic,13.4,32,18,9,19,4,12,33,36.4,21,16,6,10,16,48,21,0
2276,Nemanja Radoja,13.5,25,8,9,13,3,8,20,40.0,12,16,9,7,22,47,16,2
2278,Ivan Radovanovic,11.7,11,7,8,3,0,7,19,36.8,12,14,7,7,7,18,29,0
2280,Stefan Radu,6.2,9,6,3,6,0,5,9,55.6,4,7,2,5,5,14,15,0
2283,Rafinha,11.7,43,27,17,20,6,16,28,57.1,12,21,2,19,12,55,4,0
2284,Rafinha,2.4,14,8,3,9,2,7,11,63.6,4,3,0,3,4,18,0,0
2285,Antonio Raillo,17.0,16,7,10,4,2,5,6,83.3,1,17,14,3,18,34,81,0
2286,Antonio Raimondo,0.8,0,0,0,0,0,0,1,0.0,1,1,0,1,0,0,1,0
2288,Predrag Rajkovic,38.0,2,2,2,0,0,2,3,66.7,1,1,0,1,1,3,21,1
2289,Jesuran Rak Sakyi,0.9,0,0,0,0,0,0,1,0.0,1,3,0,3,1,1,0,0
2290,Ivan Rakitic,24.2,40,22,12,23,5,13,40,32.5,27,31,8,23,23,63,35,0
2292,Jonas Ramalho,2.7,4,2,2,2,0,2,3,66.7,1,4,1,3,3,7,9,0
2293,Adil Rami,13.0,10,9,6,4,0,7,8,87.5,1,17,9,8,16,26,43,0
2294,Sandro Ramirez,16.2,7,3,1,3,3,1,12,8.3,11,14,3,11,2,9,3,0
2295,Guilherme Ramos,10.1,25,15,17,8,0,12,19,63.2,7,21,8,13,27,52,52,0
2296,Sergio Ramos,8.9,12,5,6,6,0,8,15,53.3,7,4,2,2,8,20,27,0
2297,Aaron Ramsdale,34.0,2,1,2,0,0,1,2,50.0,1,0,0,0,0,2,26,3
2299,Jacob Ramsey,27.4,67,44,31,28,8,30,69,43.5,39,36,7,29,24,91,28,0
2300,Luca Ranieri,23.4,38,21,23,11,4,19,33,57.6,14,18,8,10,22,60,67,0
2301,Andrea Ranocchia,3.8,8,4,5,1,2,1,3,33.3,2,4,3,1,4,12,16,0
2302,Raphinha,32.4,51,29,25,14,12,22,71,31.0,49,43,0,43,29,80,28,1
2303,Tobias Raschl,6.6,12,9,4,8,0,5,7,71.4,2,10,1,9,3,15,1,0
2304,Elba Rashani,19.5,40,21,15,21,4,17,55,30.9,38,34,3,31,11,51,20,0
2305,Marcus Rashford,13.7,6,5,1,4,1,2,13,15.4,11,10,1,9,5,11,5,1
2306,Milot Rashica,24.8,31,19,12,12,7,11,30,36.7,19,22,3,19,15,46,23,0
2307,Giacomo Raspadori,30.4,29,18,5,15,9,11,38,28.9,27,29,3,26,9,38,11,0
2309,David Raum,30.6,52,29,30,10,12,30,64,46.9,34,38,5,33,27,79,39,1
2312,Ante Rebic,9.9,14,8,3,6,5,7,20,35.0,13,14,0,14,3,17,3,1
2314,Arkadiusz Reca,19.7,31,19,21,3,7,20,30,66.7,10,20,7,13,32,63,47,2
2315,Lluis Recasens,0.5,2,0,2,0,0,1,1,100.0,0,0,0,0,2,4,2,0
2316,Nathan Redmond,20.4,22,14,9,9,4,7,30,23.3,23,21,2,19,8,30,16,0
2317,Sergio Reguilon,21.3,40,24,15,18,7,22,43,51.2,21,20,8,12,31,71,45,1
2319,Pepe Reina,15.0,0,0,0,0,0,0,1,0.0,1,0,0,0,0,0,1,1
2320,Jeff Reine-Adelaide,2.2,5,3,4,1,0,4,5,80.0,1,2,0,2,0,5,0,1
2321,Reinier,1.8,5,3,4,0,1,1,1,100.0,0,3,0,3,0,5,0,0
2322,Karim Rekik,12.2,11,8,4,6,1,2,9,22.2,7,11,6,5,9,20,19,0
2324,Panagiotis Retsos,0.6,0,0,0,0,0,0,2,0.0,2,0,0,0,2,2,3,0
2326,Marco Reus,27.8,45,30,13,21,11,16,42,38.1,26,23,6,17,12,57,41,1
2327,Elvis Rexhbecaj,28.2,41,20,17,19,5,19,40,47.5,21,41,6,35,27,68,15,0
2328,Gio Reyna,4.9,7,4,2,4,1,3,9,33.3,6,6,0,6,1,8,3,0
2329,Bryan Reynolds,0.0,0,0,0,0,0,0,1,0.0,1,0,0,0,0,0,1,0
2330,Nico Ribaudo,12.4,15,6,9,5,1,11,34,32.4,23,14,2,12,7,22,3,0
2332,Franck Ribery,15.8,17,10,6,6,5,8,13,61.5,5,12,0,12,3,20,1,0
2333,Samuele Ricci,8.0,8,4,4,2,2,2,5,40.0,3,7,1,6,14,22,9,0
2334,Samuele Ricci,17.0,33,19,17,13,3,20,34,58.8,14,24,5,19,31,64,18,0
2335,Declan Rice,35.3,80,42,45,32,3,38,71,53.5,33,45,21,24,63,143,52,1
2336,Chris Richards,14.5,26,15,10,15,1,11,18,61.1,7,21,9,12,22,48,50,1
2338,Omar Richards,4.9,19,12,11,5,3,11,16,68.8,5,7,1,6,4,23,7,0
2340,Taylor Richards,0.3,1,0,0,1,0,1,2,50.0,1,0,0,0,0,1,0,0
2341,Richarlison,28.0,40,23,18,15,7,15,31,48.4,16,42,4,38,12,52,34,0
2342,Marco Richter,18.9,30,16,14,10,6,13,36,36.1,23,30,4,26,16,46,24,0
2343,Diego Rico,18.3,41,20,19,17,5,22,45,48.9,23,29,4,25,30,71,54,0
2346,Jairo Riedewald,1.3,1,1,0,1,0,1,2,50.0,1,1,0,1,1,2,2,0
2347,Manuel Riemann,31.0,1,0,1,0,0,1,4,25.0,3,0,0,0,1,2,12,3
2348,Tomas Rincon,1.8,2,2,2,0,0,0,3,0.0,3,3,1,2,2,4,4,0
2349,Tomas Rincon,13.0,22,13,9,10,3,13,34,38.2,21,15,2,13,18,40,11,0
2350,Luis Rioja,34.6,28,15,11,10,7,14,58,24.1,44,22,1,21,25,53,20,0
2351,Renaud Ripart,21.0,38,21,18,15,5,18,50,36.0,32,21,1,20,19,57,21,1
2352,Mihailo Ristic,20.0,44,32,26,16,2,25,43,58.1,18,16,6,10,17,61,48,0
2353,Matt Ritchie,14.9,22,15,10,10,2,10,27,37.0,17,10,2,8,13,35,26,0
2355,Rober,22.3,36,20,27,7,2,23,39,59.0,16,25,15,10,30,66,90,1
2356,Sergi Roberto,4.4,5,1,2,3,0,3,5,60.0,2,2,0,2,4,9,6,0
2357,Connor Roberts,18.8,20,13,10,7,3,10,15,66.7,5,25,5,20,22,42,62,1
2359,Tyler Roberts,11.0,16,7,6,7,3,9,16,56.3,7,11,1,10,5,21,11,0
2360,Andrew Robertson,28.2,36,21,16,15,5,20,35,57.1,15,24,3,21,23,59,61,0
2361,Marc Roca,4.2,9,7,2,4,3,2,8,25.0,6,6,0,6,6,15,4,0
2362,Ruben Rochina,8.3,21,13,7,8,6,8,28,28.6,20,11,1,10,6,27,5,1
2364,Enzo Roco,28.4,36,20,24,11,1,15,24,62.5,9,38,27,11,28,64,110,3
2366,Stian Rode Gregersen,21.7,39,26,23,12,4,18,33,54.5,15,26,16,10,38,77,103,2
2367,Sebastian Rode,8.4,15,7,5,8,2,5,17,29.4,12,11,1,10,13,28,8,0
2369,Rodri,32.0,72,43,24,38,10,32,59,54.2,27,28,5,23,28,100,45,0
2370,Rodri,9.8,10,7,4,5,1,5,22,22.7,17,11,0,11,3,13,4,0
2371,Rodrigo,25.2,20,9,7,6,7,4,32,12.5,28,12,0,12,11,31,27,1
2372,Gerson Rodrigues,9.4,12,9,2,6,4,1,17,5.9,16,8,1,7,0,12,2,0
2373,Kevin Rodrigues,4.8,15,11,8,7,0,6,10,60.0,4,10,1,9,7,22,6,0
2374,Angel Rodriguez,17.2,15,9,6,7,2,4,21,19.0,17,15,1,14,3,18,13,0
2375,Oscar Rodriguez Arnaiz,10.5,16,11,6,8,2,4,12,33.3,8,7,1,6,11,27,6,0
2376,Oscar Rodriguez Arnaiz,4.6,4,3,1,3,0,2,3,66.7,1,2,0,2,5,9,7,1
2377,Dani Rodriguez,31.5,53,31,20,24,9,15,46,32.6,31,28,3,25,20,73,27,0
2378,Guido Rodriguez,28.1,97,53,46,45,6,54,98,55.1,44,55,12,43,31,128,56,0
2379,Jay Rodriguez,15.4,20,12,8,8,4,4,14,28.6,10,19,1,18,4,24,12,0
2380,Ricardo Rodriguez,27.5,36,21,11,23,2,18,33,54.5,15,22,8,14,41,77,48,1
2381,Rodrygo,16.9,18,14,7,4,7,3,18,16.7,15,21,0,21,11,29,3,0
2382,Mads Roerslev,13.8,23,12,19,2,2,14,32,43.8,18,14,5,9,16,39,29,0
2383,Marko Rog,3.5,5,3,1,2,2,1,8,12.5,7,6,1,5,1,6,3,0
2384,Rogerio,19.2,21,13,12,5,4,15,22,68.2,7,20,8,12,18,39,42,1
2385,Alessio Romagnoli,15.7,24,14,14,10,0,14,18,77.8,4,21,12,9,19,43,45,0
2386,Simone Romagnoli,16.6,28,12,14,12,2,15,20,75.0,5,34,28,6,9,37,86,0
2388,Cristian Romero,20.5,62,39,39,21,2,22,34,64.7,12,46,21,25,33,95,74,1
2390,Luka Romero,0.9,2,1,0,1,1,0,2,0.0,2,0,0,0,1,3,0,0
2392,Sergio Romero,16.0,2,2,2,0,0,2,2,100.0,0,0,0,0,1,3,10,0
2393,Oriol Romeu,32.1,77,39,25,45,7,28,73,38.4,45,39,8,31,51,128,43,0
2394,Cristiano Ronaldo,27.3,8,6,1,5,2,2,6,33.3,4,8,0,8,2,10,29,0
2395,Cristiano Ronaldo,0.3,1,0,0,1,0,1,1,100.0,0,0,0,0,0,1,0,0
2396,Salomon Rondon,8.8,6,1,1,2,3,4,14,28.6,10,5,0,5,0,6,10,0
2397,Valentin Rongier,24.4,77,51,36,36,5,28,60,46.7,32,26,5,21,33,110,14,0
2398,Marten de Roon,28.3,69,42,33,29,7,34,62,54.8,28,36,2,34,45,114,41,0
2400,Pablo Rosario,30.3,59,37,18,32,9,26,66,39.4,40,33,7,26,38,97,43,0
2402,Danny Rose,7.7,16,10,11,4,1,10,24,41.7,14,8,5,3,14,30,11,1
2404,Tom Rothe,1.0,4,3,2,2,0,3,6,50.0,3,2,0,2,2,6,3,0
2405,Jerome Roussillon,19.7,14,9,8,6,0,10,16,62.5,6,24,5,19,14,28,34,2
2406,Nicolo Rovella,16.3,37,26,16,14,7,15,40,37.5,25,21,1,20,20,57,20,0
2407,Jon Rowe,2.5,3,2,2,1,0,2,3,66.7,1,7,0,7,3,6,1,0
2408,Amir Rrahmani,32.5,21,11,15,5,1,15,19,78.9,4,36,25,11,19,40,89,0
2409,Ruan,2.4,7,4,7,0,0,3,4,75.0,1,6,5,1,2,9,24,1
2410,Ruben,1.7,6,1,4,2,0,4,7,57.1,3,0,0,0,2,8,4,0
2412,Antonio Rudiger,33.7,48,28,29,15,4,36,48,75.0,12,20,11,9,28,76,91,1
2413,Sebastian Rudy,8.6,22,12,9,13,0,11,21,52.4,10,8,3,5,11,33,8,1
2414,Daniele Rugani,9.8,8,5,4,4,0,4,7,57.1,3,9,4,5,11,19,47,0
2415,Matteo Ruggeri,7.5,8,4,5,2,1,7,10,70.0,3,6,1,5,2,10,25,0
2416,Mario Rui,33.2,68,43,32,28,8,39,84,46.4,45,31,7,24,40,108,50,0
2418,Aitor Ruibal,9.5,21,15,13,3,5,10,34,29.4,24,8,0,8,8,29,6,0
2419,Isma Ruiz,3.1,3,1,3,0,0,1,9,11.1,8,5,2,3,3,6,2,0
2420,Fabian Ruiz Pena,26.5,55,33,22,29,4,29,67,43.3,38,34,1,33,22,77,32,0
2421,Victor Ruiz,15.8,11,9,7,2,2,6,9,66.7,3,18,13,5,29,40,71,1
2422,Geronimo Rulli,32.0,0,0,0,0,0,0,4,0.0,4,0,0,0,1,1,15,5
2423,Lukas Rupp,8.5,9,4,5,3,1,4,15,26.7,11,11,1,10,9,18,7,0
2424,Alessandro Russo,0.3,1,0,1,0,0,0,1,0.0,1,0,0,0,0,1,1,0
2425,Franco Russo,16.3,19,10,10,9,0,13,31,41.9,18,14,9,5,27,46,73,1
2426,Georginio Rutter,17.9,18,13,4,8,6,6,17,35.3,11,29,1,28,6,24,11,1
2428,Julian Ryerson,15.9,27,15,11,12,4,17,25,68.0,8,12,4,8,16,43,32,0
2430,Jose Sa,36.5,2,1,2,0,0,2,4,50.0,2,0,0,0,2,4,19,5
2431,Roli Pereira de Sa,6.4,12,4,3,5,4,3,20,15.0,17,6,0,6,6,18,3,0
2432,Youssouf Sabaly,8.8,12,10,11,0,1,7,13,53.8,6,11,4,7,13,25,16,1
2433,Mathys Saban,0.8,4,2,2,2,0,1,1,100.0,0,1,0,1,0,4,0,0
2434,Stefano Sabelli,3.9,6,3,3,2,1,3,9,33.3,6,5,1,4,3,9,12,0
2435,Abdelhamid Sabiri,9.9,34,18,10,15,9,7,25,28.0,18,10,2,8,7,41,3,0
2436,Marcel Sabitzer,0.5,2,1,1,1,0,1,1,100.0,0,0,0,0,1,3,0,0
2437,Marcel Sabitzer,10.1,18,7,8,8,2,9,19,47.4,10,7,0,7,9,27,10,1
2438,Falaye Sacko,7.4,15,10,14,1,0,13,16,81.3,3,11,7,4,4,19,18,2
2439,Alexis Saelemaekers,20.7,43,22,12,17,14,15,51,29.4,36,19,0,19,15,58,8,0
2440,Rafiki Said Ahamada,1.4,4,3,1,2,1,3,4,75.0,1,2,0,2,0,4,0,0
2441,Wesley Said,7.3,10,5,1,8,1,1,9,11.1,8,4,0,4,2,12,0,0
2442,Allan Saint-Maximin,31.2,13,8,6,4,3,3,17,17.6,14,13,2,11,11,24,3,0
2444,Romain Saiss,30.1,40,27,28,11,1,19,33,57.6,14,41,21,20,58,98,158,2
2445,Bukayo Saka,33.1,40,21,12,17,11,13,39,33.3,26,28,2,26,22,62,23,0
2446,Mamadou Sakho,28.6,34,22,26,8,0,16,26,61.5,10,41,34,7,41,75,134,4
2447,Bakary Sako,1.7,0,0,0,0,0,0,1,0.0,1,3,1,2,0,0,0,0
2448,Jacopo Sala,9.8,22,11,10,10,2,13,30,43.3,17,6,0,6,14,36,11,0
2449,Mohamed Salah,30.7,17,8,5,9,3,6,19,31.6,13,7,1,6,6,23,5,0
2450,Eddie Salcedo,4.8,1,1,0,0,1,0,1,0.0,1,2,1,1,0,1,7,1
2451,William Saliba,36.0,54,32,36,16,2,27,35,77.1,8,24,16,8,48,102,85,0
2453,Mohammed Salisu,33.0,80,47,54,22,4,40,65,61.5,25,49,26,23,78,158,158,4
2454,Roland Sallai,17.2,22,16,8,11,3,7,23,30.4,16,12,0,12,11,33,12,0
2455,Yoann Salmier,29.6,58,33,44,11,3,26,34,76.5,8,30,14,16,40,98,94,0
2456,Salvi,15.5,20,10,9,8,3,8,20,40.0,12,17,2,15,6,26,11,0
2457,Lazar Samardzic,5.4,13,9,4,7,2,7,26,26.9,19,6,0,6,2,15,2,0
2458,Diadie Samassekou,18.4,41,26,14,21,6,21,44,47.7,23,27,11,16,28,69,26,0
2459,Mama Samba Balde,19.1,40,28,16,14,10,8,26,30.8,18,32,1,31,5,45,9,0
2460,Albert Sambi Lokonga,12.6,22,18,11,9,2,12,14,85.7,2,12,7,5,13,35,12,4
2461,Junior Sambia,17.0,22,13,12,7,3,13,22,59.1,9,22,3,19,21,43,31,0
2463,Fede San Emeterio,9.2,16,5,5,8,3,5,15,33.3,10,5,0,5,8,24,6,0
2464,Antonio Sanabria,20.0,3,2,0,1,2,1,4,25.0,3,11,4,7,2,5,10,0
2465,Oihan Sancet,15.8,12,7,2,8,2,5,20,25.0,15,2,0,2,5,17,13,0
2466,Renato Sanches,18.3,19,7,8,10,1,9,26,34.6,17,14,3,11,14,33,7,0
2467,Alexis Sanchez,9.8,9,8,0,6,3,2,11,18.2,9,4,0,4,2,11,3,0
2468,Antonio Sanchez,18.0,53,24,29,17,7,19,49,38.8,30,32,2,30,32,85,32,1
2470,Davinson Sanchez,18.1,41,22,25,14,2,19,28,67.9,9,24,16,8,30,71,54,3
2471,German Sanchez,25.5,27,19,18,9,0,11,20,55.0,9,19,16,3,28,55,137,0
2472,Manu Sanchez,25.1,72,34,41,22,9,43,79,54.4,36,28,3,25,18,90,43,0
2473,Robert Sanchez,37.0,2,1,2,0,0,1,1,100.0,0,1,0,1,0,2,11,4
2474,Jadon Sancho,21.1,14,8,9,4,1,8,22,36.4,14,19,0,19,15,29,5,3
2476,Alex Sandro,19.8,27,16,15,9,3,11,25,44.0,14,17,6,11,27,54,40,0
2477,Leroy Sane,22.0,28,16,5,19,4,9,24,37.5,15,18,0,18,12,40,2,1
2478,Oier Sanjurjo,8.4,10,6,3,7,0,2,19,10.5,17,8,3,5,1,11,9,0
2480,Morgan Sanson,4.0,12,8,7,2,3,3,7,42.9,4,13,0,13,10,22,2,1
2481,Nicola Sansone,10.0,13,7,5,6,2,3,15,20.0,12,1,0,1,4,17,2,0
2482,Baptiste Santamaria,28.0,52,27,15,31,6,24,44,54.5,20,33,12,21,33,85,42,0
2483,Baptiste Santamaria,0.2,0,0,0,0,0,0,1,0.0,1,0,0,0,1,1,1,0
2484,Federico Santander,0.7,2,1,1,1,0,1,1,100.0,0,0,0,0,0,2,0,0
2485,Jesus Santiago,0.9,2,2,1,1,0,0,2,0.0,2,1,0,1,0,2,1,0
2486,Samir Santos,18.6,24,11,18,6,0,8,19,42.1,11,21,11,10,43,67,85,3
2487,Samir Santos,15.8,36,16,22,13,1,15,25,60.0,10,21,7,14,42,78,62,0
2489,Alvaro Sanz,0.3,0,0,0,0,0,0,1,0.0,1,0,0,0,0,0,0,0
2490,Riccardo Saponara,14.3,10,2,1,6,3,6,16,37.5,10,5,0,5,1,11,3,0
2491,Pablo Sarabia,0.2,0,0,0,0,0,0,1,0.0,1,0,0,0,0,0,0,0
2492,Marcelo Saracchi,2.1,8,5,6,1,1,2,4,50.0,2,3,0,3,4,12,7,1
2493,Josh Sargent,17.5,26,14,15,7,4,14,39,35.9,25,29,2,27,11,37,18,2
2494,Jeremy Sarmiento,0.5,1,1,0,0,1,0,2,0.0,2,2,0,2,0,1,0,0
2496,Bouna Sarr,0.7,4,4,2,1,1,4,5,80.0,1,2,1,1,6,10,1,0
2497,Ismaila Sarr,20.7,12,7,4,3,5,5,19,26.3,14,10,1,9,9,21,10,0
2498,Malang Sarr,6.1,14,7,10,2,2,7,12,58.3,5,6,3,3,11,25,20,0
2499,Joan Sastre Vanrell,2.9,6,3,5,0,1,3,4,75.0,1,3,0,3,2,8,10,0
2501,Martin Satriano,0.4,1,0,0,0,1,1,1,100.0,0,0,0,0,0,1,0,0
2502,Martin Satriano,10.4,5,2,1,1,3,2,7,28.6,5,8,0,8,2,7,3,0
2503,Teji Savanier,26.8,46,27,18,19,9,21,59,35.6,38,23,1,22,25,71,12,1
2504,Esteban Saveljich,18.9,18,11,11,7,0,9,15,60.0,6,20,12,8,16,34,69,0
2505,Stefan Savic,27.1,46,20,25,20,1,29,43,67.4,14,19,12,7,37,83,102,1
2506,Joe Scally,21.2,40,30,21,14,5,17,41,41.5,24,27,4,23,22,62,38,0
2507,Giorgio Scalvini,8.5,22,11,13,8,1,9,19,47.4,10,12,1,11,22,44,16,0
2508,Gianluca Scamacca,23.8,19,14,2,5,12,5,21,23.8,16,16,1,15,5,24,22,1
2510,Kevin Schade,9.2,9,7,6,2,1,3,10,30.0,7,15,3,12,3,12,16,0
2511,Andras Schafer,2.7,4,1,3,1,0,0,5,0.0,5,7,1,6,2,6,4,0
2512,Fabian Schar,24.0,16,11,11,3,2,8,16,50.0,8,27,18,9,32,48,95,2
2513,Louis Schaub,7.3,16,10,7,7,2,11,20,55.0,9,17,3,14,3,19,3,0
2514,Andrea Schiavone,6.3,14,8,5,9,0,10,23,43.5,13,13,3,10,8,22,12,0
2515,Patrik Schick,23.1,5,2,2,2,1,1,9,11.1,8,6,1,5,3,8,28,0
2516,Kingsley Schindler,3.9,1,0,0,0,1,1,5,20.0,4,5,1,4,5,6,5,0
2517,Xaver Schlager,11.6,43,20,20,20,3,20,49,40.8,29,25,2,23,9,52,14,0
2518,Keven Schlotterbeck,3.5,11,5,6,5,0,5,6,83.3,1,7,4,3,11,22,24,1
2519,Nico Schlotterbeck,30.9,72,43,36,34,2,33,48,68.8,15,41,32,9,56,128,154,1
2520,Jeffrey Schlupp,20.6,46,25,16,23,7,24,50,48.0,26,39,9,30,18,64,32,0
2522,Kasper Schmeichel,37.0,0,0,0,0,0,0,2,0.0,2,0,0,0,1,1,15,2
2523,Jonathan Schmid,6.5,12,6,6,3,3,5,7,71.4,2,7,1,6,6,18,15,0
2524,Benno Schmitz,26.9,57,37,21,27,9,42,86,48.8,44,44,8,36,39,96,39,0
2525,David Schnegg,1.6,2,0,1,1,0,1,3,33.3,2,4,0,4,3,5,6,0
2526,Morgan Schneiderlin,7.2,21,12,9,11,1,6,13,46.2,7,8,2,6,20,41,18,0
2527,Alessandro Schopf,26.6,40,22,19,16,5,14,30,46.7,16,31,5,26,30,70,21,1
2528,Jerdy Schouten,15.5,25,17,10,12,3,9,22,40.9,13,22,5,17,33,58,29,1
2529,Nico Schulz,9.3,21,12,9,7,5,9,21,42.9,12,8,1,7,11,32,8,0
2531,Alexander Schwolow,24.2,0,0,0,0,0,0,1,0.0,1,0,0,0,2,2,18,3
2534,Aleksandar Sedlar,4.5,5,3,4,1,0,3,5,60.0,2,4,4,0,5,10,19,0
2535,Paul Seguin,23.4,50,31,15,32,3,26,56,46.4,30,27,3,24,19,69,30,1
2536,Alidu Seidu,15.7,34,20,20,13,1,16,27,59.3,11,25,11,14,34,68,49,1
2537,Davie Selke,11.2,5,4,1,3,1,1,3,33.3,2,6,1,5,1,6,11,0
2539,Ken Sema,9.5,16,6,11,4,1,9,20,45.0,11,10,0,10,5,21,11,0
2540,Nelson Semedo,23.7,58,39,39,17,2,25,49,51.0,24,23,4,19,21,79,64,1
2543,Stefano Sensi,8.4,18,9,10,6,2,10,23,43.5,13,2,0,2,6,24,4,0
2544,Stefano Sensi,1.9,4,3,1,3,0,2,4,50.0,2,2,0,2,0,4,2,0
2546,Suat Serdar,24.6,64,30,24,29,11,25,55,45.5,30,32,3,29,20,84,14,0
2548,Laurens Serpe,0.5,1,0,1,0,0,1,2,50.0,1,0,0,0,0,1,1,0
2549,Janni Serra,12.4,4,2,2,0,2,2,7,28.6,5,8,3,5,5,9,19,0
2550,Javier Serrano,0.8,3,1,0,3,0,2,4,50.0,2,0,0,0,3,6,2,0
2551,Nicolas Serrano,3.5,9,6,3,5,1,3,10,30.0,7,5,1,4,2,11,3,0
2553,Ryan Sessegnon,11.6,25,19,14,7,4,11,22,50.0,11,18,3,15,7,32,26,0
2554,Nils Seufert,1.1,3,2,1,1,1,0,1,0.0,1,0,0,0,0,3,0,0
2555,Salva Sevilla,16.7,18,12,8,8,2,6,17,35.3,11,12,6,6,14,32,11,0
2556,Stephan El Shaarawy,11.7,13,8,4,9,0,4,6,66.7,2,10,2,8,11,24,8,0
2557,Jamie Shackleton,7.9,27,16,19,7,1,13,25,52.0,12,11,7,4,8,35,12,1
2558,Xherdan Shaqiri,7.5,7,3,0,5,2,2,10,20.0,8,2,0,2,2,9,2,0
2559,Luke Shaw,17.8,21,13,9,9,3,12,21,57.1,9,22,11,11,9,30,22,2
2560,Jonjo Shelvey,22.0,30,17,12,18,0,14,34,41.2,20,22,7,15,22,52,20,2
2561,Aimar Sher,0.5,2,1,1,1,0,0,1,0.0,1,1,0,1,3,5,1,0
2562,Eldor Shomurodov,8.7,5,4,0,4,1,1,10,10.0,9,8,0,8,2,7,5,0
2567,Djibril Sidibe,10.5,24,13,13,8,3,9,24,37.5,15,10,1,9,16,40,13,0
2568,Kaj Sierhuis,0.9,1,1,1,0,0,1,3,33.3,2,0,0,0,0,1,1,0
2569,Francisco Sierralta,4.7,7,3,7,0,0,5,8,62.5,3,7,2,5,6,13,35,0
2570,Arnor Sigurdsson,2.0,1,1,0,1,0,1,2,50.0,1,2,0,2,1,2,0,0
2571,Kiliann Sildillia,1.9,7,3,3,4,0,3,6,50.0,3,1,0,1,2,9,7,1
2572,Adrien Silva,12.0,24,12,14,5,5,9,33,27.3,24,15,5,10,23,47,23,0
2574,Andre Silva,23.1,13,9,2,3,8,4,13,30.8,9,20,2,18,2,15,15,0
2575,Bernardo Silva,31.7,57,29,19,19,19,31,67,46.3,36,24,2,22,20,77,19,0
2576,Caio Henrique Oliveira Silva,29.6,53,30,31,18,4,28,59,47.5,31,30,6,24,27,80,37,3
2577,David Silva,19.1,28,17,10,11,7,3,20,15.0,17,13,3,10,7,35,12,0
2578,Fabio Silva,6.4,3,2,0,2,1,0,8,0.0,8,2,0,2,1,4,1,0
2579,Gabriel Silva,7.9,12,7,7,2,3,9,13,69.2,4,9,3,6,18,30,13,0
2580,Jonathan Silva,2.5,10,8,4,4,2,7,12,58.3,5,4,0,4,3,13,7,0
2581,Rui Silva,21.8,1,0,1,0,0,1,2,50.0,1,0,0,0,1,2,11,1
2582,Thiago Silva,29.4,32,21,19,12,1,11,22,50.0,11,54,31,23,44,76,100,0
2583,Marco Silvestri,35.0,0,0,0,0,0,0,1,0.0,1,0,0,0,1,1,11,1
2584,Mohamed Simakan,22.3,48,27,25,21,2,27,41,65.9,14,22,11,11,40,88,46,1
2585,Giovanni Simeone,29.5,27,15,6,12,9,9,39,23.1,30,37,3,34,6,33,23,0
2589,Moses Simon,25.9,17,11,6,5,6,11,23,47.8,12,14,3,11,12,29,5,0
2591,Xavi Simons,1.5,1,1,0,1,0,1,2,50.0,1,3,0,3,0,1,0,0
2592,Wilfried Singo,29.0,55,35,24,24,7,24,34,70.6,10,26,6,20,23,78,47,0
2593,Daley Sinkgraven,3.9,6,2,4,0,2,3,7,42.9,4,3,1,2,3,9,6,0
2596,Salvatore Sirigu,37.0,1,1,1,0,0,1,2,50.0,1,0,0,0,0,1,19,2
2597,Issouf Sissokho,4.8,17,8,2,13,2,8,17,47.1,9,8,1,7,7,24,0,0
2598,Ibrahima Sissoko,25.6,47,23,18,20,9,19,46,41.3,27,32,11,21,35,82,31,0
2600,Moussa Sissoko,35.8,53,27,27,20,6,28,42,66.7,14,42,13,29,30,83,64,0
2601,Nelson Sissoko,0.5,2,0,2,0,0,1,1,100.0,0,0,0,0,0,2,2,0
2602,Sambou Sissoko,2.0,12,6,6,4,2,6,8,75.0,2,2,0,2,2,14,7,0
2603,Antonio Sivera,3.1,0,0,0,0,0,0,1,0.0,1,0,0,0,0,0,0,0
2604,Ellyes Skhiri,20.2,55,33,25,26,4,22,41,53.7,19,41,7,34,37,92,35,1
2605,Oliver Skipp,15.0,33,19,14,18,1,15,31,48.4,16,19,7,12,12,45,10,1
2606,Leo Skiri Ostigard,13.0,16,9,8,7,1,9,11,81.8,2,17,10,7,8,24,55,1
2607,Lukasz Skorupski,36.0,0,0,0,0,0,0,1,0.0,1,0,0,0,0,0,17,0
2608,Andreas Skov Olsen,8.3,12,10,4,4,4,5,11,45.5,6,9,1,8,3,15,11,0
2609,Robert Skov,4.1,3,2,1,1,1,2,9,22.2,7,2,0,2,3,6,3,0
2610,Milan Skriniar,35.0,47,27,26,17,4,24,42,57.1,18,36,25,11,25,72,90,1
2611,Islam Slimani,6.4,3,2,0,1,2,1,6,16.7,5,4,0,4,2,5,5,0
2612,William Smallbone,1.5,4,4,2,2,0,1,3,33.3,2,4,0,4,2,6,0,0
2613,Chris Smalling,23.2,36,23,28,8,0,18,25,72.0,7,32,24,8,26,62,92,1
2614,Emile Smith Rowe,21.3,14,7,7,7,0,4,20,20.0,16,18,1,17,15,29,10,1
2615,Cedric Soares,16.5,38,26,23,9,6,16,25,64.0,9,18,7,11,16,54,31,1
2616,Danilo Soares,28.5,109,71,61,39,9,56,84,66.7,28,63,9,54,62,171,65,2
2617,Ruben Sobrino,0.2,1,1,1,0,0,1,1,100.0,0,1,0,1,2,3,0,0
2618,Ruben Sobrino,20.7,28,17,11,10,7,5,35,14.3,30,21,1,20,21,49,18,0
2619,Alex Sola,0.5,1,1,1,0,0,1,3,33.3,2,1,0,1,2,3,3,0
2620,Augusto Solari,7.9,24,12,9,12,3,12,32,37.5,20,14,4,10,7,31,10,1
2621,Roberto Soldado,7.4,3,1,0,1,2,1,3,33.3,2,4,0,4,1,4,7,0
2622,Carlos Soler,27.5,29,19,10,15,4,11,37,29.7,26,19,4,15,14,43,28,0
2623,Yann Sommer,33.0,0,0,0,0,0,0,2,0.0,2,0,0,0,3,3,8,3
2624,Son,21.9,28,18,16,7,5,17,34,50.0,17,11,5,6,19,47,33,1
2626,Brandon Soppy,8.6,20,9,8,10,2,11,16,68.8,5,10,2,8,5,25,9,1
2627,David Soria,37.9,1,0,1,0,0,1,2,50.0,1,0,0,0,0,1,22,2
2628,Roberto Soriano,29.1,57,30,27,22,8,17,56,30.4,39,37,3,34,22,79,32,0
2629,Alberto Soro,6.4,12,10,3,6,3,1,7,14.3,6,21,2,19,3,15,4,0
2630,Borna Sosa,27.8,22,12,14,5,3,12,26,46.2,14,30,3,27,26,48,61,0
2632,Florian Sotoca,27.6,31,19,7,20,4,12,51,23.5,39,31,4,27,25,56,41,0
2633,Riccardo Sottil,13.8,9,4,4,4,1,3,9,33.3,6,3,0,3,1,10,2,0
2634,Tomas Soucek,34.0,66,32,27,33,6,28,65,43.1,37,34,13,21,52,118,98,1
2635,Matias Soule,0.1,0,0,0,0,0,0,1,0.0,1,0,0,0,0,0,0,0
2636,Sambou Soumano,5.0,4,1,1,2,1,2,2,100.0,0,3,0,3,1,5,7,0
2637,Adama Soumaoro,25.2,15,5,5,8,2,4,9,44.4,5,22,16,6,34,49,95,0
2638,Boubakary Soumare,12.2,19,13,10,8,1,8,17,47.1,9,13,1,12,14,33,18,0
2639,Arnaud Souquet,25.9,56,35,30,17,9,32,65,49.2,33,21,7,14,34,90,60,1
2640,Djibril Sow,26.8,57,33,28,25,4,22,60,36.7,38,35,8,27,50,107,20,1
2641,Saidou Sow,11.0,28,17,21,6,1,16,21,76.2,5,15,5,10,23,51,34,0
2642,Caglar Soyuncu,27.7,47,30,32,12,3,26,42,61.9,16,44,27,17,32,79,115,1
2643,Leonardo Spinazzola,1.4,0,0,0,0,0,0,1,0.0,1,4,1,3,0,0,3,0
2645,Tony Springett,1.6,2,1,1,1,0,1,4,25.0,3,0,0,0,0,2,2,0
2646,Jerry St. Juste,6.7,13,9,7,6,0,7,8,87.5,1,7,3,4,14,27,14,0
2647,Anton Stach,20.7,28,19,14,13,1,15,38,39.5,23,24,5,19,51,79,25,0
2648,Kostas Stafylidis,15.4,37,27,22,13,2,20,26,76.9,6,19,6,13,31,68,43,0
2650,Josip Stanisic,7.2,21,10,7,12,2,12,18,66.7,6,7,0,7,11,32,10,2
2652,Niklas Stark,22.6,28,16,18,10,0,12,17,70.6,5,27,17,10,36,64,122,2
2655,Renato Steffen,10.7,20,16,10,10,0,9,16,56.3,7,7,0,7,13,33,14,0
2657,Calvin Stengs,11.9,16,7,6,9,1,7,20,35.0,13,10,0,10,8,24,6,0
2658,Pascal Stenzel,10.0,24,11,15,5,4,17,33,51.5,16,13,3,10,11,35,25,0
2659,Dale Stephens,1.4,4,1,0,3,1,3,8,37.5,5,4,1,3,1,5,1,0
2660,Jack Stephens,9.0,19,12,13,5,1,6,16,37.5,10,12,7,5,19,38,42,0
2661,Raheem Sterling,23.6,23,10,3,11,9,10,23,43.5,13,12,0,12,12,35,3,0
2662,Finley Stevens,0.2,3,1,0,3,0,1,1,100.0,0,0,0,0,0,3,0,0
2663,Angelo Stiller,18.8,30,17,11,15,4,9,23,39.1,14,32,6,26,9,39,16,2
2664,Lars Stindl,18.1,23,15,6,14,3,9,33,27.3,24,28,2,26,10,33,14,0
2665,Riccardo Stivanello,0.5,1,1,1,0,0,1,1,100.0,0,2,2,0,0,1,6,0
2666,Kevin Stoger,4.7,10,5,5,5,0,4,10,40.0,6,6,0,6,5,15,1,1
2667,Petar Stojanovic,30.4,96,63,55,32,9,59,114,51.8,55,39,13,26,27,123,65,1
2668,John Stones,12.4,5,3,3,2,0,2,3,66.7,1,3,3,0,11,16,27,1
2670,Stefan Strandberg,10.4,13,8,10,3,0,8,11,72.7,3,15,13,2,9,22,49,0
2671,David Strelec,5.6,4,4,1,2,1,2,9,22.2,7,8,1,7,2,6,1,0
2672,Tobias Strobl,3.6,8,3,3,5,0,3,11,27.3,8,7,2,5,7,15,3,0
2673,Kevin Strootman,7.1,8,4,2,4,2,5,12,41.7,7,11,2,9,10,18,15,0
2674,Pascal Struijk,22.8,61,39,34,23,4,30,50,60.0,20,35,23,12,33,94,60,2
2675,Jens Stryger Larsen,7.6,5,2,3,1,1,2,3,66.7,1,2,0,2,4,9,17,0
2676,Leo Stulac,9.3,13,6,5,6,2,7,19,36.8,12,6,2,4,8,21,15,0
2678,Stefano Sturaro,19.6,43,26,16,16,11,22,48,45.8,26,25,1,24,15,58,29,2
2679,Damian Suarez,30.1,74,47,34,30,10,42,91,46.2,49,46,5,41,31,105,30,0
2680,Denis Suarez,31.3,61,29,20,33,8,25,82,30.5,57,32,4,28,16,77,11,0
2681,Luis Suarez,20.4,8,5,2,4,2,2,10,20.0,8,8,1,7,1,9,14,0
2682,Mario Suarez,7.9,9,4,7,2,0,3,9,33.3,6,6,4,2,7,16,37,1
2683,Isaac Success,10.1,5,2,0,3,2,1,5,20.0,4,2,0,2,2,7,6,0
2684,Niklas Sule,20.4,29,23,21,7,1,18,24,75.0,6,16,12,4,28,57,49,0
2685,Kamaldeen Sulemana,11.3,23,12,7,9,7,10,17,58.8,7,10,1,9,4,27,5,0
2686,Crysencio Summerville,1.4,5,3,1,1,3,2,3,66.7,1,2,0,2,2,7,0,0
2687,Vladyslav Supriaha,0.2,0,0,0,0,0,0,1,0.0,1,0,0,0,0,0,0,0
2688,Suso,4.3,4,3,1,3,0,3,13,23.1,10,4,0,4,0,4,0,0
2689,Bosko Sutalo,10.2,20,13,11,6,3,8,16,50.0,8,10,5,5,17,37,39,0
2690,Mattias Svanberg,28.5,39,15,15,16,8,16,54,29.6,38,31,9,22,28,67,34,0
2691,Michael Svoboda,13.7,33,17,26,6,1,18,32,56.3,14,27,15,12,10,43,61,5
2692,Abdoulaye Sylla,1.7,4,4,2,1,1,2,4,50.0,2,5,3,2,1,5,3,0
2693,Mamadou Sylla,4.4,2,2,0,1,1,0,1,0.0,1,0,0,0,1,3,5,0
2694,Mamadou Sylla,2.8,1,1,1,0,0,0,1,0.0,1,2,0,2,4,5,3,0
2695,Adam Szalai,2.9,3,2,0,2,1,0,2,0.0,2,2,0,2,0,3,0,0
2696,Wojciech Szczesny,33.0,1,1,1,0,0,1,2,50.0,1,0,0,0,0,1,8,1
2697,Dominik Szoboszlai,17.1,17,12,5,9,3,8,27,29.6,19,30,3,27,10,27,15,0
2698,Jakob Sorensen,6.7,22,11,6,14,2,10,20,50.0,10,7,3,4,10,32,19,0
2699,Alexander Sorloth,19.6,20,7,4,10,6,7,17,41.2,10,14,1,13,4,24,15,0
2700,Tachi,2.7,6,3,3,3,0,5,7,71.4,2,4,3,1,1,7,9,0
2701,Jonathan Tah,32.0,25,18,19,5,1,17,33,51.5,16,31,20,11,43,68,156,0
2702,Waniss Taibi,1.5,8,7,4,4,0,2,4,50.0,2,0,0,0,1,9,1,0
2704,Flavien Tait,23.6,28,19,13,9,6,13,40,32.5,27,15,4,11,19,47,13,1
2705,Adrien Tameze,28.6,52,29,24,21,7,20,59,33.9,39,40,5,35,52,104,41,0
2706,Japhet Tanganga,8.2,14,8,7,6,1,9,19,47.4,10,13,5,8,9,23,31,0
2707,Renato Tapia,15.7,50,31,15,31,4,20,50,40.0,30,21,5,16,28,78,43,0
2708,Edmond Tapsoba,20.2,35,17,24,10,1,20,32,62.5,12,27,15,12,29,64,72,1
2709,Florian Tardieu,29.2,58,25,31,21,6,31,71,43.7,40,31,9,22,42,100,38,0
2710,Matt Targett,15.9,34,18,28,5,1,24,45,53.3,21,16,9,7,23,57,35,0
2711,Matt Targett,16.0,41,26,26,14,1,24,37,64.9,13,15,4,11,25,66,39,1
2713,James Tarkowski,34.5,65,45,47,17,1,33,47,70.2,14,75,61,14,48,113,186,4
2714,Ciprian Tatarusanu,6.0,0,0,0,0,0,0,1,0.0,1,0,0,0,0,0,2,1
2715,Niklas Tauer,5.4,16,9,9,7,0,9,14,64.3,5,6,2,4,9,25,14,0
2716,Nuno Tavares,13.1,21,14,10,7,4,8,18,44.4,10,15,5,10,9,30,33,1
2717,Charlie Taylor,30.3,45,26,31,11,3,26,44,59.1,18,42,20,22,58,103,95,2
2718,Loum Tchaouna,1.0,3,1,1,2,0,1,5,20.0,4,0,0,0,2,5,0,0
2719,Warren Tchimbembe,2.3,1,1,0,1,0,0,1,0.0,1,2,1,1,2,3,2,0
2720,Aurelien Tchouameni,32.5,86,45,33,49,4,29,55,52.7,26,39,7,32,101,187,34,0
2722,Jordan Tell,3.2,5,5,0,3,2,1,4,25.0,3,3,0,3,0,5,1,0
2723,Nathan Tella,8.9,13,9,5,7,1,6,17,35.3,11,13,0,13,6,19,9,0
2724,Alex Telles,18.4,48,27,35,9,4,27,43,62.8,16,17,4,13,26,74,45,0
2725,Cristian Tello,9.1,17,11,6,7,4,13,31,41.9,18,9,0,9,10,27,6,0
2726,Nahuel Tenaglia,11.9,42,27,30,9,3,24,37,64.9,13,10,2,8,26,68,42,0
2727,Marc Tenas,0.6,1,1,1,0,0,1,1,100.0,0,1,0,1,0,1,0,1
2728,Marc-Andre ter Stegen,35.0,0,0,0,0,0,0,1,0.0,1,0,0,0,1,1,13,5
2731,Pietro Terracciano,31.8,0,0,0,0,0,0,4,0.0,4,0,0,0,2,2,20,1
2732,Martin Terrier,30.9,55,33,22,16,17,25,43,58.1,18,29,3,26,18,73,17,0
2733,Aleksa Terzic,3.0,8,5,3,3,2,4,7,57.1,3,7,0,7,4,12,5,0
2734,Robert Tesche,3.9,6,4,4,1,1,5,7,71.4,2,6,2,4,5,11,5,1
2735,Tanner Tessmann,7.6,11,5,4,6,1,5,14,35.7,9,19,9,10,5,16,22,0
2736,Tete,6.5,10,5,4,5,1,3,13,23.1,10,4,0,4,3,13,1,0
2737,Cedric Teuchert,1.2,3,2,3,0,0,2,6,33.3,4,1,0,1,0,3,0,0
2738,Arthur Theate,26.9,33,19,26,3,4,14,31,45.2,17,29,16,13,42,75,69,0
2739,Jan Thielmann,13.2,24,16,6,12,6,8,23,34.8,15,23,2,21,10,34,11,0
2741,Sada Thioub,10.6,13,8,5,8,0,6,14,42.9,8,9,0,9,10,23,8,0
2742,Luke Thomas,21.2,50,31,33,13,4,28,65,43.1,37,35,14,21,40,90,55,0
2743,Romain Thomas,28.5,49,37,28,21,0,30,57,52.6,27,35,19,16,44,93,126,0
2744,Adrien Thomasson,26.5,64,31,18,27,19,30,93,32.3,63,56,4,52,29,93,16,1
2745,Erik Thommy,3.0,2,0,0,2,0,1,2,50.0,1,3,0,3,4,6,0,0
2746,Dominic Thompson,1.6,1,0,1,0,0,0,1,0.0,1,2,2,0,2,3,3,0
2747,Morten Thorsby,32.7,46,26,15,23,8,28,56,50.0,28,37,12,25,25,71,39,0
2748,Thuler,9.5,21,12,17,4,0,8,15,53.3,7,9,7,2,9,30,30,0
2749,Khephren Thuram,21.1,33,19,11,18,4,17,35,48.6,18,31,11,20,28,61,19,0
2750,Marcus Thuram,10.9,6,5,0,5,1,1,4,25.0,3,5,0,5,5,11,5,0
2751,Alexis Tibidi,4.3,7,3,1,3,3,3,4,75.0,1,4,0,4,3,10,2,0
2752,Cheikh Tidiane Sabaly,1.7,6,3,1,4,1,2,2,100.0,0,1,0,1,0,6,1,0
2753,Youri Tielemans,29.2,74,38,23,45,6,42,100,42.0,58,47,13,34,21,95,41,3
2754,Kieran Tierney,21.3,18,14,11,7,0,10,11,90.9,1,23,5,18,15,33,54,0
2756,Steffen Tigges,1.2,4,3,1,2,1,2,3,66.7,1,3,1,2,0,4,3,0
2757,Malik Tillman,1.2,2,1,0,1,1,0,1,0.0,1,5,1,4,2,4,1,0
2758,Timothy Tillman,22.3,43,26,17,18,8,19,42,45.2,23,33,4,29,12,55,26,0
2759,David Timor,3.8,1,1,1,0,0,0,3,0.0,3,3,2,1,1,2,4,1
2761,Jean-Clair Todibo,34.6,59,37,43,15,1,39,60,65.0,21,45,21,24,51,110,130,2
2763,Karl Toko Ekambi,25.5,13,7,4,6,3,4,21,19.0,17,26,0,26,20,33,5,0
2764,Corentin Tolisso,7.8,11,5,1,9,1,7,17,41.2,10,5,1,4,9,20,10,0
2765,Jeremy Toljan,15.5,18,10,12,4,2,13,20,65.0,7,12,5,7,12,30,41,0
2766,Rafael Toloi,16.0,38,15,12,15,11,24,39,61.5,15,23,11,12,26,64,35,0
2767,Raul de Tomas,32.4,15,11,6,7,2,6,17,35.3,11,12,3,9,6,21,42,1
2768,Tiago Tomas,11.9,8,4,0,7,1,0,6,0.0,6,3,0,3,4,12,1,0
2769,Takehiro Tomiyasu,18.7,35,17,19,13,3,21,32,65.6,11,22,3,19,24,59,64,2
2771,James Tomkins,6.1,8,3,6,2,0,6,8,75.0,2,8,8,0,4,12,18,0
2772,Fikayo Tomori,30.2,73,44,36,34,3,18,26,69.2,8,37,23,14,45,118,84,1
2773,Sandro Tonali,28.9,54,37,23,25,6,21,41,51.2,20,26,8,18,34,88,19,0
2774,Lorenzo Tonelli,9.7,17,9,11,4,2,6,13,46.2,7,14,8,6,19,36,28,2
2775,Ivan Toney,32.3,33,21,5,20,8,12,38,31.6,26,16,2,14,14,47,44,1
2776,Ernesto Torregrossa,1.3,2,1,1,0,1,1,2,50.0,1,0,0,0,0,2,1,0
2777,Lucas Torreira,24.4,37,29,13,21,3,18,40,45.0,22,18,1,17,26,63,18,0
2778,Raul Torrente,14.2,31,21,18,11,2,16,29,55.2,13,14,9,5,12,43,69,0
2779,Ferran Torres,3.4,2,2,0,1,1,0,3,0.0,3,2,0,2,0,2,1,0
2780,Ferran Torres,15.7,10,5,3,4,3,3,7,42.9,4,12,3,9,6,16,7,0
2782,Oliver Torres,11.2,22,12,8,7,7,8,25,32.0,17,10,1,9,6,28,4,0
2783,Pau Torres,31.7,32,19,23,7,2,18,25,72.0,7,32,23,9,19,51,105,2
2784,Roberto Torres,9.0,7,4,3,1,3,3,15,20.0,12,8,0,8,8,15,4,0
2785,Lucas Torro,30.3,71,40,25,38,8,29,57,50.9,28,32,11,21,47,118,55,0
2786,Jordan Torunarigha,5.4,4,1,1,3,0,4,5,80.0,1,4,2,2,17,21,30,0
2788,Abdoulaye Toure,4.8,12,4,3,8,1,5,11,45.5,6,6,1,5,4,16,6,0
2789,Almamy Toure,5.6,12,9,8,3,1,4,17,23.5,13,10,3,7,5,17,19,0
2790,Lucas Tousart,21.8,42,25,15,22,5,10,34,29.4,24,30,6,24,35,77,55,0
2791,Yoann Touzghar,16.2,5,2,1,3,1,1,3,33.3,2,3,1,2,3,8,8,0
2792,Andros Townsend,16.2,31,17,15,6,10,15,40,37.5,25,28,2,26,14,45,6,1
2793,Adama Traore,11.9,8,3,6,0,2,3,7,42.9,4,4,1,3,2,10,1,0
2794,Adama Traore,4.2,4,2,0,3,1,3,5,60.0,2,2,0,2,4,8,3,1
2796,Bertrand Traore,2.4,3,3,0,1,2,1,2,50.0,1,0,0,0,0,3,1,0
2797,Boubacar Traore,19.2,43,26,18,23,2,10,39,25.6,29,29,5,24,25,68,11,1
2798,Charles Traore,8.0,16,12,10,4,2,2,13,15.4,11,11,4,7,15,31,30,0
2799,Hamari Traore,32.1,63,36,25,26,12,41,59,69.5,18,29,8,21,37,100,81,1
2800,Ismael Traore,35.7,28,17,16,11,1,13,28,46.4,15,25,17,8,44,72,122,1
2801,Kevin Trapp,32.0,0,0,0,0,0,0,1,0.0,1,0,0,0,1,1,13,2
2802,Miguel Trauco,12.4,25,18,16,8,1,12,22,54.5,10,13,4,9,23,48,17,0
2803,Oscar Trejo,22.3,42,24,14,18,10,15,50,30.0,35,26,1,25,13,55,11,0
2805,Manu Trigueros,24.2,45,25,16,18,11,23,66,34.8,43,19,3,16,13,58,17,0
2806,Simone Trimboli,0.7,2,1,2,0,0,2,2,100.0,0,0,0,0,2,4,0,0
2808,Christopher Trimmel,22.1,49,30,25,19,5,26,45,57.8,19,20,3,17,34,83,75,0
2809,Francisco Trincao,14.8,28,15,9,13,6,3,19,15.8,16,17,1,16,12,40,1,1
2810,Kieran Trippier,4.8,17,10,8,8,1,10,16,62.5,6,10,3,7,10,27,10,0
2811,Kieran Trippier,10.8,22,12,12,5,5,12,21,57.1,9,12,1,11,10,32,11,0
2812,William Troost-Ekong,15.4,18,9,11,6,1,10,15,66.7,5,24,14,10,7,25,82,1
2813,Leandro Trossard,31.2,34,20,12,9,13,4,31,12.9,27,33,4,29,15,49,10,0
2814,Adrien Truffert,18.2,29,21,17,9,3,11,24,45.8,13,25,5,20,19,48,30,0
2816,Kostas Tsimikas,9.7,27,12,12,8,7,12,16,75.0,4,6,2,4,10,37,22,2
2817,Axel Tuanzebe,5.6,5,3,3,2,0,2,5,40.0,3,5,4,1,5,10,12,1
2819,Ozan Tufan,3.7,3,2,1,1,1,1,5,20.0,4,2,0,2,2,5,4,0
2820,Benat Turrientes,2.3,0,0,0,0,0,0,4,0.0,4,1,0,1,2,2,2,0
2821,Tuta,24.3,46,28,20,22,4,26,47,55.3,21,43,15,28,41,87,76,1
2822,Christos Tzolis,3.7,5,3,3,1,1,2,9,22.2,7,3,0,3,1,6,1,0
2823,Destiny Udogie,27.5,64,40,30,27,7,33,60,55.0,27,39,6,33,27,91,42,0
2824,Matthieu Udol,11.2,23,14,11,10,2,12,18,66.7,6,20,7,13,31,54,29,1
2825,Ike Ugbo,9.0,3,1,0,1,2,0,1,0.0,1,4,1,3,2,5,1,0
2826,Lesley Ugochukwu,4.5,13,9,5,5,3,9,19,47.4,10,7,2,5,4,17,2,0
2827,Hwang Ui-jo,27.9,10,4,4,4,2,4,13,30.8,9,9,1,8,5,15,18,0
2829,Maximilian Ullmann,2.7,0,0,0,0,0,0,1,0.0,1,4,0,4,2,2,7,0
2831,Samuel Umtiti,1.0,2,2,2,0,0,1,2,50.0,1,1,1,0,0,2,4,0
2832,Enes Unal,31.1,37,22,2,18,17,5,42,11.9,37,25,5,20,5,42,36,0
2834,Cengiz Under,24.4,18,13,5,6,7,5,18,27.8,13,13,2,11,14,32,9,0
2835,Dayot Upamecano,24.6,66,42,42,21,3,24,36,66.7,12,20,10,10,32,98,71,6
2837,Kacper Urbanski,0.5,3,2,1,2,0,2,2,100.0,0,2,0,2,0,3,0,0
2838,Jere Uronen,9.8,28,15,15,10,3,14,24,58.3,10,12,3,9,16,44,21,0
2839,Mark Uth,22.5,32,20,9,14,9,15,49,30.6,34,27,1,26,14,46,13,0
2840,Myrto Uzuni,9.5,7,4,6,1,0,0,2,0.0,2,13,1,12,10,17,7,0
2841,Antonio Vacca,11.8,36,20,24,10,2,14,36,38.9,22,16,8,8,20,56,16,0
2842,Alvaro Vadillo,0.1,1,1,1,0,0,1,2,50.0,1,0,0,0,0,1,1,0
2843,Oscar Valentin,28.5,102,53,46,51,5,44,105,41.9,61,56,10,46,39,141,43,0
2844,German Valera,0.6,3,2,3,0,0,1,1,100.0,0,0,0,0,0,3,1,0
2845,Yan Valery,4.1,8,6,4,3,1,4,9,44.4,5,6,3,3,6,14,19,1
2846,Martin Valjent,35.3,31,19,18,12,1,13,24,54.2,11,34,26,8,31,62,173,1
2847,Jesus Vallejo,3.8,7,5,7,0,0,5,6,83.3,1,9,8,1,6,13,16,0
2848,Manu Vallejo,4.1,8,2,1,4,3,4,13,30.8,9,7,0,7,0,8,4,0
2849,Manu Vallejo,1.1,2,1,1,1,0,0,1,0.0,1,0,0,0,0,2,1,0
2850,Federico Valverde,20.4,36,16,11,16,9,12,31,38.7,19,23,5,18,24,60,12,0
2851,Virgil van Dijk,34.0,16,10,11,5,0,11,16,68.8,5,21,14,7,31,47,109,0
2852,Vanderson,12.4,35,19,10,19,6,15,23,65.2,8,17,4,13,13,48,12,0
2853,Zinho Vanheusden,11.0,18,6,12,5,1,8,14,57.1,6,19,14,5,23,41,42,0
2855,Raphael Varane,20.3,28,19,21,6,1,10,22,45.5,12,18,9,9,18,46,82,1
2856,Jamie Vardy,20.1,6,5,0,4,2,1,7,14.3,6,9,0,9,1,7,17,0
2857,Ruben Vargas,22.0,28,21,7,14,7,11,30,36.7,19,9,1,8,16,44,13,0
2858,Sebastian Vasiliadis,13.3,31,17,12,15,4,15,42,35.7,27,15,2,13,25,56,31,1
2860,Johan Vasquez,25.3,79,46,44,32,3,48,75,64.0,27,32,10,22,42,121,85,0
2862,Jose Luis Garcia Vaya,22.4,46,27,10,31,5,16,41,39.0,25,24,5,19,38,84,30,0
2863,Jesus Vazquez,9.0,24,13,10,8,6,10,22,45.5,12,16,3,13,9,33,19,0
2864,Kevin Vazquez,14.8,34,24,12,13,9,14,28,50.0,14,20,7,13,36,70,34,0
2865,Lucas Vazquez,20.4,43,22,24,9,10,17,35,48.6,18,25,7,18,20,63,41,1
2866,Matias Vecino,4.2,7,5,2,3,2,3,9,33.3,6,10,1,9,4,11,7,0
2867,Gabriel Veiga,1.2,5,4,0,4,1,3,12,25.0,9,2,0,2,4,9,1,0
2868,Miguel Veloso,14.9,23,15,4,17,2,10,16,62.5,6,18,5,13,11,34,18,1
2869,Joel Veltman,31.9,74,48,47,21,6,21,53,39.6,32,46,16,30,45,119,89,0
2870,Micky van de Ven,2.1,4,4,3,1,0,0,1,0.0,1,4,1,3,2,6,8,0
2871,Unai Vencedor Paris,26.5,26,11,11,9,6,8,42,19.0,34,31,13,18,19,45,22,0
2872,Lorenzo Venuti,17.5,25,10,13,10,2,14,24,58.3,10,13,4,9,5,30,27,0
2873,Daniele Verde,21.7,11,4,8,2,1,9,20,45.0,11,17,2,15,18,29,8,0
2875,Simone Verdi,9.2,12,8,5,2,5,9,20,45.0,11,4,0,4,3,15,1,0
2876,Gonzalo Verdu,15.5,19,9,15,4,0,8,16,50.0,8,20,14,6,13,32,59,1
2877,Jordan Veretout,25.8,34,25,20,12,2,15,39,38.5,24,12,1,11,27,61,22,1
2880,Marco Verratti,21.5,60,40,16,30,14,32,64,50.0,32,36,10,26,18,78,14,2
2881,Valerio Verre,4.7,7,5,1,4,2,4,9,44.4,5,7,0,7,0,7,5,0
2882,Valerio Verre,3.4,4,2,3,1,0,2,7,28.6,5,2,0,2,1,5,0,0
2883,Freddie Veseli,6.6,7,2,4,3,0,5,6,83.3,1,10,5,5,4,11,19,0
2884,Mikel Vesga,15.1,27,14,7,18,2,11,31,35.5,20,16,5,11,20,47,34,2
2886,Jannik Vestergaard,6.3,15,10,12,3,0,8,15,53.3,7,10,8,2,7,22,36,0
2887,Ruben Vezo,26.9,41,29,28,12,1,26,41,63.4,15,41,25,16,36,77,105,1
2888,Guglielmo Vicario,38.0,1,1,1,0,0,1,1,100.0,0,1,0,1,1,2,21,1
2889,Aleix Vidal,21.1,31,25,17,9,5,19,39,48.7,20,19,6,13,25,56,35,2
2890,Arturo Vidal,8.2,26,10,16,9,1,9,26,34.6,17,13,5,8,7,33,7,1
2891,Nacho Vidal,32.2,83,47,49,25,9,39,77,50.6,38,32,14,18,58,141,79,0
2893,Ronaldo Vieira,5.5,10,6,6,4,0,5,10,50.0,5,5,2,3,6,16,5,1
2894,Nick Viergever,23.7,32,23,25,7,0,24,34,70.6,10,31,22,9,37,69,119,1
2895,Luca Vignali,0.9,1,1,0,1,0,0,3,0.0,3,0,0,0,1,2,1,0
2896,Emanuel Vignato,6.6,12,7,5,7,0,6,13,46.2,7,2,0,2,2,14,5,0
2897,Didac Vila,2.3,7,5,2,5,0,4,9,44.4,5,2,1,1,3,10,8,0
2898,Tonny Vilhena,10.3,16,6,7,8,1,7,21,33.3,14,10,2,8,8,24,17,0
2900,Asier Villalibre,6.1,4,3,2,1,1,1,2,50.0,1,3,1,2,1,5,7,0
2901,Gonzalo Villar,3.3,5,3,4,1,0,2,5,40.0,3,4,1,3,1,6,1,0
2902,Matias Vina,17.4,46,30,27,14,5,29,59,49.2,30,26,3,23,25,71,33,0
2903,Nicolas Viola,1.1,2,2,1,1,0,1,2,50.0,1,1,1,0,0,2,1,0
2904,Mattia Viti,16.6,28,16,16,9,3,15,24,62.5,9,28,25,3,29,57,69,1
2905,Vitolo,2.5,3,2,1,1,1,2,5,40.0,3,3,0,3,1,4,1,0
2906,Daniel Vivian,22.1,32,21,24,7,1,17,24,70.8,7,20,15,5,26,58,107,1
2907,Dusan Vlahovic,20.6,5,0,0,2,3,2,11,18.2,9,6,2,4,1,6,16,0
2908,Dusan Vlahovic,12.0,0,0,0,0,0,0,4,0.0,4,3,0,3,0,0,7,0
2909,Nikola Vlasic,6.2,11,7,4,6,1,5,20,25.0,15,4,0,4,2,13,1,0
2910,Andreas Voglsammer,9.8,14,9,8,3,3,6,14,42.9,8,9,2,7,2,16,7,0
2912,Kevin Vogt,28.5,21,12,15,6,0,11,21,52.4,10,18,7,11,13,34,101,1
2913,Mergim Vojvoda,22.0,38,23,23,11,4,20,36,55.6,16,27,8,19,20,58,51,0
2914,Kevin Volland,27.1,24,10,2,18,4,6,31,19.4,25,20,0,20,3,27,9,0
2915,Cristian Volpato,0.4,1,1,0,0,1,1,1,100.0,0,0,0,0,0,1,0,0
2916,Aster Vranckx,12.7,34,13,14,16,4,14,26,53.8,12,19,7,12,13,47,16,0
2917,Stefan de Vrij,26.8,38,29,22,16,0,12,17,70.6,5,17,8,9,32,70,52,0
2918,Sime Vrsaljko,10.2,27,17,14,12,1,12,20,60.0,8,10,1,9,12,39,30,0
2919,Nikola Vukcevic,1.3,3,2,2,1,0,0,1,0.0,1,2,0,2,2,5,1,0
2920,Matej Vydra,7.5,12,7,3,4,5,3,7,42.9,4,5,1,4,0,12,9,0
2921,Elye Wahi,19.8,18,10,9,6,3,6,16,37.5,10,7,0,7,4,22,4,0
2922,Walace,33.0,83,49,37,38,8,50,113,44.2,63,51,5,46,54,137,32,1
2923,Theo Walcott,4.2,4,2,2,0,2,1,5,20.0,4,3,0,3,5,9,2,0
2924,Luca Waldschmidt,8.0,9,1,3,5,1,5,13,38.5,8,5,0,5,8,17,3,0
2925,Kyle Walker,19.5,15,6,7,7,1,8,17,47.1,9,14,4,10,14,29,16,1
2926,Kyle Walker-Peters,29.3,57,33,28,21,8,26,38,68.4,12,29,8,21,37,94,53,1
2927,Sebastian Walukiewicz,3.4,9,5,7,2,0,3,5,60.0,2,5,2,3,7,16,14,0
2928,Aaron Wan-Bissaka,19.9,49,36,25,18,6,14,20,70.0,6,24,14,10,34,83,41,2
2929,Paul Wanner,0.4,2,2,0,2,0,1,1,100.0,0,0,0,0,0,2,0,0
2931,Joel Ward,27.6,44,26,30,11,3,30,57,52.6,27,24,11,13,32,76,107,1
2932,James Ward-Prowse,35.7,41,24,12,24,5,19,70,27.1,51,43,15,28,40,81,45,1
2935,Daniel Wass,17.6,23,13,6,14,3,8,31,25.8,23,13,2,11,13,36,19,0
2936,Ollie Watkins,32.8,17,13,2,7,8,2,15,13.3,13,25,3,22,12,29,27,0
2938,Timothy Weah,18.0,19,7,8,8,3,10,20,50.0,10,16,1,15,10,29,7,0
2939,Adam Webster,15.9,26,8,17,7,2,13,20,65.0,7,25,17,8,17,43,66,2
2940,Wout Weghorst,16.1,17,9,3,9,5,6,19,31.6,13,16,5,11,6,23,13,0
2941,Wout Weghorst,17.3,13,7,3,3,7,7,17,41.2,10,10,3,7,2,15,11,1
2942,Noah Weisshaupt,1.1,1,1,1,0,0,1,2,50.0,1,2,0,2,1,2,1,1
2943,Danny Welbeck,16.4,14,7,2,8,4,3,10,30.0,7,18,2,16,5,19,18,0
2944,Timo Werner,14.3,8,4,3,3,2,2,20,10.0,18,9,0,9,2,10,4,0
2945,Ashley Westwood,25.4,21,12,8,12,1,10,31,32.3,21,21,9,12,30,51,16,1
2946,Ben White,32.0,44,23,30,8,6,28,45,62.2,17,42,24,18,42,86,102,0
2947,Silvan Widmer,32.4,60,28,32,20,8,36,61,59.0,25,44,16,28,43,103,59,2
2948,Georginio Wijnaldum,18.4,15,9,2,12,1,11,19,57.9,8,13,3,10,9,24,7,0
2949,Jetro Willems,17.8,30,15,18,10,2,15,26,57.7,11,15,3,12,14,44,42,0
2950,Brandon Williams,23.6,55,37,35,18,2,36,64,56.3,28,26,6,20,44,99,50,0
2951,Inaki Williams,30.9,14,5,1,6,7,5,17,29.4,12,18,3,15,3,17,20,0
2953,Nico Williams,14.9,20,10,6,11,3,10,31,32.3,21,18,2,16,5,25,9,0
2954,Joe Willock,22.6,64,37,30,28,6,29,68,42.6,39,37,6,31,21,85,10,1
2955,Callum Wilson,15.4,9,8,1,5,3,1,4,25.0,3,7,2,5,3,12,10,0
2956,Patrick Wimmer,22.8,53,31,13,31,9,22,61,36.1,39,30,1,29,27,80,13,0
2957,Jonas Wind,13.1,10,6,1,7,2,1,4,25.0,3,8,3,5,6,16,13,0
2959,Harry Winks,10.1,15,10,4,9,2,8,21,38.1,13,14,3,11,16,31,10,2
2960,Frederik Winther,3.6,7,2,7,0,0,5,6,83.3,1,4,1,3,8,15,21,0
2961,Florian Wirtz,20.6,25,10,6,16,3,10,28,35.7,18,12,1,11,13,38,4,0
2962,Yoane Wissa,14.3,12,6,5,4,3,1,16,6.3,15,12,5,7,8,20,6,0
2964,Axel Witsel,21.6,42,27,12,23,7,18,30,60.0,12,24,9,15,27,69,38,0
2965,Hannes Wolf,3.4,23,12,4,13,6,10,20,50.0,10,10,0,10,2,25,1,0
2966,Marius Wolf,14.7,26,10,13,9,4,12,24,50.0,12,14,1,13,13,39,8,0
2967,Luca Wollschlager,0.2,1,1,0,1,0,0,1,0.0,1,0,0,0,0,1,0,0
2968,Jeong Woo-yeong,19.8,15,9,6,7,2,5,15,33.3,10,8,1,7,7,22,11,0
2969,Chris Wood,15.2,7,5,0,3,4,3,10,30.0,7,13,4,9,0,7,3,0
2970,Chris Wood,14.7,2,0,1,1,0,1,2,50.0,1,5,2,3,2,4,9,0
2972,Christopher Wooh,11.7,29,11,20,8,1,11,18,61.1,7,21,14,7,21,50,40,1
2974,Xeka,18.0,47,27,18,24,5,27,56,48.2,29,23,3,20,24,71,26,1
2975,Granit Xhaka,25.9,32,18,16,12,4,16,41,39.0,25,21,6,15,21,53,31,0
2976,Sekou Yansane,0.2,0,0,0,0,0,0,1,0.0,1,0,0,0,0,0,1,0
2977,Andriy Yarmolenko,3.5,4,2,2,2,0,2,8,25.0,6,4,2,2,0,4,2,0
2978,Yusuf Yazici,5.7,10,5,3,6,1,1,9,11.1,8,4,0,4,2,12,1,0
2979,Kelvin Yeboah,9.4,14,7,5,7,2,9,19,47.4,10,22,1,21,1,15,7,0
2980,Gerard Yepes,0.2,1,0,0,1,0,1,1,100.0,0,1,0,1,0,1,0,0
2981,Burak Yilmaz,24.6,7,2,0,2,5,2,17,11.8,15,8,1,7,2,9,11,0
2982,Okay Yokuslu,5.2,9,8,6,2,1,5,5,100.0,0,7,5,2,5,14,17,0
2983,Okay Yokuslu,1.6,4,1,2,1,1,2,3,66.7,1,2,1,1,2,6,6,0
2985,Maya Yoshida,20.3,17,10,8,9,0,8,15,53.3,7,27,20,7,28,45,72,1
2986,Ashley Young,13.9,18,6,9,6,3,11,16,68.8,5,10,4,6,13,31,25,1
2988,Zaydou Youssouf,17.3,48,26,21,25,2,14,34,41.2,20,11,3,8,17,65,13,0
2990,Mattia Zaccagni,2.0,3,1,1,0,2,1,2,50.0,1,1,0,1,4,7,0,0
2991,Mattia Zaccagni,20.8,33,16,10,13,10,11,19,57.9,8,17,2,15,20,53,5,0
2992,Dan-Axel Zagadou,10.6,13,7,11,1,1,7,10,70.0,3,14,4,10,15,28,38,2
2993,Wilfried Zaha,30.7,40,20,14,15,11,10,31,32.3,21,28,0,28,5,45,5,0
2994,Denis Zakaria,6.6,11,7,3,6,2,3,11,27.3,8,16,3,13,11,22,7,0
2995,Denis Zakaria,15.5,23,14,9,10,4,12,35,34.3,23,25,5,20,19,42,22,1
2996,Joseba Zaldua,13.0,31,22,20,8,3,16,22,72.7,6,14,4,10,13,44,35,0
2997,Nicola Zalewski,8.8,32,19,17,11,4,21,35,60.0,14,18,1,17,16,48,4,0
2998,Andre-Frank Zambo Anguissa,21.4,50,26,24,17,9,25,51,49.0,26,31,5,26,24,74,33,1
2999,Nicolo Zaniolo,21.9,24,15,0,15,9,6,28,21.4,22,19,0,19,7,31,6,0
3000,Alessandro Zanoli,5.1,10,7,6,3,1,3,5,60.0,2,2,1,1,4,14,16,0
3001,Mattia Zanotti,0.1,1,0,1,0,0,0,1,0.0,1,0,0,0,0,1,0,0
3002,Duvan Zapata,19.1,6,2,0,4,2,4,8,50.0,4,8,1,7,3,9,5,0
3003,Gabriele Zappa,12.7,21,9,12,6,3,6,24,25.0,18,15,5,10,14,35,28,0
3004,Davide Zappacosta,26.1,32,22,12,13,7,19,37,51.4,18,32,2,30,12,44,22,0
3005,Oier Zarraga,13.0,13,5,4,7,2,3,28,10.7,25,17,10,7,19,32,10,0
3006,Simone Zaza,1.4,2,2,1,1,0,1,1,100.0,0,3,0,3,0,2,3,0
3007,Akim Zedadka,37.1,72,44,34,29,9,37,71,52.1,34,32,8,24,58,130,48,0
3008,Deyovaisio Zeefuik,6.3,11,10,6,4,1,6,12,50.0,6,12,4,8,11,22,21,1
3009,Marvin Zeegelaar,7.1,15,11,6,8,1,5,14,35.7,9,12,4,8,12,27,22,1
3010,Arber Zeneli,4.5,1,0,0,0,1,1,5,20.0,4,0,0,0,1,2,1,0
3011,Robin Zentner,32.0,2,2,2,0,0,2,2,100.0,0,0,0,0,2,4,21,1
3012,Andi Zeqiri,11.3,14,7,3,5,6,3,12,25.0,9,10,1,9,2,16,12,0
3013,Mehdi Zerkane,0.9,0,0,0,0,0,0,1,0.0,1,1,1,0,2,2,0,0
3014,Edon Zhegrova,5.3,14,5,2,8,4,5,6,83.3,1,4,1,3,2,16,2,0
3016,Luca Zidane,7.2,0,0,0,0,0,0,1,0.0,1,0,0,0,0,0,1,1
3017,Piotr Zielinski,23.2,19,12,5,9,5,6,21,28.6,15,13,2,11,8,27,4,0
3018,David Zima,14.6,20,12,8,11,1,9,20,45.0,11,15,13,2,23,43,42,0
3019,Christoph Zimmermann,1.7,6,3,5,1,0,3,4,75.0,1,0,0,0,1,7,4,0
3020,Oleksandr Zinchenko,11.6,20,14,7,10,3,11,20,55.0,9,11,3,8,14,34,15,1
3021,Hakim Ziyech,14.7,19,10,5,12,2,10,36,27.8,26,11,1,10,10,29,10,0
3022,Jeroen Zoet,7.0,1,0,1,0,0,1,1,100.0,0,0,0,0,0,1,4,0
3023,Simon Zoller,6.6,4,2,2,1,1,1,3,33.3,2,3,0,3,4,8,2,0
3024,Nadir Zortea,15.7,21,15,9,7,5,11,19,57.9,8,14,2,12,7,28,33,0
3025,Tanguy Zoukrou,0.9,1,0,1,0,0,1,2,50.0,1,0,0,0,0,1,2,0
3026,Kurt Zouma,23.1,11,6,8,3,0,4,7,57.1,3,31,26,5,34,45,132,0
3028,Igor Zubeldia,18.3,20,10,12,8,0,12,18,66.7,6,16,6,10,27,47,53,0
3029,Martin Zubimendi,28.8,52,25,19,30,3,22,44,50.0,22,30,13,17,49,101,48,1
3030,Szymon Zurkowski,25.6,58,33,24,21,13,29,68,42.6,39,43,10,33,35,93,32,1
3031,Martin Odegaard,30.9,49,21,6,24,19,22,61,36.1,39,18,1,17,11,60,11,1
3032,Milan Duric,24.1,1,1,0,1,0,1,3,33.3,2,6,1,5,2,3,32,0
3033,Filip Duricic,7.5,13,10,7,1,5,5,13,38.5,8,7,1,6,4,17,1,0
