,Player,Squad,90s,Tackles - Tkl,Tackles - TklW,Tackles - Def 3rd,Tackles - Mid 3rd,Tackles - Att 3rd,Challenges - Tkl,Challenges - Att,Challenges - Tkl%,Challenges - Lost,Blocks - Blocks,Blocks - Sh,Blocks - Pass,Int,Tkl+Int,Clr,Err
0,Max Aarons,Norwich City,32.0,64,44,49,15,0,37,55,67.3,18,39,19,20,28,92,96,1
1,Yunis Abdelhamid,Reims,33.1,48,27,34,14,0,16,32,50.0,16,50,25,25,68,116,104,0
2,Salis Abdul Samed,Clermont Foot,27.4,43,23,25,16,2,20,57,35.1,37,18,1,17,42,85,15,0
3,Laurent Abergel,Lorient,32.8,110,60,44,53,13,71,166,42.8,95,58,1,57,55,165,13,0
4,Charles Abi,Saint-Étienne,0.5,0,0,0,0,0,0,1,0.0,1,2,0,2,0,0,0,0
5,Dickson Abiama,Greuther Fürth,8.1,11,7,4,5,2,2,10,20.0,8,12,1,11,4,15,8,0
6,Matthis Abline,Rennes,1.1,0,0,0,0,0,0,0,0.0,0,2,0,2,0,0,1,0
7,Tammy Abraham,Roma,34.3,27,13,7,14,6,9,22,40.9,13,17,3,14,5,32,27,0
8,Luis Abram,Granada,6.2,6,3,3,3,0,2,4,50.0,2,6,5,1,5,11,37,1
9,Francesco Acerbi,Lazio,28.2,25,12,15,9,1,12,19,63.2,7,37,28,9,34,59,92,0
10,Ragnar Ache,Eint Frankfurt,2.9,2,0,0,1,1,1,4,25.0,3,3,0,3,0,2,1,0
11,Mohamed Achi,Nantes,0.1,0,0,0,0,0,0,0,0.0,0,0,0,0,0,0,0,0
12,Marcos Acuna,Sevilla,25.1,50,29,27,14,9,30,46,65.2,16,22,5,17,14,64,25,1
13,Che Adams,Southampton,22.7,13,6,5,5,3,2,16,12.5,14,18,2,16,8,21,18,0
14,Tyler Adams,RB Leipzig,15.0,23,7,5,16,2,7,25,28.0,18,24,1,23,16,39,19,2
15,Sargis Adamyan,Hoffenheim,3.7,8,6,3,4,1,3,11,27.3,8,4,0,4,1,9,2,0
16,Martin Adeline,Reims,3.9,15,11,5,8,2,8,16,50.0,8,0,0,0,11,26,6,0
17,Amine Adli,Leverkusen,14.0,27,14,10,14,3,8,15,53.3,7,26,2,24,11,38,12,0
18,Yacine Adli,Bordeaux,25.1,43,27,22,14,7,19,68,27.9,49,33,3,30,37,80,11,2
19,Michel Aebischer,Bologna,4.9,14,5,5,8,1,6,11,54.5,5,4,1,3,6,20,3,0
20,Felix Afena-Gyan,Roma,7.4,10,3,1,6,3,4,7,57.1,3,4,0,4,3,13,0,0
21,Martin Agirregabiria,Alavés,18.0,34,22,17,11,6,18,37,48.6,19,20,3,17,25,59,38,0
22,Julen Agirrezabala,Athletic Club,4.0,0,0,0,0,0,0,0,0.0,0,0,0,0,0,0,2,0
23,Lucien Agoume,Brest,20.8,51,31,24,20,7,23,45,51.1,22,30,9,21,52,103,27,1
24,Kevin Agudelo,Spezia,13.7,44,26,13,26,5,7,20,35.0,13,22,0,22,8,52,6,0
26,Nayef Aguerd,Rennes,30.4,27,18,16,11,0,14,24,58.3,10,24,14,10,24,51,127,1
27,Sergio Aguero,Barcelona,1.7,1,1,0,0,1,0,2,0.0,2,0,0,0,0,1,0,0
28,Ruben Aguilar,Monaco,23.8,78,53,39,32,7,43,68,63.2,25,19,4,15,44,122,57,0
29,Alvaro Aguirre,Rayo Vallecano,0.1,0,0,0,0,0,0,0,0.0,0,0,0,0,0,0,0,0
30,Naouirou Ahamada,Stuttgart,0.7,1,0,1,0,0,1,3,33.3,2,0,0,0,0,1,0,0
31,Anel Ahmedhodzic,Bordeaux,15.0,38,26,27,9,2,20,31,64.5,11,16,8,8,22,60,44,0
32,Jean-Eudes Aholou,Strasbourg,11.2,16,9,4,9,3,5,19,26.3,14,8,1,7,19,35,7,0
33,Joseph Aidoo,Celta Vigo,29.3,39,26,28,10,1,17,31,54.8,14,23,13,10,38,77,96,3
34,Ola Aina,Torino,16.0,27,19,11,10,6,15,23,65.2,8,17,3,14,28,55,30,0
35,Rayan Ait Nouri,Wolves,20.3,64,36,46,15,3,22,44,50.0,22,24,2,22,22,86,39,1
36,Kristoffer Ajer,Brentford,22.2,29,18,21,6,2,13,21,61.9,8,19,11,8,26,55,74,0
37,Ludovic Ajorque,Strasbourg,30.4,36,25,5,19,12,7,40,17.5,33,28,3,25,8,44,31,1
38,Manuel Akanji,Dortmund,25.1,33,23,20,11,2,22,32,68.8,10,26,15,11,35,68,58,0
39,Carlos Akapo,Cádiz,20.5,43,31,26,15,2,21,37,56.8,16,26,7,19,51,94,61,0
40,Marley Ake,Juventus,0.9,0,0,0,0,0,0,2,0.0,2,0,0,0,1,1,0,0
41,Nathan Ake,Manchester City,10.3,16,9,7,8,1,6,8,75.0,2,7,5,2,8,24,23,0
42,Ilias Akhomach,Barcelona,1.4,2,0,0,1,1,0,0,0.0,0,0,0,0,0,2,0,0
43,Maghnes Akliouche,Monaco,0.6,2,0,0,2,0,0,1,0.0,1,2,0,2,0,2,0,0
44,Paul Akouokou,Betis,5.7,14,9,5,7,2,8,12,66.7,4,6,0,6,11,25,6,0
45,Jean-Daniel Akpa-Akpro,Lazio,3.5,17,10,7,9,1,7,12,58.3,5,4,2,2,2,19,6,0
46,Kevin Akpoguma,Hoffenheim,17.0,33,19,16,11,6,16,28,57.1,12,32,2,30,20,53,29,2
47,David Alaba,Real Madrid,29.4,23,13,15,6,2,9,19,47.4,10,26,15,11,22,45,70,1
48,Sofiane Alakouch,Metz,1.8,7,4,3,4,0,2,5,40.0,3,4,0,4,1,8,4,0
49,Tomas Alarcon,Cádiz,15.8,31,20,17,10,4,10,31,32.3,21,19,7,12,30,61,31,0
50,Lucas Alario,Leverkusen,7.3,6,5,0,2,4,2,5,40.0,3,5,0,5,1,7,6,0
52,Jordi Alba,Barcelona,29.4,47,34,12,26,9,27,47,57.4,20,26,6,20,33,80,41,1
53,Josue Albert,Clermont Foot,0.2,0,0,0,0,0,0,0,0.0,0,0,0,0,1,1,2,0
54,Luis Alberto,Lazio,26.1,29,17,8,11,10,8,52,15.4,44,32,4,28,13,42,7,0
55,Raul Albiol,Villarreal,27.4,26,15,20,5,1,14,18,77.8,4,24,15,9,21,47,126,1
56,Marc Albrighton,Leicester City,12.6,31,19,16,9,6,10,47,21.3,37,15,3,12,14,45,20,0
57,Paco Alcacer,Villarreal,8.7,9,3,2,4,3,1,5,20.0,4,7,0,7,6,15,1,0
58,Thiago Alcantara,Liverpool,17.0,48,29,14,24,10,10,42,23.8,32,22,2,20,26,74,13,2
59,Ruben Alcaraz,Cádiz,12.3,41,20,14,24,3,22,45,48.9,23,10,2,8,13,54,14,0
60,Omar Alderete,Valencia,26.7,53,34,34,17,2,34,53,64.2,19,30,18,12,35,88,153,0
61,Ivan Alejo,Cádiz,11.8,33,15,21,10,2,15,44,34.1,29,12,0,12,8,41,17,0
62,Dogan Alemdar,Rennes,12.0,0,0,0,0,0,0,0,0.0,0,0,0,0,0,0,9,1
63,Carles Alena,Getafe,25.8,27,19,11,13,3,9,48,18.8,39,21,2,19,15,42,16,0
64,Trent Alexander-Arnold,Liverpool,31.7,40,23,19,13,8,27,60,45.0,33,22,4,18,43,83,40,0
65,Mohamed Ali Cho,Angers,20.4,10,5,1,4,5,5,17,29.4,12,17,1,16,8,18,0,1
66,Alisson,Liverpool,36.0,3,1,3,0,0,3,5,60.0,2,1,0,1,0,3,28,1
67,Allan,Everton,24.3,74,44,28,39,7,34,105,32.4,71,40,9,31,23,97,39,1
68,Jim Allevinah,Clermont Foot,16.5,18,13,8,8,2,5,18,27.8,13,11,0,11,6,24,4,0
69,Dele Alli,Tottenham,7.3,14,8,10,3,1,5,17,29.4,12,22,5,17,6,20,16,0
70,Dele Alli,Everton,3.8,7,2,3,4,0,0,4,0.0,4,7,2,5,6,13,10,0
71,Miguel Almiron,Newcastle Utd,19.1,47,29,23,17,7,11,44,25.0,33,14,1,13,20,67,13,0
72,Marcos Alonso,Chelsea,24.1,41,29,20,12,9,17,36,47.2,19,29,5,24,43,84,53,0
73,Giorgio Altare,Cagliari,16.3,39,28,18,18,3,21,26,80.8,5,17,5,12,30,69,70,0
74,Hugo Alvarez,Celta Vigo,0.1,1,0,1,0,0,0,0,0.0,0,0,0,0,0,1,1,0
75,Yeray Alvarez,Athletic Club,20.7,24,14,15,8,1,10,18,55.6,8,21,16,5,45,69,97,0
76,Dani Alves,Barcelona,12.2,30,19,13,13,4,14,26,53.8,12,10,3,7,11,41,10,2
78,Steven Alzate,Brighton,4.5,10,4,4,5,1,4,7,57.1,3,2,1,1,10,20,10,0
79,Ibrahim Amadou,Metz,9.0,16,8,10,6,0,8,15,53.3,7,4,2,2,14,30,26,0
80,Emmanuel Amankwaa Akurugu,Getafe,0.9,0,0,0,0,0,0,2,0.0,2,1,0,1,0,0,0,0
81,Daniel Amartey,Leicester City,23.6,26,13,19,7,0,19,29,65.5,10,30,22,8,21,47,93,4
82,Amath,Mallorca,9.8,21,11,11,6,4,7,17,41.2,10,12,0,12,7,28,7,0
83,Jordan Amavi,Nice,4.6,16,10,8,7,1,10,17,58.8,7,3,1,2,15,31,7,0
84,Jordan Amavi,Marseille,1.4,6,5,3,1,2,5,10,50.0,5,1,0,1,1,7,3,0
85,Wisdom Amey,Bologna,0.8,3,2,1,1,1,2,3,66.7,1,2,0,2,3,6,1,0
86,Kelvin Amian,Spezia,29.4,66,42,43,18,5,30,41,73.2,11,39,21,18,32,98,75,0
87,Nadiem Amiri,Genoa,7.6,6,4,2,2,2,2,9,22.2,7,7,0,7,0,6,0,0
88,Nadiem Amiri,Leverkusen,4.1,8,4,3,2,3,4,8,50.0,4,4,2,2,5,13,0,0
89,Ethan Ampadu,Venezia,25.4,67,43,37,27,3,24,58,41.4,34,49,19,30,51,118,76,0
90,Sofyan Amrabat,Fiorentina,10.5,24,13,9,13,2,11,19,57.9,8,25,8,17,5,29,6,1
91,Joachim Andersen,Crystal Palace,32.4,30,23,21,9,0,16,27,59.3,11,29,19,10,37,67,125,3
92,Felipe Anderson,Lazio,32.1,71,45,30,33,8,27,99,27.3,72,65,6,59,20,91,16,0
93,Sebastian Andersson,Köln,14.0,11,7,0,3,8,3,9,33.3,6,8,0,8,3,14,14,0
94,Florin Andone,Cádiz,2.0,1,1,1,0,0,0,1,0.0,1,2,0,2,0,1,1,0
95,Andres Andrade Cedeno,Arminia,11.6,27,16,18,8,1,17,35,48.6,18,16,7,9,19,46,44,0
96,Benjamin Andre,Lille,30.6,123,69,49,65,9,51,113,45.1,62,49,11,38,50,173,56,0
97,Fredrik Andre Bjorkan,Hertha BSC,3.9,12,10,7,4,1,7,9,77.8,2,6,2,4,6,18,8,0
98,Marcos Andre,Valencia,10.8,15,11,4,6,5,5,16,31.3,11,15,0,15,7,22,13,0
99,Robert Andrich,Leverkusen,20.2,33,17,18,14,1,14,28,50.0,14,19,7,12,31,64,46,0
100,Jose Angel,Osasuna,12.0,20,13,9,9,2,9,14,64.3,5,6,1,5,10,30,21,0
101,Angelino,RB Leipzig,25.5,28,21,14,13,1,14,30,46.7,16,24,3,21,29,57,40,0
102,Ebenezer Annan,Bologna,0.3,1,1,1,0,0,0,0,0.0,0,0,0,0,1,2,1,0
104,Cristian Ansaldi,Torino,7.7,20,9,11,7,2,10,13,76.9,3,9,1,8,6,26,10,0
105,Janis Antiste,Spezia,8.8,18,11,6,6,6,5,13,38.5,8,7,1,6,4,22,6,0
106,Waldemar Anton,Stuttgart,28.8,40,26,22,15,3,19,32,59.4,13,27,16,11,32,72,116,1
107,Josep Antoni Gaya,Mallorca,0.6,0,0,0,0,0,0,0,0.0,0,1,0,1,1,1,3,1
108,Michail Antonio,West Ham,33.0,23,17,5,9,9,7,18,38.9,11,19,1,18,3,26,13,0
109,Christopher Antwi-Adjei,Bochum,12.6,21,18,7,8,6,6,26,23.1,20,12,0,12,1,22,8,0
110,Houssem Aouar,Lyon,27.8,46,30,9,25,12,27,54,50.0,27,26,1,25,20,66,5,0
111,Adil Aouchiche,Saint-Étienne,12.0,13,6,5,5,3,5,33,15.2,28,18,1,17,17,30,4,0
112,Dennis Appiah,Nantes,23.3,55,34,35,18,2,28,48,58.3,20,30,13,17,27,82,74,0
113,Mauro Arambarri,Getafe,29.6,62,37,19,32,11,20,68,29.4,48,35,5,30,32,94,18,0
114,Mattia Aramu,Venezia,23.3,20,15,5,9,6,8,33,24.2,25,20,2,18,8,28,19,0
115,Charles Aranguiz,Leverkusen,17.5,45,25,18,21,6,22,52,42.3,30,24,4,20,33,78,21,0
116,Nestor Araujo,Celta Vigo,29.1,22,14,17,5,0,9,21,42.9,12,17,10,7,27,49,105,2
117,Ronald Araujo,Barcelona,25.2,41,23,29,12,0,21,25,84.0,4,37,20,17,23,64,66,1
118,Cameron Archer,Aston Villa,0.3,0,0,0,0,0,0,0,0.0,0,0,0,0,0,0,0,0
119,Alphonse Areola,West Ham,1.0,0,0,0,0,0,0,0,0.0,0,0,0,0,0,0,1,0
120,Jesus Areso,Osasuna,2.1,3,3,2,1,0,0,2,0.0,2,0,0,0,0,3,2,1
121,Matias Arezo,Granada,1.8,5,3,2,1,2,4,9,44.4,5,1,0,1,1,6,1,0
122,Santiago Arias,Granada,4.9,12,5,8,3,1,4,9,44.4,5,8,4,4,5,17,10,0
123,Adam Armstrong,Southampton,15.7,10,4,2,2,6,0,6,0.0,6,13,1,12,3,13,6,0
124,Stuart Armstrong,Southampton,16.4,27,19,15,6,6,9,23,39.1,14,10,1,9,8,35,15,0
125,Marko Arnautovic,Bologna,29.9,17,9,1,11,5,7,30,23.3,23,13,2,11,7,24,17,0
126,Maximilian Arnold,Wolfsburg,33.3,37,20,19,16,2,20,50,40.0,30,43,15,28,37,74,55,0
127,Kepa Arrizabalaga,Chelsea,4.0,0,0,0,0,0,0,0,0.0,0,0,0,0,0,0,4,0
128,Tolgay Arslan,Udinese,18.4,35,20,15,16,4,19,50,38.0,31,17,4,13,13,48,23,1
130,Arthur,Fiorentina,8.3,9,5,2,5,2,4,7,57.1,3,4,1,3,1,10,8,0
131,Santiago Arzamendia,Cádiz,5.2,14,6,6,5,3,6,13,46.2,7,6,0,6,4,18,7,0
132,Takuma Asano,Bochum,17.9,11,6,3,6,2,5,19,26.3,14,14,1,13,7,18,7,0
133,Santiago Ascacibar,Hertha BSC,26.4,93,54,50,37,6,38,89,42.7,51,31,6,25,41,134,42,0
134,Sergio Asenjo,Villarreal,6.0,0,0,0,0,0,0,1,0.0,1,0,0,0,1,1,6,0
135,Alejandro Asensio,Rayo Vallecano,0.1,0,0,0,0,0,0,0,0.0,0,0,0,0,0,0,0,0
136,Marco Asensio,Real Madrid,19.2,12,8,6,4,2,4,18,22.2,14,8,1,7,12,24,6,1
137,Harrison Ashby,West Ham,0.1,0,0,0,0,0,0,0,0.0,0,1,0,1,1,1,1,0
138,Kristoffer Askildsen,Sampdoria,8.4,18,6,7,11,0,9,19,47.4,10,14,7,7,15,33,15,0
139,Fisnik Asllani,Hoffenheim,0.1,0,0,0,0,0,0,1,0.0,1,0,0,0,0,0,0,0
140,Kristjan Asllani,Empoli,15.0,18,9,9,8,1,11,29,37.9,18,16,7,9,19,37,15,1
141,Iago Aspas,Celta Vigo,34.3,14,7,1,5,8,4,24,16.7,20,23,2,21,11,25,19,0
142,Lorenz Assignon,Rennes,6.8,15,10,11,3,1,5,9,55.6,4,3,1,2,11,26,19,0
143,Simon Asta,Greuther Fürth,8.7,13,6,4,5,4,4,8,50.0,4,14,2,12,8,21,16,0
144,Youcef Atal,Nice,12.7,29,19,17,10,2,14,25,56.0,11,13,2,11,32,61,21,0
145,Pierre-Emerick Aubameyang,Arsenal,11.5,11,5,6,4,1,3,10,30.0,7,12,1,11,0,11,4,0
146,Pierre-Emerick Aubameyang,Barcelona,12.0,2,2,0,1,1,0,5,0.0,5,9,1,8,2,4,4,0
147,Emil Audero,Sampdoria,28.4,3,1,3,0,0,3,5,60.0,2,0,0,0,2,5,17,2
148,Tommaso Augello,Sampdoria,26.6,36,20,22,8,6,17,29,58.6,12,19,4,15,29,65,68,1
149,Jean-Kevin Augustin,Nantes,0.9,1,0,0,0,1,0,3,0.0,3,1,0,1,0,1,0,0
150,Ludwig Augustinsson,Sevilla,8.8,18,14,11,3,4,8,13,61.5,5,10,3,7,5,23,21,0
151,Serge Aurier,Villarreal,11.2,14,9,11,2,1,4,7,57.1,3,14,7,7,11,25,25,0
152,Ezequiel Avila,Osasuna,20.8,17,7,6,7,4,7,21,33.3,14,14,2,12,13,30,15,1
153,Taiwo Awoniyi,Union Berlin,24.2,11,7,3,6,2,1,9,11.1,8,11,2,9,2,13,29,0
154,Ramzi Aya,Salernitana,1.5,1,1,1,0,0,1,1,100.0,0,0,0,0,0,1,4,0
156,Jordan Ayew,Crystal Palace,22.4,47,30,20,20,7,17,31,54.8,14,33,3,30,15,62,15,0
157,Kaan Ayhan,Sassuolo,15.0,20,12,14,6,0,7,15,46.7,8,20,14,6,13,33,57,0
158,Luke Ayling,Leeds United,25.2,74,42,46,23,5,51,97,52.6,46,46,25,21,28,102,52,1
159,Karim Azamoum,Troyes,4.3,6,5,4,2,0,3,5,60.0,2,4,2,2,1,7,10,0
160,Sardar Azmoun,Leverkusen,4.0,3,1,0,2,1,0,5,0.0,5,2,0,2,0,3,8,0
161,Cesar Azpilicueta,Chelsea,23.0,51,28,18,27,6,16,35,45.7,19,32,9,23,23,74,65,1
162,Iddrisu Baba,Mallorca,21.5,57,30,31,23,3,25,43,58.1,18,19,5,14,24,81,34,1
163,Carlos Bacca,Granada,5.7,4,4,2,0,2,0,3,0.0,3,5,0,5,1,5,5,0
164,Daniel Bachmann,Watford,12.0,0,0,0,0,0,0,0,0.0,0,0,0,0,1,1,5,0
165,Loic Bade,Rennes,10.9,6,5,4,2,0,3,5,60.0,2,12,10,2,12,18,48,0
166,Milan Badelj,Genoa,31.6,64,37,25,30,9,34,80,42.5,46,39,7,32,85,149,43,0
167,Edgar Badia,Elche,24.0,0,0,0,0,0,0,0,0.0,0,0,0,0,0,0,16,2
168,Benoit Badiashile,Monaco,20.4,36,19,21,15,0,14,23,60.9,9,18,12,6,28,64,68,1
169,Youssouph Badji,Brest,1.5,1,0,0,1,0,0,1,0.0,1,0,0,0,0,1,0,0
170,Miguel Baeza,Celta Vigo,0.0,0,0,0,0,0,0,0,0.0,0,0,0,0,0,0,0,0
171,Nicola Bagnolini,Bologna,0.0,0,0,0,0,0,0,0,0.0,0,0,0,0,0,0,0,0
172,Issa Bah,Venezia,0.1,0,0,0,0,0,0,0,0.0,0,0,0,0,0,0,0,0
173,Stephane Bahoken,Angers,12.2,13,8,2,7,4,1,9,11.1,8,15,0,15,3,16,3,0
174,Leon Bailey,Aston Villa,8.5,17,11,6,8,3,6,13,46.2,7,10,1,9,1,18,2,0
175,Eric Bailly,Manchester Utd,2.4,5,4,4,0,1,3,4,75.0,1,4,2,2,3,8,11,0
176,Denys Bain,Brest,2.0,3,3,1,2,0,1,1,100.0,0,3,1,2,3,6,5,0
177,Stefan Bajic,Saint-Étienne,5.7,0,0,0,0,0,0,0,0.0,0,0,0,0,0,0,4,0
178,Nedim Bajrami,Empoli,22.8,21,14,5,13,3,4,14,28.6,10,11,0,11,3,24,8,0
179,Cedric Bakambu,Marseille,4.0,2,0,1,0,1,0,3,0.0,3,2,0,2,0,2,1,0
180,Abdoulaye Bakayoko,Saint-Étienne,3.4,15,9,13,2,0,8,12,66.7,4,5,4,1,12,27,15,0
182,Tiemoue Bakayoko,Milan,5.6,19,13,9,7,3,5,16,31.3,11,8,1,7,9,28,10,2
183,Mitchel Bakker,Leverkusen,20.2,33,22,16,12,5,20,34,58.8,14,13,2,11,23,56,42,3
184,Ridle Baku,Wolfsburg,27.2,62,37,30,24,8,25,65,38.5,40,43,1,42,21,83,52,1
185,Dilane Bakwa,Bordeaux,0.5,1,1,0,1,0,1,2,50.0,1,0,0,0,0,1,1,0
186,Tommaso Baldanzi,Empoli,0.2,0,0,0,0,0,0,0,0.0,0,1,0,1,0,0,0,0
187,Alejandro Balde,Barcelona,2.1,2,1,1,0,1,0,0,0.0,0,2,2,0,1,3,1,0
188,Ibrahima Balde,Lens,0.6,0,0,0,0,0,0,0,0.0,0,0,0,0,0,0,0,0
189,Keita Balde,Cagliari,13.7,8,4,1,5,2,1,10,10.0,9,6,0,6,4,12,6,0
190,Gareth Bale,Real Madrid,3.1,2,1,1,0,1,1,4,25.0,3,2,0,2,2,4,1,0
191,Mikel Balenziaga,Athletic Club,22.5,33,24,15,15,3,25,43,58.1,18,27,4,23,21,54,79,0
192,Leonardo Balerdi,Marseille,10.6,9,6,9,0,0,5,14,35.7,9,11,4,7,19,28,30,0
193,Ivan Balliu,Rayo Vallecano,35.0,45,22,25,11,9,19,31,61.3,12,24,5,19,39,84,64,0
194,Fode Ballo-Toure,Milan,5.0,18,14,5,13,0,4,9,44.4,5,6,2,4,3,21,5,0
195,Folarin Balogun,Arsenal,0.8,1,1,0,0,1,0,0,0.0,0,1,0,1,0,1,1,0
196,Abdoulaye Bamba,Angers,5.1,6,5,6,0,0,4,11,36.4,7,5,1,4,9,15,13,0
197,Jonathan Bamba,Lille,27.0,30,12,13,9,8,13,36,36.1,23,24,1,23,21,51,10,0
198,Patrick Bamford,Leeds United,6.2,1,0,0,1,0,0,3,0.0,3,8,2,6,2,3,8,0
199,Filippo Bandinelli,Empoli,21.7,33,20,10,17,6,15,31,48.4,16,22,5,17,10,43,37,2
200,Mattia Bani,Genoa,13.5,23,13,17,6,0,14,18,77.8,4,19,11,8,20,43,76,0
201,Simon Banza,Lens,1.4,2,1,0,0,2,0,2,0.0,2,1,0,1,1,3,2,0
202,Shandon Baptiste,Brentford,10.1,14,4,9,4,1,6,15,40.0,9,10,0,10,11,25,12,0
203,Antonin Barak,Hellas Verona,26.0,18,8,9,8,1,5,17,29.4,12,32,5,27,6,24,26,0
204,Barbero,Osasuna,0.2,0,0,0,0,0,0,0,0.0,0,0,0,0,0,0,1,0
205,Danilo Barbosa,Nice,1.0,0,0,0,0,0,0,0,0.0,0,1,1,0,2,2,10,0
206,Barcia,Granada,0.8,0,0,0,0,0,0,0,0.0,0,1,1,0,1,1,0,1
208,Bradley Barcola,Lyon,2.9,7,4,2,3,2,1,8,12.5,7,7,1,6,2,9,1,0
209,Melvin Bard,Nice,28.8,59,37,38,17,4,41,63,65.1,22,33,10,23,51,110,56,0
210,Enis Bardhi,Levante,18.9,29,12,12,14,3,12,35,34.3,23,13,2,11,10,39,7,0
211,Francesco Bardi,Bologna,2.0,0,0,0,0,0,0,0,0.0,0,0,0,0,0,0,0,0
212,Keidi Bare,Espanyol,16.5,27,17,14,12,1,11,31,35.5,20,20,10,10,15,42,26,1
213,Nicolo Barella,Inter,32.4,63,42,17,35,11,29,55,52.7,26,26,2,24,21,84,8,2
214,Kike Barja,Osasuna,9.6,15,11,4,7,4,8,22,36.4,14,10,1,9,9,24,4,0
215,Ross Barkley,Chelsea,2.0,0,0,0,0,0,0,1,0.0,1,1,0,1,1,1,0,0
216,Aymen Barkok,Eint Frankfurt,1.8,6,2,2,3,1,2,7,28.6,5,4,1,3,5,11,6,0
217,Ashley Barnes,Burnley,9.0,11,2,2,7,2,2,9,22.2,7,8,1,7,2,13,5,0
218,Harvey Barnes,Leicester City,23.3,31,16,9,11,11,7,23,30.4,16,24,1,23,5,36,7,0
219,Antonio Barragan,Elche,11.3,21,14,13,7,1,11,17,64.7,6,5,3,2,17,38,34,0
220,Leandro Barreiro Martins,Mainz 05,19.9,63,32,23,27,13,29,50,58.0,21,23,6,17,32,95,23,0
221,Ander Barrenetxea,Real Sociedad,6.1,15,10,9,6,0,8,18,44.4,10,7,0,7,2,17,2,0
222,Jacob Barrett Laursen,Arminia,18.1,16,12,10,6,0,8,21,38.1,13,19,7,12,28,44,43,0
223,Musa Barrow,Bologna,23.7,12,4,4,4,4,6,20,30.0,14,20,1,19,6,18,8,0
224,Abdourahmane Barry,Greuther Fürth,2.3,6,4,3,3,0,5,7,71.4,2,5,2,3,4,10,1,0
225,Marc Bartra,Betis,22.1,39,14,18,17,4,19,35,54.3,16,39,22,17,33,72,105,1
226,Daniele Baselli,Torino,1.7,3,3,2,0,1,2,6,33.3,4,0,0,0,1,4,2,0
227,Daniele Baselli,Cagliari,3.2,6,5,3,1,2,1,5,20.0,4,2,0,2,2,8,5,0
228,Toma Basic,Lazio,10.9,12,8,3,9,0,5,17,29.4,12,13,4,9,4,16,21,0
229,Toma Basic,Bordeaux,2.3,2,2,1,0,1,0,4,0.0,4,4,1,3,2,4,0,0
230,Amine Bassi,Metz,2.0,6,3,2,3,1,1,3,33.3,2,5,0,5,0,6,0,0
231,Alvaro Bastida,Cádiz,2.2,7,4,2,4,1,4,5,80.0,1,1,0,1,3,10,1,0
232,Alessandro Bastoni,Inter,25.7,44,25,28,13,3,17,34,50.0,17,22,12,10,35,79,59,1
234,Simone Bastoni,Spezia,25.4,52,34,28,17,7,21,65,32.3,44,38,11,27,30,82,31,0
235,Lewis Bate,Leeds United,1.6,1,0,0,0,1,0,8,0.0,8,1,0,1,1,2,1,0
236,Rodrigo Battaglia,Mallorca,13.1,32,16,13,19,0,15,30,50.0,15,21,10,11,10,42,36,0
237,Maximilian Bauer,Greuther Fürth,18.8,28,15,17,10,1,11,28,39.3,17,24,14,10,29,57,99,0
238,Oliver Baumann,Hoffenheim,33.0,0,0,0,0,0,0,3,0.0,3,0,0,0,0,0,19,1
239,Timo Baumgartl,Union Berlin,24.1,59,28,34,21,4,31,47,66.0,16,27,11,16,37,96,58,0
240,Julian Baumgartlinger,Leverkusen,1.0,3,1,2,1,0,1,2,50.0,1,1,0,1,2,5,0,0
241,Christoph Baumgartner,Hoffenheim,21.0,28,15,14,7,7,13,32,40.6,19,24,3,21,8,36,16,0
242,Jon Bautista,Real Sociedad,0.5,3,0,0,3,0,0,1,0.0,1,1,0,1,1,4,1,0
243,Paul Baysse,Bordeaux,0.1,1,1,0,1,0,0,0,0.0,0,0,0,0,0,1,1,0
244,Noah Joel Sarenren Bazee,Augsburg,2.7,5,2,2,2,1,3,4,75.0,1,8,2,6,1,6,4,0
245,Bebe,Rayo Vallecano,9.6,6,5,1,3,2,4,16,25.0,12,18,0,18,3,9,6,0
246,Ihlas Bebou,Hoffenheim,23.2,22,14,5,12,5,7,21,33.3,14,20,3,17,12,34,25,0
247,Rodrigo Becao,Udinese,34.8,81,46,49,30,2,34,60,56.7,26,45,20,25,42,123,89,3
248,Mads Bech Sorensen,Brentford,9.3,8,7,6,2,0,6,7,85.7,1,9,6,3,6,14,25,0
249,Sheraldo Becker,Union Berlin,19.5,9,6,3,4,2,6,18,33.3,12,11,0,11,2,11,4,0
250,Jan Bednarek,Southampton,29.2,32,15,18,13,1,19,33,57.6,14,48,27,21,72,104,141,0
251,Donny van de Beek,Manchester Utd,0.8,6,4,4,1,1,1,2,50.0,1,5,1,4,2,8,1,0
252,Donny van de Beek,Everton,5.4,15,7,8,6,1,6,13,46.2,7,6,2,4,6,21,4,0
253,Asmir Begovic,Everton,3.0,0,0,0,0,0,0,0,0.0,0,0,0,0,0,0,3,0
254,Valon Behrami,Genoa,3.5,3,1,0,2,1,0,7,0.0,7,4,1,3,1,4,4,0
255,Kevin Behrens,Union Berlin,5.5,3,2,1,1,1,0,4,0.0,4,3,0,3,3,6,7,0
256,Youcef Belaili,Brest,9.2,2,1,0,0,2,2,9,22.2,7,5,1,4,7,9,4,0
257,Vid Belec,Salernitana,21.5,0,0,0,0,0,0,0,0.0,0,0,0,0,0,0,9,1
258,Ishak Belfodil,Hertha BSC,18.2,9,6,4,4,1,4,8,50.0,4,9,1,8,5,14,16,0
260,Haris Belkebla,Brest,25.7,46,23,21,21,4,18,39,46.2,21,26,6,20,48,94,30,1
261,Stefan Bell,Mainz 05,31.8,54,23,37,16,1,30,63,47.6,33,26,15,11,41,95,112,1
262,Armel Bella Kotchap,Bochum,19.6,34,20,25,9,0,18,28,64.3,10,21,16,5,42,76,84,2
263,Raoul Bellanova,Cagliari,27.7,29,15,14,12,3,6,27,22.2,21,39,8,31,21,50,51,0
264,Karim Bellarabi,Leverkusen,7.6,9,4,4,4,1,3,13,23.1,10,5,0,5,9,18,4,0
265,Jean-Ricner Bellegarde,Strasbourg,25.9,51,32,21,21,9,17,41,41.5,24,29,4,25,27,78,19,0
266,Hector Bellerin,Betis,22.0,52,32,29,20,3,31,44,70.5,13,11,2,9,23,75,57,1
267,Jude Bellingham,Dortmund,31.0,52,34,15,31,6,21,53,39.6,32,50,4,46,42,94,32,0
268,George Bello,Arminia,4.8,7,7,7,0,0,4,4,100.0,0,5,4,1,6,13,11,0
269,Jeanoel Belocian,Rennes,0.1,0,0,0,0,0,0,0,0.0,0,0,0,0,0,0,0,0
270,Andrea Belotti,Torino,15.2,7,3,2,2,3,3,12,25.0,9,12,4,8,2,9,9,0
271,Fran Beltran,Celta Vigo,28.9,56,41,27,23,6,28,68,41.2,40,29,5,24,32,88,39,0
272,Hatem Ben Arfa,Lille,3.5,4,2,2,1,1,2,4,50.0,2,3,0,3,0,4,1,0
273,Salim Ben Seghir,Marseille,0.0,0,0,0,0,0,0,0,0.0,0,0,0,0,0,0,0,0
274,Wissam Ben Yedder,Monaco,28.1,18,8,1,11,6,6,15,40.0,9,12,1,11,0,18,1,0
275,Marco Benassi,Fiorentina,1.8,1,0,1,0,0,1,2,50.0,1,3,0,3,3,4,3,0
276,Marco Benassi,Empoli,4.2,6,3,3,2,1,1,10,10.0,9,4,0,4,3,9,6,0
277,Dario Benedetto,Elche,6.6,5,1,2,2,1,3,6,50.0,3,4,0,4,1,6,1,0
278,Dario Benedetto,Marseille,0.6,0,0,0,0,0,0,0,0.0,0,2,0,2,0,0,0,0
279,Laszlo Benes,M'Gladbach,2.7,5,3,1,3,1,1,6,16.7,5,5,2,3,2,7,5,0
280,Walter Benitez,Nice,37.0,0,0,0,0,0,0,2,0.0,2,1,0,1,0,0,12,2
281,Iker Benito,Osasuna,1.3,2,1,1,0,1,0,1,0.0,1,2,0,2,0,2,2,0
282,Loris Benito,Bordeaux,0.7,0,0,0,0,0,0,0,0.0,0,0,0,0,1,1,3,1
283,Pedro Benito,Cádiz,0.3,0,0,0,0,0,0,1,0.0,1,0,0,0,0,0,0,0
284,Filip Benkovic,Udinese,0.1,0,0,0,0,0,0,0,0.0,0,0,0,0,0,0,0,0
286,Ismael Bennacer,Milan,16.9,44,30,22,15,7,21,50,42.0,29,20,4,16,25,69,15,0
287,Keanan Bennetts,M'Gladbach,0.6,2,0,1,1,0,1,1,100.0,0,1,0,1,0,2,0,0
288,Said Benrahma,West Ham,24.1,28,17,16,9,3,15,38,39.5,23,17,1,16,9,37,8,0
289,Ramy Bensebaini,M'Gladbach,22.4,42,30,24,15,3,27,44,61.4,17,33,7,26,39,81,77,1
290,Nabil Bentaleb,Angers,16.8,42,24,15,20,7,16,29,55.2,13,24,9,15,28,70,13,0
291,Rodrigo Bentancur,Tottenham,15.1,36,18,14,14,8,16,32,50.0,16,24,9,15,20,56,35,0
292,Rodrigo Bentancur,Juventus,12.8,32,18,11,18,3,7,20,35.0,13,15,2,13,26,58,15,1
293,Christian Benteke,Crystal Palace,12.7,3,2,1,2,0,2,6,33.3,4,7,3,4,2,5,33,0
294,Karim Benzema,Real Madrid,28.8,11,9,5,3,3,2,9,22.2,7,10,0,10,4,15,13,0
295,Alessandro Berardi,Hellas Verona,1.0,0,0,0,0,0,0,0,0.0,0,0,0,0,0,0,0,0
296,Domenico Berardi,Sassuolo,31.3,32,19,9,16,7,15,57,26.3,42,39,2,37,31,63,23,0
297,Yuri Berchiche,Athletic Club,11.3,25,11,10,11,4,7,14,50.0,7,19,6,13,13,38,25,0
298,Alex Berenguer,Athletic Club,24.1,45,26,23,14,8,11,51,21.6,40,40,2,38,16,61,20,0
299,Bartosz Bereszynski,Sampdoria,32.7,64,38,34,25,5,37,80,46.3,43,38,12,26,42,106,73,1
300,Johann Berg Gudmundsson,Burnley,12.2,16,6,7,7,2,5,20,25.0,15,11,2,9,12,28,22,0
301,Patrick Berg,Lens,3.4,14,6,6,8,0,0,4,0.0,4,2,1,1,4,18,3,0
302,Mitchell van Bergen,Reims,10.9,8,5,7,0,1,6,15,40.0,9,9,0,9,4,12,7,0
303,Steven Bergwijn,Tottenham,6.3,3,2,2,1,0,1,10,10.0,9,3,0,3,1,4,8,0
304,Etrit Berisha,Torino,10.0,0,0,0,0,0,0,0,0.0,0,0,0,0,0,0,4,0
305,Valon Berisha,Reims,5.1,10,7,2,5,3,2,10,20.0,8,9,0,9,4,14,3,0
306,Federico Bernardeschi,Juventus,16.4,16,10,7,4,5,6,13,46.2,7,12,4,8,5,21,15,0
307,Paul Bernardoni,Angers,13.0,3,2,3,0,0,3,4,75.0,1,0,0,0,0,3,8,1
308,Paul Bernardoni,Saint-Étienne,19.0,0,0,0,0,0,0,0,0.0,0,0,0,0,0,0,14,2
309,Juan Bernat,Paris S-G,10.6,24,14,10,10,4,13,18,72.2,5,8,0,8,8,32,16,0
310,Dimitry Bertaud,Montpellier,9.3,0,0,0,0,0,0,1,0.0,1,0,0,0,0,0,5,1
312,Jason Berthomier,Clermont Foot,19.2,29,14,5,17,7,12,34,35.3,22,14,2,12,8,37,4,1
313,Nicolo Bertola,Spezia,0.4,3,2,3,0,0,3,4,75.0,1,0,0,0,3,6,1,0
314,Ryan Bertrand,Leicester City,3.7,8,5,3,4,1,2,5,40.0,3,8,3,5,1,9,7,0
315,Daniel Bessa,Hellas Verona,8.5,7,2,3,3,1,4,15,26.7,11,13,3,10,5,12,11,0
316,Beto,Udinese,24.1,21,6,2,14,5,9,19,47.4,10,16,1,15,5,26,25,1
317,Jordan Beyer,M'Gladbach,15.4,46,27,32,13,1,23,39,59.0,16,18,5,13,15,61,52,2
318,Giulian Biancone,Troyes,25.5,70,42,44,22,4,40,69,58.0,29,23,8,15,53,123,71,1
319,Bartosz Bialek,Wolfsburg,2.0,0,0,0,0,0,0,1,0.0,1,1,0,1,0,0,2,0
320,Ermin Bicakcic,Hoffenheim,0.1,0,0,0,0,0,0,0,0.0,0,0,0,0,0,0,0,0
321,Mads Bidstrup,Brentford,0.5,1,0,0,1,0,0,3,0.0,3,0,0,0,1,2,2,0
322,Pedro Bigas,Elche,17.2,24,10,16,8,0,9,20,45.0,11,21,16,5,18,42,77,1
323,El Bilal Toure,Reims,13.3,13,6,4,6,3,2,7,28.6,5,10,3,7,6,19,19,0
324,Jean-Claude Billong,Clermont Foot,10.9,17,8,14,1,2,8,11,72.7,3,9,1,8,10,27,35,0
325,Luis Binks,Bologna,7.2,8,4,7,1,0,4,6,66.7,2,6,5,1,17,25,33,1
326,Cristiano Biraghi,Fiorentina,35.0,37,24,17,15,5,22,53,41.5,31,28,10,18,19,56,31,1
327,Davide Biraschi,Genoa,10.3,31,16,19,9,3,17,24,70.8,7,16,9,7,16,47,26,0
328,Tom Bischof,Hoffenheim,0.2,0,0,0,0,0,0,0,0.0,0,1,0,1,0,0,1,0
329,Yves Bissouma,Brighton,23.5,76,49,35,37,4,21,37,56.8,16,33,3,30,50,126,49,0
330,Nathan Bitu Mazala,Paris S-G,0.1,0,0,0,0,0,0,0,0.0,0,1,0,1,0,0,0,0
331,Marco Bizot,Brest,38.0,3,1,3,0,0,3,5,60.0,2,1,0,1,0,3,24,1
332,Bjarki Bjarkason,Venezia,0.0,0,0,0,0,0,0,0,0.0,0,0,0,0,0,0,0,0
333,Ludovic Blas,Nantes,32.9,33,18,7,20,6,15,44,34.1,29,33,3,30,31,64,6,1
334,Danny Blum,Bochum,3.8,2,1,0,0,2,0,2,0.0,2,4,0,4,2,4,1,0
335,Myron Boadu,Monaco,10.7,9,7,2,3,4,1,5,20.0,4,6,0,6,2,11,1,0
336,Jerome Boateng,Lyon,18.0,20,15,11,9,0,9,17,52.9,8,20,10,10,20,40,73,0
338,Kevin-Prince Boateng,Hertha BSC,7.7,6,5,1,4,1,3,9,33.3,6,7,2,5,6,12,11,0
339,Antonin Bobichon,Angers,0.4,1,0,0,1,0,0,0,0.0,0,0,0,0,1,2,0,0
340,Herbert Bockhorn,Bochum,9.4,20,14,13,4,3,12,20,60.0,8,10,1,9,14,34,18,0
341,Jean-Paul Boetius,Mainz 05,20.0,40,23,18,17,5,22,53,41.5,31,41,3,38,25,65,11,0
342,Jeremie Boga,Atalanta,8.5,7,3,0,4,3,4,6,66.7,2,6,0,6,1,8,3,1
343,Jeremie Boga,Sassuolo,7.4,7,4,1,2,4,2,3,66.7,1,3,0,3,2,9,1,1
344,Luka Bogdan,Salernitana,4.4,6,3,6,0,0,4,8,50.0,4,3,2,1,6,12,21,0
345,Emil Bohinen,Salernitana,7.8,15,9,4,9,2,10,20,50.0,10,17,3,14,12,27,14,0
346,Quentin Boisgard,Lorient,10.6,19,11,6,10,3,8,17,47.1,9,15,0,15,6,25,5,0
347,Charles Boli,Lens,0.4,2,1,0,2,0,0,0,0.0,0,0,0,0,0,2,0,0
348,Willy Boly,Wolves,10.0,25,19,18,7,0,8,15,53.3,7,14,6,8,14,39,35,0
349,Giacomo Bonaventura,Fiorentina,25.2,33,17,12,16,5,21,46,45.7,25,20,2,18,14,47,9,1
350,Federico Bonazzoli,Salernitana,20.7,24,12,9,8,7,6,25,24.0,19,17,1,16,6,30,7,0
351,Tarsis Bonga,Bochum,0.2,0,0,0,0,0,0,0,0.0,0,0,0,0,0,0,0,0
352,Kevin Bonifazi,Bologna,13.4,25,16,16,7,2,13,14,92.9,1,22,7,15,16,41,35,0
353,Solomon Bonnah,RB Leipzig,0.1,0,0,0,0,0,0,0,0.0,0,1,0,1,1,1,0,0
354,Leonardo Bonucci,Juventus,22.3,14,5,4,10,0,8,13,61.5,5,22,17,5,26,40,82,0
355,Sebastiaan Bornauw,Wolfsburg,22.3,30,19,23,5,2,16,25,64.0,9,29,8,21,42,72,97,1
356,Rafael Borre,Eint Frankfurt,26.4,31,22,4,13,14,7,33,21.2,26,24,4,20,5,36,9,0
357,Sven Botman,Lille,25.0,24,11,13,11,0,12,18,66.7,6,32,21,11,26,50,116,0
358,Denis Bouanga,Saint-Étienne,27.1,46,25,14,13,19,22,63,34.9,41,30,0,30,8,54,34,1
359,Hicham Boudaoui,Nice,18.0,31,18,15,10,6,13,36,36.1,23,17,4,13,18,49,15,0
360,Ryad Boudebouz,Saint-Étienne,25.0,27,15,11,12,4,12,29,41.4,17,17,2,15,10,37,5,0
361,Sofiane Boufal,Angers,25.9,44,29,19,16,9,18,38,47.4,20,19,2,17,7,51,1,0
362,Farid Boulaya,Metz,17.0,18,10,7,9,2,14,38,36.8,24,8,2,6,12,30,5,0
364,Yassine Bounou,Sevilla,31.0,0,0,0,0,0,0,0,0.0,0,0,0,0,0,0,11,1
365,Ismaelben Boura,Lens,1.1,2,2,1,1,0,0,0,0.0,0,1,1,0,2,4,5,0
366,Mehdi Bourabia,Spezia,3.1,5,1,2,3,0,3,11,27.3,8,7,6,1,3,8,10,0
367,Benjamin Bourigeaud,Rennes,35.5,46,24,16,18,12,24,67,35.8,43,33,3,30,30,76,44,0
368,Redwan Bourles,Lorient,0.2,0,0,0,0,0,0,0,0.0,0,0,0,0,0,0,0,0
369,Edoardo Bove,Roma,0.8,1,1,1,0,0,0,2,0.0,2,1,0,1,1,2,0,0
370,Jarrod Bowen,West Ham,33.1,36,20,20,11,5,17,44,38.6,27,29,2,27,21,57,14,0
371,Dedryck Boyata,Hertha BSC,21.1,15,13,11,3,1,8,11,72.7,3,17,13,4,17,32,134,1
372,Lucas Boye,Elche,19.0,27,13,5,15,7,9,24,37.5,15,24,1,23,2,29,23,0
373,Domagoj Bradaric,Lille,4.6,11,9,8,2,1,7,12,58.3,5,5,2,3,10,21,7,1
374,Bilal Brahimi,Nice,4.2,1,1,0,1,0,0,2,0.0,2,1,0,1,2,3,1,0
375,Bilal Brahimi,Angers,3.8,1,1,0,1,0,0,3,0.0,3,0,0,0,1,2,1,0
376,Martin Braithwaite,Barcelona,2.6,1,1,0,0,1,0,0,0.0,0,2,0,2,1,2,1,0
377,Julian Brandt,Dortmund,23.1,37,19,13,20,4,17,54,31.5,37,19,2,17,24,61,14,1
378,Jarrad Branthwaite,Everton,4.3,4,1,3,1,0,3,8,37.5,5,3,2,1,1,5,20,0
379,Darko Brasanac,Osasuna,26.7,35,22,19,14,2,14,40,35.0,26,25,8,17,25,60,15,0
380,Lilian Brassier,Brest,25.1,40,24,23,13,4,10,21,47.6,11,31,21,10,32,72,86,0
381,Claudio Bravo,Betis,16.2,0,0,0,0,0,0,0,0.0,0,0,0,0,0,0,6,2
382,Iker Bravo,Leverkusen,0.1,1,1,0,1,0,0,0,0.0,0,0,0,0,0,1,0,0
383,Fabian Bredlow,Stuttgart,4.0,0,0,0,0,0,0,0,0.0,0,0,0,0,0,0,1,0
384,Josip Brekalo,Torino,25.4,9,5,5,1,3,3,21,14.3,18,16,1,15,4,13,7,1
385,Josip Brekalo,Wolfsburg,0.2,0,0,0,0,0,0,0,0.0,0,0,0,0,0,0,0,0
386,Gleison Bremer,Torino,32.1,49,24,27,22,0,18,28,64.3,10,54,23,31,105,154,137,0
387,Jimmy Briand,Bordeaux,2.5,2,0,2,0,0,0,2,0.0,2,0,0,0,1,3,2,0
388,Yan Brice Eteki,Granada,3.8,6,3,3,2,1,3,7,42.9,4,7,3,4,4,10,6,1
390,Brian Brobbey,RB Leipzig,1.5,1,0,0,1,0,1,1,100.0,0,1,0,1,0,1,0,0
391,Armando Broja,Southampton,21.9,12,5,2,7,3,2,9,22.2,7,17,1,16,3,15,11,0
392,Dylan Bronn,Metz,28.3,47,29,33,13,1,20,31,64.5,11,32,19,13,40,87,78,1
393,John Brooks,Wolfsburg,29.1,47,25,25,18,4,36,60,60.0,24,33,19,14,41,88,125,1
394,Daniel Brosinski,Mainz 05,4.3,2,1,1,1,0,1,1,100.0,0,6,0,6,3,5,9,0
395,Josh Brownhill,Burnley,32.8,73,37,25,42,6,21,53,39.6,32,37,12,25,68,141,42,1
396,Marcelo Brozovic,Inter,32.6,77,45,34,35,8,34,68,50.0,34,28,10,18,37,114,36,2
397,Cedric Brunner,Arminia,24.3,51,35,29,20,2,25,49,51.0,24,27,10,17,43,94,84,0
398,Lewis Brunt,Leicester City,0.3,0,0,0,0,0,0,0,0.0,0,1,0,1,0,0,0,0
399,Jacob Bruun Larsen,Hoffenheim,9.0,2,1,1,1,0,0,5,0.0,5,14,3,11,5,7,5,2
400,Ante Budimir,Osasuna,19.3,24,10,3,15,6,6,19,31.6,13,22,4,18,3,27,16,0
401,Emi Buendia,Aston Villa,21.1,38,18,16,13,9,21,51,41.2,30,21,3,18,9,47,11,0
402,Osman Bukari,Nantes,11.2,18,8,7,6,5,8,22,36.4,14,8,0,8,8,26,1,0
403,Aleksander Buksa,Genoa,0.7,0,0,0,0,0,0,1,0.0,1,0,0,0,0,0,1,0
404,Alessandro Buongiorno,Torino,13.1,20,9,9,8,3,9,13,69.2,4,12,6,6,31,51,44,0
405,Sascha Burchert,Greuther Fürth,14.0,1,1,1,0,0,1,2,50.0,1,0,0,0,0,1,11,1
406,Delano Burgzorg,Mainz 05,0.3,1,1,1,0,0,0,1,0.0,1,0,0,0,0,1,0,0
407,Jonathan Burkardt,Mainz 05,29.0,17,8,0,10,7,6,25,24.0,19,31,5,26,8,25,16,0
408,Roman Burki,Dortmund,1.0,0,0,0,0,0,0,0,0.0,0,0,0,0,0,0,0,0
409,Dan Burn,Newcastle Utd,16.0,16,11,11,4,1,7,11,63.6,4,22,14,8,20,36,101,0
410,Dan Burn,Brighton,11.4,22,12,13,8,1,6,15,40.0,9,14,10,4,24,46,51,0
411,Maxime Busi,Reims,14.4,26,15,20,5,1,19,36,52.8,17,19,5,14,17,43,28,0
412,Gianluca Busio,Venezia,21.7,53,28,27,20,6,28,63,44.4,35,45,13,32,21,74,30,1
413,Oriol Busquets,Clermont Foot,2.2,3,3,0,3,0,2,6,33.3,4,7,4,3,1,4,2,0
414,Sergio Busquets,Barcelona,35.5,93,49,31,48,14,46,83,55.4,37,44,8,36,45,138,31,0
416,Jack Butland,Crystal Palace,8.5,0,0,0,0,0,0,0,0.0,0,0,0,0,0,0,1,0
417,Adrian Butzke,Granada,0.0,0,0,0,0,0,0,0,0.0,0,0,0,0,0,0,0,0
418,Marcin Bulka,Nice,1.0,0,0,0,0,0,0,0,0.0,0,0,0,0,0,0,0,0
419,Jamie Bynoe-Gittens,Dortmund,1.5,3,2,0,2,1,2,5,40.0,3,4,1,3,1,4,1,0
420,Sam Byram,Norwich City,11.4,24,15,17,6,1,19,27,70.4,8,21,11,10,22,46,48,0
421,Erick Cabaco,Getafe,4.5,2,1,1,1,0,2,5,40.0,3,5,2,3,4,6,10,0
422,Willy Caballero,Southampton,2.0,0,0,0,0,0,0,0,0.0,0,0,0,0,0,0,2,1
423,Remy Cabella,Montpellier,3.5,15,7,4,8,3,5,15,33.3,10,7,0,7,5,20,1,0
424,Jimmy Cabot,Angers,22.3,81,44,59,15,7,47,83,56.6,36,29,0,29,32,113,30,0
425,Jovane Cabral,Lazio,2.1,2,1,1,0,1,0,0,0.0,0,1,1,0,1,3,1,0
426,Leandro Cabrera,Espanyol,37.0,37,24,27,10,0,21,34,61.8,13,32,23,9,44,81,222,2
427,Liberato Cacace,Empoli,5.2,15,6,8,4,3,8,8,100.0,0,7,2,5,8,23,9,0
428,Martin Caceres,Cagliari,9.2,13,7,5,5,3,4,12,33.3,8,12,3,9,14,27,21,0
429,Martin Caceres,Levante,7.4,2,2,2,0,0,1,5,20.0,4,2,2,0,11,13,16,1
430,Anthony Caci,Strasbourg,26.6,65,34,35,24,6,33,55,60.0,22,22,3,19,33,98,49,1
431,Mathieu Cafaro,Reims,2.1,4,2,3,1,0,0,7,0.0,7,2,0,2,3,7,1,0
432,Yannick Cahuzac,Lens,6.9,5,2,2,3,0,0,5,0.0,5,8,2,6,9,14,12,0
433,Felipe Caicedo,Genoa,3.2,3,3,0,2,1,0,1,0.0,1,1,0,1,0,3,4,0
434,Felipe Caicedo,Inter,0.3,0,0,0,0,0,0,0,0.0,0,1,0,1,0,0,0,0
435,Moises Caicedo,Brighton,7.3,16,10,7,7,2,5,12,41.7,7,18,4,14,10,26,7,0
436,Marc-Aurele Caillard,Metz,17.1,0,0,0,0,0,0,2,0.0,2,0,0,0,2,2,9,1
437,Jens Cajuste,Reims,4.0,10,6,6,2,2,6,17,35.3,11,7,2,5,5,15,6,0
438,Cala,Cádiz,10.5,9,4,9,0,0,8,17,47.1,9,12,6,6,12,21,56,0
439,Davide Calabria,Milan,23.5,62,37,31,23,8,37,72,51.4,35,25,5,20,23,85,40,1
440,Riccardo Calafiori,Genoa,0.9,1,0,0,0,1,1,2,50.0,1,2,1,1,2,3,4,0
442,Riccardo Calafiori,Roma,1.9,5,4,2,2,1,1,5,20.0,4,3,0,3,3,8,1,0
443,Mattia Caldara,Venezia,30.0,48,28,30,15,3,20,34,58.8,14,49,37,12,62,110,147,1
444,Calderon,Betis,0.7,2,0,1,0,1,1,3,33.3,2,0,0,0,0,2,2,0
445,Fernando Calero,Espanyol,12.1,17,10,12,5,0,8,13,61.5,5,7,2,5,16,33,63,1
446,Duje Caleta-Car,Marseille,22.9,21,8,15,6,0,11,14,78.6,3,11,7,4,24,45,55,2
447,Hakan Calhanoglu,Inter,27.6,41,23,16,19,6,11,40,27.5,29,29,5,24,25,66,12,0
448,Daniel Caligiuri,Augsburg,22.3,46,30,17,26,3,27,72,37.5,45,36,5,31,18,64,33,0
449,Jose Callejon,Fiorentina,14.4,15,6,6,6,3,13,31,41.9,18,6,0,6,3,18,1,1
450,Lucas Calodat,Saint-Étienne,0.0,0,0,0,0,0,0,0,0.0,0,0,0,0,0,0,0,0
451,Dominic Calvert-Lewin,Everton,14.3,11,8,1,6,4,3,8,37.5,5,5,2,3,3,14,12,0
452,Mahdi Camara,Saint-Étienne,34.1,101,57,39,50,12,39,70,55.7,31,44,8,36,57,158,35,1
453,Mamadou Camara,Troyes,0.4,1,1,1,0,0,0,0,0.0,0,0,0,0,0,1,0,0
454,Victor Camarasa,Betis,1.2,2,1,1,1,0,0,1,0.0,1,2,1,1,2,4,2,0
455,Eduardo Camavinga,Real Madrid,13.7,52,35,22,20,10,20,38,52.6,18,20,2,18,17,69,14,1
456,Eduardo Camavinga,Rennes,1.6,4,1,2,1,1,2,5,40.0,3,1,1,0,1,5,3,0
457,Andrea Cambiaso,Genoa,19.9,46,20,28,14,4,18,32,56.3,14,33,8,25,23,69,37,1
458,Jose Campana,Levante,15.8,27,16,13,10,4,12,32,37.5,20,13,2,11,21,48,19,1
459,Chem Campbell,Wolves,0.1,1,1,0,1,0,0,0,0.0,0,0,0,0,0,1,0,0
460,Emre Can,Dortmund,18.8,36,22,20,16,0,15,30,50.0,15,26,10,16,36,72,40,2
461,Sergio Canales,Betis,31.0,24,14,8,12,4,10,35,28.6,25,16,1,15,10,34,12,0
462,Matteo Cancellieri,Hellas Verona,2.5,4,4,2,2,0,0,5,0.0,5,2,0,2,1,5,0,0
463,Joao Cancelo,Manchester City,35.9,83,54,33,35,15,46,91,50.5,45,25,3,22,59,142,45,1
464,Fali Cande,Metz,10.8,30,18,13,15,2,13,31,41.9,18,11,2,9,6,36,21,0
465,Antonio Candreva,Sampdoria,34.7,27,16,9,11,7,19,55,34.5,36,23,2,21,33,60,19,0
466,Sergi Canos,Brentford,23.1,56,25,32,15,9,33,60,55.0,27,32,3,29,22,78,38,0
468,Alex Cantero,Levante,6.8,6,4,2,3,1,1,8,12.5,7,2,0,2,1,7,0,0
469,Todd Cantwell,Norwich City,4.9,15,13,8,6,1,6,17,35.3,11,2,0,2,3,18,2,0
470,Ander Capa,Athletic Club,0.0,0,0,0,0,0,0,0,0.0,0,0,0,0,0,0,0,0
471,Pierrick Capelle,Angers,13.3,36,24,16,17,3,18,52,34.6,34,12,1,11,16,52,20,0
472,Leonardo Capezzi,Salernitana,1.9,3,1,0,3,0,1,4,25.0,3,8,4,4,0,3,2,0
473,Etienne Capoue,Villarreal,25.4,44,26,18,23,3,15,28,53.6,13,17,5,12,35,79,51,0
474,Gianluca Caprari,Hellas Verona,30.4,43,25,10,22,11,17,51,33.3,34,32,0,32,4,47,7,0
475,Francesco Caputo,Sampdoria,31.0,5,2,1,3,1,1,6,16.7,5,5,0,5,2,7,10,0
476,Francesco Caputo,Sassuolo,1.7,0,0,0,0,0,0,0,0.0,0,0,0,0,0,0,0,0
477,Maxence Caqueret,Lyon,25.9,73,40,29,36,8,30,80,37.5,50,38,10,28,43,116,26,2
478,Andrea Carboni,Cagliari,24.6,53,24,33,16,4,19,42,45.2,23,42,15,27,27,80,87,0
479,Isaac Carcelen,Cádiz,17.2,43,29,29,12,2,28,56,50.0,28,25,6,19,34,77,42,0
480,Cardenas,Levante,24.0,1,1,1,0,0,0,3,0.0,3,0,0,0,1,2,19,0
481,Irvin Cardona,Brest,14.8,13,7,5,4,4,3,16,18.8,13,10,0,10,5,18,17,0
482,Igor Carioca,Lorient,17.5,27,16,16,8,3,15,43,34.9,28,17,2,15,25,52,28,0
483,Carlo,Villarreal,0.1,0,0,0,0,0,0,0,0.0,0,0,0,0,0,0,0,0
484,Diego Carlos,Sevilla,32.9,35,24,20,13,2,16,24,66.7,8,48,33,15,24,59,120,5
485,Carmona,Sevilla,0.3,0,0,0,0,0,0,0,0.0,0,0,0,0,1,1,0,0
486,Yannick Carrasco,Atlético Madrid,28.7,34,19,16,12,6,19,44,43.2,25,26,5,21,19,53,12,2
487,Guido Carrillo,Elche,13.0,7,4,2,4,1,3,13,23.1,10,9,2,7,1,8,27,0
488,Dani Carvajal,Real Madrid,17.2,43,28,21,15,7,15,26,57.7,11,22,8,14,20,63,38,2
489,William Carvalho,Betis,20.1,49,33,20,25,4,15,40,37.5,25,18,7,11,16,65,20,0
490,Nicolo Casale,Hellas Verona,28.7,46,30,25,19,2,21,37,56.8,16,31,12,19,49,95,95,0
491,Casemiro,Real Madrid,28.5,79,51,45,30,4,30,67,44.8,37,65,19,46,38,117,65,3
492,Matty Cash,Aston Villa,37.5,89,50,52,34,3,47,78,60.3,31,54,16,38,49,138,100,2
494,Kiko Casilla,Elche,14.0,0,0,0,0,0,0,1,0.0,1,0,0,0,1,1,2,2
495,Moreto Cassama,Reims,8.9,12,6,7,4,1,3,19,15.8,16,10,5,5,9,21,5,0
496,Francesco Cassata,Genoa,0.1,0,0,0,0,0,0,0,0.0,0,0,0,0,0,0,0,0
497,Timothy Castagne,Leicester City,23.6,67,31,38,22,7,27,43,62.8,16,28,9,19,29,96,54,1
498,Koen Casteels,Wolfsburg,28.0,0,0,0,0,0,0,1,0.0,1,0,0,0,0,0,9,2
499,Jean-Charles Castelletto,Nantes,27.9,45,24,27,17,1,25,35,71.4,10,38,27,11,30,75,73,0
500,Samu Castillejo,Milan,1.4,4,2,0,2,2,1,8,12.5,7,4,1,3,2,6,1,0
501,Gonzalo Castro,Arminia,4.8,8,3,4,4,0,1,5,20.0,4,3,0,3,3,11,3,0
502,Jonny Castro,Wolves,11.4,25,15,13,11,1,11,20,55.0,9,14,3,11,13,38,11,0
503,Gaetano Castrovilli,Fiorentina,15.5,25,17,15,6,4,12,23,52.2,11,18,4,14,11,36,6,0
504,Danilo Cataldi,Lazio,19.0,36,17,15,17,4,12,38,31.6,26,24,12,12,17,53,19,1
505,Catena,Rayo Vallecano,36.0,39,23,24,15,0,25,42,59.5,17,26,19,7,30,69,168,3
506,Craig Cathcart,Watford,26.6,32,15,25,6,1,16,30,53.3,14,39,29,10,28,60,132,3
507,Edinson Cavani,Manchester Utd,8.5,4,1,0,3,1,2,8,25.0,6,6,0,6,2,6,8,0
508,Dani Ceballos,Real Madrid,3.1,7,5,4,3,0,1,5,20.0,4,8,2,6,4,11,2,0
509,Pietro Ceccaroni,Venezia,34.7,55,31,33,18,4,25,36,69.4,11,45,32,13,30,85,143,0
510,Federico Ceccherini,Hellas Verona,26.2,32,16,19,10,3,19,33,57.6,14,13,8,5,50,82,76,1
511,Emil Ceide,Sassuolo,0.6,1,1,0,1,0,1,2,50.0,1,1,0,1,0,1,0,0
512,Zeki Celik,Lille,30.0,64,37,43,17,4,36,63,57.1,27,32,9,23,43,107,62,2
513,Fabien Centonze,Metz,17.6,33,21,22,9,2,13,32,40.6,19,37,8,29,32,65,51,0
514,Luca Ceppitelli,Cagliari,16.1,23,12,13,10,0,16,27,59.3,11,21,14,7,25,48,54,0
515,Franco Cervi,Celta Vigo,20.0,73,41,35,22,16,33,77,42.9,44,38,2,36,21,94,19,0
516,Damir Ceter,Cagliari,0.1,0,0,0,0,0,0,0,0.0,0,0,0,0,0,0,0,0
517,Julian Chabot,Sampdoria,5.4,12,10,8,4,0,8,10,80.0,2,7,4,3,9,21,28,1
518,Julian Chabot,Köln,2.3,8,3,4,4,0,2,5,40.0,3,4,2,2,3,11,5,1
520,El Chadaille Bitshiabu,Paris S-G,0.1,0,0,0,0,0,0,0,0.0,0,0,0,0,0,0,2,0
521,Nassim Chadli,Troyes,1.1,5,3,3,0,2,2,4,50.0,2,1,0,1,0,5,0,0
522,Kayky Chagas,Manchester City,0.1,0,0,0,0,0,0,0,0.0,0,0,0,0,0,0,0,0
523,Mehdi Chahiri,Strasbourg,0.2,1,1,1,0,0,1,1,100.0,0,0,0,0,0,1,0,0
524,Trevoh Chalobah,Chelsea,16.1,40,27,22,18,0,24,31,77.4,7,16,6,10,19,59,43,2
525,Calum Chambers,Arsenal,1.9,5,3,3,1,1,3,4,75.0,1,6,3,3,0,5,10,0
526,Calum Chambers,Aston Villa,9.2,16,8,10,6,0,4,6,66.7,2,14,8,6,5,21,42,0
527,Dylan Chambost,Troyes,8.4,16,11,6,9,1,4,25,16.0,21,9,2,7,8,24,4,0
528,Timothy Chandler,Eint Frankfurt,13.5,18,12,10,8,0,11,24,45.8,13,10,3,7,19,37,28,1
529,Chapela,Cádiz,4.4,4,2,1,0,3,2,4,50.0,2,6,1,5,4,8,5,0
530,Brendan Chardonnet,Brest,29.8,44,25,32,11,1,29,40,72.5,11,42,29,13,55,99,141,0
531,Xavier Chavalerin,Troyes,30.2,49,26,19,25,5,12,55,21.8,43,32,5,27,39,88,36,0
532,Xavier Chavalerin,Reims,2.4,4,4,2,1,1,1,3,33.3,2,2,0,2,5,9,2,1
533,Justin Che,Hoffenheim,0.5,2,0,1,0,1,1,2,50.0,1,0,0,0,1,3,0,0
534,Chema,Getafe,0.5,0,0,0,0,0,0,1,0.0,1,0,0,0,0,0,0,0
535,Rayan Cherki,Lyon,4.9,6,2,1,3,2,4,9,44.4,5,2,0,2,1,7,0,0
536,Denis Cheryshev,Valencia,6.3,14,5,6,1,7,6,15,40.0,9,9,1,8,9,23,9,0
537,Daniel Chesters,West Ham,0.0,0,0,0,0,0,0,0,0.0,0,0,0,0,0,0,0,0
538,Giorgio Chiellini,Juventus,15.0,22,13,17,4,1,7,13,53.8,6,24,18,6,22,44,59,0
539,Federico Chiesa,Juventus,9.6,26,19,9,9,8,12,26,46.2,14,7,0,7,4,30,3,0
540,Ben Chilwell,Chelsea,6.0,8,3,2,6,0,2,5,40.0,3,7,0,7,4,12,14,1
541,Chiquinho,Wolves,2.3,9,6,4,5,0,4,5,80.0,1,5,0,5,2,11,1,0
542,Vlad Chiriches,Sassuolo,25.6,28,15,19,9,0,10,21,47.6,11,34,21,13,41,69,71,4
543,Pedro Chirivella,Nantes,29.3,49,31,14,26,9,25,70,35.7,45,23,2,21,37,86,11,0
544,Joris Chotard,Montpellier,32.6,59,30,33,23,3,36,78,46.2,42,27,15,12,42,101,56,0
546,Hamza Choudhury,Leicester City,3.2,9,3,4,4,1,3,5,60.0,2,0,0,0,12,21,10,0
547,Andreas Christensen,Chelsea,16.6,14,8,9,4,1,4,7,57.1,3,14,6,8,29,43,57,1
548,Max Christiansen,Greuther Fürth,22.8,46,25,19,22,5,18,43,41.9,25,52,16,36,68,114,56,0
549,Carney Chukwuemeka,Aston Villa,3.3,7,1,2,5,0,3,5,60.0,2,3,0,3,1,8,2,1
550,Samuel Chukwueze,Villarreal,14.8,13,9,6,5,2,3,6,50.0,3,7,0,7,5,18,4,0
551,Victor Chust,Cádiz,20.3,19,10,14,4,1,11,17,64.7,6,20,8,12,16,35,87,0
552,Riccardo Ciervo,Sampdoria,2.5,8,3,4,3,1,2,6,33.3,4,1,0,1,2,10,2,0
553,Jasper Cillessen,Valencia,16.2,0,0,0,0,0,0,1,0.0,1,0,0,0,1,1,6,0
554,Pathe Ciss,Rayo Vallecano,12.2,31,15,20,8,3,12,26,46.2,14,16,6,10,30,61,27,0
555,Moustapha Cisse,Atalanta,0.4,1,0,0,1,0,0,3,0.0,3,0,0,0,0,1,0,0
556,Giorgio Cittadini,Atalanta,0.0,0,0,0,0,0,0,0,0.0,0,0,0,0,1,1,0,0
557,Ciaran Clark,Newcastle Utd,11.3,13,10,4,7,2,9,14,64.3,5,14,11,3,13,26,43,1
558,Alexis Claude-Maurice,Nice,2.3,2,0,1,0,1,1,4,25.0,3,7,0,7,3,5,1,0
559,Jonathan Clauss,Lens,33.8,63,34,33,20,10,22,55,40.0,33,43,1,42,73,136,51,0
560,Carlos Clerc,Levante,16.8,35,17,21,10,4,7,19,36.8,12,8,3,5,26,61,32,1
561,Tom Cleverley,Watford,18.0,37,20,19,17,1,18,33,54.5,15,23,6,17,18,55,19,3
562,Nathaniel Clyne,Crystal Palace,15.0,21,10,11,9,1,10,20,50.0,10,7,2,5,15,36,32,0
563,Conor Coady,Wolves,37.3,31,14,23,7,1,16,28,57.1,12,46,40,6,28,59,140,0
564,Marcus Coco,Nantes,10.3,34,14,17,11,6,8,18,44.4,10,11,1,10,10,44,15,0
565,Coke,Levante,1.3,3,2,1,1,1,3,4,75.0,1,1,0,1,2,5,7,0
566,Seamus Coleman,Everton,29.5,61,36,35,16,10,33,51,64.7,18,30,11,19,32,93,80,2
567,Alex Collado,Granada,11.3,27,12,6,16,5,12,31,38.7,19,28,2,26,6,33,11,0
568,Ebrima Colley,Spezia,4.4,6,1,3,2,1,1,7,14.3,6,8,0,8,3,9,2,0
569,Omar Colley,Sampdoria,30.5,47,36,32,14,1,22,32,68.8,10,31,19,12,80,127,135,2
570,Nathan Collins,Burnley,18.6,37,15,27,8,2,17,27,63.0,10,38,25,13,24,61,83,2
572,Kingsley Coman,Bayern Munich,15.1,14,8,1,9,4,5,16,31.3,11,14,0,14,8,22,5,0
573,Eray Comert,Valencia,4.5,5,3,4,1,0,3,6,50.0,3,3,2,1,2,7,6,0
574,Santi Comesana,Rayo Vallecano,29.8,87,56,45,33,9,40,104,38.5,64,46,6,40,33,120,30,0
575,Diego Conde,Getafe,0.1,0,0,0,0,0,0,0,0.0,0,0,0,0,0,0,0,0
576,Aaron Connolly,Brighton,1.7,0,0,0,0,0,0,1,0.0,1,2,0,2,0,0,0,0
577,Andrea Consigli,Sassuolo,36.9,0,0,0,0,0,0,2,0.0,2,0,0,0,0,0,23,3
578,Abdu Conte,Troyes,15.0,22,12,16,5,1,12,24,50.0,12,12,2,10,4,26,10,0
579,Andrea Conti,Sampdoria,2.6,4,2,2,1,1,3,6,50.0,3,4,0,4,7,11,4,0
580,Andrea Conti,Milan,0.1,0,0,0,0,0,0,0,0.0,0,0,0,0,0,0,0,0
581,Liam Cooper,Leeds United,20.2,41,23,27,13,1,23,33,69.7,10,29,18,11,43,84,72,2
582,Lucas Copado,Bayern Munich,0.2,1,0,1,0,0,1,1,100.0,0,0,0,0,0,1,0,0
583,Diego Coppola,Hellas Verona,2.8,8,4,4,4,0,3,3,100.0,0,5,1,4,4,12,5,0
584,Francis Coquelin,Villarreal,9.2,26,17,9,11,6,11,20,55.0,9,15,5,10,19,45,11,0
585,Sebastien Corchia,Nantes,14.7,33,20,17,11,5,24,42,57.1,18,24,3,21,13,46,36,0
586,Sergio Cordova,Augsburg,3.6,4,3,2,2,0,1,2,50.0,1,4,0,4,0,4,4,0
587,Jack Cork,Burnley,18.6,20,6,6,11,3,7,20,35.0,13,17,4,13,17,37,29,1
588,Maxwel Cornet,Burnley,19.6,16,9,7,5,4,7,15,46.7,8,13,4,9,10,26,14,0
589,Maxwel Cornet,Lyon,0.7,3,1,1,0,2,3,4,75.0,1,0,0,0,1,4,1,0
590,Jesus Corona,Sevilla,12.9,12,7,7,5,0,3,6,50.0,3,4,0,4,8,20,6,0
591,Angel Correa,Atlético Madrid,20.6,16,8,5,10,1,7,29,24.1,22,25,2,23,10,26,4,0
592,Joaquin Correa,Inter,11.4,11,5,2,6,3,1,13,7.7,12,8,1,7,3,14,2,0
593,Thierry Correia,Valencia,15.7,35,23,26,6,3,14,29,48.3,15,20,5,15,19,54,27,0
594,Danny da Costa,Eint Frankfurt,8.1,15,4,6,7,2,6,18,33.3,12,14,1,13,11,26,18,1
595,David Pereira da Costa,Lens,16.3,22,12,9,6,7,11,26,42.3,15,12,0,12,13,35,5,0
596,Helder Costa,Leeds United,0.2,0,0,0,0,0,0,0,0.0,0,1,0,1,0,0,0,0
598,Helder Costa,Valencia,12.4,27,16,11,9,7,14,41,34.1,27,12,1,11,3,30,9,0
599,Jaume Costa,Mallorca,20.3,35,26,23,7,5,23,31,74.2,8,22,7,15,23,58,55,0
600,Benoit Costil,Bordeaux,25.0,1,0,1,0,0,1,2,50.0,1,0,0,0,0,1,6,3
601,Vladimir Coufal,West Ham,24.5,45,25,24,14,7,18,36,50.0,18,31,9,22,22,67,64,1
602,Kalifa Coulibaly,Nantes,9.4,5,1,1,1,3,0,4,0.0,4,2,2,0,0,5,11,0
603,Lassana Coulibaly,Salernitana,25.9,58,32,29,26,3,24,62,38.7,38,40,13,27,22,80,27,0
604,Mamadou Coulibaly,Salernitana,9.0,15,12,8,5,2,7,20,35.0,13,9,0,9,11,26,9,0
605,Tanguy Coulibaly,Stuttgart,12.0,27,15,14,11,2,9,19,47.4,10,14,2,12,4,31,10,0
606,Thibaut Courtois,Real Madrid,36.0,1,0,1,0,0,1,2,50.0,1,0,0,0,0,1,9,1
607,Philippe Coutinho,Aston Villa,14.8,17,12,4,11,2,6,21,28.6,15,11,1,10,7,24,4,0
608,Philippe Coutinho,Barcelona,5.6,6,3,3,3,0,3,11,27.3,8,3,0,3,4,10,3,0
609,Nicolas Cozza,Montpellier,30.8,80,47,50,23,7,35,65,53.8,30,35,19,16,38,118,82,1
610,Alessio Cragno,Cagliari,35.0,3,3,2,1,0,3,3,100.0,0,0,0,0,1,4,14,1
611,Aaron Cresswell,West Ham,30.3,28,18,18,6,4,13,25,52.0,12,31,18,13,35,63,66,0
612,Charlie Cresswell,Leeds United,1.6,5,2,1,4,0,3,3,100.0,0,1,1,0,2,7,6,0
613,Domenico Criscito,Genoa,18.0,37,21,19,14,4,16,25,64.0,9,22,12,10,39,76,57,0
614,Bryan Cristante,Roma,29.8,79,39,31,39,9,37,69,53.6,32,31,5,26,40,119,45,0
615,Cristo,Real Sociedad,0.2,0,0,0,0,0,0,0,0.0,0,0,0,0,0,0,0,0
616,Enzo Crivelli,Saint-Étienne,1.1,1,0,0,0,1,0,0,0.0,0,0,0,0,0,1,1,0
617,Domen Crnigoj,Venezia,20.9,21,13,7,11,3,11,29,37.9,18,27,8,19,24,45,42,0
618,Giovanni Crociata,Empoli,0.2,0,0,0,0,0,0,1,0.0,1,0,0,0,0,0,0,0
619,Juan Cruz Armada,Osasuna,21.5,28,21,15,12,1,8,16,50.0,8,15,12,3,16,44,58,1
620,Juan Cuadrado,Juventus,27.6,48,23,30,13,5,30,55,54.5,25,23,5,18,29,77,34,0
621,Cucho,Watford,12.7,13,5,5,5,3,5,27,18.5,22,13,1,12,5,18,9,0
622,Marc Cucurella,Brighton,34.3,93,62,43,32,18,44,71,62.0,27,42,14,28,30,123,74,0
624,Marc Cucurella,Getafe,0.3,0,0,0,0,0,0,0,0.0,0,0,0,0,0,0,0,0
625,Jorge Cuenca,Getafe,29.8,46,32,30,15,1,21,28,75.0,7,29,14,15,39,85,155,0
626,Mickael Cuisance,Venezia,10.2,23,9,7,12,4,10,28,35.7,18,14,0,14,12,35,5,0
627,Mickael Cuisance,Bayern Munich,0.1,1,1,0,1,0,0,0,0.0,0,0,0,0,0,1,0,0
628,Luke Cundle,Wolves,2.0,4,3,0,4,0,1,1,100.0,0,0,0,0,1,5,1,0
629,Matheus Cunha,Atlético Madrid,11.8,19,12,3,11,5,5,20,25.0,15,18,2,16,6,25,9,0
630,Matheus Cunha,Hertha BSC,0.7,0,0,0,0,0,0,0,0.0,0,0,0,0,0,0,0,0
631,Patrick Cutrone,Empoli,15.6,5,2,0,3,2,1,9,11.1,8,11,1,10,5,10,1,0
632,Wylan Cyprien,Nantes,16.6,33,17,12,18,3,13,32,40.6,19,16,6,10,10,43,14,2
633,Rafael Czichos,Köln,15.6,29,18,18,9,2,14,28,50.0,14,23,13,10,19,48,53,2
634,Lennart-Marten Czyborra,Arminia,1.5,0,0,0,0,0,0,2,0.0,2,0,0,0,3,3,3,1
635,Danilo D'Ambrosio,Inter,11.1,30,15,21,8,1,11,22,50.0,11,21,10,11,8,38,20,0
636,Lucas Da Cunha,Nice,4.4,13,7,2,7,4,6,11,54.5,5,2,0,2,1,14,2,0
637,Lucas Da Cunha,Clermont Foot,9.3,17,11,5,8,4,9,18,50.0,9,13,0,13,1,18,3,0
638,Damien Da Silva,Lyon,12.5,13,9,7,5,1,5,9,55.6,4,15,10,5,22,35,53,1
639,Moanes Dabbur,Hoffenheim,14.6,18,10,3,5,10,4,17,23.5,13,10,0,10,5,23,4,0
640,Colin Dagba,Paris S-G,1.8,4,2,2,2,0,3,6,50.0,3,4,2,2,2,6,1,0
641,Finn Dahmen,Mainz 05,2.0,0,0,0,0,0,0,0,0.0,0,0,0,0,0,0,2,0
642,Mahmoud Dahoud,Dortmund,18.4,42,19,10,24,8,20,46,43.5,26,18,3,15,17,59,16,0
643,Patson Daka,Leicester City,12.9,15,10,2,8,5,2,19,10.5,17,7,0,7,2,17,8,0
644,Stuart Dallas,Leeds United,32.4,93,55,58,31,4,56,105,53.3,49,45,14,31,57,150,63,2
645,Diogo Dalot,Manchester Utd,20.0,55,41,35,12,8,31,57,54.4,26,24,13,11,29,84,59,0
646,Mikkel Damsgaard,Sampdoria,6.4,27,13,12,11,4,20,36,55.6,16,16,1,15,7,34,7,0
647,Flavius Daniliuc,Nice,14.4,46,31,26,17,3,34,43,79.1,9,13,7,6,14,60,34,1
648,Danilo,Juventus,21.0,37,26,20,13,4,18,28,64.3,10,21,12,9,32,69,53,1
650,Arnaut Danjuma,Villarreal,16.4,7,6,3,0,4,2,4,50.0,2,5,0,5,2,9,3,0
651,Kevin Danso,Lens,31.0,41,29,29,12,0,23,34,67.6,11,38,25,13,40,81,111,0
652,Dante,Nice,31.9,42,29,30,12,0,23,33,69.7,10,43,27,16,49,91,96,1
653,Ebrima Darboe,Roma,0.7,1,1,0,1,0,0,0,0.0,0,0,0,0,1,2,0,1
654,Marton Dardai,Hertha BSC,8.4,10,4,8,2,0,8,18,44.4,10,16,6,10,20,30,33,2
655,Sergi Darder,Espanyol,34.7,45,22,16,19,10,18,54,33.3,36,16,1,15,26,71,32,1
656,Vladimir Darida,Hertha BSC,19.8,32,18,15,13,4,13,32,40.6,19,22,3,19,20,52,17,2
657,Karl Darlow,Newcastle Utd,8.0,0,0,0,0,0,0,0,0.0,0,0,0,0,0,0,5,1
658,Matteo Darmian,Inter,16.7,32,16,17,9,6,16,41,39.0,25,16,1,15,19,51,25,0
659,Josh Dasilva,Brentford,2.9,2,1,0,1,1,1,2,50.0,1,3,0,3,1,3,7,0
660,Jonathan David,Lille,31.2,24,9,7,11,6,9,30,30.0,21,14,4,10,5,29,15,0
661,Alphonso Davies,Bayern Munich,19.3,34,17,17,8,9,13,31,41.9,18,27,1,26,23,57,26,1
662,Ben Davies,Tottenham,28.2,36,21,20,12,4,13,26,50.0,13,32,19,13,30,66,75,1
663,Tom Davies,Everton,2.6,3,1,1,1,1,2,5,40.0,3,2,1,1,2,5,9,0
664,Keinan Davis,Aston Villa,0.1,0,0,0,0,0,0,0,0.0,0,0,0,0,0,0,0,0
665,Pawel Dawidowicz,Hellas Verona,13.3,30,18,16,10,4,16,25,64.0,9,14,11,3,21,51,53,0
666,Craig Dawson,West Ham,30.6,29,17,20,8,1,14,25,56.0,11,59,52,7,29,58,139,0
667,Kevin De Bruyne,Manchester City,24.5,32,16,4,15,13,12,37,32.4,25,32,2,30,6,38,16,0
668,Konrad De La Fuente,Marseille,8.7,11,7,8,2,1,7,11,63.6,4,5,0,5,2,13,4,0
669,Sebastien De Maio,Udinese,2.0,5,1,4,1,0,1,9,11.1,8,6,5,1,1,6,9,0
670,Tommaso De Nipoti,Atalanta,0.1,0,0,0,0,0,0,0,0.0,0,0,0,0,0,0,0,0
671,Rodrigo De Paul,Atlético Madrid,23.9,55,30,22,25,8,30,60,50.0,30,24,3,21,21,76,17,2
672,Mattia De Sciglio,Juventus,13.0,24,12,7,9,8,11,24,45.8,13,10,0,10,10,34,30,0
673,Lorenzo De Silvestri,Bologna,25.5,23,14,13,8,2,9,31,29.0,22,25,7,18,26,49,52,0
674,Saulo Decarli,Bochum,0.1,0,0,0,0,0,0,0,0.0,0,0,0,0,0,0,0,0
676,Troy Deeney,Watford,0.3,0,0,0,0,0,0,1,0.0,1,0,0,0,0,0,2,0
677,Gregoire Defrel,Sassuolo,15.1,15,9,4,8,3,6,16,37.5,10,11,1,10,4,19,11,0
678,Alessandro Deiola,Cagliari,23.7,47,22,15,25,7,23,58,39.7,35,28,10,18,26,73,45,0
679,Romain Del Castillo,Rennes,0.3,2,1,0,1,1,2,2,100.0,0,0,0,0,1,3,0,0
680,Romain Del Castillo,Brest,10.8,27,16,3,17,7,12,31,38.7,19,12,0,12,7,34,3,0
681,Thomas Delaine,Metz,25.7,48,35,34,12,2,22,42,52.4,20,20,7,13,27,75,31,0
682,Thomas Delaney,Sevilla,17.2,41,24,17,21,3,16,30,53.3,14,19,10,9,13,54,35,0
683,Thomas Delaney,Dortmund,0.2,0,0,0,0,0,0,0,0.0,0,0,0,0,0,0,0,0
684,Liam Delap,Manchester City,0.1,0,0,0,0,0,0,0,0.0,0,0,0,0,0,0,0,0
685,Sacha Delaye,Montpellier,2.9,8,6,3,2,3,2,8,25.0,6,1,0,1,1,9,1,1
686,Filippo Delli Carri,Salernitana,3.7,6,4,4,2,0,5,14,35.7,9,6,2,4,4,10,14,0
687,Andy Delort,Nice,27.2,15,9,3,5,7,7,12,58.3,5,13,4,9,9,24,14,0
688,Andy Delort,Montpellier,3.0,2,0,0,1,1,0,1,0.0,1,1,0,1,0,2,4,0
689,Fabian Delph,Everton,7.4,18,15,10,7,1,8,21,38.1,13,12,5,7,14,32,10,0
690,Moussa Dembele,Lyon,24.5,18,9,5,5,8,6,15,40.0,9,13,0,13,8,26,30,1
691,Ousmane Dembele,Barcelona,15.7,24,16,6,10,8,7,23,30.4,16,8,0,8,8,32,3,0
692,Yusuf Demir,Barcelona,2.1,3,1,1,1,1,2,5,40.0,3,1,0,1,2,5,1,0
693,Merih Demiral,Atalanta,21.3,31,17,18,12,1,15,28,53.6,13,26,14,12,58,89,68,1
694,Kerem Demirbay,Leverkusen,22.8,52,31,19,30,3,16,41,39.0,25,32,9,23,33,85,21,0
695,Ermedin Demirovic,Freiburg,9.7,12,6,4,4,4,1,10,10.0,9,14,1,13,1,13,7,0
696,Diego Demme,Napoli,7.7,21,12,4,13,4,10,21,47.6,11,11,2,9,9,30,2,0
697,Jason Denayer,Lyon,11.1,11,4,8,3,0,6,7,85.7,1,8,7,1,16,27,52,0
698,Leander Dendoncker,Wolves,21.7,42,17,25,14,3,22,50,44.0,28,37,10,27,9,51,38,1
699,Emmanuel Dennis,Watford,28.7,51,35,20,22,9,17,52,32.7,35,36,2,34,15,66,13,0
700,Fabio Depaoli,Hellas Verona,7.8,12,7,6,4,2,1,7,14.3,6,9,2,7,8,20,14,0
702,Fabio Depaoli,Sampdoria,1.2,3,1,1,2,0,0,2,0.0,2,2,1,1,1,4,2,0
703,Mike van der Hoorn,Arminia,0.2,1,0,1,0,0,0,0,0.0,0,0,0,0,1,2,2,0
704,Arthur Desmas,Clermont Foot,14.5,0,0,0,0,0,0,3,0.0,3,0,0,0,0,0,1,3
705,Sergino Dest,Barcelona,16.8,32,15,21,10,1,13,18,72.2,5,22,4,18,2,34,18,0
706,Mattia Destro,Genoa,19.4,9,4,1,4,4,1,6,16.7,5,14,1,13,2,11,16,0
707,Gerard Deulofeu,Udinese,29.1,11,6,2,3,6,7,29,24.1,22,14,0,14,9,20,4,0
708,Kiernan Dewsbury-Hall,Leicester City,23.4,39,24,20,14,5,19,40,47.5,21,37,8,29,21,60,26,1
709,Jacopo Dezi,Venezia,0.2,0,0,0,0,0,0,1,0.0,1,0,0,0,1,1,0,0
710,Samuel Di Carmine,Hellas Verona,0.4,0,0,0,0,0,0,0,0.0,0,0,0,0,0,0,0,0
711,Federico Di Francesco,Empoli,15.2,16,5,2,8,6,9,23,39.1,14,17,1,16,9,25,11,0
712,Giovanni Di Lorenzo,Napoli,31.9,58,36,30,20,8,33,58,56.9,25,28,10,18,38,96,46,1
713,Angel Di Maria,Paris S-G,18.3,29,18,6,13,10,14,37,37.8,23,17,0,17,6,35,3,0
714,Francesco Di Mariano,Venezia,0.7,1,1,0,1,0,0,0,0.0,0,2,1,1,0,1,0,0
715,Francesco Di Tacchio,Salernitana,13.9,17,7,5,10,2,9,25,36.0,16,16,8,8,22,39,25,0
716,Boulaye Dia,Villarreal,14.1,8,6,3,4,1,2,5,40.0,3,6,1,5,5,13,4,0
717,Moussa Diaby,Leverkusen,30.7,20,11,8,9,3,5,38,13.2,33,11,0,11,8,28,2,0
718,Yadaly Diaby,Clermont Foot,0.7,0,0,0,0,0,0,1,0.0,1,0,0,0,2,2,2,0
719,Mouctar Diakhaby,Valencia,21.6,35,24,18,15,2,13,23,56.5,10,29,17,12,30,65,87,3
720,Ibrahim Diakite,Reims,0.0,0,0,0,0,0,0,1,0.0,1,0,0,0,0,0,0,0
721,Abdou Diallo,Paris S-G,9.7,22,14,10,9,3,8,14,57.1,6,6,2,4,10,32,19,1
722,Habib Diallo,Strasbourg,17.1,9,5,0,8,1,0,8,0.0,8,13,4,9,4,13,11,0
723,Ibrahima Diallo,Southampton,11.4,22,11,10,9,3,10,24,41.7,14,7,0,7,9,31,10,0
724,Mouhamadou Diarra,Strasbourg,1.2,2,1,1,1,0,1,1,100.0,0,0,0,0,0,2,0,0
725,Stephane Diarra,Lorient,5.8,11,9,7,3,1,5,10,50.0,5,4,0,4,7,18,1,0
726,Ruben Dias,Manchester City,26.7,26,19,11,12,3,8,15,53.3,7,19,13,6,23,49,66,0
728,Krepin Diatta,Monaco,3.2,3,2,1,0,2,1,3,33.3,2,2,0,2,1,4,0,0
729,Amadou Diawara,Roma,1.9,7,2,5,2,0,1,3,33.3,2,2,0,2,0,7,1,0
730,Brahim Diaz,Milan,20.6,23,17,3,11,9,8,22,36.4,14,11,0,11,8,31,4,0
731,Javier Diaz,Sevilla,1.0,0,0,0,0,0,0,0,0.0,0,0,0,0,0,0,0,0
732,Luis Diaz,Liverpool,10.6,9,7,3,5,1,2,8,25.0,6,7,0,7,4,13,2,0
733,Victor Diaz,Granada,16.7,23,15,14,9,0,12,25,48.0,13,19,11,8,17,40,71,1
734,Daniel Didavi,Stuttgart,3.1,6,2,0,4,2,4,7,57.1,3,4,1,3,1,7,1,0
735,Bamba Dieng,Marseille,10.8,17,11,5,5,7,4,14,28.6,10,7,0,7,5,22,8,0
736,Eric Dier,Tottenham,34.1,15,9,6,8,1,7,14,50.0,7,37,32,5,27,42,142,1
737,Elhadji Dieye,Saint-Étienne,0.4,3,2,2,1,0,0,1,0.0,1,2,0,2,1,4,0,0
738,Lucas Digne,Aston Villa,14.1,13,10,8,3,2,9,19,47.4,10,15,8,7,23,36,40,0
739,Lucas Digne,Everton,13.0,33,19,26,4,3,21,28,75.0,7,16,5,11,14,47,30,0
740,Mitchell Dijks,Bologna,7.7,15,6,6,6,3,5,12,41.7,7,11,2,9,3,18,10,1
741,Javairo Dilrosun,Bordeaux,19.2,13,4,2,8,3,7,24,29.2,17,14,1,13,11,24,5,0
742,Javairo Dilrosun,Hertha BSC,1.5,3,1,1,2,0,1,1,100.0,0,1,0,1,0,3,0,0
743,Federico Dimarco,Inter,15.9,28,15,10,15,3,13,24,54.2,11,6,1,5,19,47,19,0
744,Landry Dimata,Espanyol,6.0,2,2,1,1,0,1,4,25.0,3,0,0,0,1,3,7,0
745,Stole Dimitrievski,Rayo Vallecano,30.8,0,0,0,0,0,0,0,0.0,0,0,0,0,1,1,14,3
746,Junior Dina Ebimbe,Paris S-G,3.5,9,4,3,4,2,2,3,66.7,1,5,3,2,2,11,1,0
747,Tristan Dingome,Troyes,12.0,23,11,10,12,1,10,18,55.6,8,7,1,6,9,32,3,0
748,Sinaly Diomande,Lyon,6.4,6,3,4,2,0,5,6,83.3,1,6,6,0,12,18,26,0
749,Issa Diop,West Ham,10.7,10,8,5,5,0,4,11,36.4,7,14,13,1,7,17,44,0
750,Sofiane Diop,Monaco,21.6,38,20,12,19,7,15,47,31.9,32,10,0,10,23,61,4,0
751,Andy Diouf,Rennes,0.2,1,1,1,0,0,1,1,100.0,0,1,0,1,0,1,0,0
752,Assane Diousse,Saint-Étienne,0.3,1,1,1,0,0,1,1,100.0,0,0,0,0,0,1,0,0
754,Axel Disasi,Monaco,30.2,42,27,20,21,1,23,39,59.0,16,40,30,10,26,68,75,0
755,Filippo Distefano,Fiorentina,0.0,0,0,0,0,0,0,0,0.0,0,0,0,0,0,0,0,0
756,Matias Dituro,Celta Vigo,38.0,0,0,0,0,0,0,0,0.0,0,0,0,0,0,0,10,5
757,Tiago Djalo,Lille,25.9,60,39,39,19,2,26,39,66.7,13,26,10,16,24,84,71,0
758,Djene,Getafe,34.6,44,26,24,16,4,23,34,67.6,11,24,5,19,59,103,109,2
759,Moussa Djenepo,Southampton,5.1,9,3,3,5,1,3,11,27.3,8,6,1,5,2,11,6,1
760,Koffi Djidji,Torino,19.3,48,29,21,23,4,14,18,77.8,4,20,9,11,34,82,60,0
761,Alexander Djiku,Strasbourg,29.9,50,37,33,13,4,18,35,51.4,17,30,13,17,61,111,90,2
762,Bryan Djile Nokoue,Saint-Étienne,0.6,3,3,1,2,0,2,2,100.0,0,1,0,1,1,4,2,0
763,Berat Djimsiti,Atalanta,25.1,43,24,21,20,2,29,46,63.0,17,21,11,10,31,74,56,0
764,Ouparine Djoco,Clermont Foot,23.5,0,0,0,0,0,0,0,0.0,0,0,0,0,1,1,14,2
765,Nais Djouahra,Real Sociedad,2.4,7,3,2,2,3,4,8,50.0,4,3,0,3,2,9,2,0
766,Marko Dmitrovic,Sevilla,6.0,0,0,0,0,0,0,0,0.0,0,0,0,0,0,0,3,1
767,Lewis Dobbin,Everton,0.4,2,1,0,1,1,1,2,50.0,1,0,0,0,0,2,0,0
768,Matt Doherty,Tottenham,9.7,18,12,5,11,2,8,14,57.1,6,11,2,9,13,31,20,0
769,Jeremy Doku,Rennes,5.2,10,5,3,5,2,3,6,50.0,3,4,0,4,3,13,0,0
770,Kasper Dolberg,Nice,16.6,9,4,4,3,2,3,9,33.3,6,15,1,14,6,15,17,0
771,Jaume Domenech,Valencia,3.8,0,0,0,0,0,0,0,0.0,0,0,0,0,0,0,3,1
772,Brandon Domingues,Troyes,2.6,6,2,2,4,0,2,3,66.7,1,3,0,3,3,9,0,0
773,Carlos Dominguez,Celta Vigo,3.8,4,1,4,0,0,4,6,66.7,2,2,1,1,4,8,21,0
774,Mario Dominguez,Valencia,0.3,0,0,0,0,0,0,0,0.0,0,0,0,0,0,0,1,0
775,Nicolas Dominguez,Bologna,22.4,76,45,36,32,8,32,76,42.1,44,38,9,29,32,108,34,1
776,John Donald,Elche,2.0,7,4,4,2,1,5,8,62.5,3,5,3,2,3,10,3,0
777,Lee Dongjun,Hertha BSC,1.3,2,1,0,2,0,1,3,33.3,2,2,0,2,2,4,1,0
778,Anastasios Donis,Reims,4.1,8,7,4,2,2,2,6,33.3,4,3,0,3,0,8,1,0
780,Gianluigi Donnarumma,Paris S-G,17.0,0,0,0,0,0,0,0,0.0,0,0,0,0,0,0,9,2
781,Niklas Dorsch,Augsburg,25.8,76,47,47,23,6,30,60,50.0,30,34,12,22,35,111,36,3
782,Gabriel Dos Santos,Arsenal,34.0,50,30,36,12,2,30,41,73.2,11,34,26,8,13,63,112,4
783,Jodel Dossou,Clermont Foot,22.3,36,17,15,14,7,15,43,34.9,28,14,0,14,5,41,7,0
784,Lohann Doucet,Nantes,0.1,0,0,0,0,0,0,0,0.0,0,0,0,0,1,1,0,0
785,Abdoulaye Doucoure,Everton,28.2,75,43,30,37,8,32,71,45.1,39,33,8,25,28,103,32,0
786,Cheick Doucoure,Lens,32.7,75,43,34,34,7,35,79,44.3,44,30,7,23,68,143,24,0
787,Fode Doucoure,Reims,1.7,12,9,9,3,0,9,11,81.8,2,1,0,1,4,16,6,0
788,Ismael Doukoure,Strasbourg,0.2,0,0,0,0,0,0,0,0.0,0,0,0,0,0,0,1,0
789,Kamory Doumbia,Reims,3.9,8,2,2,5,1,5,13,38.5,8,9,3,6,3,11,3,0
790,Moussa Doumbia,Reims,1.0,0,0,0,0,0,0,1,0.0,1,0,0,0,0,0,0,0
791,Souleyman Doumbia,Angers,24.7,30,20,16,9,5,13,27,48.1,14,25,4,21,39,69,51,0
792,Kieran Dowell,Norwich City,10.1,18,7,8,7,3,9,32,28.1,23,10,1,9,7,25,4,0
793,Bartlomiej Dragowski,Fiorentina,6.2,0,0,0,0,0,0,0,0.0,0,0,0,0,1,1,5,2
794,Radu Dragusin,Sampdoria,6.9,4,3,2,2,0,2,6,33.3,4,8,4,4,10,14,33,0
795,Radu Dragusin,Salernitana,5.4,5,4,2,3,0,4,10,40.0,6,7,3,4,13,18,17,0
796,Cody Drameh,Leeds United,1.4,4,2,3,1,0,1,3,33.3,2,0,0,0,1,5,4,0
797,Julian Draxler,Paris S-G,6.1,3,2,0,3,0,0,4,0.0,4,3,0,3,5,8,3,0
798,Matthieu Dreyer,Lorient,16.0,1,1,1,0,0,1,1,100.0,0,0,0,0,0,1,9,0
799,Domingos Duarte,Granada,18.7,18,14,9,9,0,6,11,54.5,5,27,20,7,22,40,82,0
800,Oscar Duarte,Levante,19.7,18,8,12,6,0,8,23,34.8,15,18,9,9,24,42,102,0
801,Ruben Duarte,Alavés,29.1,76,47,43,27,6,43,85,50.6,42,40,6,34,57,133,82,0
802,Leo Dubois,Lyon,19.4,43,27,22,14,7,27,46,58.7,19,27,3,24,22,65,35,1
803,Martin Dubravka,Newcastle Utd,26.0,1,1,1,0,0,0,1,0.0,1,0,0,0,0,1,8,2
804,Ondrej Duda,Köln,17.9,23,16,4,12,7,6,23,26.1,17,14,2,12,17,40,9,0
806,Jeremy Dudziak,Greuther Fürth,12.6,17,6,5,8,4,3,14,21.4,11,8,0,8,10,27,4,0
807,Shane Duffy,Brighton,16.0,15,12,12,3,0,8,14,57.1,6,24,18,6,16,31,76,1
808,Unai Dufur,Osasuna,1.0,0,0,0,0,0,0,0,0.0,0,1,0,1,4,4,4,0
809,Denzel Dumfries,Inter,22.5,32,12,9,14,9,16,32,50.0,16,15,6,9,9,41,26,0
810,Paul Dummett,Newcastle Utd,2.2,7,3,3,4,0,5,8,62.5,3,5,0,5,3,10,5,0
811,Alfred Duncan,Fiorentina,21.5,34,19,13,16,5,11,32,34.4,21,32,3,29,10,44,7,0
812,Lewis Dunk,Brighton,28.6,10,8,5,5,0,5,11,45.5,6,32,28,4,27,37,113,3
813,Erik Durm,Eint Frankfurt,5.3,13,7,6,5,2,10,13,76.9,3,8,1,7,10,23,7,0
814,Hugo Duro,Getafe,0.1,0,0,0,0,0,0,0,0.0,0,0,0,0,0,0,0,0
815,Hugo Duro,Valencia,20.4,25,19,11,13,1,15,38,39.5,23,24,2,22,4,29,20,1
816,Jean-Kevin Duverne,Brest,33.4,71,44,43,21,7,42,90,46.7,48,40,5,35,53,124,92,0
817,Paulo Dybala,Juventus,22.9,30,13,7,14,9,8,35,22.9,27,19,0,19,9,39,4,3
818,Edin Dzeko,Inter,27.4,14,8,7,4,3,8,25,32.0,17,22,5,17,4,18,35,0
819,Enzo Ebosse,Angers,21.0,25,14,19,6,0,11,19,57.9,8,19,9,10,15,40,42,0
820,Tyronne Ebuehi,Venezia,12.6,28,12,16,8,4,10,18,55.6,8,13,3,10,16,44,38,1
821,Ederson,Manchester City,37.0,2,1,2,0,0,0,2,0.0,2,0,0,0,0,2,12,0
822,Ederson,Salernitana,12.7,29,18,11,14,4,14,26,53.8,12,11,2,9,19,48,8,0
823,Odsonne Edouard,Crystal Palace,17.4,16,10,2,7,7,7,21,33.3,14,20,5,15,0,16,18,0
824,CJ Egan-Riley,Manchester City,0.0,1,1,1,0,0,1,1,100.0,0,0,0,0,0,1,0,0
825,Maximilian Eggestein,Freiburg,24.4,48,28,17,25,6,22,50,44.0,28,35,11,24,30,78,32,1
826,Lilian Egloff,Stuttgart,0.3,1,0,0,1,0,0,0,0.0,0,1,0,1,0,1,0,0
827,Kingsley Ehizibue,Köln,7.6,32,18,27,5,0,15,24,62.5,9,13,4,9,9,41,26,0
828,Julian Eitschberger,Hertha BSC,0.5,0,0,0,0,0,0,1,0.0,1,1,1,0,2,2,2,0
829,Albin Ekdal,Sampdoria,18.2,43,28,17,21,5,26,56,46.4,30,27,7,20,29,72,25,0
830,Hugo Ekitike,Reims,14.1,18,10,8,6,4,4,11,36.4,7,9,2,7,6,24,15,0
832,Jurgen Ekkelenkamp,Hertha BSC,8.0,8,3,2,6,0,2,7,28.6,5,9,2,7,4,12,5,0
833,Caleb Ekuban,Genoa,19.1,19,12,2,12,5,7,23,30.4,16,19,5,14,9,28,6,0
834,Anthony Elanga,Manchester Utd,13.5,26,20,12,12,2,15,29,51.7,14,17,1,16,9,35,7,0
835,Alberth Elis,Bordeaux,15.7,19,10,5,5,9,11,25,44.0,14,9,0,9,7,26,10,0
836,Harvey Elliott,Liverpool,3.8,3,0,1,1,1,0,6,0.0,6,8,1,7,4,7,2,0
837,Elif Elmas,Napoli,18.0,25,15,10,10,5,12,28,42.9,16,13,2,11,8,33,17,0
838,Mohamed Elneny,Arsenal,9.0,16,8,10,5,1,7,12,58.3,5,7,1,6,14,30,13,0
839,Aritz Elustondo,Real Sociedad,23.4,21,14,16,5,0,10,20,50.0,10,19,13,6,29,50,86,0
840,Nico Elvedi,M'Gladbach,27.0,40,24,23,17,0,22,36,61.1,14,33,22,11,34,74,83,1
841,Mohamed Elyounoussi,Southampton,22.7,36,17,14,15,7,11,39,28.2,28,23,2,21,12,48,28,0
842,Adri Embarba,Espanyol,22.1,44,29,22,15,7,26,69,37.7,43,35,3,32,19,63,30,0
843,Breel Embolo,M'Gladbach,24.1,16,11,1,12,3,3,8,37.5,5,14,2,12,6,22,7,0
844,Emerson,Tottenham,25.4,72,47,50,16,6,36,67,53.7,31,25,2,23,22,94,92,1
845,Emerson,Barcelona,1.0,3,3,2,1,0,1,2,50.0,1,1,0,1,2,5,1,0
846,Renaud Emond,Nantes,2.1,1,0,0,1,0,0,4,0.0,4,2,1,1,0,1,1,0
847,Youssef En-Nesyri,Sevilla,14.2,10,5,5,2,3,4,11,36.4,7,9,1,8,4,14,18,0
848,Keita Endo,Union Berlin,0.6,1,1,1,0,0,0,0,0.0,0,1,0,1,0,1,0,0
849,Wataru Endo,Stuttgart,32.2,73,41,34,34,5,31,72,43.1,41,43,12,31,30,103,64,0
850,Christian Eriksen,Brentford,10.4,13,6,4,5,4,8,17,47.1,9,9,1,8,9,22,14,0
851,Martin Erlic,Spezia,28.6,28,16,18,10,0,10,18,55.6,8,54,39,15,28,56,122,1
852,Gonzalo Escalante,Lazio,0.1,1,0,1,0,0,1,1,100.0,0,2,1,1,1,2,0,0
853,Gonzalo Escalante,Alavés,14.4,30,14,9,20,1,13,34,38.2,21,27,2,25,21,51,28,0
854,Aaron Escandell,Granada,3.2,0,0,0,0,0,0,1,0.0,1,0,0,0,0,0,4,0
855,Sergio Escudero,Granada,15.9,46,24,25,17,4,26,54,48.1,28,18,3,15,26,72,35,0
856,Alfonso Espino,Cádiz,37.0,107,63,58,39,10,44,112,39.3,68,45,10,35,54,161,87,1
858,Michael Esser,Bochum,3.0,0,0,0,0,0,0,1,0.0,1,0,0,0,0,0,2,0
859,Estanis,Barcelona,0.1,1,1,0,1,0,1,1,100.0,0,0,0,0,0,1,0,0
860,Maxime Esteve,Montpellier,20.6,27,18,22,4,1,15,27,55.6,12,31,24,7,22,49,69,1
861,Pervis Estupinan,Villarreal,17.5,36,22,20,11,5,17,24,70.8,7,13,5,8,25,61,29,2
862,Oghenekaro Etebo,Watford,4.5,11,8,7,4,0,3,8,37.5,5,3,1,2,5,16,5,0
863,Jonny Evans,Leicester City,15.0,24,14,14,8,2,14,22,63.6,8,17,13,4,20,44,59,0
864,Eberechi Eze,Crystal Palace,6.7,10,6,5,2,3,6,11,54.5,5,4,1,3,5,15,1,0
865,Abdessamad Ezzalzouli,Barcelona,6.4,17,9,9,5,3,5,8,62.5,3,3,0,3,9,26,0,0
866,Lukasz Fabianski,West Ham,37.0,0,0,0,0,0,0,0,0.0,0,0,0,0,0,0,11,0
867,Fabinho,Liverpool,25.7,46,25,17,23,6,24,70,34.3,46,33,10,23,39,85,25,1
868,Fabio,Nantes,18.5,61,40,31,23,7,36,74,48.6,38,29,7,22,35,96,31,1
869,Cesc Fabregas,Monaco,0.4,1,0,0,1,0,1,1,100.0,0,0,0,0,1,2,0,0
870,Wout Faes,Reims,37.0,40,24,30,9,1,25,33,75.8,8,47,37,10,53,93,169,2
871,Wahid Faghir,Stuttgart,1.4,0,0,0,0,0,0,1,0.0,1,2,0,2,0,0,0,0
872,Romain Faivre,Lyon,9.9,10,4,2,6,2,4,13,30.8,9,4,0,4,3,13,2,0
873,Romain Faivre,Brest,19.9,30,18,12,13,5,12,30,40.0,18,11,0,11,13,43,10,0
874,Radamel Falcao,Rayo Vallecano,9.3,2,1,0,1,1,1,4,25.0,3,4,1,3,2,4,11,0
875,Diego Falcinelli,Bologna,0.7,2,2,2,0,0,0,0,0.0,0,0,0,0,1,3,1,0
876,Wladimiro Falcone,Sampdoria,9.5,0,0,0,0,0,0,0,0.0,0,0,0,0,1,1,5,0
877,Fali,Cádiz,20.0,32,19,24,8,0,17,32,53.1,15,26,16,10,24,56,82,0
878,Paolo Farago,Cagliari,0.2,1,1,1,0,0,0,0,0.0,0,2,0,2,0,1,0,0
879,Omar Faraj,Levante,0.0,1,0,1,0,0,1,1,100.0,0,0,0,0,0,1,0,0
880,Davide Faraoni,Hellas Verona,28.6,62,40,38,21,3,29,62,46.8,33,38,5,33,23,85,62,1
881,Mohamed Fares,Genoa,6.5,4,2,1,3,0,0,4,0.0,4,8,3,5,8,12,11,0
882,Diego Farias,Cagliari,0.7,1,1,0,1,0,1,3,33.3,2,0,0,0,0,1,0,0
884,Wuilker Farinez,Lens,12.3,0,0,0,0,0,0,0,0.0,0,0,0,0,0,0,4,0
885,Omer Faruk Beyaz,Stuttgart,0.8,4,3,1,3,0,1,5,20.0,4,0,0,0,2,6,0,0
886,Noah Fatar,Angers,0.1,1,0,0,0,1,0,1,0.0,1,0,0,0,1,2,0,0
887,Ansu Fati,Barcelona,3.7,3,2,0,2,1,1,1,100.0,0,4,0,4,1,4,0,0
888,Julien Faussurier,Brest,5.4,10,6,3,3,4,6,13,46.2,7,12,1,11,5,15,6,0
889,Andrea Favilli,Genoa,0.4,1,1,0,0,1,0,0,0.0,0,0,0,0,0,1,2,0
890,Federico Fazio,Salernitana,15.9,17,11,10,6,1,9,12,75.0,3,21,16,5,27,44,67,1
891,Aleix Febas,Mallorca,1.3,4,1,0,4,0,2,4,50.0,2,0,0,0,0,4,0,0
892,Adrian Fein,Greuther Fürth,0.4,0,0,0,0,0,0,1,0.0,1,0,0,0,2,2,0,0
893,Nabil Fekir,Betis,31.0,43,29,5,25,13,7,36,19.4,29,14,0,14,7,50,7,0
894,Felipe,Atlético Madrid,16.7,20,15,11,8,1,8,18,44.4,10,17,11,6,28,48,77,0
895,Luiz Felipe,Lazio,27.7,41,23,21,16,4,20,34,58.8,14,40,33,7,33,74,102,1
896,Joao Felix,Atlético Madrid,14.0,5,2,1,4,0,1,5,20.0,4,4,1,3,7,12,8,0
897,Ohis Felix Uduokhai,Augsburg,8.7,9,6,6,3,0,6,11,54.5,5,13,8,5,9,18,33,0
898,Kiko Femenia,Watford,23.8,35,22,23,10,2,21,37,56.8,16,24,8,16,37,72,51,0
899,Evan Ferguson,Brighton,0.3,0,0,0,0,0,0,0,0.0,0,0,0,0,0,0,0,0
900,Nathan Ferguson,Crystal Palace,0.1,0,0,0,0,0,0,0,0.0,0,0,0,0,0,0,0,0
901,Bruno Fernandes,Manchester Utd,34.6,54,28,26,22,6,26,91,28.6,65,36,0,36,17,71,42,2
902,Edimilson Fernandes,Arminia,3.1,2,0,1,1,0,1,4,25.0,3,2,2,0,2,4,6,0
903,Aitor Fernandez,Levante,13.0,2,1,2,0,0,2,2,100.0,0,0,0,0,0,2,7,0
904,Alex Fernandez,Cádiz,22.8,47,31,22,17,8,21,61,34.4,40,30,7,23,30,77,31,0
905,Alvaro Fernandez,Brentford,12.0,0,0,0,0,0,0,0,0.0,0,0,0,0,0,0,5,2
906,Federico Fernandez,Newcastle Utd,5.8,3,0,3,0,0,2,5,40.0,3,10,10,0,4,7,28,0
907,Fernandinho,Manchester City,10.7,21,10,7,10,4,9,27,33.3,18,8,2,6,8,29,13,1
908,Fernando,Sevilla,20.6,24,17,14,9,1,12,33,36.4,21,21,13,8,29,53,32,2
910,Alex Ferrari,Sampdoria,18.3,40,22,28,9,3,19,33,57.6,14,31,22,9,39,79,63,1
911,Salvador Ferrer,Spezia,16.6,32,18,15,9,8,12,25,48.0,13,24,12,12,18,50,46,0
912,Jordan Ferri,Montpellier,32.3,55,35,28,23,4,29,87,33.3,58,21,5,16,30,85,35,0
913,Riccardo Fiamozzi,Empoli,6.9,7,5,2,2,3,2,4,50.0,2,6,5,1,7,14,12,0
914,Fidel,Elche,25.1,44,23,18,17,9,14,57,24.6,43,9,1,8,7,51,20,0
915,Karol Fila,Strasbourg,6.2,10,8,5,4,1,4,8,50.0,4,7,2,5,4,14,6,0
916,Alfred Finnbogason,Augsburg,3.2,3,1,0,2,1,2,4,50.0,2,5,1,4,2,5,8,0
917,Luca Fiordilino,Venezia,7.3,21,13,11,6,4,13,27,48.1,14,14,4,10,11,32,12,0
918,Vincenzo Fiorillo,Salernitana,1.0,0,0,0,0,0,0,0,0.0,0,0,0,0,0,0,1,0
919,Roberto Firmino,Liverpool,11.0,23,14,5,8,10,3,16,18.8,13,20,0,20,4,27,3,0
920,Junior Firpo,Leeds United,19.0,61,29,30,26,5,31,59,52.5,28,22,6,16,24,85,37,0
921,Mark Flekken,Freiburg,32.0,0,0,0,0,0,0,2,0.0,2,1,0,1,2,2,10,1
922,Ashley Fletcher,Watford,0.3,2,1,1,1,0,1,1,100.0,0,1,1,0,0,2,0,0
923,Alexis Flips,Reims,11.7,37,21,21,9,7,22,45,48.9,23,21,0,21,24,61,17,0
924,Alessandro Florenzi,Milan,12.8,28,14,14,7,7,14,32,43.8,18,9,2,7,27,55,10,1
925,Phil Foden,Manchester City,23.6,16,8,10,4,2,7,17,41.2,10,9,0,9,11,27,5,0
926,Mamadou Fofana,Metz,0.4,1,1,0,1,0,1,2,50.0,1,2,1,1,1,2,2,0
927,Seko Fofana,Lens,37.3,27,19,11,13,3,12,58,20.7,46,24,2,22,26,53,17,1
928,Wesley Fofana,Leicester City,7.0,12,8,11,1,0,7,11,63.6,4,5,2,3,12,24,26,1
929,Youssouf Fofana,Monaco,24.3,69,43,19,41,9,29,56,51.8,27,29,7,22,32,101,22,2
930,Thomas Foket,Reims,24.8,28,19,12,13,3,18,40,45.0,22,26,4,22,33,61,35,0
931,Thomas Fontaine,Lorient,1.9,2,0,1,0,1,0,1,0.0,1,3,3,0,2,4,4,0
932,Jose Fontan,Celta Vigo,3.1,5,3,3,2,0,1,5,20.0,4,3,1,2,10,15,10,0
933,Jose Fonte,Lille,38.0,23,12,14,7,2,11,25,44.0,14,39,32,7,44,67,159,1
934,Fernando Forestieri,Udinese,0.6,0,0,0,0,0,0,1,0.0,1,1,0,1,0,0,1,0
936,Pablo Fornals,West Ham,31.1,54,28,21,21,12,22,84,26.2,62,49,2,47,27,81,16,1
937,Emil Forsberg,RB Leipzig,19.0,21,12,2,11,8,7,22,31.8,15,18,0,18,2,23,2,1
938,Adam Forshaw,Leeds United,17.0,53,23,21,27,5,21,54,38.9,33,17,1,16,19,72,12,2
939,Marcus Forss,Brentford,2.3,3,3,0,2,1,2,4,50.0,2,5,0,5,1,4,0,0
940,Fraser Forster,Southampton,19.0,1,0,1,0,0,0,1,0.0,1,0,0,0,0,1,23,2
941,Philipp Forster,Stuttgart,10.7,20,13,4,12,4,11,26,42.3,15,12,1,11,3,23,2,0
942,Francesco Forte,Venezia,4.7,3,2,0,2,1,2,5,40.0,3,1,0,1,0,3,2,0
943,Steven Fortes,Lens,1.0,2,0,2,0,0,1,2,50.0,1,2,1,1,0,2,4,0
944,Ben Foster,Watford,26.0,0,0,0,0,0,0,3,0.0,3,0,0,0,0,0,9,4
945,Tariqe Fosu,Brentford,0.2,0,0,0,0,0,0,0,0.0,0,1,0,1,0,0,0,0
946,Timothy Fosu-Mensah,Leverkusen,1.6,5,3,3,1,1,4,4,100.0,0,1,0,1,2,7,2,0
947,Dimitri Foulquier,Granada,2.0,0,0,0,0,0,0,1,0.0,1,2,1,1,1,1,2,0
948,Dimitri Foulquier,Valencia,26.0,36,17,17,15,4,21,34,61.8,13,19,3,16,29,65,49,0
949,Juan Foyth,Villarreal,21.4,69,49,35,28,6,35,47,74.5,12,29,7,22,20,89,50,0
950,Gianluca Frabotta,Hellas Verona,0.2,0,0,0,0,0,0,1,0.0,1,1,0,1,1,1,0,0
951,Raphael Framberger,Augsburg,9.4,26,19,12,10,4,13,27,48.1,14,8,2,6,9,35,25,0
952,Przemyslaw Frankowski,Lens,27.2,57,39,22,27,8,36,74,48.6,38,27,0,27,28,85,52,0
953,Enric Franquesa,Levante,6.9,5,3,4,0,1,0,1,0.0,1,4,0,4,7,12,11,0
954,Fransergio,Bordeaux,14.0,24,10,8,12,4,12,43,27.9,31,18,6,12,23,47,23,0
955,Ryan Fraser,Newcastle Utd,16.3,10,3,5,3,2,5,13,38.5,8,11,1,10,11,21,11,0
956,Davide Frattesi,Sassuolo,31.7,46,16,26,18,2,26,52,50.0,26,44,12,32,29,75,62,1
957,Fred,Manchester Utd,22.5,63,27,32,24,7,22,79,27.8,57,38,11,27,32,95,24,0
958,Ryan Fredericks,West Ham,3.4,2,2,2,0,0,0,1,0.0,1,2,1,1,4,6,6,0
959,Morten Frendrup,Genoa,7.7,40,24,19,13,8,13,29,44.8,16,19,2,17,17,57,7,1
960,Remo Freuler,Atalanta,26.3,69,39,22,33,14,30,70,42.9,40,48,8,40,35,104,26,1
962,Marvin Friedrich,M'Gladbach,6.7,14,8,10,4,0,9,11,81.8,2,5,3,2,5,19,26,0
963,Marvin Friedrich,Union Berlin,13.0,17,5,14,3,0,10,16,62.5,6,13,7,6,23,40,47,0
964,Jeremie Frimpong,Leverkusen,22.8,32,18,19,12,1,12,23,52.2,11,24,6,18,17,49,40,2
965,Christian Fruchtl,Bayern Munich,0.1,0,0,0,0,0,0,0,0.0,0,0,0,0,0,0,0,0
966,Jorge de Frutos,Levante,19.6,33,15,14,11,8,10,51,19.6,41,11,1,10,12,45,13,0
967,Leo Fuhr Hjelde,Leeds United,1.7,5,4,3,2,0,3,3,100.0,0,3,3,0,4,9,7,0
968,Chris Fuhrich,Stuttgart,19.0,28,16,10,10,8,18,39,46.2,21,31,2,29,8,36,9,0
969,Angelo Fulgini,Angers,32.5,35,25,8,18,9,14,44,31.8,30,21,5,16,22,57,5,1
970,Marius Funk,Greuther Fürth,8.0,0,0,0,0,0,0,0,0.0,0,0,0,0,0,0,8,1
971,Stephan Furstner,Mainz 05,0.1,0,0,0,0,0,0,2,0.0,2,0,0,0,0,0,1,0
972,Matteo Gabbia,Milan,6.0,4,3,1,3,0,0,4,0.0,4,2,2,0,8,12,12,0
973,Manolo Gabbiadini,Sampdoria,12.7,6,4,3,2,1,1,7,14.3,6,5,2,3,3,9,10,0
974,Mijat Gacinovic,Hoffenheim,1.2,3,3,1,1,1,3,3,100.0,0,1,0,1,1,4,2,0
975,Gianluca Gaetano,Napoli,0.2,1,1,1,0,0,1,2,50.0,1,0,0,0,2,3,0,0
976,Luca Gagliano,Cagliari,0.1,0,0,0,0,0,0,0,0.0,0,1,0,1,0,0,1,0
977,Roberto Gagliardini,Inter,7.2,12,6,7,4,1,1,13,7.7,12,14,5,9,9,21,7,0
978,Riccardo Gagliolo,Salernitana,12.6,23,12,16,4,3,16,27,59.3,11,15,8,7,28,51,52,0
979,Javi Galan,Celta Vigo,36.6,108,66,60,37,11,42,99,42.4,57,48,8,40,45,153,52,0
980,Inigo Ruiz de Galarreta,Mallorca,15.3,40,21,14,21,5,14,30,46.7,16,16,2,14,20,60,21,0
981,Nicolas Galazzi,Venezia,0.2,2,1,1,0,1,0,1,0.0,1,0,0,0,0,2,0,0
982,Pablo Galdames Millan,Genoa,11.4,28,12,6,16,6,12,35,34.3,23,16,2,14,8,36,9,1
983,Thiago Galhardo,Celta Vigo,12.8,12,6,3,3,6,2,12,16.7,10,15,2,13,6,18,9,0
984,Conor Gallagher,Crystal Palace,31.6,69,38,35,20,14,21,69,30.4,48,58,9,49,29,98,26,0
985,Gauthier Gallon,Troyes,31.0,3,0,3,0,0,1,1,100.0,0,0,0,0,2,5,12,1
986,Cristian Gamboa,Bochum,19.1,59,36,40,16,3,30,61,49.2,31,22,7,15,32,91,35,1
988,Kevin Gameiro,Strasbourg,26.5,19,10,5,9,5,6,18,33.3,12,22,1,21,6,25,1,0
989,Idrissa Gana Gueye,Paris S-G,18.2,60,36,24,24,12,18,44,40.9,26,23,4,19,24,84,13,0
990,Ignatius Ganago,Lens,11.4,3,2,1,2,0,2,6,33.3,4,4,0,4,2,5,3,0
991,Silvere Ganvoula M'Boussy,Bochum,1.7,0,0,0,0,0,0,1,0.0,1,0,0,0,0,0,1,0
992,Alvaro Garcia,Rayo Vallecano,33.3,42,23,15,18,9,8,35,22.9,27,27,3,24,42,84,24,0
993,Dani Garcia,Athletic Club,24.2,36,22,15,17,4,14,47,29.8,33,27,10,17,24,60,41,1
994,David Garcia,Osasuna,34.5,28,14,15,11,2,12,22,54.5,10,27,21,6,52,80,168,0
995,Eric Garcia,Barcelona,22.7,27,18,13,13,1,11,26,42.3,15,22,12,10,44,71,53,3
996,Fran Garcia,Rayo Vallecano,33.6,60,35,44,12,4,39,73,53.4,34,34,8,26,45,105,53,0
997,Joan Garcia,Espanyol,1.2,0,0,0,0,0,0,0,0.0,0,0,0,0,1,1,1,2
998,Manu Garcia,Alavés,12.0,18,9,6,9,3,9,27,33.3,18,8,2,6,13,31,4,0
999,Raul Garcia,Athletic Club,20.0,27,17,6,11,10,8,36,22.2,28,30,4,26,9,36,21,0
1000,Ruben Garcia,Osasuna,26.4,43,26,12,23,8,16,49,32.7,33,31,4,27,24,67,16,0
1001,Saul Garcia,Alavés,0.0,1,1,1,0,0,0,0,0.0,0,0,0,0,0,1,0,0
1002,Unai Garcia,Osasuna,15.6,21,12,14,6,1,14,17,82.4,3,19,11,8,22,43,78,0
1003,Alejandro Garnacho,Manchester Utd,0.1,0,0,0,0,0,0,1,0.0,1,0,0,0,0,0,0,0
1004,Mario Gaspar,Villarreal,6.9,10,4,2,5,3,6,10,60.0,4,6,3,3,6,16,15,0
1005,Djeidi Gassama,Paris S-G,0.0,0,0,0,0,0,0,0,0.0,0,1,1,0,0,0,0,0
1006,Johan Gastien,Clermont Foot,30.5,56,34,26,25,5,27,74,36.5,47,45,11,34,53,109,49,1
1007,Gavi,Barcelona,25.7,38,18,13,18,7,9,33,27.3,24,36,0,36,25,63,13,0
1008,Dwight Gayle,Newcastle Utd,0.4,1,0,0,1,0,0,1,0.0,1,0,0,0,1,2,0,0
1009,Jean-Philippe Gbamin,Everton,0.7,1,1,1,0,0,0,2,0.0,2,0,0,0,1,2,1,0
1010,David de Gea,Manchester Utd,38.0,0,0,0,0,0,0,0,0.0,0,0,0,0,0,0,11,2
1011,Linus Gechter,Hertha BSC,8.0,15,8,13,2,0,7,14,50.0,7,12,7,5,11,26,29,0
1012,Dennis Geiger,Hoffenheim,15.3,34,23,9,20,5,17,30,56.7,13,15,1,14,14,48,7,1
1014,Joe Gelhardt,Leeds United,8.3,4,3,1,0,3,2,10,20.0,8,9,0,9,0,4,3,0
1015,Luca Gemello,Torino,1.0,0,0,0,0,0,0,0,0.0,0,0,0,0,0,0,0,0
1016,Yannick Gerhardt,Wolfsburg,17.5,42,20,18,17,7,22,36,61.1,14,24,1,23,25,67,25,1
1017,Valere Germain,Montpellier,21.9,23,14,6,11,6,8,31,25.8,23,13,1,12,9,32,27,0
1018,Gerson,Marseille,28.3,42,17,16,20,6,8,35,22.9,27,26,4,22,16,58,16,2
1019,Willem Geubbels,Nantes,6.0,8,5,4,2,2,5,12,41.7,7,5,0,5,6,14,5,0
1020,Hamadi Al Ghaddioui,Stuttgart,5.5,5,4,2,1,2,0,4,0.0,4,3,1,2,0,5,4,0
1021,Ismael Gharbi,Paris S-G,0.0,0,0,0,0,0,0,0,0.0,0,0,0,0,0,0,0,0
1022,Anwar El Ghazi,Aston Villa,4.3,4,4,2,2,0,2,7,28.6,5,6,0,6,1,5,2,0
1023,Anwar El Ghazi,Everton,0.1,1,1,1,0,0,1,1,100.0,0,3,0,3,0,1,0,0
1024,Lamine Ghezali,Saint-Étienne,0.0,0,0,0,0,0,0,0,0.0,0,1,0,1,0,0,0,0
1025,Paolo Ghiglione,Genoa,6.7,17,12,8,6,3,9,14,64.3,5,11,5,6,10,27,12,1
1026,Saman Ghoddos,Brentford,6.0,17,10,8,6,3,9,15,60.0,6,2,0,2,3,20,16,0
1027,Faouzi Ghoulam,Napoli,3.7,3,1,1,2,0,0,3,0.0,3,2,1,1,3,6,10,0
1028,Dimitris Giannoulis,Norwich City,13.0,36,21,17,17,2,24,36,66.7,12,22,6,16,19,55,41,1
1029,Morgan Gibbs-White,Wolves,0.1,0,0,0,0,0,0,0,0.0,0,1,0,1,0,0,0,0
1030,Ben Gibson,Norwich City,27.7,23,16,17,6,0,7,12,58.3,5,36,30,6,27,50,139,2
1031,Niko Giesselmann,Union Berlin,23.1,24,17,10,11,3,15,38,39.5,23,26,4,22,18,42,29,1
1032,Rafal Gikiewicz,Augsburg,34.0,2,0,2,0,0,2,7,28.6,5,0,0,0,3,5,11,5
1033,Bryan Gil,Tottenham,1.0,3,0,1,0,2,1,2,50.0,1,2,0,2,0,3,0,0
1034,Bryan Gil,Valencia,8.4,13,8,6,3,4,2,13,15.4,11,13,0,13,1,14,4,0
1035,Oscar Gil,Espanyol,18.8,52,35,27,20,5,25,46,54.3,21,33,9,24,19,71,33,2
1036,Mario Gila,Real Madrid,0.3,1,0,1,0,0,0,1,0.0,1,0,0,0,1,2,1,0
1037,Billy Gilmour,Norwich City,20.6,41,21,16,21,4,14,52,26.9,38,21,4,17,17,58,29,0
1038,Daniel Ginczek,Wolfsburg,0.1,0,0,0,0,0,0,0,0.0,0,0,0,0,0,0,0,0
1040,Matthias Ginter,M'Gladbach,26.2,36,22,20,13,3,27,40,67.5,13,21,10,11,33,69,76,0
1041,Nicholas Gioacchini,Montpellier,5.5,7,5,3,2,2,4,10,40.0,6,8,0,8,4,11,5,0
1042,Sebastian Giovinco,Sampdoria,0.4,0,0,0,0,0,0,1,0.0,1,0,0,0,0,0,0,0
1043,Jimmy Giraudon,Troyes,18.0,14,6,10,4,0,7,22,31.8,15,24,14,10,37,51,68,1
1044,Andrei Girotto,Nantes,35.0,85,52,49,32,4,52,103,50.5,51,67,33,34,69,154,143,0
1045,Olivier Giroud,Milan,21.0,15,11,4,6,5,3,17,17.6,14,13,4,9,3,18,19,0
1046,Serge Gnabry,Bayern Munich,24.3,47,31,16,20,11,22,57,38.6,35,26,0,26,14,61,3,0
1047,Ben Godfrey,Everton,22.5,47,32,29,14,4,24,39,61.5,15,41,19,22,15,62,100,2
1048,Diego Godin,Cagliari,9.1,18,7,13,3,2,10,15,66.7,5,7,5,2,13,31,46,0
1049,Edoardo Goldaniga,Cagliari,10.4,12,5,7,5,0,4,11,36.4,7,8,5,3,22,34,23,0
1050,Edoardo Goldaniga,Sassuolo,0.0,0,0,0,0,0,0,0,0.0,0,0,0,0,0,0,0,0
1051,Aleksandr Golovin,Monaco,16.7,40,22,10,18,12,18,41,43.9,23,26,1,25,12,52,8,0
1052,Andre Gomes,Everton,6.9,16,4,6,6,4,8,32,25.0,24,8,2,6,1,17,7,1
1053,Angel Gomes,Lille,10.6,23,13,6,12,5,10,15,66.7,5,4,0,4,3,26,4,0
1054,Toti Gomes,Wolves,4.0,11,7,10,1,0,7,9,77.8,2,6,3,3,8,19,15,0
1055,Dani Gomez,Levante,11.8,7,4,3,2,2,4,12,33.3,8,3,0,3,3,10,5,0
1056,Joe Gomez,Liverpool,3.7,10,6,5,2,3,5,9,55.6,4,4,1,3,5,15,6,0
1057,Maxi Gomez,Valencia,21.7,5,3,1,2,2,5,8,62.5,3,5,1,4,3,8,22,0
1058,Moi Gomez,Villarreal,14.3,15,7,8,3,4,5,17,29.4,12,5,0,5,6,21,6,0
1059,Papu Gomez,Sevilla,19.8,19,11,9,5,5,9,35,25.7,26,15,2,13,7,26,12,2
1060,Sergi Gomez,Espanyol,30.2,33,24,29,3,1,18,27,66.7,9,33,23,10,40,73,125,2
1061,Victor Gomez,Espanyol,0.0,0,0,0,0,0,0,0,0.0,0,0,0,0,0,0,0,0
1062,Alfred Gomis,Rennes,25.0,1,0,1,0,0,1,2,50.0,1,0,0,0,1,2,8,2
1063,Maxime Gonalons,Granada,17.2,43,28,17,22,4,14,39,35.9,25,33,10,23,18,61,29,0
1064,Vagner Goncalves,Metz,1.0,2,1,0,2,0,1,1,100.0,0,0,0,0,1,3,0,0
1066,Cedric Gondo,Salernitana,7.8,5,2,2,2,1,2,5,40.0,3,2,0,2,3,8,2,0
1067,Alvaro Gonzalez,Marseille,5.0,1,1,1,0,0,1,1,100.0,0,0,0,0,1,2,9,0
1068,Diego Gonzalez,Elche,19.9,25,16,18,7,0,9,16,56.3,7,21,13,8,19,44,87,0
1069,Edgar Gonzalez,Betis,16.3,25,19,15,8,2,17,24,70.8,7,17,11,6,23,48,82,0
1070,Giovanni Gonzalez,Mallorca,4.1,9,3,4,4,1,3,5,60.0,2,7,2,5,4,13,14,0
1071,Nicolas Gonzalez,Fiorentina,26.2,21,16,6,8,7,9,28,32.1,19,26,2,24,21,42,4,1
1072,Nicolas Gonzalez,Barcelona,12.4,31,20,5,23,3,11,27,40.7,16,12,0,12,6,37,12,0
1073,Peter Gonzalez,Real Madrid,0.3,0,0,0,0,0,0,0,0.0,0,0,0,0,1,1,0,0
1074,Roberto Gonzalez,Betis,1.5,5,4,3,2,0,4,6,66.7,2,5,0,5,1,6,1,0
1075,Charlie Goode,Brentford,5.0,7,5,5,2,0,4,4,100.0,0,4,2,2,2,9,8,0
1076,Anthony Gordon,Everton,25.4,54,32,20,30,4,21,59,35.6,38,49,3,46,22,76,17,0
1077,Kaide Gordon,Liverpool,0.1,1,0,0,0,1,0,0,0.0,0,0,0,0,0,1,0,0
1078,Leon Goretzka,Bayern Munich,15.5,25,15,12,9,4,11,26,42.3,15,11,1,10,17,42,23,2
1079,Gori,Espanyol,0.1,0,0,0,0,0,0,0,0.0,0,2,0,2,0,0,0,0
1080,Andoni Gorosabel,Real Sociedad,25.4,47,31,32,9,6,25,47,53.2,22,16,3,13,18,65,49,0
1081,Robin Gosens,Atalanta,5.1,7,3,3,4,0,4,8,50.0,4,4,0,4,9,16,1,0
1082,Robin Gosens,Inter,1.9,3,1,1,2,0,0,0,0.0,0,5,2,3,3,6,3,0
1083,Dan Gosling,Watford,1.8,2,1,1,1,0,2,6,33.3,4,2,0,2,0,2,3,0
1084,Amine Gouiri,Nice,30.6,22,13,2,13,7,10,32,31.3,22,22,5,17,11,33,17,1
1085,Lucas Gourna-Douath,Saint-Étienne,20.0,45,26,22,18,5,21,36,58.3,15,22,3,19,13,58,9,2
1086,Jeffrey Gouweleeuw,Augsburg,28.6,50,27,33,17,0,22,36,61.1,14,35,18,17,49,99,116,0
1087,Jonathan Gradit,Lens,34.1,60,28,24,28,8,25,45,55.6,20,39,27,12,65,125,106,0
1088,Jens Grahl,Eint Frankfurt,1.0,0,0,0,0,0,0,0,0.0,0,0,0,0,0,0,1,0
1089,Alberto Grassi,Cagliari,24.2,47,26,13,30,4,16,38,42.1,22,27,9,18,63,110,33,1
1090,Jaume Grau,Osasuna,0.0,1,1,1,0,0,0,1,0.0,1,0,0,0,0,1,0,0
1092,Andrew Gravillon,Reims,23.7,32,24,19,13,0,17,27,63.0,10,25,15,10,33,65,83,1
1093,Demarai Gray,Everton,26.0,30,19,13,10,7,10,22,45.5,12,30,2,28,15,45,21,1
1094,Adrian Grbic,Lorient,5.8,2,1,0,2,0,2,6,33.3,4,3,1,2,0,2,7,0
1095,Ivo Grbic,Lille,21.0,0,0,0,0,0,0,0,0.0,0,0,0,0,0,0,14,1
1096,Jack Grealish,Manchester City,21.3,18,17,4,10,4,5,13,38.5,8,11,1,10,8,26,7,0
1097,Etienne Green,Saint-Étienne,13.3,1,1,1,0,0,0,0,0.0,0,0,0,0,1,2,9,0
1098,Julian Green,Greuther Fürth,11.7,9,5,0,8,1,2,8,25.0,6,10,2,8,7,16,10,0
1099,Mason Greenwood,Manchester Utd,14.1,15,9,9,1,5,3,9,33.3,6,5,0,5,1,16,6,0
1100,Sam Greenwood,Leeds United,2.6,8,5,0,5,3,4,7,57.1,3,3,0,3,2,10,1,0
1101,Michael Gregoritsch,Augsburg,15.5,19,8,4,10,5,2,15,13.3,13,18,2,16,6,25,29,0
1102,Dominik Greif,Mallorca,1.0,0,0,0,0,0,0,0,0.0,0,0,0,0,0,0,0,0
1103,Clement Grenier,Mallorca,0.7,0,0,0,0,0,0,0,0.0,0,1,1,0,0,0,1,0
1104,Sebastian Griesbeck,Greuther Fürth,27.1,60,31,38,19,3,39,62,62.9,23,38,13,25,43,103,100,1
1105,Sebastian Griesbeck,Union Berlin,0.1,1,1,0,1,0,1,1,100.0,0,0,0,0,0,1,0,0
1106,Antoine Griezmann,Barcelona,2.9,13,5,3,10,0,2,6,33.3,4,4,0,4,3,16,5,0
1107,Antoine Griezmann,Atlético Madrid,18.8,30,14,11,15,4,12,32,37.5,20,18,1,17,7,37,18,0
1108,Vincenzo Grifo,Freiburg,30.8,27,15,9,13,5,9,26,34.6,17,12,2,10,13,40,28,0
1109,Lennart Grill,Leverkusen,1.0,0,0,0,0,0,0,0,0.0,0,0,0,0,0,0,0,0
1110,Florian Grillitsch,Hoffenheim,16.6,37,19,15,21,1,17,31,54.8,14,18,7,11,29,66,36,1
1111,Pascal Gross,Brighton,22.6,28,15,15,11,2,12,33,36.4,21,34,8,26,18,46,23,0
1112,Carlos Gruezo,Augsburg,10.8,22,11,10,10,2,8,21,38.1,13,11,2,9,9,31,15,0
1113,Vicente Guaita,Crystal Palace,29.5,1,0,1,0,0,1,1,100.0,0,0,0,0,1,2,8,1
1114,Andres Guardado,Betis,15.5,30,13,12,17,1,13,34,38.2,21,18,4,14,21,51,29,1
1115,Sergi Guardiola,Rayo Vallecano,19.0,10,9,3,5,2,1,21,4.8,20,14,2,12,4,14,17,0
1116,Nemanja Gudelj,Sevilla,11.6,16,7,10,4,2,5,8,62.5,3,14,9,5,22,38,37,0
1118,Gabriel Gudmundsson,Lille,14.9,43,31,24,16,3,17,35,48.6,18,15,3,12,20,63,13,0
1119,Noah Guede-Nadje,Angers,0.0,0,0,0,0,0,0,0,0.0,0,0,0,0,0,0,0,0
1120,Goncalo Guedes,Valencia,29.0,21,14,6,7,8,2,22,9.1,20,14,0,14,9,30,1,0
1121,Marc Guehi,Crystal Palace,35.8,35,17,24,10,1,15,16,93.8,1,34,26,8,30,65,127,0
1122,Matteo Guendouzi,Marseille,35.0,45,30,10,26,9,13,47,27.7,34,15,1,14,16,61,18,0
1123,Yanis Guermouche,Montpellier,0.1,2,1,0,1,1,1,1,100.0,0,0,0,0,0,2,0,0
1124,Raphael Guerreiro,Dortmund,19.9,35,19,19,12,4,16,31,51.6,15,18,2,16,25,60,14,1
1125,Evann Guessand,Nice,4.9,9,8,2,5,2,3,8,37.5,5,4,0,4,0,9,1,0
1126,Ander Guevara,Real Sociedad,9.6,18,13,6,10,2,10,17,58.8,7,12,6,6,12,30,8,0
1127,Lamine Gueye,Metz,6.2,5,5,1,1,3,3,7,42.9,4,4,0,4,6,11,1,0
1128,Pape Gueye,Marseille,17.0,38,19,15,22,1,16,31,51.6,15,15,3,12,24,62,16,0
1129,John Guidetti,Alavés,3.1,2,1,0,0,2,0,1,0.0,1,1,0,1,0,2,0,0
1130,Josuha Guilavogui,Bordeaux,14.8,39,16,18,17,4,14,29,48.3,15,16,8,8,36,75,23,0
1131,Josuha Guilavogui,Wolfsburg,10.5,23,14,13,9,1,7,18,38.9,11,11,6,5,25,48,42,0
1132,Frederic Guilbert,Strasbourg,28.0,69,39,33,24,12,32,62,51.6,30,37,11,26,55,124,39,0
1133,Bruno Guimaraes,Newcastle Utd,11.5,44,23,18,22,4,21,38,55.3,17,25,6,19,9,53,13,0
1134,Bruno Guimaraes,Lyon,18.2,50,31,20,25,5,23,59,39.0,36,21,4,17,21,71,11,1
1135,Serhou Guirassy,Rennes,11.3,4,2,1,2,1,1,7,14.3,6,4,0,4,1,5,8,0
1136,Peter Gulacsi,RB Leipzig,33.0,0,0,0,0,0,0,0,0.0,0,0,0,0,1,1,15,1
1137,Manuel Gulde,Freiburg,13.6,18,10,14,3,1,8,11,72.7,3,16,8,8,17,35,37,0
1138,Gerard Gumbau,Elche,21.0,46,19,22,19,5,22,51,43.1,29,18,4,14,23,69,25,0
1139,Robert Gumny,Augsburg,25.2,48,29,25,20,3,25,43,58.1,18,24,7,17,28,76,57,3
1140,Ilkay Gundogan,Manchester City,20.6,23,9,10,12,1,12,31,38.7,19,11,1,10,15,38,10,0
1141,Angus Gunn,Norwich City,9.0,0,0,0,0,0,0,0,0.0,0,0,0,0,0,0,11,0
1142,Christian Gunter,Freiburg,34.0,34,20,16,15,3,18,50,36.0,32,23,6,17,17,51,49,2
1144,Koray Gunter,Hellas Verona,26.8,32,18,19,11,2,16,32,50.0,16,27,21,6,69,101,110,1
1145,Lasse Gunther,Augsburg,1.8,8,5,4,3,1,5,9,55.6,4,0,0,0,2,10,2,0
1146,Jon Guridi,Real Sociedad,2.3,5,3,2,3,0,1,4,25.0,3,3,1,2,3,8,4,0
1147,Malo Gusto,Lyon,20.9,55,35,29,21,5,24,40,60.0,16,21,6,15,33,88,41,1
1148,Raul Guti,Elche,18.1,25,15,7,14,4,10,30,33.3,20,9,3,6,25,50,7,0
1149,Marcos Mauro Lopez Gutierrez,Cádiz,1.5,1,0,0,1,0,0,2,0.0,2,2,1,1,1,2,9,0
1150,Miguel Gutierrez,Real Madrid,2.9,7,5,5,0,2,3,5,60.0,2,0,0,0,2,9,2,0
1151,Albert Gudmundsson,Genoa,6.7,5,3,2,1,2,3,8,37.5,5,2,0,2,5,10,4,0
1152,Josko Gvardiol,RB Leipzig,26.8,47,31,28,17,2,22,39,56.4,17,30,11,19,51,98,62,2
1153,Emmanuel Gyasi,Spezia,33.7,47,30,31,9,7,21,41,51.2,20,22,4,18,16,63,43,1
1154,Norbert Gyomber,Salernitana,28.5,53,32,40,11,2,33,50,66.0,17,38,24,14,44,97,126,1
1155,Erling Haaland,Dortmund,21.2,2,1,0,1,1,0,1,0.0,1,8,1,7,1,3,31,0
1156,Nicolas Haas,Empoli,11.1,35,22,15,10,10,17,39,43.6,22,24,4,20,9,44,17,1
1157,Janik Haberer,Freiburg,9.1,14,8,5,6,3,7,19,36.8,12,11,4,7,16,30,11,0
1158,Alexander Hack,Mainz 05,23.0,52,26,35,17,0,29,46,63.0,17,31,14,17,51,103,95,1
1159,Robin Hack,Arminia,15.2,14,8,6,5,3,3,21,14.3,18,18,1,17,5,19,4,0
1160,Munir El Haddadi,Sevilla,5.3,8,4,1,6,1,2,8,25.0,6,7,1,6,5,13,2,0
1161,Andre Hahn,Augsburg,23.3,36,20,9,15,12,17,50,34.0,33,38,5,33,15,51,43,0
1162,Amadou Haidara,RB Leipzig,14.7,30,14,11,19,0,17,37,45.9,20,22,6,16,16,46,8,1
1163,Massadio Haidara,Lens,12.0,28,21,18,7,3,15,24,62.5,9,18,4,14,22,50,31,0
1164,Oualid El Hajjam,Troyes,11.9,22,11,12,6,4,15,23,65.2,8,12,6,6,22,44,28,0
1165,Achraf Hakimi,Paris S-G,27.5,74,51,38,27,9,40,72,55.6,32,26,5,21,28,102,23,2
1166,Marcel Halstenberg,RB Leipzig,5.6,10,7,6,4,0,6,11,54.5,5,6,0,6,7,17,11,0
1167,Pierre-Yves Hamel,Lorient,0.3,0,0,0,0,0,0,1,0.0,1,0,0,0,2,2,0,0
1168,Pierre-Yves Hamel,Clermont Foot,5.8,11,6,0,5,6,5,6,83.3,1,2,1,1,0,11,0,0
1170,Romain Hamouma,Saint-Étienne,9.8,10,7,1,5,4,2,13,15.4,11,8,0,8,4,14,1,0
1171,Samir Handanovic,Inter,37.0,1,0,1,0,0,1,2,50.0,1,1,0,1,0,1,6,3
1172,Grant Hanley,Norwich City,32.2,44,25,28,14,2,18,35,51.4,17,56,45,11,56,100,176,2
1173,Ridgeciano Haps,Venezia,22.8,36,20,26,4,6,11,21,52.4,10,34,12,22,29,65,57,1
1174,Genki Haraguchi,Union Berlin,19.5,37,20,12,22,3,15,48,31.3,33,25,3,22,26,63,15,0
1175,Amine Harit,Marseille,12.9,18,11,9,9,0,9,17,52.9,8,10,0,10,4,22,2,0
1176,Varazdat Haroyan,Cádiz,16.0,31,21,20,10,1,19,29,65.5,10,22,12,10,15,46,62,0
1177,Jack Harrison,Leeds United,29.3,57,37,22,22,13,31,76,40.8,45,35,1,34,21,78,19,0
1178,Abdou Harroui,Sassuolo,5.0,11,4,4,7,0,8,11,72.7,3,14,0,14,4,15,5,0
1179,Luis Hartwig,Bochum,0.0,0,0,0,0,0,0,0,0.0,0,0,0,0,0,0,0,0
1180,Makoto Hasebe,Eint Frankfurt,13.2,27,12,15,11,1,13,29,44.8,16,24,8,16,22,49,36,0
1181,Hans Hateboer,Atalanta,15.4,22,14,10,8,4,11,26,42.3,15,11,1,10,7,29,20,0
1182,Kortney Hause,Aston Villa,4.4,3,3,2,0,1,3,4,75.0,1,8,5,3,6,9,13,0
1183,Kai Havertz,Chelsea,20.1,17,8,5,7,5,4,14,28.6,10,28,1,27,4,21,32,1
1184,Isaac Hayden,Newcastle Utd,11.1,28,14,11,14,3,12,29,41.4,17,17,8,9,14,42,24,0
1185,Eden Hazard,Real Madrid,8.0,6,3,3,2,1,3,7,42.9,4,3,0,3,2,8,0,0
1186,Thorgan Hazard,Dortmund,14.9,23,13,8,10,5,15,40,37.5,25,23,1,22,6,29,4,0
1187,Jonas Hector,Köln,28.4,76,39,36,26,14,29,74,39.2,45,59,8,51,50,126,68,1
1188,Hwang Hee-chan,Wolves,20.2,27,13,9,16,2,14,44,31.8,30,10,0,10,13,40,7,1
1189,Hwang Hee-chan,RB Leipzig,0.5,0,0,0,0,0,0,0,0.0,0,0,0,0,1,1,0,0
1190,Silvan Hefti,Genoa,14.3,50,30,23,22,5,32,58,55.2,26,20,4,16,20,70,34,1
1191,Dominique Heintz,Union Berlin,5.2,8,5,5,3,0,3,6,50.0,3,7,4,3,7,15,14,0
1192,Dominique Heintz,Freiburg,0.3,0,0,0,0,0,0,0,0.0,0,0,0,0,1,1,0,0
1193,Jordan Henderson,Liverpool,28.9,36,20,9,25,2,17,44,38.6,27,25,1,24,23,59,14,0
1194,Liam Henderson,Empoli,22.4,22,13,7,8,7,9,31,29.0,22,14,4,10,9,31,13,0
1196,Jeff Hendrick,Newcastle Utd,0.8,1,1,0,1,0,1,1,100.0,0,0,0,0,0,1,1,0
1197,Wayne Hennessey,Burnley,2.0,0,0,0,0,0,0,0,0.0,0,0,0,0,1,1,0,1
1198,Benjamin Henrichs,RB Leipzig,12.7,30,21,18,6,6,12,22,54.5,10,16,1,15,19,49,14,0
1199,Henrique,Lyon,12.3,13,7,10,1,2,5,16,31.3,11,13,1,12,22,35,14,0
1200,Dalbert Henrique,Cagliari,23.1,43,23,23,16,4,11,35,31.4,24,28,5,23,24,67,34,0
1201,Luis Henrique,Marseille,7.8,4,3,2,1,1,2,5,40.0,3,2,0,2,5,9,1,0
1202,Matheus Henrique,Sassuolo,12.0,10,3,6,3,1,6,24,25.0,18,14,2,12,7,17,12,1
1203,Rico Henry,Brentford,30.8,28,20,18,8,2,12,34,35.3,22,31,10,21,26,54,76,1
1204,Thomas Henry,Venezia,23.5,9,4,2,3,4,5,13,38.5,8,11,5,6,2,11,25,0
1205,Christophe Herelle,Brest,21.5,48,28,30,16,2,17,26,65.4,9,20,15,5,44,92,84,1
1206,Jerome Hergault,Lorient,3.9,3,1,1,2,0,2,5,40.0,3,4,1,3,4,7,7,0
1207,Kike Hermoso,Betis,1.0,2,1,2,0,0,2,2,100.0,0,2,1,1,0,2,5,1
1208,Mario Hermoso,Atlético Madrid,20.7,30,15,23,4,3,20,38,52.6,18,18,3,15,29,59,49,2
1209,Aridane Hernandez,Osasuna,12.9,12,9,10,2,0,3,13,23.1,10,11,9,2,20,32,71,0
1210,Lucas Hernandez,Bayern Munich,22.6,50,31,20,24,6,26,42,61.9,16,22,11,11,28,78,54,1
1211,Luis Hernandez,Cádiz,15.2,9,5,9,0,0,5,8,62.5,3,5,3,2,16,25,34,0
1212,Mario Hernandez,Rayo Vallecano,4.4,10,4,7,3,0,5,9,55.6,4,1,0,1,4,14,7,0
1213,Theo Hernandez,Milan,30.1,53,35,34,14,5,29,40,72.5,11,16,3,13,23,76,29,3
1214,Hernani,Genoa,7.6,20,10,8,9,3,13,32,40.6,19,17,4,13,13,33,5,1
1215,Ander Herrera,Paris S-G,12.1,29,17,7,16,6,14,39,35.9,25,22,8,14,14,43,8,0
1216,Hector Herrera,Atlético Madrid,9.5,16,8,11,4,1,7,20,35.0,13,13,2,11,12,28,16,0
1217,Sergio Herrera,Osasuna,36.0,3,2,3,0,0,3,6,50.0,3,1,0,1,1,4,18,0
1218,Yangel Herrera,Espanyol,18.3,41,31,19,19,3,18,39,46.2,21,27,5,22,19,60,33,1
1219,Patrick Herrmann,M'Gladbach,8.4,15,7,5,6,4,9,24,37.5,15,10,1,9,6,21,8,0
1220,Son Heung-min,Tottenham,33.4,15,6,5,7,3,5,23,21.7,18,27,6,21,13,28,8,0
1222,Daan Heymans,Venezia,2.8,3,1,1,2,0,1,5,20.0,4,7,3,4,4,7,3,0
1223,Aaron Hickey,Bologna,31.3,46,29,24,15,7,20,30,66.7,10,36,13,23,29,75,44,0
1224,Piero Hincapie,Leverkusen,19.5,33,23,23,8,2,19,25,76.0,6,34,15,19,33,66,56,2
1225,Martin Hinteregger,Eint Frankfurt,24.7,45,28,28,16,1,28,43,65.1,15,36,16,20,42,87,78,3
1226,Marwin Hitz,Dortmund,4.5,0,0,0,0,0,0,0,0.0,0,0,0,0,0,0,2,0
1227,Ki-Jana Hoever,Wolves,3.4,10,6,5,5,0,7,12,58.3,5,6,0,6,6,16,8,0
1228,Nicolas Hofler,Freiburg,28.9,73,42,37,29,7,28,62,45.2,34,50,21,29,46,119,42,0
1229,Jonas Hofmann,M'Gladbach,23.1,30,20,6,17,7,17,42,40.5,25,23,0,23,12,42,10,0
1230,Rob Holding,Arsenal,9.4,13,9,11,1,1,5,6,83.3,1,23,18,5,10,23,42,1
1231,Lucas Holer,Freiburg,28.7,41,25,10,17,14,13,28,46.4,15,25,4,21,17,58,39,2
1232,Mason Holgate,Everton,23.7,35,18,26,9,0,11,26,42.3,15,25,17,8,26,61,95,1
1233,Gerrit Holtmann,Bochum,20.4,15,9,5,3,7,6,22,27.3,16,26,2,24,8,23,6,0
1234,Martin Hongla,Hellas Verona,7.2,14,8,5,6,3,4,8,50.0,4,6,2,4,4,18,16,1
1235,Franck Honorat,Brest,32.2,54,38,25,13,16,27,47,57.4,20,24,2,22,15,69,25,0
1236,Justin Hoogma,Greuther Fürth,3.0,6,5,4,2,0,4,6,66.7,2,5,5,0,4,10,4,0
1237,Sydney van Hooijdonk,Bologna,0.4,0,0,0,0,0,0,1,0.0,1,1,0,1,0,0,0,0
1238,Matthew Hoppe,Mallorca,1.5,1,0,0,0,1,0,3,0.0,3,0,0,0,0,1,0,0
1239,Jannes Horn,Köln,5.3,6,4,4,2,0,4,8,50.0,4,1,1,0,3,9,9,0
1240,Timo Horn,Köln,13.0,0,0,0,0,0,0,1,0.0,1,0,0,0,0,0,5,0
1241,Fraser Hornby,Reims,3.9,3,1,1,2,0,0,2,0.0,2,3,0,3,4,7,5,0
1242,Cedric Hountondji,Clermont Foot,22.6,33,17,20,12,1,16,24,66.7,8,23,12,11,34,67,76,0
1243,Lukas Hradecky,Leverkusen,32.0,1,1,1,0,0,1,1,100.0,0,0,0,0,0,1,10,1
1244,Branimir Hrgota,Greuther Fürth,30.9,46,29,10,31,5,21,72,29.2,51,27,1,26,11,57,3,1
1245,Petko Hristov,Spezia,13.9,17,10,11,6,0,10,16,62.5,6,29,23,6,19,36,47,0
1246,Ajdin Hrustic,Eint Frankfurt,10.7,16,11,5,7,4,11,32,34.4,21,18,1,17,10,26,7,0
1248,Timo Hubers,Köln,19.3,45,27,28,17,0,27,45,60.0,18,31,19,12,52,97,95,0
1249,Benjamin Hubner,Hoffenheim,4.2,9,5,0,7,2,3,5,60.0,2,2,2,0,9,18,7,0
1250,Callum Hudson-Odoi,Chelsea,10.7,14,10,5,6,3,8,23,34.8,15,8,0,8,2,16,6,1
1251,Will Hughes,Crystal Palace,11.7,29,14,10,16,3,7,16,43.8,9,13,7,6,8,37,10,0
1252,Mats Hummels,Dortmund,19.6,34,22,20,13,1,20,36,55.6,16,18,13,5,32,66,66,1
1253,Elseid Hysaj,Lazio,22.5,46,30,25,17,4,29,45,64.4,16,18,6,12,24,70,34,1
1254,Suk Hyun-jun,Troyes,1.7,0,0,0,0,0,0,0,0.0,0,2,0,2,0,0,2,0
1255,Pierre Hojbjerg,Tottenham,35.5,78,45,31,38,9,38,85,44.7,47,61,13,48,48,126,54,0
1256,Iago,Augsburg,24.2,49,29,25,19,5,15,34,44.1,19,28,6,22,27,76,62,0
1257,Robert Ibanez,Osasuna,1.0,3,3,2,0,1,1,2,50.0,1,1,0,1,1,4,1,0
1258,Roger Ibanez,Roma,32.1,54,32,31,19,4,26,43,60.5,17,26,7,19,62,116,104,2
1259,Vicente Iborra,Villarreal,11.5,19,10,9,7,3,12,24,50.0,12,11,5,6,11,30,27,1
1260,Zlatan Ibrahimovic,Milan,11.3,0,0,0,0,0,0,2,0.0,2,2,1,1,3,3,9,0
1261,Mauro Icardi,Paris S-G,11.4,5,3,1,3,1,3,7,42.9,4,3,0,3,5,10,12,0
1262,Adam Idah,Norwich City,6.9,9,6,2,5,2,2,3,66.7,1,4,2,2,3,12,7,0
1263,Oussama Idrissi,Sevilla,1.4,1,0,0,1,0,0,1,0.0,1,1,0,1,1,2,1,0
1264,Oussama Idrissi,Cádiz,10.0,8,4,3,4,1,4,15,26.7,11,8,0,8,3,11,5,0
1265,Iglesias,Getafe,8.0,19,10,11,8,0,7,17,41.2,10,8,2,6,10,29,28,0
1266,Borja Iglesias,Betis,17.5,6,4,1,2,3,0,8,0.0,8,11,1,10,4,10,7,0
1267,Jonathan Iglesias,Clermont Foot,6.4,18,11,6,10,2,10,18,55.6,8,8,2,6,5,23,2,1
1268,Juan Ignacio Ramirez,Saint-Étienne,1.4,2,1,0,1,1,0,0,0.0,0,0,0,0,0,2,0,0
1269,Igor,Fiorentina,24.9,53,31,34,16,3,30,40,75.0,10,37,19,18,31,84,46,4
1270,Kelechi Iheanacho,Leicester City,14.0,10,7,2,5,3,3,14,21.4,11,19,0,19,4,14,10,0
1271,Danylo Ihnatenko,Bordeaux,7.7,17,9,8,7,2,10,24,41.7,14,9,2,7,6,23,17,1
1272,Jonathan Ikone,Fiorentina,7.2,7,3,2,3,2,3,10,30.0,7,10,2,8,1,8,2,0
1274,Jonathan Ikone,Lille,11.8,11,3,6,4,1,4,11,36.4,7,13,1,12,5,16,4,0
1275,Ivan Ilic,Hellas Verona,28.1,39,18,16,19,4,20,54,37.0,34,34,12,22,22,61,55,0
1276,Josip Ilicic,Atalanta,9.3,7,7,3,2,2,4,17,23.5,13,6,1,5,3,10,1,0
1277,Asier Illarramendi,Real Sociedad,4.2,9,5,5,3,1,1,10,10.0,9,5,1,4,4,13,12,0
1278,Stefan Ilsanker,Eint Frankfurt,3.0,14,8,7,6,1,5,10,50.0,5,6,2,4,6,20,15,1
1279,Ciro Immobile,Lazio,30.1,10,5,4,4,2,1,15,6.7,14,7,1,6,3,13,16,0
1280,Burak Ince,Arminia,1.5,1,1,1,0,0,1,2,50.0,1,1,0,1,0,1,0,0
1281,Danny Ings,Aston Villa,21.1,23,16,2,16,5,13,37,35.1,24,31,2,29,6,29,22,0
1282,Marcus Ingvartsen,Union Berlin,1.4,0,0,0,0,0,0,2,0.0,2,0,0,0,2,2,1,0
1283,Marcus Ingvartsen,Mainz 05,7.6,3,2,2,0,1,3,9,33.3,6,6,0,6,6,9,7,1
1284,Bonke Innocent,Lorient,9.7,27,16,10,16,1,11,26,42.3,15,11,3,8,16,43,14,0
1285,Lorenzo Insigne,Napoli,25.4,23,14,8,12,3,8,44,18.2,36,30,1,29,20,43,3,1
1286,Nikita Iosifov,Villarreal,0.0,0,0,0,0,0,0,0,0.0,0,0,0,0,0,0,0,0
1287,Tim Iroegbunam,Aston Villa,1.0,5,4,2,3,0,1,1,100.0,0,0,0,0,2,7,1,0
1288,Alexander Isak,Real Sociedad,23.8,7,4,1,3,3,2,12,16.7,10,14,2,12,3,10,10,0
1289,Isco,Real Madrid,3.7,9,5,4,4,1,5,12,41.7,7,1,0,1,2,11,1,0
1290,Wilson Isidor,Monaco,0.6,0,0,0,0,0,0,4,0.0,4,1,0,1,0,0,0,0
1291,Ardian Ismajli,Empoli,14.1,13,9,8,4,1,5,14,35.7,9,21,11,10,24,37,80,0
1292,Hiroki Ito,Stuttgart,26.1,43,31,21,19,3,25,43,58.1,18,40,19,21,53,96,95,0
1293,Cedric Itten,Greuther Fürth,7.1,5,2,1,2,2,1,6,16.7,5,3,0,3,2,7,4,0
1294,Gian-Luca Itter,Greuther Fürth,16.2,44,26,30,11,3,21,38,55.3,17,24,9,15,13,57,51,0
1295,Alex Iwobi,Everton,22.6,40,19,23,12,5,21,52,40.4,31,39,3,36,20,60,25,2
1296,Armando Izzo,Torino,5.8,16,9,14,2,0,9,11,81.8,2,5,4,1,17,33,21,0
1297,Nicolas Jackson,Villarreal,1.8,2,0,1,0,1,0,0,0.0,0,0,0,0,1,3,1,0
1298,Lee Jae-sung,Mainz 05,16.0,30,12,8,14,8,6,27,22.2,21,20,2,18,18,48,18,0
1300,Paul Jaeckel,Union Berlin,22.7,51,29,27,24,0,29,51,56.9,22,34,10,24,57,108,81,0
1301,Mato Jajalo,Udinese,7.0,24,14,14,7,3,11,23,47.8,12,7,0,7,11,35,5,0
1302,Kristijan Jakic,Eint Frankfurt,20.9,37,22,10,21,6,15,62,24.2,47,33,3,30,21,58,25,1
1303,Ismail Jakobs,Monaco,13.4,32,16,14,15,3,16,35,45.7,19,16,1,15,17,49,31,0
1304,Marin Jakolis,Angers,2.5,2,1,0,1,1,0,6,0.0,6,0,0,0,1,3,0,0
1305,Abdel Jalil Medioub,Bordeaux,6.9,9,5,5,3,1,3,4,75.0,1,8,4,4,12,21,34,0
1306,Daniel James,Manchester Utd,1.4,2,1,0,2,0,0,0,0.0,0,2,0,2,0,2,1,0
1307,Daniel James,Leeds United,26.3,24,14,8,8,8,10,23,43.5,13,18,1,17,8,32,12,0
1308,Reece James,Chelsea,20.7,33,25,14,18,1,9,22,40.9,13,20,2,18,17,50,22,0
1309,Vitaly Janelt,Brentford,25.5,61,32,26,27,8,27,53,50.9,26,23,7,16,28,89,35,0
1310,Jakub Jankto,Getafe,6.5,11,7,5,5,1,10,17,58.8,7,4,0,4,4,15,7,0
1311,Pontus Jansson,Brentford,36.9,40,21,32,8,0,22,34,64.7,12,37,27,10,52,92,187,0
1312,Tony Jantschke,M'Gladbach,2.5,6,5,2,4,0,3,6,50.0,3,3,2,1,5,11,8,0
1313,Adnan Januzaj,Real Sociedad,18.1,17,11,5,8,4,9,24,37.5,15,15,3,12,12,29,15,0
1314,Leo Jardim,Lille,17.0,0,0,0,0,0,0,0,0.0,0,0,0,0,1,1,10,0
1315,Pawel Jaroszynski,Salernitana,5.7,10,5,7,3,0,5,7,71.4,2,4,0,4,10,20,19,0
1316,Jason,Alavés,7.5,11,7,6,4,1,7,20,35.0,13,7,0,7,7,18,5,0
1317,Jason,Valencia,0.8,4,1,2,1,1,0,1,0.0,1,2,0,2,1,5,1,0
1318,Dennis Jastrzembski,Hertha BSC,2.5,2,1,1,1,0,2,8,25.0,6,1,0,1,5,7,3,0
1319,Luis Javier Suarez,Granada,31.6,26,14,9,9,8,8,27,29.6,19,25,3,22,6,32,23,0
1320,Corentin Jean,Lens,2.8,9,6,4,4,1,3,6,50.0,3,5,0,5,1,10,0,0
1321,Jemerson,Metz,13.4,37,25,30,7,0,18,26,69.2,8,23,8,15,25,62,33,1
1322,Fredrik Jensen,Augsburg,4.6,5,4,1,3,1,4,7,57.1,3,5,1,4,2,7,4,0
1323,Mathias Jensen,Brentford,17.8,33,18,12,16,5,22,63,34.9,41,32,3,29,22,55,13,0
1324,Moritz Jenz,Lorient,15.3,26,12,18,6,2,11,24,45.8,13,19,11,8,28,54,55,0
1326,Gabriel Jesus,Manchester City,20.9,18,12,2,4,12,6,26,23.1,20,18,0,18,15,33,8,0
1327,Juan Jesus,Napoli,14.2,25,17,14,11,0,12,18,66.7,6,21,16,5,9,34,34,0
1328,Alvaro Jimenez,Cádiz,2.6,6,3,3,2,1,4,7,57.1,3,3,0,3,3,9,0,0
1329,Raul Jimenez,Wolves,29.2,29,14,6,16,7,6,30,20.0,24,31,5,26,13,42,26,0
1330,Joao Pedro,Watford,18.3,20,14,7,8,5,6,23,26.1,17,23,3,20,15,35,17,0
1331,Joaquin,Betis,5.2,6,2,4,2,0,3,8,37.5,5,5,2,3,3,9,10,0
1332,Joelinton,Newcastle Utd,28.4,72,38,30,33,9,26,61,42.6,35,46,11,35,34,106,50,2
1333,Jofre,Espanyol,0.2,1,1,0,0,1,1,1,100.0,0,0,0,0,0,1,0,0
1334,Marco John,Hoffenheim,0.5,0,0,0,0,0,0,1,0.0,1,1,0,1,1,1,1,0
1335,Dennis Johnsen,Venezia,16.1,14,10,8,4,2,6,18,33.3,12,14,1,13,5,19,3,0
1336,Ben Johnson,West Ham,15.5,33,16,15,15,3,21,28,75.0,7,16,8,8,22,55,55,0
1337,Curtis Jones,Liverpool,9.5,11,9,3,6,2,1,10,10.0,9,4,0,4,6,17,4,0
1338,Phil Jones,Manchester Utd,1.8,5,5,3,1,1,2,3,66.7,1,4,4,0,3,8,8,0
1339,Frenkie de Jong,Barcelona,27.5,35,19,12,18,5,12,23,52.2,11,19,5,14,20,55,16,0
1340,Luuk de Jong,Barcelona,7.3,9,7,1,5,3,1,2,50.0,1,4,0,4,0,9,12,0
1341,Joan Jordan,Sevilla,27.9,61,30,22,31,8,28,65,43.1,37,27,6,21,30,91,18,1
1342,Kaio Jorge,Juventus,1.3,2,1,0,2,0,1,3,33.3,2,1,0,1,0,2,2,0
1343,Jorginho,Chelsea,25.3,64,33,27,31,6,29,83,34.9,54,27,4,23,36,100,21,1
1344,Josan,Elche,13.5,36,22,23,9,4,26,44,59.1,18,11,4,7,10,46,21,0
1345,Willian Jose,Betis,17.8,15,13,2,10,3,2,8,25.0,6,10,2,8,3,18,16,0
1346,Joselu,Alavés,34.7,16,11,1,9,6,7,25,28.0,18,21,4,17,7,23,45,0
1347,Josema,Elche,2.0,3,2,1,1,1,0,2,0.0,2,1,1,0,0,3,11,0
1348,Lenny Joseph,Metz,1.7,2,1,1,1,0,0,0,0.0,0,3,0,3,0,2,0,0
1349,Diogo Jota,Liverpool,26.3,39,18,12,18,9,13,55,23.6,42,19,2,17,6,45,6,0
1350,Stevan Jovetic,Hertha BSC,11.3,5,2,0,2,3,1,6,16.7,5,3,0,3,1,6,6,0
1352,Luka Jovic,Real Madrid,4.1,1,1,0,1,0,0,1,0.0,1,3,0,3,1,2,4,0
1353,Miguel Juan Llambrich,Espanyol,0.8,2,2,1,1,0,0,0,0.0,0,1,0,1,0,2,5,0
1354,Jose Juan Macias,Getafe,2.2,1,0,0,0,1,0,1,0.0,1,1,0,1,1,2,0,0
1355,Juanmi,Betis,23.7,39,25,11,19,9,19,49,38.8,30,24,1,23,9,48,10,1
1356,Gideon Jung,Greuther Fürth,1.6,3,1,1,2,0,2,4,50.0,2,1,1,0,2,5,5,0
1357,Flavio Junior Bianchi,Genoa,3.5,2,2,1,0,1,0,2,0.0,2,0,0,0,0,2,0,0
1358,Lago Junior,Mallorca,2.0,3,2,3,0,0,3,5,60.0,2,0,0,0,2,5,2,0
1359,Hamed Junior Traore,Sassuolo,19.7,32,18,8,14,10,10,46,21.7,36,22,2,20,12,44,6,1
1360,Vinicius Junior,Real Madrid,29.9,46,24,23,19,4,15,50,30.0,35,25,0,25,6,52,6,0
1361,James Justin,Leicester City,11.1,22,13,11,8,3,7,15,46.7,8,16,4,12,17,39,34,0
1362,Jutgla,Barcelona,3.3,2,1,0,1,1,0,1,0.0,1,2,0,2,1,3,1,0
1363,Jens Jonsson,Cádiz,14.5,40,29,22,17,1,17,35,48.6,18,17,7,10,34,74,32,0
1364,Mathias Jorgensen,Brentford,5.8,10,4,3,5,2,7,10,70.0,3,6,1,5,10,20,13,0
1365,Ozan Kabak,Norwich City,10.2,10,5,4,6,0,5,9,55.6,4,19,11,8,16,26,26,0
1366,Christian Kabasele,Watford,13.3,11,5,10,1,0,7,10,70.0,3,20,16,4,14,25,67,1
1367,Issa Kabore,Troyes,25.0,45,22,22,14,9,20,38,52.6,18,27,2,25,20,65,38,1
1368,Anton Kade,Hertha BSC,0.9,4,2,3,1,0,2,8,25.0,6,3,0,3,3,7,1,0
1369,Pavel Kaderabek,Hoffenheim,13.3,11,10,6,3,2,5,16,31.3,11,18,6,12,13,24,22,0
1370,Tino Kadewere,Lyon,5.6,7,5,2,2,3,4,13,30.8,9,7,0,7,4,11,1,1
1371,Florian Kainz,Köln,25.8,41,26,9,25,7,23,51,45.1,28,27,3,24,32,73,24,0
1372,Gael Kakuta,Lens,18.6,22,14,2,13,7,4,20,20.0,16,10,0,10,4,26,3,0
1373,Sasa Kalajdzic,Stuttgart,13.6,10,6,2,5,3,3,11,27.3,8,5,0,5,2,12,14,0
1374,Arnaud Kalimuendo,Lens,23.9,9,8,1,3,5,2,7,28.6,5,6,1,5,8,17,0,0
1375,Arnaud Kalimuendo,Paris S-G,0.1,0,0,0,0,0,0,0,0.0,0,0,0,0,0,0,0,0
1376,Nikola Kalinic,Hellas Verona,4.5,2,0,0,1,1,1,2,50.0,1,2,0,2,0,2,2,0
1378,Yayah Kallon,Genoa,7.1,15,11,5,6,4,3,11,27.3,8,7,1,6,1,16,5,0
1379,Samuel Kalu,Watford,2.5,2,2,0,2,0,1,1,100.0,0,2,0,2,3,5,3,0
1380,Samuel Kalu,Bordeaux,3.6,8,5,3,4,1,2,5,40.0,3,2,0,2,3,11,1,0
1381,Pierre Kalulu,Milan,21.6,61,36,36,21,4,17,22,77.3,5,36,15,21,26,87,54,0
1382,Daichi Kamada,Eint Frankfurt,23.8,40,21,7,26,7,11,40,27.5,29,18,0,18,8,48,10,0
1383,Boubacar Kamara,Marseille,30.9,68,38,27,36,5,26,47,55.3,21,29,10,19,46,114,44,1
1384,Hassane Kamara,Watford,18.0,53,34,31,16,6,27,43,62.8,16,20,4,16,69,122,67,0
1385,Hassane Kamara,Nice,6.0,13,10,4,6,3,5,8,62.5,3,10,2,8,9,22,4,0
1386,Dimitrije Kamenovic,Lazio,0.5,1,1,1,0,0,1,1,100.0,0,0,0,0,2,3,1,0
1387,Kevin Kampl,RB Leipzig,21.1,41,19,16,20,5,10,42,23.8,32,24,5,19,24,65,17,0
1388,Jean-Armel Kana-Biyik,Metz,7.4,10,6,8,2,0,4,9,44.4,5,11,4,7,16,26,22,1
1389,Nordine Kandil,Strasbourg,1.0,2,1,2,0,0,1,1,100.0,0,1,1,0,0,2,0,0
1390,Harry Kane,Tottenham,35.9,15,5,2,10,3,7,18,38.9,11,26,8,18,3,18,39,0
1391,Lee Kang-in,Mallorca,15.7,13,6,2,9,2,5,29,17.2,24,11,1,10,5,18,7,0
1392,N'Golo Kante,Chelsea,19.7,59,31,20,27,12,25,40,62.5,15,37,2,35,31,90,8,0
1393,Stefanos Kapino,Arminia,1.0,0,0,0,0,0,0,0,0.0,0,0,0,0,0,0,0,0
1394,Atakan Karazor,Stuttgart,21.1,48,24,18,27,3,18,36,50.0,18,37,14,23,34,82,47,0
1395,Rick Karsdorp,Roma,32.0,53,38,33,13,7,28,50,56.0,22,22,5,17,34,87,26,1
1396,Denso Kasius,Bologna,2.0,9,7,5,3,1,2,5,40.0,3,4,0,4,3,12,4,0
1397,Grigoris Kastanos,Salernitana,15.0,30,19,9,19,2,7,23,30.4,16,21,5,16,22,52,8,0
1398,Silas Katompa,Stuttgart,3.1,5,4,4,0,1,3,7,42.9,4,5,0,5,2,7,1,0
1399,Noah Katterbach,Köln,0.2,1,1,1,0,0,1,1,100.0,0,0,0,0,0,1,1,0
1400,Eiji Kawashima,Strasbourg,1.0,0,0,0,0,0,0,0,0.0,0,0,0,0,0,0,0,0
1401,Edo Kayembe,Watford,8.9,21,13,11,9,1,8,16,50.0,8,6,1,5,9,30,13,0
1402,Moise Kean,Everton,0.0,0,0,0,0,0,0,0,0.0,0,0,0,0,0,0,0,0
1404,Moise Kean,Juventus,12.2,9,4,2,5,2,6,16,37.5,10,5,0,5,3,12,8,1
1405,Michael Keane,Everton,31.0,46,25,32,13,1,28,45,62.2,17,33,28,5,62,108,128,2
1406,Ilan Kebbal,Reims,19.7,31,15,13,10,8,12,44,27.3,32,16,0,16,13,44,3,0
1407,Wajdi Kechrida,Salernitana,10.6,9,6,6,3,0,8,13,61.5,5,10,2,8,8,17,15,0
1408,Thilo Kehrer,Paris S-G,16.8,21,14,9,11,1,9,21,42.9,12,19,11,8,24,45,29,0
1409,Habib Keita,Lyon,0.1,0,0,0,0,0,0,0,0.0,0,0,0,0,0,0,0,0
1410,Naby Keita,Liverpool,13.0,46,23,17,19,10,26,42,61.9,16,33,2,31,14,60,8,0
1411,Yannik Keitel,Freiburg,5.6,11,4,5,4,2,5,15,33.3,10,7,1,6,1,12,8,0
1412,Caoimhin Kelleher,Liverpool,2.0,1,1,1,0,0,1,1,100.0,0,0,0,0,0,1,1,0
1413,Marc-Oliver Kempf,Hertha BSC,11.7,10,9,9,1,0,5,14,35.7,9,14,7,7,25,35,49,1
1414,Marc-Oliver Kempf,Stuttgart,9.3,13,8,7,4,2,3,10,30.0,7,16,14,2,16,29,26,2
1415,Kenedy,Chelsea,0.6,5,2,1,2,2,2,3,66.7,1,0,0,0,0,5,0,0
1416,Jonjoe Kenny,Everton,11.3,17,7,11,6,0,13,21,61.9,8,8,1,7,20,37,31,0
1417,Dimitrios Keramitsis,Roma,0.0,0,0,0,0,0,0,0,0.0,0,0,0,0,0,0,0,0
1418,Franck Kessie,Milan,25.6,41,23,12,24,5,17,26,65.4,9,39,10,29,23,64,22,0
1419,Saif-Eddine Khaoui,Clermont Foot,10.3,19,10,5,10,4,9,18,50.0,9,9,0,9,14,33,5,0
1420,Wahbi Khazri,Saint-Étienne,24.7,33,18,7,17,9,9,34,26.5,25,21,0,21,12,45,7,0
1421,Rani Khedira,Union Berlin,30.6,75,38,25,42,8,32,66,48.5,34,21,8,13,50,125,27,1
1422,Kike,Osasuna,20.7,11,7,3,4,4,3,23,13.0,20,10,1,9,3,14,12,0
1423,Luca Kilian,Mainz 05,0.0,0,0,0,0,0,0,0,0.0,0,0,0,0,0,0,0,0
1424,Luca Kilian,Köln,25.3,42,24,30,9,3,21,41,51.2,20,31,13,18,46,88,109,3
1425,Max Kilman,Wolves,29.9,50,26,38,10,2,24,37,64.9,13,36,21,15,45,95,113,3
1426,Joshua Kimmich,Bayern Munich,27.5,39,20,14,17,8,18,58,31.0,40,34,8,26,52,91,29,1
1427,Presnel Kimpembe,Paris S-G,28.6,34,19,18,15,1,14,23,60.9,9,20,14,6,38,72,73,1
1428,Joshua King,Watford,25.0,19,15,7,6,6,4,17,23.5,13,15,4,11,8,27,31,0
1430,Jakub Kiwior,Spezia,21.8,50,27,25,19,6,26,57,45.6,31,38,15,23,40,90,53,0
1431,Sofian Kiyine,Venezia,13.8,24,14,9,11,4,12,32,37.5,20,15,1,14,10,34,9,0
1432,Simon Kjaer,Milan,8.9,20,12,9,8,3,6,12,50.0,6,17,13,4,9,29,39,0
1433,Kristoffer Klaesson,Leeds United,0.4,0,0,0,0,0,0,0,0.0,0,0,0,0,0,0,0,0
1434,Philipp Klement,Stuttgart,3.8,7,3,1,4,2,3,3,100.0,0,6,1,5,1,8,0,0
1435,Mateusz Klich,Leeds United,23.0,47,25,18,23,6,25,66,37.9,41,22,4,18,11,58,20,0
1436,Thibault Klidje,Bordeaux,1.0,0,0,0,0,0,0,1,0.0,1,1,1,0,2,2,0,0
1437,Mateo Klimowicz,Stuttgart,6.7,13,6,6,7,0,5,16,31.3,11,2,0,2,4,17,3,0
1438,Fabian Klos,Arminia,15.8,7,5,0,5,2,2,10,20.0,8,17,4,13,0,7,31,0
1439,Lukas Klostermann,RB Leipzig,18.3,29,16,11,15,3,13,19,68.4,6,16,3,13,26,55,58,0
1440,Justin Kluivert,Nice,20.8,19,9,6,12,1,5,21,23.8,16,13,1,12,14,33,6,0
1441,Lukas Klunter,Hertha BSC,2.2,1,1,1,0,0,1,5,20.0,4,1,0,1,2,3,2,0
1442,Ansgar Knauff,Dortmund,1.3,3,1,1,1,1,0,4,0.0,4,2,0,2,0,3,4,0
1443,Ansgar Knauff,Eint Frankfurt,8.4,18,14,8,5,5,8,15,53.3,7,11,1,10,8,26,6,0
1444,Robin Knoche,Union Berlin,33.0,50,24,38,12,0,30,53,56.6,23,45,26,19,49,99,151,1
1445,Gregor Kobel,Dortmund,28.5,0,0,0,0,0,0,2,0.0,2,0,0,0,1,1,20,0
1446,Robin Koch,Leeds United,17.5,21,13,9,10,2,9,34,26.5,25,26,10,16,20,41,44,0
1447,Samuel Koeberle,Reims,0.0,0,0,0,0,0,0,0,0.0,0,0,0,0,0,0,0,0
1448,Philippe Koffi,Reims,4.2,4,0,0,3,1,0,2,0.0,2,2,1,1,3,7,3,0
1449,Dominik Kohr,Mainz 05,17.9,40,20,18,19,3,16,42,38.1,26,21,2,19,35,75,22,0
1450,Koba Koindredi,Valencia,2.0,4,3,2,1,1,2,6,33.3,4,3,0,3,4,8,5,0
1451,Koke,Atlético Madrid,27.9,55,30,19,29,7,26,63,41.3,37,21,5,16,24,79,31,1
1452,Aleksandr Kokorin,Fiorentina,0.6,1,1,1,0,0,0,0,0.0,0,1,0,1,0,1,0,0
1453,Aleksandar Kolarov,Inter,0.5,1,1,1,0,0,1,1,100.0,0,0,0,0,1,2,2,0
1454,Sead Kolasinac,Arsenal,1.0,0,0,0,0,0,0,0,0.0,0,0,0,0,4,4,1,0
1456,Sead Kolasinac,Marseille,4.9,7,6,2,3,2,5,8,62.5,3,4,0,4,0,7,7,1
1457,Luca Koleosho,Espanyol,0.0,0,0,0,0,0,0,0,0.0,0,0,0,0,0,0,0,0
1458,Randal Kolo Muani,Nantes,32.8,28,14,7,10,11,10,25,40.0,15,14,3,11,6,34,31,0
1459,Timothee Kolodziejczak,Saint-Étienne,28.5,43,24,22,14,7,20,36,55.6,16,29,7,22,60,103,72,1
1460,Ghislain Konan,Reims,26.9,35,19,19,15,1,16,30,53.3,14,35,8,27,28,63,45,0
1461,Ibrahima Konate,Liverpool,11.0,16,10,9,6,1,7,10,70.0,3,13,9,4,16,32,37,1
1462,Geoffrey Kondogbia,Atlético Madrid,20.9,74,44,25,40,9,21,49,42.9,28,16,5,11,44,118,24,0
1463,Ibrahima Kone,Lorient,8.1,7,4,0,3,4,2,3,66.7,1,8,3,5,1,8,3,0
1464,Kouadio Kone,M'Gladbach,24.3,60,37,29,28,3,25,42,59.5,17,27,4,23,34,94,12,0
1465,Youssouf Kone,Troyes,10.9,30,18,21,8,1,19,30,63.3,11,8,3,5,10,40,25,0
1466,Ezri Konsa,Aston Villa,27.5,25,15,13,11,1,10,13,76.9,3,31,22,9,15,40,86,2
1467,Teun Koopmeiners,Atalanta,23.6,40,24,10,19,11,22,54,40.7,32,31,2,29,15,55,19,0
1468,Laurent Koscielny,Bordeaux,10.4,14,9,10,3,1,8,13,61.5,5,17,12,5,12,26,39,0
1469,Odilon Kossonou,Leverkusen,19.9,23,17,16,6,1,15,25,60.0,10,36,14,22,26,49,66,0
1470,Filip Kostic,Eint Frankfurt,28.0,44,17,26,9,9,20,53,37.7,33,24,1,23,15,59,24,0
1471,Rominigue Kouame,Troyes,33.0,47,22,24,20,3,19,58,32.8,39,33,5,28,46,93,22,2
1472,Kalidou Koulibaly,Napoli,26.7,39,23,31,6,2,25,38,65.8,13,41,25,16,29,68,90,1
1473,Jules Kounde,Sevilla,30.4,40,17,27,10,3,18,28,64.3,10,33,18,15,21,61,101,2
1474,Christos Kourfalidis,Cagliari,0.2,0,0,0,0,0,0,1,0.0,1,1,0,1,0,0,0,0
1475,Boubakar Kouyate,Metz,29.6,84,50,56,28,0,48,77,62.3,29,63,33,30,79,163,217,3
1476,Cheikhou Kouyate,Crystal Palace,21.9,52,38,28,22,2,18,39,46.2,21,40,14,26,38,90,39,0
1477,Mateo Kovacic,Chelsea,17.3,51,31,14,26,11,17,35,48.6,18,19,4,15,7,58,9,1
1478,Viktor Kovalenko,Spezia,14.7,16,10,7,8,1,9,21,42.9,12,16,3,13,13,29,8,0
1479,Emil Krafth,Newcastle Utd,18.2,37,16,25,11,1,27,36,75.0,9,16,10,6,25,62,56,0
1480,Alex Kral,West Ham,0.0,0,0,0,0,0,0,0,0.0,0,0,0,0,0,0,0,0
1482,Andrej Kramaric,Hoffenheim,30.1,8,4,1,5,2,7,17,41.2,10,10,0,10,9,17,7,1
1483,Christoph Kramer,M'Gladbach,8.3,28,11,15,10,3,12,28,42.9,16,18,5,13,12,40,9,0
1484,Jean-Philippe Krasso,Saint-Étienne,5.0,7,5,0,5,2,2,10,20.0,8,7,1,6,0,7,1,0
1485,Julian Kristoffersen,Salernitana,0.1,0,0,0,0,0,0,0,0.0,0,0,0,0,0,0,0,0
1486,Toni Kroos,Real Madrid,23.4,34,26,13,17,4,14,36,38.9,22,16,3,13,12,46,13,1
1487,Florian Kruger,Arminia,12.5,3,1,0,3,0,2,10,20.0,8,12,1,11,2,5,13,0
1488,Tim Krul,Norwich City,29.0,1,1,1,0,0,1,4,25.0,3,0,0,0,0,1,10,4
1489,Rade Krunic,Milan,15.7,33,18,16,14,3,15,31,48.4,16,19,2,17,16,49,17,0
1490,Max Kruse,Wolfsburg,12.5,9,3,4,4,1,5,12,41.7,7,2,0,2,3,12,4,0
1491,Max Kruse,Union Berlin,14.1,4,1,0,3,1,2,16,12.5,14,12,0,12,3,7,2,0
1492,Lukas Kubler,Freiburg,25.9,62,35,38,16,8,28,49,57.1,21,24,8,16,44,106,70,0
1493,Takefusa Kubo,Mallorca,17.8,31,19,12,14,5,10,24,41.7,14,24,3,21,8,39,4,0
1494,Juraj Kucka,Watford,21.3,59,39,32,25,2,27,73,37.0,46,30,9,21,27,86,46,2
1495,Mykola Kukharevych,Troyes,0.2,0,0,0,0,0,0,0,0.0,0,0,0,0,0,0,0,0
1496,Dejan Kulusevski,Tottenham,14.0,19,13,7,10,2,5,23,21.7,18,14,0,14,13,32,3,0
1497,Dejan Kulusevski,Juventus,8.6,15,12,9,6,0,8,21,38.1,13,14,0,14,5,20,5,0
1498,Marash Kumbulla,Roma,11.4,21,13,13,7,1,8,15,53.3,7,17,8,9,16,37,26,0
1499,Fabian Kunze,Arminia,14.0,35,21,14,20,1,15,32,46.9,17,17,2,15,19,54,27,1
1500,Enock Kwateng,Bordeaux,22.2,54,35,31,19,4,33,72,45.8,39,17,4,13,43,97,48,1
1501,Grejohn Kyei,Clermont Foot,4.4,3,2,1,1,1,0,6,0.0,6,6,0,6,0,3,1,0
1502,Giorgos Kyriakopoulos,Sassuolo,21.9,30,14,19,7,4,19,38,50.0,19,32,9,23,11,41,52,0
1503,Andrea La Mantia,Empoli,5.4,2,0,0,0,2,1,2,50.0,1,3,1,2,1,3,6,0
1504,Gaetan Laborde,Montpellier,3.8,2,2,1,1,0,2,4,50.0,2,3,0,3,5,7,5,0
1505,Gaetan Laborde,Rennes,30.3,19,7,5,8,6,3,22,13.6,19,29,3,26,8,27,16,0
1506,Alexandre Lacazette,Arsenal,19.8,27,10,8,13,6,7,21,33.3,14,12,1,11,5,32,6,0
1508,Tom Lacoux,Bordeaux,10.1,18,13,11,5,2,9,24,37.5,15,14,4,10,9,27,20,1
1509,Lenny Lacroix,Metz,2.2,9,7,8,1,0,5,8,62.5,3,5,1,4,10,19,5,0
1510,Maxence Lacroix,Wolfsburg,27.7,59,33,41,16,2,29,40,72.5,11,35,16,19,60,119,144,0
1511,Alban Lafont,Nantes,38.0,3,3,3,0,0,3,8,37.5,5,1,0,1,1,4,25,2
1512,Victor Laguardia,Alavés,33.8,29,16,21,8,0,19,30,63.3,11,36,24,12,27,56,151,1
1513,Konrad Laimer,RB Leipzig,13.8,38,24,11,22,5,24,53,45.3,29,29,3,26,4,42,9,0
1514,Stefan Lainer,M'Gladbach,16.3,19,11,9,7,3,12,28,42.9,16,24,5,19,14,33,31,0
1515,Diego Lainez,Betis,1.6,1,1,0,1,0,0,3,0.0,3,3,0,3,1,2,0,0
1516,Adam Lallana,Brighton,17.3,34,17,14,14,6,12,41,29.3,29,16,6,10,16,50,13,1
1517,Vassilis Lambropoulos,Bochum,13.0,18,12,13,3,2,11,25,44.0,14,21,10,11,17,35,56,0
1518,Erik Lamela,Sevilla,11.3,31,18,12,14,5,10,29,34.5,19,11,0,11,5,36,3,0
1519,Mohamed Lamine Bayo,Clermont Foot,26.8,12,5,4,3,5,3,24,12.5,21,7,1,6,7,19,14,0
1520,Didier Lamkel Ze,Metz,6.7,3,1,1,0,2,1,3,33.3,2,3,1,2,1,4,7,0
1521,Sam Lammers,Atalanta,0.4,1,0,0,0,1,0,0,0.0,0,0,0,0,0,1,0,0
1522,Sam Lammers,Eint Frankfurt,5.7,4,4,0,2,2,2,6,33.3,4,9,2,7,2,6,4,0
1523,Tariq Lamptey,Brighton,17.3,36,25,14,17,5,15,25,60.0,10,13,3,10,21,57,23,0
1524,Manuel Lanzini,West Ham,19.8,28,15,10,11,7,10,35,28.6,25,16,0,16,19,47,10,0
1525,Aymeric Laporte,Manchester City,31.4,33,15,22,10,1,14,20,70.0,6,15,10,5,20,53,64,2
1526,Julien Laporte,Lorient,32.1,63,45,35,26,2,32,64,50.0,32,37,22,15,54,117,174,0
1527,Yasser Larouci,Troyes,3.8,6,5,2,4,0,3,3,100.0,0,1,0,1,7,13,5,0
1528,Kevin Lasagna,Hellas Verona,13.2,13,7,4,5,4,4,15,26.7,11,16,0,16,3,16,7,0
1529,Jamaal Lascelles,Newcastle Utd,22.9,15,7,9,5,1,4,12,33.3,8,38,28,10,22,37,121,1
1530,Bryan Lasme,Arminia,9.7,6,6,1,2,3,0,3,0.0,3,7,0,7,1,7,9,0
1531,Paul Lasne,Brest,9.4,26,12,6,16,4,8,18,44.4,10,11,2,9,24,50,10,0
1532,Juanmi Latasa,Real Madrid,0.1,0,0,0,0,0,0,0,0.0,0,0,0,0,0,0,0,0
1534,Toni Lato,Valencia,6.6,17,12,12,3,2,9,16,56.3,7,6,0,6,8,25,14,0
1535,Armand Lauriente,Lorient,27.5,33,18,9,16,8,11,30,36.7,19,27,2,25,15,48,3,0
1536,Darko Lazovic,Hellas Verona,30.7,36,23,20,8,8,21,39,53.8,18,28,4,24,19,55,49,1
1537,Manuel Lazzari,Lazio,18.5,28,14,13,15,0,16,26,61.5,10,10,2,8,12,40,16,1
1538,Theo Le Bris,Lorient,0.7,2,1,1,1,0,1,2,50.0,1,2,0,2,0,2,1,0
1539,Jeremy Le Douaron,Brest,16.1,11,5,4,4,3,1,17,5.9,16,15,0,15,4,15,14,0
1540,Enzo Le Fee,Lorient,24.4,70,44,25,36,9,41,90,45.6,49,25,1,24,29,99,18,0
1541,Vincent Le Goff,Lorient,34.0,61,38,38,19,4,37,62,59.7,25,18,3,15,37,98,50,0
1542,Maxime Le Marchand,Strasbourg,9.6,17,8,16,1,0,8,10,80.0,2,9,5,4,14,31,32,0
1543,Robin Le Normand,Real Sociedad,37.0,49,32,36,8,5,28,36,77.8,8,34,22,12,48,97,125,0
1544,Patrick Leal,Venezia,0.0,0,0,0,0,0,0,1,0.0,1,0,0,0,0,0,0,0
1545,Rafael Leao,Milan,28.9,17,7,3,9,5,10,20,50.0,10,12,1,11,12,29,8,0
1546,Jean-Louis Leca,Lens,25.7,0,0,0,0,0,0,0,0.0,0,1,0,1,1,1,11,1
1547,Jeremias Ledesma,Cádiz,38.0,3,1,3,0,0,3,4,75.0,1,0,0,0,1,4,21,4
1548,Pierre Lees-Melou,Norwich City,25.2,58,36,23,29,6,25,92,27.2,67,37,11,26,25,83,23,0
1549,Wu Lei,Espanyol,5.3,3,2,1,2,0,3,8,37.5,5,4,0,4,4,7,3,0
1550,Maxim Leitsch,Bochum,17.1,18,10,9,7,2,10,15,66.7,5,31,19,12,31,49,74,1
1551,Lucas Leiva,Lazio,18.9,55,30,26,25,4,15,53,28.3,38,27,10,17,28,83,37,0
1552,Florian Lejeune,Alavés,30.0,33,24,22,10,1,12,20,60.0,8,30,19,11,31,64,158,0
1553,Inigo Lekue,Athletic Club,21.4,32,23,16,12,4,22,44,50.0,22,37,12,25,23,55,63,0
1554,Thomas Lemar,Atlético Madrid,16.0,24,14,9,12,3,8,23,34.8,15,18,0,18,8,32,11,0
1555,Felix Lemarechal,Monaco,0.1,0,0,0,0,0,0,1,0.0,1,0,0,0,0,0,0,0
1556,Mario Lemina,Nice,21.9,62,35,25,33,4,28,38,73.7,10,32,9,23,48,110,37,0
1557,Fabien Lemoine,Lorient,12.4,35,22,20,14,1,17,41,41.5,24,21,4,17,14,49,24,1
1558,Tim Lemperle,Köln,1.7,4,1,2,1,1,1,3,33.3,2,1,0,1,2,6,2,0
1560,Ruben Lendinez,Valencia,1.5,3,3,1,2,0,3,8,37.5,5,4,0,4,2,5,6,0
1561,Clement Lenglet,Barcelona,9.2,20,11,11,7,2,8,13,61.5,5,7,3,4,13,33,21,0
1562,Aaron Lennon,Burnley,17.2,33,17,10,13,10,10,34,29.4,24,26,4,22,9,42,14,0
1563,Bernd Leno,Arsenal,4.0,1,1,1,0,0,1,1,100.0,0,0,0,0,0,1,1,0
1564,Christopher Lenz,Eint Frankfurt,7.4,29,15,22,6,1,12,21,57.1,9,9,4,5,7,36,21,0
1565,Leo Leroy,Montpellier,7.0,31,21,17,11,3,12,34,35.3,22,20,4,16,8,39,8,0
1566,Alexandre Letellier,Paris S-G,0.1,0,0,0,0,0,0,0,0.0,0,0,0,0,0,0,0,0
1567,Robert Lewandowski,Bayern Munich,32.7,10,3,0,6,4,5,17,29.4,12,17,2,15,6,16,8,0
1568,Jamie Leweling,Greuther Fürth,21.8,13,8,3,7,3,3,16,18.8,13,9,0,9,13,26,5,0
1569,Jamal Lewis,Newcastle Utd,2.9,8,6,6,1,1,3,4,75.0,1,3,2,1,3,11,8,0
1570,Luca Lezzerini,Venezia,5.5,0,0,0,0,0,0,0,0.0,0,1,0,1,0,0,0,0
1571,Ben Lhassine Kone,Torino,0.9,3,3,1,2,0,1,2,50.0,1,0,0,0,1,4,1,0
1572,Yanis Lhery,Saint-Étienne,0.8,0,0,0,0,0,0,0,0.0,0,4,0,4,0,0,0,0
1573,Dimitri Lienard,Strasbourg,22.7,71,43,40,21,10,46,77,59.7,31,12,0,12,21,92,28,0
1574,Philipp Lienhart,Freiburg,31.9,24,13,17,6,1,13,24,54.2,11,33,23,10,50,74,158,1
1575,Matthijs de Ligt,Juventus,29.7,34,19,21,13,0,15,18,83.3,3,31,21,10,26,60,103,0
1576,Isaac Lihadji,Lille,2.6,3,3,1,1,1,1,5,20.0,4,1,0,1,2,5,0,0
1577,Anderson Lima,Lazio,0.7,2,0,1,1,0,0,2,0.0,2,1,0,1,2,4,1,0
1578,Andreas Linde,Greuther Fürth,12.0,0,0,0,0,0,0,0,0.0,0,0,0,0,1,1,1,1
1579,Victor Lindelof,Manchester Utd,26.2,16,11,9,7,0,9,14,64.3,5,26,17,9,25,41,96,0
1580,Jesper Lindstrom,Eint Frankfurt,22.0,28,13,6,13,9,12,36,33.3,24,30,0,30,24,52,11,1
1581,Karol Linetty,Torino,10.0,14,8,3,4,7,6,18,33.3,12,8,0,8,3,17,2,0
1582,Jesse Lingard,Manchester Utd,4.1,9,7,4,3,2,2,6,33.3,4,4,0,4,0,9,1,0
1583,Pol Lirola,Marseille,19.7,28,16,15,9,4,13,28,46.4,15,15,0,15,13,41,22,0
1584,Valentino Livramento,Southampton,24.5,54,28,30,18,6,27,45,60.0,18,23,9,14,47,101,50,1
1586,Dejan Ljubicic,Köln,21.9,33,19,12,13,8,13,49,26.5,36,19,1,18,15,48,11,0
1587,Javier Llabres,Mallorca,1.5,2,1,0,1,1,1,2,50.0,1,1,0,1,0,2,0,0
1588,Diego Llorente,Leeds United,26.0,53,31,32,19,2,33,47,70.2,14,35,17,18,40,93,77,2
1589,Marcos Llorente,Atlético Madrid,27.2,51,23,25,22,4,28,43,65.1,15,33,10,23,27,78,44,0
1590,Hugo Lloris,Tottenham,38.0,1,1,1,0,0,1,2,50.0,1,0,0,0,1,2,24,3
1591,Giovani Lo Celso,Tottenham,2.6,8,4,4,2,2,4,10,40.0,6,6,1,5,1,9,0,1
1592,Giovani Lo Celso,Villarreal,11.0,22,12,8,10,4,9,22,40.9,13,4,0,4,5,27,3,0
1593,Julen Lobete,Real Sociedad,3.2,4,3,3,0,1,1,2,50.0,1,6,1,5,1,5,1,0
1594,Stanislav Lobotka,Napoli,18.7,39,24,16,20,3,14,36,38.9,22,9,1,8,12,51,13,1
1595,Jurgen Locadia,Brighton,0.3,0,0,0,0,0,0,0,0.0,0,0,0,0,0,0,0,0
1596,Jurgen Locadia,Bochum,4.9,4,2,1,0,3,1,1,100.0,0,1,0,1,1,5,2,0
1597,Manuel Locatelli,Juventus,24.0,44,25,21,16,7,21,47,44.7,26,43,21,22,22,66,33,0
1598,Bradley Locko,Reims,11.2,28,19,13,11,4,14,24,58.3,10,20,8,12,14,42,15,0
1599,Renan Lodi,Atlético Madrid,13.1,31,18,14,13,4,11,27,40.7,16,22,4,18,13,44,19,1
1600,Ruben Loftus-Cheek,Chelsea,15.5,29,10,16,11,2,10,19,52.6,9,15,6,9,11,40,17,0
1601,Kevin Long,Burnley,4.6,3,2,1,2,0,1,2,50.0,1,4,1,3,1,4,20,0
1602,Shane Long,Southampton,3.4,9,5,2,4,3,1,1,100.0,0,4,0,4,0,9,2,0
1603,Sean Longstaff,Newcastle Utd,16.3,54,34,18,31,5,24,65,36.9,41,18,6,12,9,63,18,0
1604,Ademola Lookman,Leicester City,16.1,32,14,10,13,9,10,28,35.7,18,19,1,18,10,42,4,0
1605,Anthony Lopes,Lyon,33.1,0,0,0,0,0,0,0,0.0,0,0,0,0,3,3,12,3
1606,David Lopez,Espanyol,8.3,18,13,9,8,1,9,16,56.3,7,10,8,2,10,28,25,2
1607,Diego Lopez,Espanyol,35.3,0,0,0,0,0,0,2,0.0,2,0,0,0,1,1,21,1
1608,Javi Lopez,Alavés,5.1,8,6,6,2,0,4,6,66.7,2,7,1,6,4,12,15,0
1609,Maxime Lopez,Sassuolo,32.6,69,36,40,27,2,35,87,40.2,52,33,7,26,42,111,38,1
1610,Pau Lopez,Marseille,29.0,0,0,0,0,0,0,1,0.0,1,0,0,0,0,0,12,1
1612,Unai Lopez,Rayo Vallecano,12.9,19,9,6,10,3,10,33,30.3,23,7,0,7,10,29,8,1
1613,Dion Lopy,Reims,18.2,53,29,22,24,7,21,53,39.6,32,20,4,16,22,75,17,0
1614,Samuel Loric,Lorient,3.0,7,5,2,3,2,5,8,62.5,3,2,0,2,5,12,9,0
1615,Anthony Losilla,Bochum,32.6,65,39,29,30,6,34,69,49.3,35,32,9,23,70,135,53,1
1616,Jonas Lossl,Brentford,2.0,0,0,0,0,0,0,0,0.0,0,0,0,0,0,0,1,0
1617,Marcel Lotka,Hertha BSC,9.8,1,0,1,0,0,1,1,100.0,0,0,0,0,1,2,3,3
1618,Jordan Lotomba,Nice,19.8,33,17,21,9,3,16,30,53.3,14,17,4,13,12,45,28,0
1619,Johaneko Louisjean,Bordeaux,0.1,0,0,0,0,0,0,0,0.0,0,0,0,0,0,0,0,0
1620,Imran Louza,Watford,15.7,41,21,18,20,3,16,38,42.1,22,28,6,22,42,83,20,1
1621,Matteo Lovato,Atalanta,3.4,5,4,4,1,0,0,1,0.0,1,4,2,2,7,12,8,0
1622,Matteo Lovato,Cagliari,13.8,23,15,13,10,0,8,20,40.0,12,21,10,11,28,51,43,0
1623,Eduard Lowen,Bochum,15.7,28,22,12,11,5,10,43,23.3,33,17,2,15,9,37,15,1
1624,Matthew Lowton,Burnley,19.7,38,24,20,10,8,20,37,54.1,17,25,11,14,26,64,68,0
1625,Anthony Lozano,Cádiz,18.6,8,4,2,3,3,5,18,27.8,13,16,2,14,2,10,7,0
1626,Hirving Lozano,Napoli,17.9,28,20,12,11,5,8,30,26.7,22,24,0,24,9,37,9,0
1627,Jean Lucas,Monaco,16.1,43,25,14,24,5,17,40,42.5,23,15,5,10,13,56,4,1
1628,Anderson Lucoqui,Mainz 05,8.3,22,10,11,6,5,11,22,50.0,11,15,3,12,11,33,10,0
1629,Florentino Luis,Getafe,11.0,42,25,22,17,3,17,35,48.6,18,21,2,19,21,63,11,1
1630,Jose Luis Gaya,Valencia,20.8,35,21,24,10,1,16,34,47.1,18,17,3,14,19,54,37,0
1631,Jose Luis Morales,Levante,30.2,27,17,6,9,12,12,42,28.6,30,29,0,29,4,31,7,0
1632,Jose Luis Palomino,Atalanta,29.7,78,40,42,33,3,32,50,64.0,18,43,21,22,100,178,80,2
1633,Luismi,Sevilla,0.1,0,0,0,0,0,0,0,0.0,0,0,0,0,0,0,0,0
1634,Douglas Luiz,Aston Villa,30.2,59,39,30,24,5,21,72,29.2,51,30,7,23,34,93,28,1
1635,Romelu Lukaku,Chelsea,17.7,2,1,0,1,1,1,5,20.0,4,11,1,10,0,2,20,0
1636,Castello Lukeba,Lyon,23.3,34,19,27,7,0,15,23,65.2,8,18,9,9,38,72,64,2
1638,Dodi Lukebakio,Hertha BSC,2.0,2,1,2,0,0,1,3,33.3,2,2,0,2,2,4,0,0
1639,Dodi Lukebakio,Wolfsburg,9.8,7,4,3,2,2,1,10,10.0,9,5,0,5,13,20,4,0
1640,Sasa Lukic,Torino,33.1,51,34,17,27,7,19,43,44.2,24,34,6,28,24,75,41,0
1641,Levi Lumeka,Troyes,0.7,0,0,0,0,0,0,2,0.0,2,0,0,0,0,0,2,0
1642,Andriy Lunin,Real Madrid,2.0,0,0,0,0,0,0,0,0.0,0,0,0,0,0,0,2,0
1643,Andrey Lunyov,Leverkusen,1.0,0,0,0,0,0,0,0,0.0,0,0,0,0,0,0,0,0
1644,Sebastiano Luperto,Empoli,21.8,29,17,17,10,2,10,20,50.0,10,32,26,6,45,74,132,0
1645,Andreas Luthe,Union Berlin,27.0,0,0,0,0,0,0,1,0.0,1,0,0,0,0,0,11,4
1646,Lyanco,Southampton,10.1,18,15,11,7,0,10,18,55.6,8,18,13,5,13,31,50,1
1647,Charalambos Lykogiannis,Cagliari,20.2,19,12,16,1,2,11,20,55.0,9,18,8,10,31,50,73,0
1648,Yannis M'Bemba,Nantes,0.1,0,0,0,0,0,0,0,0.0,0,0,0,0,0,0,1,0
1649,Alexis Mac Allister,Brighton,23.6,65,40,23,30,12,29,68,42.6,39,37,7,30,13,78,22,0
1650,Deiver Machado,Lens,5.8,16,14,11,1,4,12,14,85.7,2,9,1,8,3,19,12,1
1651,Darwin Machis,Granada,15.3,23,13,11,8,4,9,23,39.1,14,10,0,10,15,38,17,0
1652,Yvann Macon,Saint-Étienne,17.0,41,22,24,14,3,16,42,38.1,26,18,4,14,18,59,27,0
1653,James Maddison,Leicester City,27.3,40,20,8,24,8,14,46,30.4,32,18,3,15,11,51,12,0
1654,Niki Maenpaa,Venezia,16.5,0,0,0,0,0,0,0,0.0,0,0,0,0,0,0,8,2
1655,Pablo Maffeo,Mallorca,32.7,84,47,48,28,8,38,69,55.1,31,30,13,17,46,130,74,0
1656,Louis Mafouta,Metz,5.8,0,0,0,0,0,0,5,0.0,5,1,0,1,0,0,4,0
1657,Giulio Maggiore,Spezia,31.3,58,32,20,32,6,31,77,40.3,46,30,5,25,29,87,33,0
1658,Matej Maglica,Stuttgart,0.1,0,0,0,0,0,0,1,0.0,1,0,0,0,0,0,0,0
1659,Francesco Magnanelli,Sassuolo,3.0,5,4,4,1,0,1,9,11.1,8,3,1,2,1,6,3,0
1660,Giangiacomo Magnani,Hellas Verona,5.9,10,7,5,5,0,8,16,50.0,8,5,3,2,10,20,46,0
1661,Giangiacomo Magnani,Sampdoria,2.7,4,2,4,0,0,1,1,100.0,0,2,2,0,7,11,12,0
1662,Hugo Magnetti,Brest,16.3,50,34,27,20,3,22,50,44.0,28,14,3,11,25,75,13,0
1664,Yohann Magnin,Clermont Foot,19.1,53,31,22,26,5,24,42,57.1,18,17,7,10,20,73,36,0
1665,Harry Maguire,Manchester Utd,27.9,34,21,22,8,4,19,31,61.3,12,36,29,7,32,66,101,3
1666,Riyad Mahrez,Manchester City,16.6,11,3,5,4,2,5,19,26.3,14,15,1,14,6,17,6,0
1667,Arne Maier,Augsburg,20.7,20,13,6,10,4,8,26,30.8,18,18,1,17,15,35,13,0
1668,Habib Maiga,Metz,14.1,47,28,29,13,5,24,48,50.0,24,20,7,13,14,61,18,0
1669,Mike Maignan,Milan,32.0,2,1,2,0,0,2,2,100.0,0,0,0,0,1,3,4,2
1670,Ainsley Maitland-Niles,Arsenal,3.0,8,4,5,3,0,2,4,50.0,2,2,0,2,4,12,4,0
1671,Ainsley Maitland-Niles,Roma,5.4,8,6,5,0,3,5,14,35.7,9,7,0,7,6,14,7,0
1672,Josh Maja,Bordeaux,0.1,0,0,0,0,0,0,0,0.0,0,1,0,1,0,0,0,0
1673,Abdul Majeed Waris,Strasbourg,3.6,5,3,2,3,0,5,10,50.0,5,2,0,2,0,5,1,0
1674,Lovro Majer,Rennes,20.4,32,21,9,14,9,11,42,26.2,31,26,2,24,11,43,9,0
1675,Jean-Victor Makengo,Udinese,26.1,30,21,7,17,6,15,29,51.7,14,26,6,20,19,49,17,0
1676,Beni Makouana,Montpellier,3.6,2,2,0,0,2,0,1,0.0,1,1,0,1,3,5,2,0
1677,Nemanja Maksimovic,Getafe,32.6,56,32,24,26,6,18,49,36.7,31,42,13,29,71,127,41,0
1678,Nikola Maksimovic,Genoa,12.4,14,6,10,4,0,7,9,77.8,2,17,11,6,12,26,61,1
1679,Kevin Malcuit,Napoli,3.2,4,2,4,0,0,2,2,100.0,0,3,0,3,8,12,6,0
1680,Daniel Maldini,Milan,1.6,8,3,4,3,1,2,6,33.3,4,4,0,4,1,9,0,0
1681,Youssef Maleh,Fiorentina,11.3,27,16,8,13,6,12,25,48.0,13,14,1,13,6,33,2,0
1682,Donyell Malen,Dortmund,18.7,13,10,4,5,4,7,13,53.8,6,10,0,10,10,23,11,0
1683,Ruslan Malinovskyi,Atalanta,17.7,18,10,3,10,5,5,19,26.3,14,27,3,24,5,23,1,0
1684,Hugo Mallo,Celta Vigo,20.3,45,25,24,19,2,16,31,51.6,15,23,9,14,20,65,53,0
1685,Lennard Maloney,Dortmund,0.1,1,0,1,0,0,1,1,100.0,0,0,0,0,0,1,0,0
1686,Mickael Malsa,Levante,12.7,37,17,16,18,3,15,42,35.7,27,20,8,12,18,55,15,0
1687,Giorgi Mamardashvili,Valencia,18.0,0,0,0,0,0,0,0,0.0,0,0,0,0,0,0,6,1
1688,Rey Manaj,Spezia,19.6,19,12,3,11,5,6,26,23.1,20,16,0,16,4,23,13,0
1690,Hianga Mananga Mbock,Brest,8.9,18,12,8,7,3,9,21,42.9,12,5,2,3,5,23,6,0
1691,Vincent Manceau,Angers,26.2,32,19,18,13,1,14,37,37.8,23,23,6,17,32,64,72,0
1692,Gianluca Mancini,Roma,32.0,41,25,22,18,1,18,33,54.5,15,38,19,19,39,80,69,0
1693,Leonardo Mancuso,Empoli,4.7,1,1,0,1,0,0,6,0.0,6,2,0,2,1,2,2,0
1694,Steve Mandanda,Marseille,9.0,0,0,0,0,0,0,1,0.0,1,1,0,1,1,1,4,1
1695,Reinildo Mandava,Atlético Madrid,14.4,45,25,30,14,1,22,30,73.3,8,18,9,9,21,66,38,0
1696,Reinildo Mandava,Lille,16.9,43,23,29,11,3,32,51,62.7,19,13,4,9,37,80,55,0
1697,Aissa Mandi,Villarreal,15.3,11,5,2,8,1,3,6,50.0,3,17,14,3,13,24,49,3
1698,Rolando Mandragora,Torino,14.7,21,10,3,16,2,12,21,57.1,9,18,4,14,10,31,13,0
1699,Anthony Mandrea,Angers,10.0,0,0,0,0,0,0,0,0.0,0,0,0,0,0,0,9,0
1700,Sadio Mane,Liverpool,31.3,33,20,7,14,12,8,26,30.8,18,30,1,29,8,41,15,0
1701,Eliaquim Mangala,Saint-Étienne,13.1,17,12,12,5,0,8,12,66.7,4,11,8,3,17,34,61,1
1702,Orel Mangala,Stuttgart,20.6,17,10,5,7,5,11,22,50.0,11,11,4,7,12,29,19,1
1703,Thomas Mangani,Angers,24.4,58,30,23,34,1,31,68,45.6,37,38,11,27,36,94,29,0
1704,Ricardo Mangas,Bordeaux,26.1,35,22,22,8,5,26,41,63.4,15,18,4,14,25,60,47,3
1705,Kostas Manolas,Napoli,3.5,2,2,1,1,0,2,3,66.7,1,2,1,1,4,6,10,1
1706,Javier Manquillo,Newcastle Utd,14.0,39,29,28,10,1,21,36,58.3,15,15,6,9,10,49,32,0
1707,Myziane Maolida,Nice,0.4,1,0,0,1,0,0,0,0.0,0,1,0,1,0,1,0,0
1708,Myziane Maolida,Hertha BSC,8.6,7,4,5,1,1,3,9,33.3,6,5,0,5,1,8,6,0
1709,Sekou Mara,Bordeaux,10.1,8,4,1,1,6,1,8,12.5,7,7,0,7,2,10,6,0
1710,Nikola Maras,Rayo Vallecano,11.6,13,9,12,1,0,9,15,60.0,6,17,13,4,15,28,51,0
1711,Fernando Marcal,Wolves,16.1,42,22,27,14,1,21,37,56.8,16,25,4,21,28,70,52,0
1712,Marcelo,Real Madrid,5.8,8,4,2,3,3,5,10,50.0,5,7,2,5,1,9,11,0
1713,Marcelo,Bordeaux,10.0,9,5,7,2,0,4,6,66.7,2,4,3,1,13,22,46,1
1714,Marcelo,Lyon,2.0,4,3,0,4,0,4,6,66.7,2,3,2,1,4,8,10,0
1716,Solly March,Brighton,19.4,30,17,11,9,10,7,22,31.8,15,22,3,19,17,47,25,0
1717,Riccardo Marchizza,Empoli,15.0,21,15,11,8,2,11,16,68.8,5,15,6,9,10,31,24,0
1718,Gian Marco Ferrari,Sassuolo,34.7,16,11,10,6,0,10,23,43.5,13,37,27,10,43,59,114,2
1719,Ivan Marcone,Elche,9.0,24,14,17,6,1,12,24,50.0,12,8,3,5,12,36,13,0
1720,Oscar de Marcos,Athletic Club,18.7,50,37,24,19,7,28,43,65.1,15,20,3,17,19,69,27,0
1721,Davide Marfella,Napoli,0.1,0,0,0,0,0,0,0,0.0,0,0,0,0,0,0,0,0
1722,Jose Mari,Cádiz,4.3,14,7,3,10,1,7,8,87.5,1,4,1,3,7,21,2,0
1723,Pablo Mari,Arsenal,2.0,5,3,1,3,1,3,6,50.0,3,5,4,1,3,8,10,0
1724,Pablo Mari,Udinese,14.9,16,8,8,6,2,8,16,50.0,8,18,12,6,21,37,72,0
1725,Jose Maria Gimenez,Atlético Madrid,22.7,18,12,12,6,0,8,16,50.0,8,25,19,6,25,43,96,1
1726,Mariano,Real Madrid,3.8,2,0,2,0,0,0,0,0.0,0,2,0,2,1,3,3,0
1727,Razvan Marin,Cagliari,31.3,42,21,16,22,4,24,54,44.4,30,23,5,18,10,52,17,1
1728,Guillermo Maripan,Monaco,20.4,36,24,27,9,0,20,40,50.0,20,21,14,7,25,61,66,1
1729,Mika Marmol,Barcelona,0.0,0,0,0,0,0,0,0,0.0,0,0,0,0,0,0,0,0
1730,Omar Marmoush,Wolfsburg,0.3,0,0,0,0,0,0,0,0.0,0,0,0,0,0,0,0,0
1731,Omar Marmoush,Stuttgart,17.5,26,17,6,14,6,4,20,20.0,16,9,1,8,7,33,6,0
1732,Marquinhos,Paris S-G,31.8,37,14,25,11,1,20,35,57.1,15,35,19,16,16,53,102,0
1733,Roger Marti,Levante,23.5,23,14,3,13,7,8,30,26.7,22,14,0,14,2,25,8,0
1734,Anthony Martial,Manchester Utd,2.4,0,0,0,0,0,0,1,0.0,1,1,0,1,0,0,1,0
1735,Anthony Martial,Sevilla,5.4,2,1,0,0,2,2,6,33.3,4,4,0,4,0,2,3,0
1736,Martin,Cádiz,1.3,2,2,0,2,0,0,0,0.0,0,1,0,1,1,3,3,0
1737,Aaron Martin,Mainz 05,25.5,54,33,32,18,4,24,55,43.6,31,24,4,20,20,74,35,0
1738,Ander Martin,Real Sociedad,1.0,1,0,0,1,0,1,1,100.0,0,0,0,0,3,4,1,0
1739,Andres Martin,Rayo Vallecano,2.1,0,0,0,0,0,0,1,0.0,1,1,0,1,0,0,0,0
1740,Carlos Martin,Atlético Madrid,0.1,0,0,0,0,0,0,0,0.0,0,0,0,0,0,0,1,0
1742,Ivan Martin,Alavés,1.8,1,1,1,0,0,0,1,0.0,1,2,0,2,1,2,1,0
1743,Jonas Martin,Rennes,23.4,35,20,12,21,2,19,53,35.8,34,17,3,14,22,57,28,1
1744,Gabriel Martinelli,Arsenal,20.7,27,19,7,14,6,10,29,34.5,19,26,1,25,20,47,15,0
1745,Emiliano Martinez,Aston Villa,36.0,1,1,1,0,0,1,3,33.3,2,0,0,0,0,1,6,1
1746,Inigo Martinez,Athletic Club,26.0,28,13,18,7,3,14,23,60.9,9,22,10,12,39,67,143,0
1747,Javi Martinez,Osasuna,9.8,21,14,8,11,2,10,29,34.5,19,6,0,6,9,30,10,0
1748,Josep Martinez,RB Leipzig,1.0,0,0,0,0,0,0,0,0.0,0,0,0,0,0,0,0,0
1749,Lautaro Martinez,Inter,25.4,20,10,3,10,7,6,11,54.5,5,21,1,20,18,38,6,0
1750,Pablo Martinez,Levante,7.3,15,8,7,8,0,4,13,30.8,9,6,3,3,15,30,5,0
1751,Lucas Martinez Quarta,Fiorentina,15.9,36,25,23,11,2,21,34,61.8,13,22,9,13,19,55,46,0
1752,Gelson Martins,Monaco,21.2,42,27,10,26,6,21,59,35.6,38,26,1,25,17,59,4,0
1753,Adam Marusic,Lazio,30.2,30,18,16,12,2,13,32,40.6,19,19,8,11,41,71,71,0
1754,Omar Mascarell,Elche,27.7,46,26,16,23,7,24,60,40.0,36,42,14,28,48,94,52,2
1755,Andrea Masiello,Genoa,5.7,5,3,4,1,0,4,7,57.1,3,8,4,4,11,16,20,1
1756,Adam Masina,Watford,12.0,24,13,11,10,3,12,29,41.4,17,18,6,12,18,42,45,0
1757,Erhan Masovic,Bochum,17.2,35,20,21,13,1,21,33,63.6,12,28,19,9,34,69,64,1
1758,Roberto Massimo,Stuttgart,9.7,14,5,6,7,1,4,16,25.0,12,9,0,9,3,17,6,0
1759,Arthur Masuaku,West Ham,7.2,31,23,19,11,1,14,23,60.9,9,9,1,8,9,40,17,0
1760,Jaime Mata,Getafe,7.5,7,5,3,1,3,1,9,11.1,8,4,1,3,1,8,5,0
1761,Juan Mata,Manchester Utd,2.6,6,4,2,3,1,3,5,60.0,2,1,0,1,1,7,1,0
1762,Pape Matar Sarr,Metz,23.7,45,26,21,23,1,18,39,46.2,21,33,3,30,29,74,22,0
1763,Eliot Matazo,Monaco,8.8,8,7,4,4,0,2,11,18.2,9,11,3,8,13,21,9,0
1764,Ales Mateju,Venezia,8.1,16,12,10,5,1,13,29,44.8,16,10,6,4,9,25,15,0
1765,Jean-Philippe Mateta,Crystal Palace,12.7,8,4,2,5,1,3,18,16.7,15,11,3,8,4,12,13,0
1766,Nemanja Matic,Manchester Utd,15.4,31,18,19,11,1,15,31,48.4,16,21,6,15,31,62,21,3
1768,Joel Matip,Liverpool,31.0,47,34,23,19,5,20,31,64.5,11,26,14,12,44,91,93,1
1769,Chrislain Matsima,Monaco,1.5,3,2,1,2,0,2,7,28.6,5,3,3,0,1,4,6,1
1770,Azor Matusiwa,Reims,27.4,58,32,28,26,4,26,55,47.3,29,49,19,30,62,120,43,0
1771,Neal Maupay,Brighton,25.3,17,10,2,6,9,4,18,22.2,14,21,2,19,2,19,2,0
1772,Stephy Mavididi,Montpellier,25.5,24,13,11,7,6,14,39,35.9,25,23,2,21,8,32,11,0
1773,Konstantinos Mavropanos,Stuttgart,30.1,57,39,35,21,1,30,51,58.8,21,46,23,23,69,126,174,2
1774,Eric Maxim Choupo-Moting,Bayern Munich,4.2,10,9,3,6,1,3,10,30.0,7,1,0,1,5,15,2,0
1775,Luis Maximiano,Granada,34.8,3,1,3,0,0,3,6,50.0,3,0,0,0,1,4,16,2
1776,Borja Mayoral,Roma,1.1,0,0,0,0,0,0,0,0.0,0,0,0,0,0,0,0,0
1777,Borja Mayoral,Getafe,11.6,7,5,2,3,2,1,2,50.0,1,10,4,6,4,11,3,0
1778,Derek Mazou-Sacko,Troyes,0.0,1,0,0,0,1,1,1,100.0,0,0,0,0,0,1,1,0
1779,Pasquale Mazzocchi,Venezia,13.8,18,8,11,4,3,10,26,38.5,16,11,8,3,21,39,31,1
1780,Pasquale Mazzocchi,Salernitana,14.1,28,19,15,11,2,14,34,41.2,20,5,0,5,11,39,31,0
1781,Kevin Mbabu,Wolfsburg,15.5,31,20,21,5,5,12,23,52.2,11,25,8,17,35,66,35,0
1782,Kylian Mbappe,Paris S-G,33.6,11,8,1,4,6,7,13,53.8,6,6,0,6,5,16,13,0
1783,Ibrahima Mbaye,Bologna,1.2,1,1,1,0,0,1,2,50.0,1,1,1,0,1,2,6,0
1784,Amadou Mbengue,Metz,6.8,19,10,10,9,0,11,22,50.0,11,7,2,5,10,29,19,0
1785,Bryan Mbeumo,Brentford,32.3,28,16,1,12,15,6,20,30.0,14,21,6,15,11,39,20,0
1786,Jason Mbock,Angers,0.2,0,0,0,0,0,0,0,0.0,0,0,0,0,0,0,0,0
1787,Jordi Mboula,Mallorca,4.8,8,2,3,3,2,5,9,55.6,4,7,1,6,3,11,3,0
1788,Moustapha Mbow,Reims,1.0,6,6,3,2,1,3,3,100.0,0,0,0,0,1,7,6,0
1789,Nathanael Mbuku,Reims,15.8,14,13,4,7,3,2,8,25.0,6,14,0,14,11,25,4,0
1790,James McArthur,Crystal Palace,16.0,33,23,13,19,1,16,44,36.4,28,23,9,14,30,63,27,0
1791,James Mcatee,Manchester City,0.2,0,0,0,0,0,0,2,0.0,2,0,0,0,0,0,0,0
1792,Kasey McAteer,Leicester City,0.0,0,0,0,0,0,0,0,0.0,0,0,0,0,0,0,0,0
1794,Liam McCarron,Leeds United,0.1,0,0,0,0,0,0,0,0.0,0,1,0,1,0,0,0,0
1795,Alex McCarthy,Southampton,17.0,0,0,0,0,0,0,0,0.0,0,0,0,0,0,0,4,0
1796,John McGinn,Aston Villa,34.3,106,64,35,55,16,54,104,51.9,50,53,6,47,35,141,34,0
1797,Weston McKennie,Juventus,15.2,20,11,11,7,2,8,26,30.8,18,17,8,9,23,43,20,0
1798,Stuart McKinstry,Leeds United,0.0,0,0,0,0,0,0,0,0.0,0,0,0,0,0,0,0,0
1799,Kenny McLean,Norwich City,30.1,42,22,18,20,4,17,59,28.8,42,29,7,22,34,76,54,0
1800,Dwight McNeil,Burnley,34.5,78,49,27,38,13,33,73,45.2,40,64,11,53,35,113,31,1
1801,Scott McTominay,Manchester Utd,26.5,65,33,32,24,9,30,61,49.2,31,45,10,35,31,96,60,1
1802,Gary Medel,Bologna,31.4,39,23,27,11,1,16,36,44.4,20,30,21,9,44,83,112,0
1803,Facundo Medina,Lens,28.8,61,42,34,23,4,38,62,61.3,24,24,8,16,37,98,78,3
1804,Nathan de Medina,Arminia,8.6,17,10,11,6,0,6,10,60.0,4,14,3,11,10,27,28,0
1805,Ben Mee,Burnley,20.4,26,12,16,7,3,12,19,63.2,7,28,22,6,24,50,94,1
1806,Admir Mehmedi,Wolfsburg,0.0,0,0,0,0,0,0,0,0.0,0,0,0,0,0,0,0,0
1807,Hannibal Mejbri,Manchester Utd,0.8,2,1,1,1,0,1,1,100.0,0,0,0,0,0,2,0,0
1808,Farid El Melali,Angers,0.2,0,0,0,0,0,0,1,0.0,1,1,0,1,0,0,1,0
1809,Filippo Melegoni,Genoa,10.9,20,12,5,8,7,8,16,50.0,8,10,1,9,11,31,8,1
1810,Oscar Melendo,Espanyol,11.0,11,5,4,4,3,3,13,23.1,10,4,1,3,1,12,10,0
1811,Gonzalo Melero,Levante,18.8,29,16,10,15,4,16,36,44.4,20,21,8,13,7,36,22,0
1812,Birger Meling,Rennes,20.3,43,27,25,11,7,23,31,74.2,8,23,7,16,22,65,40,0
1813,Arthur Melo,Juventus,10.7,25,12,10,14,1,13,24,54.2,11,11,2,9,7,32,8,1
1814,Memphis,Barcelona,20.6,10,4,2,4,4,3,13,23.1,10,9,1,8,3,13,4,0
1815,Houboulang Mendes,Lorient,35.8,58,28,37,18,3,40,57,70.2,17,41,21,20,41,99,128,4
1816,Nuno Mendes,Paris S-G,18.4,48,29,23,18,7,25,47,53.2,22,27,5,22,21,69,17,1
1817,Pedro Mendes,Montpellier,0.2,1,1,1,0,0,0,0,0.0,0,1,1,0,0,1,2,0
1818,Thiago Mendes,Lyon,20.7,36,22,18,16,2,12,30,40.0,18,24,5,19,34,70,56,1
1820,Tomas Mendes,Alavés,0.1,0,0,0,0,0,0,0,0.0,0,0,0,0,0,0,1,0
1821,Brais Mendez,Celta Vigo,33.6,68,35,24,35,9,26,87,29.9,61,52,6,46,37,105,30,0
1822,Edgar Mendez,Alavés,17.9,25,14,11,10,4,11,34,32.4,23,16,0,16,4,29,17,0
1823,Arial Mendy,Clermont Foot,8.8,6,4,4,2,0,2,11,18.2,9,6,1,5,7,13,17,0
1824,Batista Mendy,Angers,26.8,49,28,21,22,6,23,45,51.1,22,37,6,31,34,83,40,0
1825,Benjamin Mendy,Manchester City,0.9,2,2,1,1,0,2,6,33.3,4,0,0,0,0,2,0,0
1826,Edouard Mendy,Chelsea,34.0,1,0,1,0,0,1,3,33.3,2,0,0,0,0,1,13,4
1827,Ferland Mendy,Real Madrid,19.3,24,14,11,10,3,8,14,57.1,6,8,2,6,18,42,27,3
1828,Nampalys Mendy,Leicester City,11.5,12,6,8,4,0,6,17,35.3,11,7,4,3,11,23,11,1
1829,Gideon Mensah,Bordeaux,13.4,37,24,19,12,6,18,38,47.4,20,11,2,9,16,53,21,0
1830,Jorge Mere,Köln,5.4,9,6,3,6,0,4,7,57.1,3,6,4,2,10,19,19,0
1831,Alex Meret,Napoli,6.9,0,0,0,0,0,0,0,0.0,0,0,0,0,0,0,3,1
1832,Fran Merida,Espanyol,3.0,7,3,5,2,0,4,10,40.0,6,1,0,1,6,13,1,0
1833,Mikel Merino,Real Sociedad,32.1,71,38,21,40,10,26,67,38.8,41,50,10,40,21,92,56,2
1834,Quentin Merlin,Nantes,21.4,45,28,19,20,6,26,49,53.1,23,25,4,21,27,72,29,2
1835,Martin Merquelanz,Rayo Vallecano,1.9,2,1,2,0,0,2,6,33.3,4,2,0,2,0,2,1,0
1836,Yildirim Mert Cetin,Hellas Verona,0.5,1,0,1,0,0,1,1,100.0,0,0,0,0,0,1,2,0
1837,Dries Mertens,Napoli,15.4,16,7,1,11,4,3,16,18.8,13,8,2,6,9,25,2,0
1838,Illan Meslier,Leeds United,37.6,1,1,1,0,0,1,1,100.0,0,0,0,0,0,1,27,1
1839,Lionel Messi,Paris S-G,23.9,10,3,1,5,4,3,13,23.1,10,5,0,5,4,14,0,0
1840,Junior Messias,Milan,15.9,34,18,11,14,9,15,34,44.1,19,11,1,10,17,51,17,0
1841,Thomas Meunier,Dortmund,15.6,29,19,13,12,4,16,33,48.5,17,10,2,8,12,41,25,1
1842,Mexer,Bordeaux,13.6,14,10,11,3,0,11,17,64.7,6,12,7,5,21,35,60,2
1843,Marco Meyerhofer,Greuther Fürth,25.3,53,35,22,22,9,24,37,64.9,13,38,19,19,47,100,64,1
1844,Matt Miazga,Alavés,9.3,7,7,3,4,0,2,7,28.6,5,14,12,2,11,18,55,1
1846,Kingsley Michael,Bologna,0.8,4,1,2,2,0,1,2,50.0,1,2,1,1,1,5,1,1
1847,Sven Michel,Union Berlin,3.8,10,6,5,3,2,2,8,25.0,6,3,0,3,1,11,1,0
1848,Edouard Michut,Paris S-G,0.8,0,0,0,0,0,0,2,0.0,2,2,0,2,1,1,2,0
1849,Miguel,Alavés,9.2,7,3,1,5,1,2,15,13.3,13,6,0,6,1,8,7,0
1850,Valentin Mihaila,Atalanta,0.8,1,1,0,1,0,0,1,0.0,1,2,0,2,0,1,0,0
1851,Mikael,Salernitana,1.0,1,1,0,1,0,0,0,0.0,0,0,0,0,0,1,1,0
1852,Hilmir Mikaelsson,Venezia,0.2,2,0,0,1,1,0,0,0.0,0,0,0,0,0,2,0,0
1853,Georges Mikautadze,Metz,0.0,0,0,0,0,0,0,0,0.0,0,0,0,0,0,0,0,0
1854,William Mikelbrencis,Metz,6.8,11,5,6,4,1,6,9,66.7,3,6,3,3,5,16,9,0
1855,Nikola Milenkovic,Fiorentina,32.5,54,32,31,20,3,29,34,85.3,5,30,15,15,39,93,94,0
1856,Arkadiusz Milik,Marseille,15.7,9,2,0,5,4,4,18,22.2,14,9,1,8,3,12,10,1
1857,Sergej Milinkovic-Savic,Lazio,34.4,67,44,20,32,15,29,67,43.3,38,50,9,41,34,101,43,1
1858,Vanja Milinkovic-Savic,Torino,27.0,0,0,0,0,0,0,1,0.0,1,0,0,0,0,0,7,2
1859,Eder Militao,Real Madrid,33.7,50,32,30,12,8,20,39,51.3,19,42,20,22,52,102,107,3
1860,Luka Milivojevic,Crystal Palace,8.6,18,9,9,6,3,10,16,62.5,6,6,1,5,11,29,15,0
1861,Luis Milla,Granada,30.8,59,29,25,30,4,25,64,39.1,39,28,4,24,25,84,34,0
1862,Pere Milla,Elche,18.3,20,15,14,5,1,8,44,18.2,36,21,1,20,5,25,21,0
1863,Enzo Millot,Stuttgart,0.6,2,0,0,2,0,0,1,0.0,1,0,0,0,1,3,1,0
1864,James Milner,Liverpool,9.5,28,16,12,11,5,12,29,41.4,17,19,5,14,17,45,20,0
1865,Santi Mina,Celta Vigo,26.3,27,17,8,15,4,5,32,15.6,27,28,2,26,6,33,22,0
1866,Yerry Mina,Everton,9.4,12,10,12,0,0,10,13,76.9,3,13,9,4,11,23,38,1
1867,Takumi Minamino,Liverpool,2.1,3,2,1,1,1,2,8,25.0,6,2,0,2,1,4,2,0
1868,Tyrone Mings,Aston Villa,35.4,23,12,17,3,3,14,22,63.6,8,47,30,17,46,69,153,2
1869,Oscar Mingueza,Barcelona,9.9,25,11,12,11,2,16,23,69.6,7,5,0,5,9,34,22,1
1870,Rafa Mir,Sevilla,20.1,4,3,1,1,2,0,11,0.0,11,4,3,1,0,4,17,0
1872,Jorge Miramon,Levante,22.0,36,19,16,12,8,15,44,34.1,29,15,3,12,35,71,58,0
1873,Aleksei Miranchuk,Atalanta,8.6,11,7,3,7,1,4,12,33.3,8,3,0,3,1,12,7,0
1874,Juan Miranda,Betis,8.7,21,11,16,4,1,12,22,54.5,10,10,4,6,15,36,22,0
1875,Fabio Miretti,Juventus,3.6,4,2,2,2,0,2,9,22.2,7,3,1,2,2,6,3,0
1876,Tyrick Mitchell,Crystal Palace,34.5,104,57,67,26,11,46,67,68.7,21,47,5,42,41,145,101,0
1877,Stefan Mitrovic,Getafe,29.6,16,8,12,4,0,8,13,61.5,5,28,18,10,22,38,114,1
1878,Maximilian Mittelstadt,Hertha BSC,16.6,52,33,30,12,10,26,50,52.0,24,28,5,23,46,98,37,0
1879,Henrikh Mkhitaryan,Roma,27.7,45,29,11,27,7,17,52,32.7,35,33,2,31,22,67,33,0
1880,Jakub Moder,Brighton,18.9,42,25,18,17,7,23,42,54.8,19,25,2,23,10,52,22,1
1881,Anthony Modeste,Köln,29.0,10,6,4,5,1,3,18,16.7,15,11,2,9,4,14,29,0
1882,Marco Modolo,Venezia,4.4,6,3,4,2,0,2,5,40.0,3,6,6,0,4,10,26,0
1883,Luka Modric,Real Madrid,22.6,18,10,8,7,3,6,27,22.2,21,10,4,6,20,38,9,0
1884,Terem Moffi,Lorient,30.1,17,10,3,12,2,9,32,28.1,23,11,2,9,4,21,22,0
1885,Kevin Mohwald,Union Berlin,3.9,7,1,3,3,1,1,7,14.3,6,3,0,3,3,10,6,0
1886,Dion Moise Sahi,Strasbourg,1.4,0,0,0,0,0,0,0,0.0,0,1,0,1,1,1,1,0
1887,Johan Mojica,Elche,31.7,46,25,34,7,5,23,31,74.2,8,22,3,19,25,71,61,3
1888,Clinton Mola,Stuttgart,1.3,3,1,2,1,0,2,4,50.0,2,5,5,0,3,6,2,0
1889,Jorge Molina,Granada,21.8,4,2,2,1,1,2,18,11.1,16,13,2,11,6,10,11,0
1890,Nahuel Molina,Udinese,29.3,41,24,17,21,3,16,48,33.3,32,24,3,21,22,63,44,2
1891,Cristian Molinaro,Venezia,6.1,12,9,10,2,0,5,7,71.4,2,7,2,5,6,18,20,0
1892,Florent Mollet,Montpellier,29.2,31,22,14,12,5,14,57,24.6,43,27,4,23,24,55,13,0
1893,Jon Moncayola,Osasuna,32.4,40,20,18,18,4,17,44,38.6,27,26,9,17,20,60,43,0
1894,Monchu,Granada,7.4,15,6,5,9,1,5,10,50.0,5,8,3,5,4,19,4,0
1895,Thomas Monconduit,Lorient,25.0,41,25,19,17,5,20,57,35.1,37,21,10,11,22,63,51,1
1896,Gonzalo Montiel,Sevilla,11.8,15,4,8,5,2,12,24,50.0,12,8,2,6,10,25,22,0
1898,Lorenzo Montipo,Hellas Verona,34.0,0,0,0,0,0,0,0,0.0,0,0,0,0,1,1,16,3
1899,Angel Montoro,Granada,14.8,26,13,16,7,3,17,27,63.0,10,11,1,10,11,37,29,1
1900,Martin Montoya,Betis,5.8,20,12,11,7,2,15,26,57.7,11,6,0,6,11,31,20,0
1901,Wesley Moraes,Aston Villa,0.0,0,0,0,0,0,0,0,0.0,0,0,0,0,0,0,0,0
1902,Alvaro Morata,Juventus,25.6,18,9,4,9,5,8,31,25.8,23,26,1,25,5,23,24,0
1903,Jan Moravek,Augsburg,5.2,11,6,3,7,1,6,18,33.3,12,11,2,9,6,17,8,0
1904,Jon Morcillo,Athletic Club,0.6,3,0,1,2,0,3,4,75.0,1,1,0,1,0,3,0,0
1905,Jeremy Morel,Lorient,6.7,13,9,8,4,1,6,6,100.0,0,9,7,2,7,20,31,0
1906,Alberto Moreno,Villarreal,13.6,13,7,5,7,1,5,18,27.8,13,13,1,12,27,40,15,0
1907,Alex Moreno,Betis,26.7,76,40,53,15,8,33,60,55.0,27,28,6,22,34,110,82,1
1908,Gerard Moreno,Villarreal,13.2,5,2,2,2,1,1,7,14.3,6,6,1,5,6,11,14,0
1909,Tete Morente,Elche,18.1,21,14,13,7,1,7,28,25.0,21,30,1,29,12,33,12,0
1910,Ilaix Moriba,Valencia,9.1,26,18,10,13,3,14,35,40.0,21,15,0,15,12,38,14,0
1911,Ilaix Moriba,RB Leipzig,0.4,0,0,0,0,0,0,4,0.0,4,2,0,2,1,1,0,0
1912,Manu Morlanes,Espanyol,12.7,36,15,16,17,3,18,43,41.9,25,24,5,19,13,49,17,0
1913,Raul Moro,Lazio,2.2,3,3,0,2,1,1,5,20.0,4,2,0,2,0,3,0,0
1914,Loren Moron,Espanyol,6.3,6,4,1,3,2,0,12,0.0,12,11,1,10,2,8,9,0
1915,Loren Moron,Betis,0.0,1,1,1,0,0,1,1,100.0,0,0,0,0,0,1,0,0
1916,Tyler Morton,Liverpool,0.7,0,0,0,0,0,0,2,0.0,2,0,0,0,3,3,0,0
1917,Cristhian Mosquera,Valencia,2.4,4,2,3,0,1,3,6,50.0,3,1,0,1,3,7,1,1
1918,Lebo Mothiba,Troyes,5.8,8,4,4,3,1,2,5,40.0,3,3,0,3,2,10,0,0
1919,Lebo Mothiba,Strasbourg,0.0,0,0,0,0,0,0,0,0.0,0,0,0,0,0,0,0,0
1920,Andrei Motoc,Salernitana,1.0,1,1,0,1,0,0,0,0.0,0,2,2,0,2,3,1,0
1921,Baptiste Mouazan,Lorient,1.1,4,3,2,2,0,1,3,33.3,2,3,0,3,1,5,1,0
1922,Aimen Moueffek,Saint-Étienne,4.8,7,4,2,3,2,2,8,25.0,6,3,0,3,2,9,4,0
1924,Youssoufa Moukoko,Dortmund,2.5,1,0,0,1,0,0,1,0.0,1,5,0,5,3,4,0,0
1925,Harold Moukoudi,Saint-Étienne,18.5,25,12,17,8,0,14,25,56.0,11,27,14,13,35,60,48,0
1926,Jessy Moulin,Troyes,7.0,0,0,0,0,0,0,0,0.0,0,0,0,0,1,1,7,0
1927,Steve Mounie,Brest,25.7,17,6,3,12,2,4,27,14.8,23,13,1,12,6,23,12,0
1928,Mason Mount,Chelsea,26.3,41,16,10,17,14,10,34,29.4,24,18,1,17,13,54,12,0
1929,Lucas Moura,Tottenham,19.7,25,10,7,14,4,8,35,22.9,27,19,0,19,18,43,19,0
1930,Lys Mousset,Salernitana,1.8,1,0,0,1,0,0,0,0.0,0,2,0,2,0,1,0,0
1931,Joao Moutinho,Wolves,33.0,74,39,34,27,13,30,106,28.3,76,48,8,40,34,108,36,2
1932,Samuel Moutoussamy,Nantes,16.8,48,32,20,20,8,23,62,37.1,39,14,2,12,17,65,16,0
1933,Toni Moya,Alavés,15.4,23,10,7,13,3,13,43,30.2,30,18,5,13,20,43,18,0
1934,Samuel Mraz,Spezia,0.6,0,0,0,0,0,0,0,0.0,0,1,0,1,0,0,0,0
1935,Nordi Mukiele,RB Leipzig,20.5,35,22,23,9,3,14,27,51.9,13,31,5,26,31,66,44,2
1936,Mert Muldur,Sassuolo,22.7,52,35,43,7,2,27,49,55.1,22,25,6,19,24,76,44,1
1937,Florian Muller,Stuttgart,30.0,0,0,0,0,0,0,1,0.0,1,1,0,1,0,0,13,2
1938,Thomas Muller,Bayern Munich,28.4,35,20,7,16,12,16,54,29.6,38,32,1,31,15,50,12,0
1939,Bali Mumba,Norwich City,0.5,1,1,1,0,0,0,0,0.0,0,0,0,0,0,1,5,0
1940,Marshall Munetsi,Reims,20.9,34,17,21,11,2,17,39,43.6,22,39,13,26,43,77,72,2
1941,Iker Muniain,Athletic Club,30.9,32,10,8,19,5,12,40,30.0,28,20,1,19,17,49,8,1
1942,Aihen Munoz,Real Sociedad,14.9,28,17,14,13,1,18,29,62.1,11,11,1,10,17,45,34,0
1943,Luis Muriel,Atalanta,17.1,15,4,2,7,6,3,19,15.8,16,12,0,12,4,19,5,0
1944,Jeison Murillo,Celta Vigo,12.4,15,10,13,2,0,9,13,69.2,4,11,8,3,17,32,37,0
1945,Vedat Muriqi,Lazio,2.4,1,0,1,0,0,0,5,0.0,5,0,0,0,0,1,2,0
1946,Vedat Muriqi,Mallorca,16.0,6,3,1,3,2,1,7,14.3,6,12,0,12,6,12,29,0
1947,Jacob Murphy,Newcastle Utd,16.4,49,26,34,11,4,26,41,63.4,15,20,2,18,23,72,17,0
1948,Nicola Murru,Sampdoria,10.9,22,17,10,11,1,8,13,61.5,5,17,3,14,7,29,20,1
1950,Yunus Musah,Valencia,14.0,23,13,8,8,7,6,20,30.0,14,19,1,18,14,37,11,0
1951,Torben Musel,M'Gladbach,0.1,0,0,0,0,0,0,0,0.0,0,0,0,0,0,0,0,0
1952,Jamal Musiala,Bayern Munich,16.3,40,26,11,16,13,15,36,41.7,21,25,0,25,19,59,2,1
1953,Juan Musso,Atalanta,32.6,1,1,1,0,0,0,0,0.0,0,0,0,0,0,1,17,1
1954,Shkodran Mustafi,Levante,7.3,9,6,6,3,0,5,9,55.6,4,6,3,3,15,24,40,0
1955,Junior Mwanga,Bordeaux,1.0,5,2,4,1,0,3,3,100.0,0,1,0,1,0,5,1,0
1956,Enock Mwepu,Brighton,11.1,22,12,10,10,2,5,27,18.5,22,20,2,18,12,34,19,0
1957,Vitaliy Mykolenko,Everton,11.7,25,15,15,7,3,12,21,57.1,9,15,2,13,16,41,37,0
1958,Joakim Maehle,Atalanta,16.3,21,11,6,9,6,12,27,44.4,15,18,2,16,14,35,13,0
1959,Mamadou N'Diaye,Alavés,25.7,0.0,20,0.0,0.0,0.0,0.0,0.0,0.0,0.0,0.0,0.0,0.0,36,0.0,0.0,0.0
1960,Obite N'Dicka,Eint Frankfurt,31.7,60,34,29,27,4,44,59,74.6,15,46,20,26,48,108,137,0
1961,Kevin N'Doram,Metz,13.7,10,8,3,5,2,3,20,15.0,17,24,5,19,19,29,21,0
1962,Eric N'Jo,Troyes,1.1,0,0,0,0,0,0,1,0.0,1,1,1,0,2,2,1,0
1963,Vital N'Simba,Clermont Foot,31.0,66,45,38,23,5,36,63,57.1,27,28,7,21,29,95,30,0
1964,Nacho,Real Madrid,17.3,18,14,9,9,0,12,22,54.5,10,22,15,7,34,52,50,0
1965,Mickael Nade,Saint-Étienne,28.5,57,35,37,18,2,23,38,60.5,15,29,15,14,60,117,84,0
1966,Marvelous Nakamba,Aston Villa,10.0,32,19,18,14,0,12,34,35.3,22,14,4,10,12,44,17,1
1967,Nahitan Nandez,Cagliari,16.9,39,21,16,15,8,18,33,54.5,15,16,1,15,9,48,15,1
1968,Nani,Venezia,3.2,2,1,1,1,0,0,1,0.0,1,1,0,1,2,4,0,1
1969,Paul Nardi,Lorient,22.0,1,0,1,0,0,1,2,50.0,1,0,0,0,0,1,10,2
1970,Nikolas Nartey,Stuttgart,4.5,6,3,0,5,1,3,9,33.3,6,4,2,2,7,13,5,0
1971,Matija Nastasic,Fiorentina,2.4,1,1,1,0,0,1,1,100.0,0,1,1,0,5,6,11,0
1972,Roberto Navarro,Real Sociedad,2.2,5,3,1,1,3,3,5,60.0,2,2,0,2,2,7,2,0
1973,Ximo Navarro,Alavés,15.0,28,19,21,6,1,13,27,48.1,14,11,5,6,22,50,56,2
1974,Jesus Navas,Sevilla,19.8,18,13,11,5,2,9,17,52.9,8,15,2,13,17,35,26,1
1976,Keylor Navas,Paris S-G,20.6,0,0,0,0,0,0,0,0.0,0,0,0,0,0,0,5,1
1977,Papa Ndiaga Yade,Metz,7.7,15,10,8,7,0,8,18,44.4,10,4,1,3,10,25,9,0
1978,Wilfred Ndidi,Leicester City,18.0,60,32,32,27,1,22,55,40.0,33,36,8,28,42,102,54,1
1979,Tanguy Ndombele,Tottenham,5.4,10,7,3,5,2,1,8,12.5,7,5,0,5,1,11,1,0
1980,Tanguy Ndombele,Lyon,7.8,25,14,5,17,3,12,19,63.2,7,8,3,5,3,28,6,2
1981,Dan Ndoye,Nice,2.3,0,0,0,0,0,0,2,0.0,2,4,0,4,0,0,0,0
1982,Paul Nebel,Mainz 05,2.5,5,3,3,1,1,2,3,66.7,1,0,0,0,0,5,1,0
1983,Alvaro Negredo,Cádiz,24.0,5,3,1,4,0,3,6,50.0,3,11,5,6,2,7,23,0
1984,Reiss Nelson,Arsenal,0.2,1,0,0,0,1,0,1,0.0,1,1,0,1,0,1,0,0
1985,David Nemeth,Mainz 05,3.5,3,2,2,1,0,1,3,33.3,2,5,1,4,6,9,11,1
1986,Ilija Nestorovski,Udinese,2.1,0,0,0,0,0,0,3,0.0,3,0,0,0,0,0,4,0
1987,Neto,Barcelona,3.0,0,0,0,0,0,0,0,0.0,0,0,0,0,0,0,2,1
1988,Pedro Neto,Wolves,5.2,4,4,2,0,2,0,9,0.0,9,0,0,0,6,10,1,0
1989,Luca Netz,M'Gladbach,15.5,24,11,12,10,2,11,40,27.5,29,24,4,20,13,37,33,1
1990,Manuel Neuer,Bayern Munich,27.9,2,1,2,0,0,1,2,50.0,1,0,0,0,0,2,7,1
1991,Florian Neuhaus,M'Gladbach,23.6,55,28,24,26,5,27,64,42.2,37,38,6,32,31,86,19,4
1992,Carlos Neva,Granada,23.4,31,19,24,7,0,16,28,57.1,12,27,9,18,32,63,81,0
1993,Ruben Neves,Wolves,29.6,68,37,23,41,4,24,87,27.6,63,39,5,34,41,109,49,3
1994,Neymar,Paris S-G,20.6,29,19,5,12,12,12,36,33.3,24,9,1,8,4,33,2,1
1995,Yvan Neyou,Saint-Étienne,10.4,29,13,14,12,3,9,27,33.3,18,8,3,5,23,52,13,0
1996,Jeremy Ngakia,Watford,10.0,31,18,23,5,3,11,26,42.3,15,11,4,7,12,43,32,0
1997,Jessic Ngankam,Greuther Fürth,3.8,3,1,1,1,1,1,2,50.0,1,3,0,3,0,3,1,0
1998,Opa Nguette,Metz,11.6,21,14,9,6,6,5,14,35.7,9,13,3,10,2,23,9,0
1999,Aurelien Nguiamba,Spezia,0.6,3,2,1,2,0,2,3,66.7,1,2,1,1,0,3,1,0
2000,Sikou Niakate,Metz,7.3,8,7,8,0,0,4,11,36.4,7,5,3,2,27,35,34,0
2002,Moussa Niakhate,Mainz 05,28.5,40,23,25,13,2,20,33,60.6,13,37,11,26,50,90,69,1
2003,Ibrahima Niane,Metz,17.6,1,1,0,1,0,0,5,0.0,5,6,1,5,3,4,16,0
2004,M'Baye Niang,Bordeaux,8.6,4,0,0,2,2,0,4,0.0,4,9,1,8,1,5,4,0
2005,Tanguy Nianzou,Bayern Munich,6.5,11,7,7,3,1,7,11,63.6,4,7,2,5,7,18,17,0
2006,Cheikh Niasse,Lille,0.5,2,2,0,2,0,2,3,66.7,1,1,1,0,1,3,2,0
2007,Florian Niederlechner,Augsburg,12.9,6,5,1,3,2,4,13,30.8,9,9,0,9,4,10,7,0
2008,Havard Nielsen,Greuther Fürth,15.2,17,12,5,11,1,8,21,38.1,13,18,1,17,7,24,22,0
2009,Saul Niguez,Chelsea,5.3,20,9,11,9,0,9,16,56.3,7,14,3,11,7,27,10,1
2010,Saul Niguez,Atlético Madrid,2.2,7,2,0,6,1,3,4,75.0,1,7,1,6,0,7,3,0
2011,Dimitris Nikolaou,Spezia,36.0,39,26,29,7,3,22,34,64.7,12,48,24,24,49,88,132,1
2012,Joakim Nilsson,Arminia,30.4,37,19,24,13,0,20,26,76.9,6,36,23,13,56,93,143,1
2013,Casimir Ninga,Angers,4.5,5,1,1,4,0,2,5,40.0,3,2,0,2,1,6,0,0
2014,Fernando Nino,Mallorca,9.8,10,4,3,2,5,2,12,16.7,10,9,2,7,3,13,15,0
2015,Eddie Nketiah,Arsenal,9.3,9,4,1,4,4,1,4,25.0,3,9,2,7,4,13,5,0
2016,Nicolas Nkoulou,Watford,1.9,1,0,0,1,0,0,0,0.0,0,2,1,1,2,3,8,0
2017,Christopher Nkunku,RB Leipzig,30.3,23,10,10,11,2,9,35,25.7,26,23,2,21,15,38,15,0
2018,Felix Nmecha,Wolfsburg,3.6,3,1,1,1,1,0,2,0.0,2,2,0,2,7,10,6,0
2019,Lukas Nmecha,Wolfsburg,18.1,12,5,5,5,2,5,19,26.3,14,9,1,8,4,16,10,0
2020,Mark Noble,West Ham,3.7,8,2,7,1,0,5,11,45.5,6,4,1,3,4,12,2,1
2021,Peru Nolaskoain,Athletic Club,0.0,0,0,0,0,0,0,0,0.0,0,0,0,0,0,0,0,0
2022,Nolito,Celta Vigo,15.4,25,15,14,7,4,13,47,27.7,34,20,1,19,9,34,5,0
2023,Arnaud Nordin,Saint-Étienne,20.8,21,11,8,8,5,8,22,36.4,14,19,0,19,6,27,8,0
2024,Havard Nordtveit,Hoffenheim,3.4,7,6,2,4,1,4,4,100.0,0,2,1,1,10,17,11,0
2025,Mathias Normann,Norwich City,18.3,34,21,19,14,1,17,46,37.0,29,17,8,9,19,53,43,1
2026,Connor Noss,M'Gladbach,0.6,1,0,0,1,0,0,1,0.0,1,1,1,0,0,1,0,0
2028,Hugo Novoa,RB Leipzig,1.5,4,4,2,0,2,2,7,28.6,5,2,0,2,1,5,0,0
2029,Soma Novothny,Bochum,0.9,1,1,1,0,0,0,1,0.0,1,1,0,1,0,1,2,0
2030,Jean-Pierre Nsame,Venezia,2.7,1,1,0,0,1,0,0,0.0,0,0,0,0,0,1,1,0
2031,Randy Ntekja,Rayo Vallecano,16.2,24,13,9,11,4,8,19,42.1,11,21,1,20,8,32,12,0
2032,Alexander Nubel,Monaco,38.0,0,0,0,0,0,0,1,0.0,1,0,0,0,0,0,11,1
2033,Kasim Nuhu,Hoffenheim,0.1,0,0,0,0,0,0,1,0.0,1,0,0,0,0,0,1,0
2034,Unai Nunez,Athletic Club,6.9,4,4,2,2,0,3,6,50.0,3,9,8,1,8,12,26,2
2035,Hans Nunoo Sarpei,Greuther Fürth,7.1,16,11,9,7,0,10,14,71.4,4,8,5,3,14,30,21,0
2036,Bram Nuytinck,Udinese,22.6,38,24,24,13,1,15,34,44.1,19,42,31,11,22,60,101,0
2037,Simeon Nwankwo,Salernitana,9.4,5,5,0,4,1,4,10,40.0,6,8,3,5,3,8,10,0
2038,Gerzino Nyamsi,Strasbourg,33.2,35,21,24,9,2,20,27,74.1,7,25,16,9,25,60,90,1
2039,Allan Nyom,Getafe,2.7,3,1,2,1,0,2,2,100.0,0,2,1,1,2,5,7,0
2040,M'Bala Nzola,Spezia,11.9,2,2,0,0,2,1,6,16.7,5,8,0,8,0,2,13,0
2041,Christian Norgaard,Brentford,33.9,109,60,42,58,9,52,101,51.5,49,48,9,39,64,173,58,1
2042,Adam Obert,Cagliari,3.0,8,5,6,2,0,5,6,83.3,1,6,4,2,4,12,11,0
2043,Joel Obi,Salernitana,12.7,23,14,5,14,4,5,12,41.7,7,17,6,11,10,33,7,0
2044,Jan Oblak,Atlético Madrid,38.0,0,0,0,0,0,0,0,0.0,0,0,0,0,1,1,10,4
2045,Lucas Ocampos,Sevilla,23.6,45,24,23,18,4,23,55,41.8,32,35,1,34,9,54,24,1
2046,Bastian Oczipka,Union Berlin,10.4,24,15,15,7,2,10,13,76.9,3,10,2,8,12,36,21,0
2047,Brian Oddei,Sassuolo,0.1,0,0,0,0,0,0,0,0.0,0,0,0,0,0,0,0,0
2048,Alvaro Odriozola,Fiorentina,19.3,25,15,12,6,7,15,32,46.9,17,17,6,11,8,33,25,2
2049,Angelo Ogbonna,West Ham,10.2,7,4,5,2,0,3,7,42.9,4,5,4,1,11,18,29,0
2050,Florent Ogier,Clermont Foot,27.0,31,17,18,12,1,17,31,54.8,14,41,27,14,37,68,89,0
2051,Stefano Okaka,Udinese,0.2,0,0,0,0,0,0,0,0.0,0,2,0,2,0,0,1,0
2052,David Okereke,Venezia,22.8,16,10,4,9,3,3,20,15.0,17,19,3,16,10,26,20,0
2054,Masaya Okugawa,Arminia,28.1,46,25,18,22,6,12,37,32.4,25,29,1,28,20,66,13,0
2055,Lucas Olaza,Elche,3.3,5,3,3,1,1,1,1,100.0,0,5,1,4,4,9,6,0
2056,Oier Olazabal,Espanyol,1.5,0,0,0,0,0,0,0,0.0,0,0,0,0,0,0,0,0
2057,Mathias Olesen,Köln,0.2,0,0,0,0,0,0,0,0.0,0,0,0,0,1,1,0,0
2058,Michael Olise,Crystal Palace,12.7,22,18,8,11,3,7,24,29.2,17,17,0,17,6,28,6,0
2059,Christian Oliva,Cagliari,0.5,2,2,2,0,0,1,4,25.0,3,0,0,0,0,2,0,0
2060,Brian Olivan,Mallorca,24.3,33,20,22,9,2,12,23,52.2,11,17,7,10,28,61,63,0
2061,Sergio Oliveira,Roma,9.9,27,14,11,14,2,15,30,50.0,15,13,0,13,10,37,7,0
2062,Mathias Olivera,Getafe,31.1,79,47,39,34,6,40,69,58.0,29,45,4,41,55,134,67,1
2063,Dani Olmo,RB Leipzig,8.3,14,6,5,7,2,5,18,27.8,13,5,1,4,4,18,1,0
2064,Robin Olsen,Aston Villa,1.0,0,0,0,0,0,0,0,0.0,0,0,0,0,0,0,0,0
2065,Warmed Omari,Rennes,31.1,33,17,22,10,1,15,23,65.2,8,20,13,7,31,64,94,5
2066,Jonas Omlin,Montpellier,28.7,2,1,2,0,0,2,3,66.7,1,0,0,0,0,2,12,3
2067,Andrew Omobamidele,Norwich City,4.2,8,6,5,3,0,5,11,45.5,6,8,8,0,5,13,13,0
2068,Amadou Onana,Lille,15.1,48,31,17,27,4,18,25,72.0,7,10,3,7,30,78,19,0
2069,Jean Onana,Bordeaux,20.4,70,49,33,33,4,35,86,40.7,51,37,5,32,36,106,23,1
2070,Karim Onisiwo,Mainz 05,26.2,18,10,4,6,8,7,22,31.8,15,27,2,25,7,25,8,0
2071,Javier Ontiveros,Osasuna,0.4,0,0,0,0,0,0,2,0.0,2,0,0,0,1,1,0,1
2072,Tyler Onyango,Everton,0.3,0,0,0,0,0,0,0,0.0,0,0,0,0,0,0,1,0
2073,Frank Onyeka,Brentford,11.6,25,17,13,9,3,8,27,29.6,19,16,2,14,14,39,13,0
2074,Willi Orban,RB Leipzig,29.4,32,22,20,11,1,13,25,52.0,12,40,24,16,44,76,123,2
2075,Divock Origi,Liverpool,1.5,0,0,0,0,0,0,2,0.0,2,1,0,1,1,1,2,0
2076,Riccardo Orsolini,Bologna,19.8,21,13,9,11,1,13,29,44.8,16,9,4,5,5,26,14,0
2077,Stefan Ortega,Arminia,33.0,1,0,1,0,0,1,2,50.0,1,2,0,2,0,1,5,1
2078,Pedro Ortiz,Sevilla,0.1,0,0,0,0,0,0,0,0.0,0,0,0,0,0,0,1,0
2080,Victor Osimhen,Napoli,22.0,10,5,1,2,7,2,6,33.3,4,16,3,13,3,13,17,0
2081,Milutin Osmajic,Cádiz,2.9,1,1,0,1,0,0,0,0.0,0,0,0,0,1,2,3,0
2082,David Ospina,Napoli,31.0,0,0,0,0,0,0,0,0.0,0,0,0,0,1,1,11,1
2083,Patrick Osterhage,Bochum,6.7,9,6,3,5,1,3,7,42.9,4,7,1,6,11,20,8,0
2084,Tomas Ostrak,Köln,0.3,1,0,0,0,1,1,3,33.3,2,0,0,0,1,2,0,0
2085,Otavio,Bordeaux,12.7,36,23,13,21,2,16,39,41.0,23,9,3,6,18,54,11,0
2086,Paulo Otavio,Wolfsburg,4.0,14,10,7,4,3,8,15,53.3,7,11,6,5,4,18,9,0
2087,Dango Ouattara,Lorient,9.0,21,15,9,11,1,11,23,47.8,12,10,1,9,14,35,15,1
2088,Remi Oudin,Bordeaux,19.3,34,18,19,13,2,18,32,56.3,14,14,3,11,27,61,21,0
2089,Alexandre Oukidja,Metz,20.8,0,0,0,0,0,0,1,0.0,1,1,0,1,1,1,17,2
2090,Azzedine Ounahi,Angers,18.1,39,22,16,22,1,11,40,27.5,29,19,1,18,26,65,13,0
2091,Adam Ounas,Napoli,3.6,6,1,0,3,3,3,7,42.9,4,3,0,3,2,8,3,0
2092,Jesus Owono,Alavés,1.0,0,0,0,0,0,0,0,0.0,0,0,0,0,0,0,1,0
2093,Reece Oxford,Augsburg,29.9,27,14,16,9,2,15,31,48.4,16,42,33,9,72,99,172,1
2094,Alex Oxlade-Chamberlain,Liverpool,8.7,15,11,2,8,5,3,14,21.4,11,12,2,10,6,21,5,0
2095,Mikel Oyarzabal,Real Sociedad,18.6,18,10,7,7,4,7,21,33.3,14,18,2,16,10,28,16,1
2096,Ambroise Oyongo,Montpellier,7.3,13,4,7,4,2,9,15,60.0,6,5,1,4,6,19,17,0
2097,Salih Ozcan,Köln,25.7,42,30,14,23,5,22,51,43.1,29,37,5,32,51,93,35,1
2098,Levin Oztunali,Union Berlin,6.4,14,11,6,5,3,7,17,41.2,10,3,0,3,4,18,12,0
2099,Fernando Pacheco,Alavés,33.9,2,1,2,0,0,2,2,100.0,0,0,0,0,0,2,18,1
2100,Jon Pacheco,Real Sociedad,4.2,6,4,4,2,0,3,3,100.0,0,6,4,2,6,12,18,0
2101,Goncalo Paciencia,Eint Frankfurt,5.7,4,2,2,1,1,1,3,33.3,2,2,0,2,1,5,4,0
2102,Daniele Padelli,Udinese,3.0,0,0,0,0,0,0,0,0.0,0,0,0,0,0,0,2,1
2103,Simone Pafundi,Udinese,0.3,0,0,0,0,0,0,1,0.0,1,0,0,0,0,0,0,0
2104,Vincent Pajot,Metz,25.7,86,56,35,47,4,20,46,43.5,26,33,6,27,51,137,38,0
2106,Exequiel Palacios,Leverkusen,12.2,30,19,12,14,4,15,38,39.5,23,20,1,19,28,58,11,2
2107,Helibelton Palacios,Elche,21.5,69,38,56,10,3,37,55,67.3,18,21,8,13,18,87,61,0
2108,Isaac Palazon Camacho,Rayo Vallecano,25.4,42,28,20,19,3,18,59,30.5,41,31,3,28,13,55,22,0
2109,Nicolas Pallois,Nantes,27.2,51,33,40,11,0,34,59,57.6,25,40,19,21,53,104,116,1
2110,Cole Palmer,Manchester City,1.4,2,1,1,1,0,0,2,0.0,2,3,0,3,1,3,0,0
2111,Erik Palmer-Brown,Troyes,19.3,37,22,29,8,0,20,26,76.9,6,26,18,8,34,71,87,1
2112,Emerson Palmieri,Chelsea,0.1,0,0,0,0,0,0,0,0.0,0,0,0,0,0,0,0,0
2113,Emerson Palmieri,Lyon,25.2,46,25,16,22,8,22,34,64.7,12,23,8,15,27,73,66,0
2114,Martin Palumbo,Juventus,0.1,0,0,0,0,0,0,1,0.0,1,0,0,0,0,0,0,0
2115,Goran Pandev,Genoa,9.4,2,0,1,0,1,0,9,0.0,9,3,1,2,2,4,0,0
2116,Ivor Pandur,Hellas Verona,3.0,0,0,0,0,0,0,0,0.0,0,0,0,0,0,0,2,0
2117,Milos Pantovic,Bochum,17.0,19,10,8,7,4,6,25,24.0,19,26,4,22,18,37,14,0
2118,Antonios Papadopoulos,Dortmund,0.2,0,0,0,0,0,0,0,0.0,0,1,0,1,0,0,0,0
2119,Matondo-Merveille Papela,Mainz 05,0.9,3,2,2,1,0,2,3,66.7,1,2,0,2,2,5,0,0
2120,Lucas Paqueta,Lyon,30.0,68,38,24,26,18,17,51,33.3,34,43,5,38,9,77,22,0
2121,Ruben Pardo,Bordeaux,0.1,0,0,0,0,0,0,0,0.0,0,0,0,0,0,0,0,0
2122,Kevin Paredes,Wolfsburg,0.2,1,0,0,0,1,0,0,0.0,0,1,0,1,0,1,0,0
2123,Leandro Paredes,Paris S-G,9.3,23,13,9,11,3,12,24,50.0,12,10,6,4,10,33,5,2
2124,Daniel Parejo,Villarreal,30.0,43,29,15,15,13,20,52,38.5,32,32,7,25,29,72,19,1
2125,Fabiano Parisi,Empoli,16.4,35,19,25,5,5,13,31,41.9,18,30,10,20,22,57,42,0
2126,Raul Parra,Cádiz,1.0,2,1,2,0,0,1,3,33.3,2,0,0,0,0,2,5,0
2127,Thomas Partey,Arsenal,22.5,43,29,22,17,4,18,44,40.9,26,22,4,18,23,66,35,2
2128,Mario Pasalic,Atalanta,22.2,27,12,8,13,6,12,30,40.0,18,27,6,21,20,47,14,0
2129,Felix Passlack,Dortmund,5.2,13,9,8,4,1,6,12,50.0,6,5,1,4,4,17,7,0
2130,Javier Pastore,Elche,5.8,7,3,3,2,2,3,12,25.0,9,5,1,4,4,11,2,0
2132,Patric,Lazio,18.3,21,15,17,4,0,9,20,45.0,11,22,11,11,12,33,44,2
2133,Rui Patricio,Roma,38.0,0,0,0,0,0,0,0,0.0,0,1,0,1,0,0,10,3
2134,Paulinho,Leverkusen,13.5,22,13,6,13,3,13,27,48.1,14,14,1,13,6,28,7,0
2135,Gabriel Paulista,Valencia,17.7,21,12,16,5,0,14,20,70.0,6,18,12,6,39,60,88,0
2136,Benjamin Pavard,Bayern Munich,23.1,35,20,21,13,1,19,29,65.5,10,28,16,12,36,71,50,1
2137,Strahinja Pavlovic,Monaco,5.0,23,16,8,13,2,8,12,66.7,4,5,3,2,9,32,15,0
2138,Leonardo Pavoletti,Cagliari,16.9,10,6,2,5,3,3,9,33.3,6,9,5,4,2,12,12,0
2139,Dimitri Payet,Marseille,28.8,16,8,4,10,2,7,31,22.6,24,9,0,9,9,25,3,0
2140,Mads Pedersen,Augsburg,15.5,28,21,8,15,5,12,27,44.4,15,13,4,9,15,43,30,0
2141,Alfonso Pedraza,Villarreal,18.9,34,16,17,12,5,10,28,35.7,18,12,3,9,31,65,32,0
2142,Pedri,Barcelona,9.8,20,12,9,8,3,7,20,35.0,13,13,0,13,5,25,7,1
2143,Pedro,Lazio,22.6,36,23,8,19,9,16,47,34.0,31,18,2,16,6,42,8,0
2144,Joao Pedro,Cagliari,36.9,15,12,2,8,5,4,18,22.2,14,23,5,18,8,23,18,1
2145,Adria Pedrosa,Espanyol,30.2,58,30,38,14,6,26,57,45.6,31,25,7,18,25,83,92,2
2146,Gianluca Pegolo,Sassuolo,1.0,0,0,0,0,0,0,0,0.0,0,0,0,0,0,0,0,1
2147,Peter Pekarik,Hertha BSC,24.8,45,29,33,11,1,32,46,69.6,14,28,10,18,29,74,58,0
2148,Pietro Pellegri,Torino,2.4,1,1,0,1,0,0,4,0.0,4,0,0,0,0,1,5,0
2149,Pietro Pellegri,Milan,1.5,2,2,0,1,1,0,1,0.0,1,0,0,0,0,2,1,0
2150,Lorenzo Pellegrini,Roma,25.4,35,14,10,17,8,16,60,26.7,44,29,1,28,27,62,20,0
2151,Luca Pellegrini,Juventus,12.3,23,10,13,5,5,12,19,63.2,7,9,1,8,5,28,23,0
2152,Facundo Pellistri,Alavés,7.5,9,5,4,3,2,1,10,10.0,9,13,2,11,6,15,7,0
2153,Federico Peluso,Sassuolo,0.1,1,1,0,1,0,1,1,100.0,0,0,0,0,0,1,0,0
2154,Timothee Pembele,Bordeaux,15.7,20,8,8,10,2,10,29,34.5,19,12,3,9,16,36,24,0
2155,Ruben Pena,Villarreal,1.5,2,0,1,1,0,2,6,33.3,4,1,0,1,5,7,2,0
2156,Philipp Pentke,Hoffenheim,1.0,0,0,0,0,0,0,0,0.0,0,0,0,0,0,0,0,0
2158,Nicolas Pepe,Arsenal,7.7,8,5,3,5,0,3,9,33.3,6,9,1,8,8,16,2,0
2159,Ricardo Pepi,Augsburg,5.3,4,2,1,3,0,1,8,12.5,7,7,0,7,3,7,8,0
2160,Alberto Perea,Cádiz,8.6,19,9,7,9,3,6,20,30.0,14,15,1,14,9,28,4,0
2161,Brayann Pereira,Lens,0.2,1,1,1,0,0,1,1,100.0,0,0,0,0,0,1,1,0
2162,Danilo Pereira,Paris S-G,22.6,33,17,10,20,3,14,28,50.0,14,19,10,9,37,70,29,1
2163,Mathias Pereira Lage,Angers,11.6,21,7,10,7,4,8,30,26.7,22,18,7,11,21,42,22,0
2164,Ricardo Pereira,Leicester City,11.0,37,20,19,13,5,21,40,52.5,19,13,1,12,17,54,39,0
2165,Gaston Pereiro,Cagliari,10.8,13,5,7,4,2,5,18,27.8,13,12,1,11,1,14,8,0
2166,Luan Peres Petroni,Marseille,29.8,65,35,33,25,7,36,52,69.2,16,26,12,14,43,108,64,1
2167,Dor Peretz,Venezia,6.5,27,18,8,16,3,13,25,52.0,12,8,4,4,8,35,11,0
2168,Roberto Pereyra,Udinese,19.9,18,12,7,6,5,7,23,30.4,16,26,5,21,12,30,11,0
2169,Ayoze Perez,Leicester City,4.9,4,2,0,3,1,0,13,0.0,13,11,1,10,2,6,5,0
2170,Carles Perez,Roma,6.2,8,3,3,1,4,3,12,25.0,9,10,0,10,2,10,2,0
2171,Inigo Perez,Osasuna,3.8,3,2,2,1,0,2,4,50.0,2,1,0,1,0,3,3,0
2172,Juan Perez,Osasuna,2.0,0,0,0,0,0,0,1,0.0,1,0,0,0,0,0,1,1
2173,Kike Perez,Elche,5.8,8,6,1,3,4,0,10,0.0,10,6,1,5,3,11,4,0
2174,Lucas Perez,Elche,14.1,4,1,2,1,1,3,10,30.0,7,2,0,2,3,7,4,0
2175,Lucas Perez,Cádiz,11.8,3,3,2,1,0,0,10,0.0,10,3,1,2,0,3,1,0
2176,Nehuen Perez,Udinese,18.8,44,21,21,21,2,16,25,64.0,9,27,9,18,21,65,47,0
2177,Mattia Perin,Juventus,4.5,0,0,0,0,0,0,0,0.0,0,0,0,0,0,0,3,0
2178,Ivan Perisic,Inter,31.3,38,22,18,11,9,28,50,56.0,22,39,7,32,47,85,42,0
2179,Sonny Perkins,West Ham,0.0,0,0,0,0,0,0,0,0.0,0,0,0,0,0,0,0,0
2180,Diego Perotti,Salernitana,3.2,11,5,7,1,3,4,13,30.8,9,1,0,1,2,13,6,0
2181,Romain Perraud,Southampton,18.0,34,22,18,14,2,16,29,55.2,13,24,6,18,17,51,42,0
2182,Lucas Perrin,Strasbourg,27.8,43,32,24,17,2,26,45,57.8,19,28,11,17,42,85,67,0
2184,Mario Perrone,Salernitana,0.2,0,0,0,0,0,0,0,0.0,0,0,0,0,0,0,0,0
2185,Pavao Pervan,Wolfsburg,6.0,0,0,0,0,0,0,0,0.0,0,0,0,0,0,0,3,0
2186,Matteo Pessina,Atalanta,16.0,27,14,10,11,6,14,33,42.4,19,22,3,19,13,40,7,0
2187,Andrea Petagna,Napoli,6.5,3,3,0,3,0,1,4,25.0,3,1,0,1,0,3,5,0
2188,Nils Petersen,Freiburg,6.4,5,3,2,3,0,1,13,7.7,12,7,0,7,2,7,17,0
2189,Danijel Petkovic,Angers,15.0,0,0,0,0,0,0,1,0.0,1,0,0,0,1,1,9,5
2190,Leo Petrot,Lorient,20.2,31,17,23,8,0,21,29,72.4,8,33,17,16,22,53,86,0
2191,Njegos Petrovic,Granada,10.2,24,11,4,19,1,8,14,57.1,6,16,4,12,9,33,11,0
2192,Jens Petter Hauge,Eint Frankfurt,11.6,14,5,6,7,1,7,23,30.4,16,7,0,7,3,17,5,0
2193,Alex Petxa,Athletic Club,4.6,12,9,4,7,1,4,8,50.0,4,8,2,6,4,16,6,0
2194,German Pezzella,Betis,22.1,21,9,16,5,0,16,29,55.2,13,29,18,11,39,60,106,0
2195,Giuseppe Pezzella,Atalanta,11.9,28,13,15,7,6,8,18,44.4,10,13,5,8,9,37,16,0
2196,Immanuel Pherai,Dortmund,0.0,0,0,0,0,0,0,0,0.0,0,0,0,0,0,0,0,0
2197,Maximilian Philipp,Wolfsburg,10.7,15,11,6,7,2,5,21,23.8,16,12,1,11,4,19,5,0
2198,Romain Philippoteaux,Brest,0.3,1,1,0,1,0,0,0,0.0,0,0,0,0,0,1,0,0
2199,Kalvin Phillips,Leeds United,17.7,54,25,24,25,5,24,57,42.1,33,37,9,28,24,78,18,0
2200,Jaden Philogene Bidace,Aston Villa,0.1,0,0,0,0,0,0,0,0.0,0,0,0,0,0,0,0,0
2201,Jerome Phojo,Clermont Foot,0.1,0,0,0,0,0,0,0,0.0,0,0,0,0,0,0,1,0
2202,Krzysztof Piatek,Fiorentina,8.1,5,4,1,1,3,2,3,66.7,1,6,0,6,2,7,8,0
2203,Krzysztof Piatek,Hertha BSC,3.9,2,2,0,1,1,0,1,0.0,1,0,0,0,0,2,6,0
2204,Pablo Piatti,Elche,3.5,9,4,5,3,1,3,8,37.5,5,5,1,4,2,11,3,0
2205,Cristiano Piccini,Valencia,3.6,14,8,9,5,0,5,7,71.4,2,3,2,1,1,15,11,0
2206,Roberto Piccoli,Genoa,2.4,1,1,0,1,0,0,0,0.0,0,0,0,0,1,2,1,1
2207,Roberto Piccoli,Atalanta,2.2,2,0,0,0,2,0,2,0.0,2,1,0,1,0,2,0,0
2208,Jordan Pickford,Everton,35.0,1,1,1,0,0,0,1,0.0,1,1,0,1,1,2,14,1
2210,Jeremy Pied,Lille,0.1,0,0,0,0,0,0,0,0.0,0,0,0,0,1,1,0,0
2211,Amos Pieper,Arminia,26.4,58,29,38,19,1,32,51,62.7,19,37,23,14,50,108,132,1
2212,Ronael Pierre-Gabriel,Brest,28.3,79,45,52,21,6,42,73,57.5,31,22,7,15,48,127,74,0
2213,Erik Pieters,Burnley,8.1,28,15,15,11,2,17,28,60.7,11,18,7,11,10,38,38,0
2214,Tomas Pina Isla,Alavés,16.0,28,16,13,11,4,14,29,48.3,15,12,3,9,22,50,23,0
2215,Andrea Pinamonti,Empoli,31.9,11,6,0,7,4,2,18,11.1,16,24,3,21,7,18,23,0
2216,Orbelin Pineda,Celta Vigo,1.1,4,1,4,0,0,1,2,50.0,1,0,0,0,0,4,1,0
2217,Ethan Pinnock,Brentford,29.9,51,35,37,12,2,25,38,65.8,13,30,11,19,44,95,154,1
2218,Yeremi Pino,Villarreal,18.6,32,14,14,8,10,10,24,41.7,14,33,4,29,6,38,12,1
2219,Carlo Pinsoglio,Juventus,0.5,0,0,0,0,0,0,0,0.0,0,0,0,0,0,0,0,0
2220,Riccardo Pinzi,Udinese,0.0,0,0,0,0,0,0,0,0.0,0,0,0,0,0,0,0,0
2221,Gerard Pique,Barcelona,23.2,22,12,18,4,0,11,14,78.6,3,19,16,3,34,56,86,1
2222,Marko Pjaca,Torino,12.8,7,4,1,4,2,3,8,37.5,5,10,2,8,4,11,2,0
2223,Marvin Plattenhardt,Hertha BSC,18.2,25,11,18,6,1,15,27,55.6,12,18,3,15,17,42,52,0
2224,Alassane Plea,M'Gladbach,23.0,18,14,6,9,3,7,20,35.0,13,9,1,8,4,22,9,0
2225,Tommaso Pobega,Torino,24.9,48,30,17,20,11,21,40,52.5,19,32,3,29,25,73,38,0
2226,Daniel Podence,Wolves,16.5,18,11,10,5,3,4,17,23.5,13,8,1,7,10,28,1,0
2227,Suf Podgoreanu,Spezia,1.3,2,0,1,1,0,1,4,25.0,3,2,0,2,1,3,3,0
2228,Paul Pogba,Manchester Utd,15.0,13,9,5,7,1,6,28,21.4,22,11,0,11,13,26,16,0
2229,Joel Pohjanpalo,Leverkusen,0.1,0,0,0,0,0,0,0,0.0,0,0,0,0,0,0,0,0
2230,Matteo Politano,Napoli,18.3,24,12,8,11,5,15,54,27.8,39,11,2,9,13,37,5,0
2231,Julian Pollersbeck,Lyon,4.8,0,0,0,0,0,0,0,0.0,0,0,0,0,1,1,1,0
2232,Sebastian Polter,Bochum,26.0,9,3,1,4,4,2,11,18.2,9,15,5,10,2,11,24,0
2233,Ezequiel Ponce,Elche,7.4,5,4,1,3,1,3,10,30.0,7,5,0,5,1,6,7,0
2234,Marin Pongracic,Dortmund,9.2,17,10,13,4,0,6,10,60.0,4,11,5,6,17,34,32,2
2236,Pere Pons,Alavés,15.2,26,18,4,20,2,7,21,33.3,14,10,1,9,6,32,11,0
2237,Nick Pope,Burnley,36.0,0,0,0,0,0,0,2,0.0,2,0,0,0,2,2,30,3
2238,Manolo Portanova,Genoa,14.7,46,28,9,26,11,14,34,41.2,20,26,2,24,17,63,22,0
2239,Portu,Real Sociedad,17.7,16,7,2,6,8,3,19,15.8,16,21,3,18,7,23,8,0
2240,Stefan Posch,Hoffenheim,24.4,48,30,20,26,2,22,39,56.4,17,43,18,25,28,76,71,2
2241,Sergio Postigo,Levante,9.4,11,7,8,2,1,4,8,50.0,4,7,5,2,7,18,45,1
2242,Yussuf Poulsen,RB Leipzig,12.0,13,4,3,6,4,3,13,23.1,10,13,0,13,3,16,9,0
2243,Gaetan Poussin,Bordeaux,13.0,1,1,1,0,0,1,1,100.0,0,0,0,0,0,1,15,1
2244,Dario Poveda,Getafe,4.2,2,0,1,0,1,0,5,0.0,5,7,1,6,1,3,1,0
2245,Jose Pozo,Rayo Vallecano,0.8,2,2,0,2,0,2,3,66.7,1,1,0,1,0,2,1,0
2246,Dennis Praet,Torino,17.1,19,10,6,8,5,8,22,36.4,14,12,1,11,3,22,4,0
2247,Mateusz Praszelik,Hellas Verona,0.3,0,0,0,0,0,0,0,0.0,0,0,0,0,0,0,0,0
2248,Abdon Prats,Mallorca,7.1,2,2,1,0,1,1,5,20.0,4,5,0,5,1,3,6,0
2249,Sanjin Prcic,Strasbourg,24.3,47,28,14,27,6,14,29,48.3,15,18,3,15,47,94,19,0
2250,Nicolas de Preville,Metz,21.9,17,8,7,8,2,3,19,15.8,16,12,4,8,5,22,11,0
2251,Isaac Price,Everton,0.2,0,0,0,0,0,0,0,0.0,0,1,0,1,0,0,0,0
2252,Manuel Prietl,Arminia,23.6,59,26,23,31,5,23,60,38.3,37,28,3,25,39,98,33,0
2253,Alejandro Primo,Levante,1.0,0,0,0,0,0,0,0,0.0,0,0,0,0,0,0,0,0
2254,Grischa Promel,Union Berlin,26.9,36,22,14,17,5,22,52,42.3,30,18,3,15,23,59,22,0
2255,Nick Proschwitz,Hoffenheim,0.3,0,0,0,0,0,0,0,0.0,0,0,0,0,0,0,0,0
2256,Ivan Provedel,Spezia,30.7,0,0,0,0,0,0,1,0.0,1,0,0,0,2,2,10,2
2257,Javi Puado,Espanyol,24.9,24,14,18,5,1,12,37,32.4,25,18,2,16,11,35,24,0
2258,Pubill,Levante,5.7,12,6,10,2,0,4,8,50.0,4,7,2,5,4,16,8,2
2259,Antonio Puertas,Granada,25.1,34,20,18,12,4,17,44,38.6,27,33,3,30,11,45,36,0
2260,Riqui Puig,Barcelona,5.4,6,3,2,4,0,2,14,14.3,12,5,0,5,3,9,0,0
2262,Teemu Pukki,Norwich City,36.1,23,11,2,14,7,6,29,20.7,23,21,1,20,4,27,3,0
2263,Erick Pulgar,Fiorentina,3.8,6,6,4,2,0,4,9,44.4,5,5,1,4,5,11,2,1
2264,Christian Pulisic,Chelsea,14.3,10,7,6,3,1,3,17,17.6,14,12,0,12,5,15,10,0
2265,Afimico Pululu,Greuther Fürth,0.8,1,0,1,0,0,1,2,50.0,1,1,0,1,0,1,0,0
2266,Ignacio Pussetto,Udinese,13.4,17,9,2,9,6,2,10,20.0,8,18,2,16,4,21,13,0
2267,Niklas Pyyhtia,Bologna,0.2,0,0,0,0,0,0,1,0.0,1,0,0,0,0,0,0,0
2268,Przemyslaw Placheta,Norwich City,5.6,4,3,3,1,0,2,7,28.6,5,3,1,2,2,6,5,1
2269,Yacine Qasmi,Rayo Vallecano,0.0,0,0,0,0,0,0,0,0.0,0,0,0,0,0,0,0,0
2270,Fabio Quagliarella,Sampdoria,18.5,6,2,2,2,2,2,15,13.3,13,14,1,13,3,9,12,0
2271,Quini,Granada,25.6,73,34,48,21,4,42,79,53.2,37,28,10,18,36,109,62,0
2272,Dani Raba,Villarreal,1.0,1,0,0,1,0,1,2,50.0,1,2,0,2,0,1,2,0
2273,Dani Raba,Granada,0.3,2,2,1,0,1,2,3,66.7,1,0,0,0,1,3,0,0
2274,Adrien Rabiot,Juventus,25.4,64,43,32,24,8,15,34,44.1,19,34,8,26,20,84,41,1
2275,Uros Racic,Valencia,13.4,32,18,9,19,4,12,33,36.4,21,16,6,10,16,48,21,0
2276,Nemanja Radoja,Levante,13.5,25,8,9,13,3,8,20,40.0,12,16,9,7,22,47,16,2
2277,Nemanja Radonjic,Marseille,0.2,0,0,0,0,0,0,0,0.0,0,0,0,0,0,0,0,0
2278,Ivan Radovanovic,Salernitana,11.7,11,7,8,3,0,7,19,36.8,12,14,7,7,7,18,29,0
2279,Ionut Radu,Inter,1.0,0,0,0,0,0,0,0,0.0,0,0,0,0,0,0,0,1
2280,Stefan Radu,Lazio,6.2,9,6,3,6,0,5,9,55.6,4,7,2,5,5,14,15,0
2281,Boris Radunovic,Cagliari,3.0,0,0,0,0,0,0,0,0.0,0,0,0,0,0,0,0,0
2282,Sidney Raebiger,RB Leipzig,0.0,0,0,0,0,0,0,0,0.0,0,0,0,0,0,0,0,0
2283,Rafinha,Real Sociedad,11.7,43,27,17,20,6,16,28,57.1,12,21,2,19,12,55,4,0
2284,Rafinha,Paris S-G,2.4,14,8,3,9,2,7,11,63.6,4,3,0,3,4,18,0,0
2285,Antonio Raillo,Mallorca,17.0,16,7,10,4,2,5,6,83.3,1,17,14,3,18,34,81,0
2286,Antonio Raimondo,Bologna,0.8,0,0,0,0,0,0,1,0.0,1,1,0,1,0,0,1,0
2288,Predrag Rajkovic,Reims,38.0,2,2,2,0,0,2,3,66.7,1,1,0,1,1,3,21,1
2289,Jesuran Rak Sakyi,Crystal Palace,0.9,0,0,0,0,0,0,1,0.0,1,3,0,3,1,1,0,0
2290,Ivan Rakitic,Sevilla,24.2,40,22,12,23,5,13,40,32.5,27,31,8,23,23,63,35,0
2291,Diant Ramaj,Eint Frankfurt,1.0,0,0,0,0,0,0,0,0.0,0,0,0,0,0,0,3,0
2292,Jonas Ramalho,Osasuna,2.7,4,2,2,2,0,2,3,66.7,1,4,1,3,3,7,9,0
2293,Adil Rami,Troyes,13.0,10,9,6,4,0,7,8,87.5,1,17,9,8,16,26,43,0
2294,Sandro Ramirez,Getafe,16.2,7,3,1,3,3,1,12,8.3,11,14,3,11,2,9,3,0
2295,Guilherme Ramos,Arminia,10.1,25,15,17,8,0,12,19,63.2,7,21,8,13,27,52,52,0
2296,Sergio Ramos,Paris S-G,8.9,12,5,6,6,0,8,15,53.3,7,4,2,2,8,20,27,0
2297,Aaron Ramsdale,Arsenal,34.0,2,1,2,0,0,1,2,50.0,1,0,0,0,0,2,26,3
2298,Aaron Ramsey,Juventus,1.1,0,0,0,0,0,0,0,0.0,0,0,0,0,1,1,0,0
2299,Jacob Ramsey,Aston Villa,27.4,67,44,31,28,8,30,69,43.5,39,36,7,29,24,91,28,0
2300,Luca Ranieri,Salernitana,23.4,38,21,23,11,4,19,33,57.6,14,18,8,10,22,60,67,0
2301,Andrea Ranocchia,Inter,3.8,8,4,5,1,2,1,3,33.3,2,4,3,1,4,12,16,0
2302,Raphinha,Leeds United,32.4,51,29,25,14,12,22,71,31.0,49,43,0,43,29,80,28,1
2303,Tobias Raschl,Greuther Fürth,6.6,12,9,4,8,0,5,7,71.4,2,10,1,9,3,15,1,0
2304,Elba Rashani,Clermont Foot,19.5,40,21,15,21,4,17,55,30.9,38,34,3,31,11,51,20,0
2305,Marcus Rashford,Manchester Utd,13.7,6,5,1,4,1,2,13,15.4,11,10,1,9,5,11,5,1
2306,Milot Rashica,Norwich City,24.8,31,19,12,12,7,11,30,36.7,19,22,3,19,15,46,23,0
2307,Giacomo Raspadori,Sassuolo,30.4,29,18,5,15,9,11,38,28.9,27,29,3,26,9,38,11,0
2308,Raul,Betis,0.0,0,0,0,0,0,0,0,0.0,0,0,0,0,0,0,0,0
2309,David Raum,Hoffenheim,30.6,52,29,30,10,12,30,64,46.9,34,38,5,33,27,79,39,1
2310,Nicola Ravaglia,Sampdoria,0.1,0,0,0,0,0,0,0,0.0,0,0,0,0,0,0,0,0
2311,David Raya,Brentford,24.0,0,0,0,0,0,0,0,0.0,0,1,0,1,0,0,10,1
2312,Ante Rebic,Milan,9.9,14,8,3,6,5,7,20,35.0,13,14,0,14,3,17,3,1
2314,Arkadiusz Reca,Spezia,19.7,31,19,21,3,7,20,30,66.7,10,20,7,13,32,63,47,2
2315,Lluis Recasens,Espanyol,0.5,2,0,2,0,0,1,1,100.0,0,0,0,0,2,4,2,0
2316,Nathan Redmond,Southampton,20.4,22,14,9,9,4,7,30,23.3,23,21,2,19,8,30,16,0
2317,Sergio Reguilon,Tottenham,21.3,40,24,15,18,7,22,43,51.2,21,20,8,12,31,71,45,1
2318,Manolo Reina,Mallorca,21.0,0,0,0,0,0,0,0,0.0,0,0,0,0,1,1,6,2
2319,Pepe Reina,Lazio,15.0,0,0,0,0,0,0,1,0.0,1,0,0,0,0,0,1,1
2320,Jeff Reine-Adelaide,Lyon,2.2,5,3,4,1,0,4,5,80.0,1,2,0,2,0,5,0,1
2321,Reinier,Dortmund,1.8,5,3,4,0,1,1,1,100.0,0,3,0,3,0,5,0,0
2322,Karim Rekik,Sevilla,12.2,11,8,4,6,1,2,9,22.2,7,11,6,5,9,20,19,0
2323,Alex Remiro,Real Sociedad,35.0,0,0,0,0,0,0,0,0.0,0,0,0,0,1,1,24,2
2324,Panagiotis Retsos,Hellas Verona,0.6,0,0,0,0,0,0,2,0.0,2,0,0,0,2,2,3,0
2325,Panagiotis Retsos,Leverkusen,0.4,0,0,0,0,0,0,0,0.0,0,0,0,0,1,1,0,1
2326,Marco Reus,Dortmund,27.8,45,30,13,21,11,16,42,38.1,26,23,6,17,12,57,41,1
2327,Elvis Rexhbecaj,Bochum,28.2,41,20,17,19,5,19,40,47.5,21,41,6,35,27,68,15,0
2328,Gio Reyna,Dortmund,4.9,7,4,2,4,1,3,9,33.3,6,6,0,6,1,8,3,0
2329,Bryan Reynolds,Roma,0.0,0,0,0,0,0,0,1,0.0,1,0,0,0,0,0,1,0
2330,Nico Ribaudo,Espanyol,12.4,15,6,9,5,1,11,34,32.4,23,14,2,12,7,22,3,0
2331,Tiago Ribeiro,Monaco,0.0,0,0,0,0,0,0,0,0.0,0,0,0,0,0,0,0,0
2332,Franck Ribery,Salernitana,15.8,17,10,6,6,5,8,13,61.5,5,12,0,12,3,20,1,0
2333,Samuele Ricci,Torino,8.0,8,4,4,2,2,2,5,40.0,3,7,1,6,14,22,9,0
2334,Samuele Ricci,Empoli,17.0,33,19,17,13,3,20,34,58.8,14,24,5,19,31,64,18,0
2335,Declan Rice,West Ham,35.3,80,42,45,32,3,38,71,53.5,33,45,21,24,63,143,52,1
2336,Chris Richards,Hoffenheim,14.5,26,15,10,15,1,11,18,61.1,7,21,9,12,22,48,50,1
2337,Chris Richards,Bayern Munich,0.0,0,0,0,0,0,0,0,0.0,0,1,0,1,0,0,0,0
2338,Omar Richards,Bayern Munich,4.9,19,12,11,5,3,11,16,68.8,5,7,1,6,4,23,7,0
2340,Taylor Richards,Brighton,0.3,1,0,0,1,0,1,2,50.0,1,0,0,0,0,1,0,0
2341,Richarlison,Everton,28.0,40,23,18,15,7,15,31,48.4,16,42,4,38,12,52,34,0
2342,Marco Richter,Hertha BSC,18.9,30,16,14,10,6,13,36,36.1,23,30,4,26,16,46,24,0
2343,Diego Rico,Real Sociedad,18.3,41,20,19,17,5,22,45,48.9,23,29,4,25,30,71,54,0
2344,Sergio Rico,Mallorca,14.0,0,0,0,0,0,0,0,0.0,0,0,0,0,0,0,5,2
2345,Sergio Rico,Paris S-G,0.3,0,0,0,0,0,0,0,0.0,0,0,0,0,0,0,1,0
2346,Jairo Riedewald,Crystal Palace,1.3,1,1,0,1,0,1,2,50.0,1,1,0,1,1,2,2,0
2347,Manuel Riemann,Bochum,31.0,1,0,1,0,0,1,4,25.0,3,0,0,0,1,2,12,3
2348,Tomas Rincon,Torino,1.8,2,2,2,0,0,0,3,0.0,3,3,1,2,2,4,4,0
2349,Tomas Rincon,Sampdoria,13.0,22,13,9,10,3,13,34,38.2,21,15,2,13,18,40,11,0
2350,Luis Rioja,Alavés,34.6,28,15,11,10,7,14,58,24.1,44,22,1,21,25,53,20,0
2351,Renaud Ripart,Troyes,21.0,38,21,18,15,5,18,50,36.0,32,21,1,20,19,57,21,1
2352,Mihailo Ristic,Montpellier,20.0,44,32,26,16,2,25,43,58.1,18,16,6,10,17,61,48,0
2353,Matt Ritchie,Newcastle Utd,14.9,22,15,10,10,2,10,27,37.0,17,10,2,8,13,35,26,0
2354,Maxence Rivera,Saint-Étienne,0.1,0,0,0,0,0,0,0,0.0,0,0,0,0,0,0,0,0
2355,Rober,Levante,22.3,36,20,27,7,2,23,39,59.0,16,25,15,10,30,66,90,1
2356,Sergi Roberto,Barcelona,4.4,5,1,2,3,0,3,5,60.0,2,2,0,2,4,9,6,0
2357,Connor Roberts,Burnley,18.8,20,13,10,7,3,10,15,66.7,5,25,5,20,22,42,62,1
2358,Patrick Roberts,Troyes,0.2,0,0,0,0,0,0,0,0.0,0,0,0,0,0,0,0,0
2359,Tyler Roberts,Leeds United,11.0,16,7,6,7,3,9,16,56.3,7,11,1,10,5,21,11,0
2360,Andrew Robertson,Liverpool,28.2,36,21,16,15,5,20,35,57.1,15,24,3,21,23,59,61,0
2361,Marc Roca,Bayern Munich,4.2,9,7,2,4,3,2,8,25.0,6,6,0,6,6,15,4,0
2362,Ruben Rochina,Granada,8.3,21,13,7,8,6,8,28,28.6,20,11,1,10,6,27,5,1
2363,Cimo Rocker,Hertha BSC,0.2,0,0,0,0,0,0,0,0.0,0,0,0,0,2,2,0,0
2364,Enzo Roco,Elche,28.4,36,20,24,11,1,15,24,62.5,9,38,27,11,28,64,110,3
2366,Stian Rode Gregersen,Bordeaux,21.7,39,26,23,12,4,18,33,54.5,15,26,16,10,38,77,103,2
2367,Sebastian Rode,Eint Frankfurt,8.4,15,7,5,8,2,5,17,29.4,12,11,1,10,13,28,8,0
2368,Joe Rodon,Tottenham,1.0,0,0,0,0,0,0,0,0.0,0,2,1,1,0,0,7,0
2369,Rodri,Manchester City,32.0,72,43,24,38,10,32,59,54.2,27,28,5,23,28,100,45,0
2370,Rodri,Betis,9.8,10,7,4,5,1,5,22,22.7,17,11,0,11,3,13,4,0
2371,Rodrigo,Leeds United,25.2,20,9,7,6,7,4,32,12.5,28,12,0,12,11,31,27,1
2372,Gerson Rodrigues,Troyes,9.4,12,9,2,6,4,1,17,5.9,16,8,1,7,0,12,2,0
2373,Kevin Rodrigues,Rayo Vallecano,4.8,15,11,8,7,0,6,10,60.0,4,10,1,9,7,22,6,0
2374,Angel Rodriguez,Mallorca,17.2,15,9,6,7,2,4,21,19.0,17,15,1,14,3,18,13,0
2375,Oscar Rodriguez Arnaiz,Getafe,10.5,16,11,6,8,2,4,12,33.3,8,7,1,6,11,27,6,0
2376,Oscar Rodriguez Arnaiz,Sevilla,4.6,4,3,1,3,0,2,3,66.7,1,2,0,2,5,9,7,1
2377,Dani Rodriguez,Mallorca,31.5,53,31,20,24,9,15,46,32.6,31,28,3,25,20,73,27,0
2378,Guido Rodriguez,Betis,28.1,97,53,46,45,6,54,98,55.1,44,55,12,43,31,128,56,0
2379,Jay Rodriguez,Burnley,15.4,20,12,8,8,4,4,14,28.6,10,19,1,18,4,24,12,0
2380,Ricardo Rodriguez,Torino,27.5,36,21,11,23,2,18,33,54.5,15,22,8,14,41,77,48,1
2381,Rodrygo,Real Madrid,16.9,18,14,7,4,7,3,18,16.7,15,21,0,21,11,29,3,0
2382,Mads Roerslev,Brentford,13.8,23,12,19,2,2,14,32,43.8,18,14,5,9,16,39,29,0
2383,Marko Rog,Cagliari,3.5,5,3,1,2,2,1,8,12.5,7,6,1,5,1,6,3,0
2384,Rogerio,Sassuolo,19.2,21,13,12,5,4,15,22,68.2,7,20,8,12,18,39,42,1
2385,Alessio Romagnoli,Milan,15.7,24,14,14,10,0,14,18,77.8,4,21,12,9,19,43,45,0
2386,Simone Romagnoli,Empoli,16.6,28,12,14,12,2,15,20,75.0,5,34,28,6,9,37,86,0
2387,Leonardo Roman,Mallorca,2.0,0,0,0,0,0,0,0,0.0,0,0,0,0,0,0,2,0
2388,Cristian Romero,Tottenham,20.5,62,39,39,21,2,22,34,64.7,12,46,21,25,33,95,74,1
2389,Ivan Romero,Sevilla,2.0,2,2,0,2,0,0,0,0.0,0,1,0,1,2,4,0,0
2390,Luka Romero,Lazio,0.9,2,1,0,1,1,0,2,0.0,2,0,0,0,1,3,0,0
2392,Sergio Romero,Venezia,16.0,2,2,2,0,0,2,2,100.0,0,0,0,0,1,3,10,0
2393,Oriol Romeu,Southampton,32.1,77,39,25,45,7,28,73,38.4,45,39,8,31,51,128,43,0
2394,Cristiano Ronaldo,Manchester Utd,27.3,8,6,1,5,2,2,6,33.3,4,8,0,8,2,10,29,0
2395,Cristiano Ronaldo,Juventus,0.3,1,0,0,1,0,1,1,100.0,0,0,0,0,0,1,0,0
2396,Salomon Rondon,Everton,8.8,6,1,1,2,3,4,14,28.6,10,5,0,5,0,6,10,0
2397,Valentin Rongier,Marseille,24.4,77,51,36,36,5,28,60,46.7,32,26,5,21,33,110,14,0
2398,Marten de Roon,Atalanta,28.3,69,42,33,29,7,34,62,54.8,28,36,2,34,45,114,41,0
2399,Unai Ropero,Alavés,0.1,0,0,0,0,0,0,0,0.0,0,0,0,0,1,1,0,0
2400,Pablo Rosario,Nice,30.3,59,37,18,32,9,26,66,39.4,40,33,7,26,38,97,43,0
2401,Romario Rosch,Mainz 05,0.0,0,0,0,0,0,0,0,0.0,0,0,0,0,0,0,0,0
2402,Danny Rose,Watford,7.7,16,10,11,4,1,10,24,41.7,14,8,5,3,14,30,11,1
2403,Francesco Rossi,Atalanta,0.4,0,0,0,0,0,0,0,0.0,0,0,0,0,0,0,0,0
2404,Tom Rothe,Dortmund,1.0,4,3,2,2,0,3,6,50.0,3,2,0,2,2,6,3,0
2405,Jerome Roussillon,Wolfsburg,19.7,14,9,8,6,0,10,16,62.5,6,24,5,19,14,28,34,2
2406,Nicolo Rovella,Genoa,16.3,37,26,16,14,7,15,40,37.5,25,21,1,20,20,57,20,0
2407,Jon Rowe,Norwich City,2.5,3,2,2,1,0,2,3,66.7,1,7,0,7,3,6,1,0
2408,Amir Rrahmani,Napoli,32.5,21,11,15,5,1,15,19,78.9,4,36,25,11,19,40,89,0
2409,Ruan,Sassuolo,2.4,7,4,7,0,0,3,4,75.0,1,6,5,1,2,9,24,1
2410,Ruben,Espanyol,1.7,6,1,4,2,0,4,7,57.1,3,0,0,0,2,8,4,0
2411,John Ruddy,Wolves,1.5,0,0,0,0,0,0,0,0.0,0,0,0,0,0,0,3,0
2412,Antonio Rudiger,Chelsea,33.7,48,28,29,15,4,36,48,75.0,12,20,11,9,28,76,91,1
2413,Sebastian Rudy,Hoffenheim,8.6,22,12,9,13,0,11,21,52.4,10,8,3,5,11,33,8,1
2414,Daniele Rugani,Juventus,9.8,8,5,4,4,0,4,7,57.1,3,9,4,5,11,19,47,0
2415,Matteo Ruggeri,Salernitana,7.5,8,4,5,2,1,7,10,70.0,3,6,1,5,2,10,25,0
2416,Mario Rui,Napoli,33.2,68,43,32,28,8,39,84,46.4,45,31,7,24,40,108,50,0
2418,Aitor Ruibal,Betis,9.5,21,15,13,3,5,10,34,29.4,24,8,0,8,8,29,6,0
2419,Isma Ruiz,Granada,3.1,3,1,3,0,0,1,9,11.1,8,5,2,3,3,6,2,0
2420,Fabian Ruiz Pena,Napoli,26.5,55,33,22,29,4,29,67,43.3,38,34,1,33,22,77,32,0
2421,Victor Ruiz,Betis,15.8,11,9,7,2,2,6,9,66.7,3,18,13,5,29,40,71,1
2422,Geronimo Rulli,Villarreal,32.0,0,0,0,0,0,0,4,0.0,4,0,0,0,1,1,15,5
2423,Lukas Rupp,Norwich City,8.5,9,4,5,3,1,4,15,26.7,11,11,1,10,9,18,7,0
2424,Alessandro Russo,Salernitana,0.3,1,0,1,0,0,0,1,0.0,1,0,0,0,0,1,1,0
2425,Franco Russo,Mallorca,16.3,19,10,10,9,0,13,31,41.9,18,14,9,5,27,46,73,1
2426,Georginio Rutter,Hoffenheim,17.9,18,13,4,8,6,6,17,35.3,11,29,1,28,6,24,11,1
2427,Mathew Ryan,Real Sociedad,3.0,0,0,0,0,0,0,0,0.0,0,0,0,0,0,0,2,0
2428,Julian Ryerson,Union Berlin,15.9,27,15,11,12,4,17,25,68.0,8,12,4,8,16,43,32,0
2429,Frederik Ronnow,Union Berlin,7.0,0,0,0,0,0,0,0,0.0,0,0,0,0,0,0,1,0
2430,Jose Sa,Wolves,36.5,2,1,2,0,0,2,4,50.0,2,0,0,0,2,4,19,5
2431,Roli Pereira de Sa,Nantes,6.4,12,4,3,5,4,3,20,15.0,17,6,0,6,6,18,3,0
2432,Youssouf Sabaly,Betis,8.8,12,10,11,0,1,7,13,53.8,6,11,4,7,13,25,16,1
2433,Mathys Saban,Saint-Étienne,0.8,4,2,2,2,0,1,1,100.0,0,1,0,1,0,4,0,0
2434,Stefano Sabelli,Genoa,3.9,6,3,3,2,1,3,9,33.3,6,5,1,4,3,9,12,0
2435,Abdelhamid Sabiri,Sampdoria,9.9,34,18,10,15,9,7,25,28.0,18,10,2,8,7,41,3,0
2436,Marcel Sabitzer,RB Leipzig,0.5,2,1,1,1,0,1,1,100.0,0,0,0,0,1,3,0,0
2437,Marcel Sabitzer,Bayern Munich,10.1,18,7,8,8,2,9,19,47.4,10,7,0,7,9,27,10,1
2438,Falaye Sacko,Saint-Étienne,7.4,15,10,14,1,0,13,16,81.3,3,11,7,4,4,19,18,2
2439,Alexis Saelemaekers,Milan,20.7,43,22,12,17,14,15,51,29.4,36,19,0,19,15,58,8,0
2440,Rafiki Said,Brest,1.4,4,3,1,2,1,3,4,75.0,1,2,0,2,0,4,0,0
2441,Wesley Said,Lens,7.3,10,5,1,8,1,1,9,11.1,8,4,0,4,2,12,0,0
2442,Allan Saint-Maximin,Newcastle Utd,31.2,13,8,6,4,3,3,17,17.6,14,13,2,11,11,24,3,0
2444,Romain Saiss,Wolves,30.1,40,27,28,11,1,19,33,57.6,14,41,21,20,58,98,158,2
2445,Bukayo Saka,Arsenal,33.1,40,21,12,17,11,13,39,33.3,26,28,2,26,22,62,23,0
2446,Mamadou Sakho,Montpellier,28.6,34,22,26,8,0,16,26,61.5,10,41,34,7,41,75,134,4
2447,Bakary Sako,Saint-Étienne,1.7,0,0,0,0,0,0,1,0.0,1,3,1,2,0,0,0,0
2448,Jacopo Sala,Spezia,9.8,22,11,10,10,2,13,30,43.3,17,6,0,6,14,36,11,0
2449,Mohamed Salah,Liverpool,30.7,17,8,5,9,3,6,19,31.6,13,7,1,6,6,23,5,0
2450,Eddie Salcedo,Spezia,4.8,1,1,0,0,1,0,1,0.0,1,2,1,1,0,1,7,1
2451,William Saliba,Marseille,36.0,54,32,36,16,2,27,35,77.1,8,24,16,8,48,102,85,0
2452,Romain Salin,Rennes,1.0,0,0,0,0,0,0,0,0.0,0,0,0,0,0,0,0,0
2453,Mohammed Salisu,Southampton,33.0,80,47,54,22,4,40,65,61.5,25,49,26,23,78,158,158,4
2454,Roland Sallai,Freiburg,17.2,22,16,8,11,3,7,23,30.4,16,12,0,12,11,33,12,0
2455,Yoann Salmier,Troyes,29.6,58,33,44,11,3,26,34,76.5,8,30,14,16,40,98,94,0
2456,Salvi,Cádiz,15.5,20,10,9,8,3,8,20,40.0,12,17,2,15,6,26,11,0
2457,Lazar Samardzic,Udinese,5.4,13,9,4,7,2,7,26,26.9,19,6,0,6,2,15,2,0
2458,Diadie Samassekou,Hoffenheim,18.4,41,26,14,21,6,21,44,47.7,23,27,11,16,28,69,26,0
2459,Mama Samba Balde,Troyes,19.1,40,28,16,14,10,8,26,30.8,18,32,1,31,5,45,9,0
2460,Albert Sambi Lokonga,Arsenal,12.6,22,18,11,9,2,12,14,85.7,2,12,7,5,13,35,12,4
2461,Junior Sambia,Montpellier,17.0,22,13,12,7,3,13,22,59.1,9,22,3,19,21,43,31,0
2462,Luigi Samele,Sassuolo,0.1,0,0,0,0,0,0,0,0.0,0,0,0,0,0,0,1,0
2463,Fede San Emeterio,Cádiz,9.2,16,5,5,8,3,5,15,33.3,10,5,0,5,8,24,6,0
2464,Antonio Sanabria,Torino,20.0,3,2,0,1,2,1,4,25.0,3,11,4,7,2,5,10,0
2465,Oihan Sancet,Athletic Club,15.8,12,7,2,8,2,5,20,25.0,15,2,0,2,5,17,13,0
2466,Renato Sanches,Lille,18.3,19,7,8,10,1,9,26,34.6,17,14,3,11,14,33,7,0
2467,Alexis Sanchez,Inter,9.8,9,8,0,6,3,2,11,18.2,9,4,0,4,2,11,3,0
2468,Antonio Sanchez,Mallorca,18.0,53,24,29,17,7,19,49,38.8,30,32,2,30,32,85,32,1
2470,Davinson Sanchez,Tottenham,18.1,41,22,25,14,2,19,28,67.9,9,24,16,8,30,71,54,3
2471,German Sanchez,Granada,25.5,27,19,18,9,0,11,20,55.0,9,19,16,3,28,55,137,0
2472,Manu Sanchez,Osasuna,25.1,72,34,41,22,9,43,79,54.4,36,28,3,25,18,90,43,0
2473,Robert Sanchez,Brighton,37.0,2,1,2,0,0,1,1,100.0,0,1,0,1,0,2,11,4
2474,Jadon Sancho,Manchester Utd,21.1,14,8,9,4,1,8,22,36.4,14,19,0,19,15,29,5,3
2475,Philippe Sandler,Troyes,0.8,0,0,0,0,0,0,0,0.0,0,1,1,0,3,3,6,0
2476,Alex Sandro,Juventus,19.8,27,16,15,9,3,11,25,44.0,14,17,6,11,27,54,40,0
2477,Leroy Sane,Bayern Munich,22.0,28,16,5,19,4,9,24,37.5,15,18,0,18,12,40,2,1
2478,Oier Sanjurjo,Osasuna,8.4,10,6,3,7,0,2,19,10.5,17,8,3,5,1,11,9,0
2479,Mohamed Sankoh,Stuttgart,0.0,0,0,0,0,0,0,0,0.0,0,0,0,0,0,0,0,0
2480,Morgan Sanson,Aston Villa,4.0,12,8,7,2,3,3,7,42.9,4,13,0,13,10,22,2,1
2481,Nicola Sansone,Bologna,10.0,13,7,5,6,2,3,15,20.0,12,1,0,1,4,17,2,0
2482,Baptiste Santamaria,Rennes,28.0,52,27,15,31,6,24,44,54.5,20,33,12,21,33,85,42,0
2483,Baptiste Santamaria,Freiburg,0.2,0,0,0,0,0,0,1,0.0,1,0,0,0,1,1,1,0
2484,Federico Santander,Bologna,0.7,2,1,1,1,0,1,1,100.0,0,0,0,0,0,2,0,0
2485,Jesus Santiago,Valencia,0.9,2,2,1,1,0,0,2,0.0,2,1,0,1,0,2,1,0
2486,Samir Santos,Watford,18.6,24,11,18,6,0,8,19,42.1,11,21,11,10,43,67,85,3
2487,Samir Santos,Udinese,15.8,36,16,22,13,1,15,25,60.0,10,21,7,14,42,78,62,0
2488,Sergio Santos,Real Madrid,0.1,0,0,0,0,0,0,0,0.0,0,0,0,0,0,0,0,0
2489,Alvaro Sanz,Barcelona,0.3,0,0,0,0,0,0,1,0.0,1,0,0,0,0,0,0,0
2490,Riccardo Saponara,Fiorentina,14.3,10,2,1,6,3,6,16,37.5,10,5,0,5,1,11,3,0
2491,Pablo Sarabia,Paris S-G,0.2,0,0,0,0,0,0,1,0.0,1,0,0,0,0,0,0,0
2492,Marcelo Saracchi,Levante,2.1,8,5,6,1,1,2,4,50.0,2,3,0,3,4,12,7,1
2493,Josh Sargent,Norwich City,17.5,26,14,15,7,4,14,39,35.9,25,29,2,27,11,37,18,2
2494,Jeremy Sarmiento,Brighton,0.5,1,1,0,0,1,0,2,0.0,2,2,0,2,0,1,0,0
2496,Bouna Sarr,Bayern Munich,0.7,4,4,2,1,1,4,5,80.0,1,2,1,1,6,10,1,0
2497,Ismaila Sarr,Watford,20.7,12,7,4,3,5,5,19,26.3,14,10,1,9,9,21,10,0
2498,Malang Sarr,Chelsea,6.1,14,7,10,2,2,7,12,58.3,5,6,3,3,11,25,20,0
2499,Joan Sastre Vanrell,Mallorca,2.9,6,3,5,0,1,3,4,75.0,1,3,0,3,2,8,10,0
2500,Giacomo Satalino,Sassuolo,0.1,0,0,0,0,0,0,0,0.0,0,0,0,0,0,0,0,0
2501,Martin Satriano,Inter,0.4,1,0,0,0,1,1,1,100.0,0,0,0,0,0,1,0,0
2502,Martin Satriano,Brest,10.4,5,2,1,1,3,2,7,28.6,5,8,0,8,2,7,3,0
2503,Teji Savanier,Montpellier,26.8,46,27,18,19,9,21,59,35.6,38,23,1,22,25,71,12,1
2504,Esteban Saveljich,Rayo Vallecano,18.9,18,11,11,7,0,9,15,60.0,6,20,12,8,16,34,69,0
2505,Stefan Savic,Atlético Madrid,27.1,46,20,25,20,1,29,43,67.4,14,19,12,7,37,83,102,1
2506,Joe Scally,M'Gladbach,21.2,40,30,21,14,5,17,41,41.5,24,27,4,23,22,62,38,0
2507,Giorgio Scalvini,Atalanta,8.5,22,11,13,8,1,9,19,47.4,10,12,1,11,22,44,16,0
2508,Gianluca Scamacca,Sassuolo,23.8,19,14,2,5,12,5,21,23.8,16,16,1,15,5,24,22,1
2509,Dane Scarlett,Tottenham,0.0,0,0,0,0,0,0,0,0.0,0,0,0,0,0,0,0,0
2510,Kevin Schade,Freiburg,9.2,9,7,6,2,1,3,10,30.0,7,15,3,12,3,12,16,0
2511,Andras Schafer,Union Berlin,2.7,4,1,3,1,0,0,5,0.0,5,7,1,6,2,6,4,0
2512,Fabian Schar,Newcastle Utd,24.0,16,11,11,3,2,8,16,50.0,8,27,18,9,32,48,95,2
2513,Louis Schaub,Köln,7.3,16,10,7,7,2,11,20,55.0,9,17,3,14,3,19,3,0
2514,Andrea Schiavone,Salernitana,6.3,14,8,5,9,0,10,23,43.5,13,13,3,10,8,22,12,0
2515,Patrik Schick,Leverkusen,23.1,5,2,2,2,1,1,9,11.1,8,6,1,5,3,8,28,0
2516,Kingsley Schindler,Köln,3.9,1,0,0,0,1,1,5,20.0,4,5,1,4,5,6,5,0
2517,Xaver Schlager,Wolfsburg,11.6,43,20,20,20,3,20,49,40.8,29,25,2,23,9,52,14,0
2518,Keven Schlotterbeck,Freiburg,3.5,11,5,6,5,0,5,6,83.3,1,7,4,3,11,22,24,1
2519,Nico Schlotterbeck,Freiburg,30.9,72,43,36,34,2,33,48,68.8,15,41,32,9,56,128,154,1
2520,Jeffrey Schlupp,Crystal Palace,20.6,46,25,16,23,7,24,50,48.0,26,39,9,30,18,64,32,0
2522,Kasper Schmeichel,Leicester City,37.0,0,0,0,0,0,0,2,0.0,2,0,0,0,1,1,15,2
2523,Jonathan Schmid,Freiburg,6.5,12,6,6,3,3,5,7,71.4,2,7,1,6,6,18,15,0
2524,Benno Schmitz,Köln,26.9,57,37,21,27,9,42,86,48.8,44,44,8,36,39,96,39,0
2525,David Schnegg,Venezia,1.6,2,0,1,1,0,1,3,33.3,2,4,0,4,3,5,6,0
2526,Morgan Schneiderlin,Nice,7.2,21,12,9,11,1,6,13,46.2,7,8,2,6,20,41,18,0
2527,Alessandro Schopf,Arminia,26.6,40,22,19,16,5,14,30,46.7,16,31,5,26,30,70,21,1
2528,Jerdy Schouten,Bologna,15.5,25,17,10,12,3,9,22,40.9,13,22,5,17,33,58,29,1
2529,Nico Schulz,Dortmund,9.3,21,12,9,7,5,9,21,42.9,12,8,1,7,11,32,8,0
2530,Marvin Schwabe,Köln,21.0,0,0,0,0,0,0,0,0.0,0,0,0,0,0,0,8,1
2531,Alexander Schwolow,Hertha BSC,24.2,0,0,0,0,0,0,1,0.0,1,0,0,0,2,2,18,3
2532,Valentino Scotta,Sevilla,0.0,0,0,0,0,0,0,0,0.0,0,0,0,0,0,0,0,0
2533,Demba Seck,Torino,1.6,2,1,0,2,0,0,0,0.0,0,0,0,0,0,2,0,0
2534,Aleksandar Sedlar,Mallorca,4.5,5,3,4,1,0,3,5,60.0,2,4,4,0,5,10,19,0
2535,Paul Seguin,Greuther Fürth,23.4,50,31,15,32,3,26,56,46.4,30,27,3,24,19,69,30,1
2536,Alidu Seidu,Clermont Foot,15.7,34,20,20,13,1,16,27,59.3,11,25,11,14,34,68,49,1
2537,Davie Selke,Hertha BSC,11.2,5,4,1,3,1,1,3,33.3,2,6,1,5,1,6,11,0
2538,Matz Sels,Strasbourg,37.0,1,1,1,0,0,0,0,0.0,0,0,0,0,1,2,22,0
2539,Ken Sema,Watford,9.5,16,6,11,4,1,9,20,45.0,11,10,0,10,5,21,11,0
2540,Nelson Semedo,Wolves,23.7,58,39,39,17,2,25,49,51.0,24,23,4,19,21,79,64,1
2541,Lion Semic,Dortmund,0.0,0,0,0,0,0,0,0,0.0,0,0,0,0,0,0,0,0
2542,Adrian Semper,Genoa,1.0,0,0,0,0,0,0,0,0.0,0,0,0,0,0,0,0,0
2543,Stefano Sensi,Sampdoria,8.4,18,9,10,6,2,10,23,43.5,13,2,0,2,6,24,4,0
2544,Stefano Sensi,Inter,1.9,4,3,1,3,0,2,4,50.0,2,2,0,2,0,4,2,0
2545,Luigi Sepe,Salernitana,15.5,0,0,0,0,0,0,0,0.0,0,0,0,0,1,1,3,0
2546,Suat Serdar,Hertha BSC,24.6,64,30,24,29,11,25,55,45.5,30,32,3,29,20,84,14,0
2548,Laurens Serpe,Genoa,0.5,1,0,1,0,0,1,2,50.0,1,0,0,0,0,1,1,0
2549,Janni Serra,Arminia,12.4,4,2,2,0,2,2,7,28.6,5,8,3,5,5,9,19,0
2550,Javier Serrano,Atlético Madrid,0.8,3,1,0,3,0,2,4,50.0,2,0,0,0,3,6,2,0
2551,Nicolas Serrano,Athletic Club,3.5,9,6,3,5,1,3,10,30.0,7,5,1,4,2,11,3,0
2552,Zidan Sertdemir,Leverkusen,0.2,2,2,2,0,0,0,0,0.0,0,0,0,0,0,2,0,0
2553,Ryan Sessegnon,Tottenham,11.6,25,19,14,7,4,11,22,50.0,11,18,3,15,7,32,26,0
2554,Nils Seufert,Greuther Fürth,1.1,3,2,1,1,1,0,1,0.0,1,0,0,0,0,3,0,0
2555,Salva Sevilla,Mallorca,16.7,18,12,8,8,2,6,17,35.3,11,12,6,6,14,32,11,0
2556,Stephan El Shaarawy,Roma,11.7,13,8,4,9,0,4,6,66.7,2,10,2,8,11,24,8,0
2557,Jamie Shackleton,Leeds United,7.9,27,16,19,7,1,13,25,52.0,12,11,7,4,8,35,12,1
2558,Xherdan Shaqiri,Lyon,7.5,7,3,0,5,2,2,10,20.0,8,2,0,2,2,9,2,0
2559,Luke Shaw,Manchester Utd,17.8,21,13,9,9,3,12,21,57.1,9,22,11,11,9,30,22,2
2560,Jonjo Shelvey,Newcastle Utd,22.0,30,17,12,18,0,14,34,41.2,20,22,7,15,22,52,20,2
2561,Aimar Sher,Spezia,0.5,2,1,1,1,0,0,1,0.0,1,1,0,1,3,5,1,0
2562,Eldor Shomurodov,Roma,8.7,5,4,0,4,1,1,10,10.0,9,8,0,8,2,7,5,0
2563,Shola Shoretire,Manchester Utd,0.2,0,0,0,0,0,0,0,0.0,0,0,0,0,0,0,0,0
2564,Mahame Siby,Strasbourg,0.2,0,0,0,0,0,0,0,0.0,0,0,0,0,1,1,2,0
2565,Aboubakar Sidibe,Clermont Foot,0.1,0,0,0,0,0,0,0,0.0,0,0,0,0,0,0,0,0
2566,Alassane Sidibe,Atalanta,0.1,1,1,1,0,0,0,0,0.0,0,0,0,0,0,1,0,0
2567,Djibril Sidibe,Monaco,10.5,24,13,13,8,3,9,24,37.5,15,10,1,9,16,40,13,0
2568,Kaj Sierhuis,Reims,0.9,1,1,1,0,0,1,3,33.3,2,0,0,0,0,1,1,0
2569,Francisco Sierralta,Watford,4.7,7,3,7,0,0,5,8,62.5,3,7,2,5,6,13,35,0
2570,Arnor Sigurdsson,Venezia,2.0,1,1,0,1,0,1,2,50.0,1,2,0,2,1,2,0,0
2571,Kiliann Sildillia,Freiburg,1.9,7,3,3,4,0,3,6,50.0,3,1,0,1,2,9,7,1
2572,Adrien Silva,Sampdoria,12.0,24,12,14,5,5,9,33,27.3,24,15,5,10,23,47,23,0
2574,Andre Silva,RB Leipzig,23.1,13,9,2,3,8,4,13,30.8,9,20,2,18,2,15,15,0
2575,Bernardo Silva,Manchester City,31.7,57,29,19,19,19,31,67,46.3,36,24,2,22,20,77,19,0
2576,Caio Henrique Oliveira Silva,Monaco,29.6,53,30,31,18,4,28,59,47.5,31,30,6,24,27,80,37,3
2577,David Silva,Real Sociedad,19.1,28,17,10,11,7,3,20,15.0,17,13,3,10,7,35,12,0
2578,Fabio Silva,Wolves,6.4,3,2,0,2,1,0,8,0.0,8,2,0,2,1,4,1,0
2579,Gabriel Silva,Saint-Étienne,7.9,12,7,7,2,3,9,13,69.2,4,9,3,6,18,30,13,0
2580,Jonathan Silva,Getafe,2.5,10,8,4,4,2,7,12,58.3,5,4,0,4,3,13,7,0
2581,Rui Silva,Betis,21.8,1,0,1,0,0,1,2,50.0,1,0,0,0,1,2,11,1
2582,Thiago Silva,Chelsea,29.4,32,21,19,12,1,11,22,50.0,11,54,31,23,44,76,100,0
2583,Marco Silvestri,Udinese,35.0,0,0,0,0,0,0,1,0.0,1,0,0,0,1,1,11,1
2584,Mohamed Simakan,RB Leipzig,22.3,48,27,25,21,2,27,41,65.9,14,22,11,11,40,88,46,1
2585,Giovanni Simeone,Hellas Verona,29.5,27,15,6,12,9,9,39,23.1,30,37,3,34,6,33,23,0
2586,Giovanni Simeone,Cagliari,0.1,0,0,0,0,0,0,0,0.0,0,0,0,0,0,0,0,0
2587,Giuliano Simeone,Atlético Madrid,0.0,0,0,0,0,0,0,0,0.0,0,0,0,0,0,0,0,0
2588,Ellis Simms,Everton,0.7,0,0,0,0,0,0,0,0.0,0,1,1,0,0,0,1,0
2589,Moses Simon,Nantes,25.9,17,11,6,5,6,11,23,47.8,12,14,3,11,12,29,5,0
2590,Unai Simon,Athletic Club,34.0,0,0,0,0,0,0,0,0.0,0,0,0,0,1,1,5,1
2591,Xavi Simons,Paris S-G,1.5,1,1,0,1,0,1,2,50.0,1,3,0,3,0,1,0,0
2592,Wilfried Singo,Torino,29.0,55,35,24,24,7,24,34,70.6,10,26,6,20,23,78,47,0
2593,Daley Sinkgraven,Leverkusen,3.9,6,2,4,0,2,3,7,42.9,4,3,1,2,3,9,6,0
2594,Tobias Sippel,M'Gladbach,1.0,0,0,0,0,0,0,0,0.0,0,0,0,0,0,0,0,0
2595,Hugo Siquet,Freiburg,0.2,0,0,0,0,0,0,0,0.0,0,0,0,0,0,0,0,0
2596,Salvatore Sirigu,Genoa,37.0,1,1,1,0,0,1,2,50.0,1,0,0,0,0,1,19,2
2597,Issouf Sissokho,Bordeaux,4.8,17,8,2,13,2,8,17,47.1,9,8,1,7,7,24,0,0
2598,Ibrahima Sissoko,Strasbourg,25.6,47,23,18,20,9,19,46,41.3,27,32,11,21,35,82,31,0
2600,Moussa Sissoko,Watford,35.8,53,27,27,20,6,28,42,66.7,14,42,13,29,30,83,64,0
2601,Nelson Sissoko,Saint-Étienne,0.5,2,0,2,0,0,1,1,100.0,0,0,0,0,0,2,2,0
2602,Sambou Sissoko,Reims,2.0,12,6,6,4,2,6,8,75.0,2,2,0,2,2,14,7,0
2603,Antonio Sivera,Alavés,3.1,0,0,0,0,0,0,1,0.0,1,0,0,0,0,0,0,0
2604,Ellyes Skhiri,Köln,20.2,55,33,25,26,4,22,41,53.7,19,41,7,34,37,92,35,1
2605,Oliver Skipp,Tottenham,15.0,33,19,14,18,1,15,31,48.4,16,19,7,12,12,45,10,1
2606,Leo Skiri Ostigard,Genoa,13.0,16,9,8,7,1,9,11,81.8,2,17,10,7,8,24,55,1
2607,Lukasz Skorupski,Bologna,36.0,0,0,0,0,0,0,1,0.0,1,0,0,0,0,0,17,0
2608,Andreas Skov Olsen,Bologna,8.3,12,10,4,4,4,5,11,45.5,6,9,1,8,3,15,11,0
2609,Robert Skov,Hoffenheim,4.1,3,2,1,1,1,2,9,22.2,7,2,0,2,3,6,3,0
2610,Milan Skriniar,Inter,35.0,47,27,26,17,4,24,42,57.1,18,36,25,11,25,72,90,1
2611,Islam Slimani,Lyon,6.4,3,2,0,1,2,1,6,16.7,5,4,0,4,2,5,5,0
2612,William Smallbone,Southampton,1.5,4,4,2,2,0,1,3,33.3,2,4,0,4,2,6,0,0
2613,Chris Smalling,Roma,23.2,36,23,28,8,0,18,25,72.0,7,32,24,8,26,62,92,1
2614,Emile Smith Rowe,Arsenal,21.3,14,7,7,7,0,4,20,20.0,16,18,1,17,15,29,10,1
2615,Cedric Soares,Arsenal,16.5,38,26,23,9,6,16,25,64.0,9,18,7,11,16,54,31,1
2616,Danilo Soares,Bochum,28.5,109,71,61,39,9,56,84,66.7,28,63,9,54,62,171,65,2
2617,Ruben Sobrino,Valencia,0.2,1,1,1,0,0,1,1,100.0,0,1,0,1,2,3,0,0
2618,Ruben Sobrino,Cádiz,20.7,28,17,11,10,7,5,35,14.3,30,21,1,20,21,49,18,0
2619,Alex Sola,Real Sociedad,0.5,1,1,1,0,0,1,3,33.3,2,1,0,1,2,3,3,0
2620,Augusto Solari,Celta Vigo,7.9,24,12,9,12,3,12,32,37.5,20,14,4,10,7,31,10,1
2621,Roberto Soldado,Levante,7.4,3,1,0,1,2,1,3,33.3,2,4,0,4,1,4,7,0
2622,Carlos Soler,Valencia,27.5,29,19,10,15,4,11,37,29.7,26,19,4,15,14,43,28,0
2623,Yann Sommer,M'Gladbach,33.0,0,0,0,0,0,0,2,0.0,2,0,0,0,3,3,8,3
2624,Son,Levante,21.9,28,18,16,7,5,17,34,50.0,17,11,5,6,19,47,33,1
2626,Brandon Soppy,Udinese,8.6,20,9,8,10,2,11,16,68.8,5,10,2,8,5,25,9,1
2627,David Soria,Getafe,37.9,1,0,1,0,0,1,2,50.0,1,0,0,0,0,1,22,2
2628,Roberto Soriano,Bologna,29.1,57,30,27,22,8,17,56,30.4,39,37,3,34,22,79,32,0
2629,Alberto Soro,Granada,6.4,12,10,3,6,3,1,7,14.3,6,21,2,19,3,15,4,0
2630,Borna Sosa,Stuttgart,27.8,22,12,14,5,3,12,26,46.2,14,30,3,27,26,48,61,0
2631,Hugo Sotelo,Celta Vigo,0.0,0,0,0,0,0,0,0,0.0,0,0,0,0,0,0,0,0
2632,Florian Sotoca,Lens,27.6,31,19,7,20,4,12,51,23.5,39,31,4,27,25,56,41,0
2633,Riccardo Sottil,Fiorentina,13.8,9,4,4,4,1,3,9,33.3,6,3,0,3,1,10,2,0
2634,Tomas Soucek,West Ham,34.0,66,32,27,33,6,28,65,43.1,37,34,13,21,52,118,98,1
2635,Matias Soule,Juventus,0.1,0,0,0,0,0,0,1,0.0,1,0,0,0,0,0,0,0
2636,Sambou Soumano,Lorient,5.0,4,1,1,2,1,2,2,100.0,0,3,0,3,1,5,7,0
2637,Adama Soumaoro,Bologna,25.2,15,5,5,8,2,4,9,44.4,5,22,16,6,34,49,95,0
2638,Boubakary Soumare,Leicester City,12.2,19,13,10,8,1,8,17,47.1,9,13,1,12,14,33,18,0
2639,Arnaud Souquet,Montpellier,25.9,56,35,30,17,9,32,65,49.2,33,21,7,14,34,90,60,1
2640,Djibril Sow,Eint Frankfurt,26.8,57,33,28,25,4,22,60,36.7,38,35,8,27,50,107,20,1
2641,Saidou Sow,Saint-Étienne,11.0,28,17,21,6,1,16,21,76.2,5,15,5,10,23,51,34,0
2642,Caglar Soyuncu,Leicester City,27.7,47,30,32,12,3,26,42,61.9,16,44,27,17,32,79,115,1
2643,Leonardo Spinazzola,Roma,1.4,0,0,0,0,0,0,1,0.0,1,4,1,3,0,0,3,0
2644,Marco Sportiello,Atalanta,5.0,0,0,0,0,0,0,0,0.0,0,0,0,0,0,0,2,0
2645,Tony Springett,Norwich City,1.6,2,1,1,1,0,1,4,25.0,3,0,0,0,0,2,2,0
2646,Jerry St. Juste,Mainz 05,6.7,13,9,7,6,0,7,8,87.5,1,7,3,4,14,27,14,0
2647,Anton Stach,Mainz 05,20.7,28,19,14,13,1,15,38,39.5,23,24,5,19,51,79,25,0
2648,Kostas Stafylidis,Bochum,15.4,37,27,22,13,2,20,26,76.9,6,19,6,13,31,68,43,0
2649,Luca Stanga,Milan,0.0,1,0,0,1,0,0,0,0.0,0,0,0,0,0,1,0,0
2650,Josip Stanisic,Bayern Munich,7.2,21,10,7,12,2,12,18,66.7,6,7,0,7,11,32,10,2
2652,Niklas Stark,Hertha BSC,22.6,28,16,18,10,0,12,17,70.6,5,27,17,10,36,64,122,2
2653,Jason Steele,Brighton,1.0,0,0,0,0,0,0,0,0.0,0,0,0,0,0,0,0,0
2654,Jed Steer,Aston Villa,1.0,0,0,0,0,0,0,0,0.0,0,0,0,0,0,0,0,0
2655,Renato Steffen,Wolfsburg,10.7,20,16,10,10,0,9,16,56.3,7,7,0,7,13,33,14,0
2656,Zack Steffen,Manchester City,1.0,0,0,0,0,0,0,0,0.0,0,0,0,0,0,0,2,0
2657,Calvin Stengs,Nice,11.9,16,7,6,9,1,7,20,35.0,13,10,0,10,8,24,6,0
2658,Pascal Stenzel,Stuttgart,10.0,24,11,15,5,4,17,33,51.5,16,13,3,10,11,35,25,0
2659,Dale Stephens,Burnley,1.4,4,1,0,3,1,3,8,37.5,5,4,1,3,1,5,1,0
2660,Jack Stephens,Southampton,9.0,19,12,13,5,1,6,16,37.5,10,12,7,5,19,38,42,0
2661,Raheem Sterling,Manchester City,23.6,23,10,3,11,9,10,23,43.5,13,12,0,12,12,35,3,0
2662,Finley Stevens,Brentford,0.2,3,1,0,3,0,1,1,100.0,0,0,0,0,0,3,0,0
2663,Angelo Stiller,Hoffenheim,18.8,30,17,11,15,4,9,23,39.1,14,32,6,26,9,39,16,2
2664,Lars Stindl,M'Gladbach,18.1,23,15,6,14,3,9,33,27.3,24,28,2,26,10,33,14,0
2665,Riccardo Stivanello,Bologna,0.5,1,1,1,0,0,1,1,100.0,0,2,2,0,0,1,6,0
2666,Kevin Stoger,Mainz 05,4.7,10,5,5,5,0,4,10,40.0,6,6,0,6,5,15,1,1
2667,Petar Stojanovic,Empoli,30.4,96,63,55,32,9,59,114,51.8,55,39,13,26,27,123,65,1
2668,John Stones,Manchester City,12.4,5,3,3,2,0,2,3,66.7,1,3,3,0,11,16,27,1
2669,Thomas Strakosha,Lazio,23.0,0,0,0,0,0,0,0,0.0,0,0,0,0,0,0,7,2
2670,Stefan Strandberg,Salernitana,10.4,13,8,10,3,0,8,11,72.7,3,15,13,2,9,22,49,0
2671,David Strelec,Spezia,5.6,4,4,1,2,1,2,9,22.2,7,8,1,7,2,6,1,0
2672,Tobias Strobl,Augsburg,3.6,8,3,3,5,0,3,11,27.3,8,7,2,5,7,15,3,0
2673,Kevin Strootman,Cagliari,7.1,8,4,2,4,2,5,12,41.7,7,11,2,9,10,18,15,0
2674,Pascal Struijk,Leeds United,22.8,61,39,34,23,4,30,50,60.0,20,35,23,12,33,94,60,2
2675,Jens Stryger Larsen,Udinese,7.6,5,2,3,1,1,2,3,66.7,1,2,0,2,4,9,17,0
2676,Leo Stulac,Empoli,9.3,13,6,5,6,2,7,19,36.8,12,6,2,4,8,21,15,0
2678,Stefano Sturaro,Genoa,19.6,43,26,16,16,11,22,48,45.8,26,25,1,24,15,58,29,2
2679,Damian Suarez,Getafe,30.1,74,47,34,30,10,42,91,46.2,49,46,5,41,31,105,30,0
2680,Denis Suarez,Celta Vigo,31.3,61,29,20,33,8,25,82,30.5,57,32,4,28,16,77,11,0
2681,Luis Suarez,Atlético Madrid,20.4,8,5,2,4,2,2,10,20.0,8,8,1,7,1,9,14,0
2682,Mario Suarez,Rayo Vallecano,7.9,9,4,7,2,0,3,9,33.3,6,6,4,2,7,16,37,1
2683,Isaac Success,Udinese,10.1,5,2,0,3,2,1,5,20.0,4,2,0,2,2,7,6,0
2684,Niklas Sule,Bayern Munich,20.4,29,23,21,7,1,18,24,75.0,6,16,12,4,28,57,49,0
2685,Kamaldeen Sulemana,Rennes,11.3,23,12,7,9,7,10,17,58.8,7,10,1,9,4,27,5,0
2686,Crysencio Summerville,Leeds United,1.4,5,3,1,1,3,2,3,66.7,1,2,0,2,2,7,0,0
2687,Vladyslav Supriaha,Sampdoria,0.2,0,0,0,0,0,0,1,0.0,1,0,0,0,0,0,0,0
2688,Suso,Sevilla,4.3,4,3,1,3,0,3,13,23.1,10,4,0,4,0,4,0,0
2689,Bosko Sutalo,Hellas Verona,10.2,20,13,11,6,3,8,16,50.0,8,10,5,5,17,37,39,0
2690,Mattias Svanberg,Bologna,28.5,39,15,15,16,8,16,54,29.6,38,31,9,22,28,67,34,0
2691,Michael Svoboda,Venezia,13.7,33,17,26,6,1,18,32,56.3,14,27,15,12,10,43,61,5
2692,Abdoulaye Sylla,Nantes,1.7,4,4,2,1,1,2,4,50.0,2,5,3,2,1,5,3,0
2693,Mamadou Sylla,Alavés,4.4,2,2,0,1,1,0,1,0.0,1,0,0,0,1,3,5,0
2694,Mamadou Sylla,Rayo Vallecano,2.8,1,1,1,0,0,0,1,0.0,1,2,0,2,4,5,3,0
2695,Adam Szalai,Mainz 05,2.9,3,2,0,2,1,0,2,0.0,2,2,0,2,0,3,0,0
2696,Wojciech Szczesny,Juventus,33.0,1,1,1,0,0,1,2,50.0,1,0,0,0,0,1,8,1
2697,Dominik Szoboszlai,RB Leipzig,17.1,17,12,5,9,3,8,27,29.6,19,30,3,27,10,27,15,0
2698,Jakob Sorensen,Norwich City,6.7,22,11,6,14,2,10,20,50.0,10,7,3,4,10,32,19,0
2699,Alexander Sorloth,Real Sociedad,19.6,20,7,4,10,6,7,17,41.2,10,14,1,13,4,24,15,0
2700,Tachi,Alavés,2.7,6,3,3,3,0,5,7,71.4,2,4,3,1,1,7,9,0
2701,Jonathan Tah,Leverkusen,32.0,25,18,19,5,1,17,33,51.5,16,31,20,11,43,68,156,0
2702,Waniss Taibi,Angers,1.5,8,7,4,4,0,2,4,50.0,2,0,0,0,1,9,1,0
2704,Flavien Tait,Rennes,23.6,28,19,13,9,6,13,40,32.5,27,15,4,11,19,47,13,1
2705,Adrien Tameze,Hellas Verona,28.6,52,29,24,21,7,20,59,33.9,39,40,5,35,52,104,41,0
2706,Japhet Tanganga,Tottenham,8.2,14,8,7,6,1,9,19,47.4,10,13,5,8,9,23,31,0
2707,Renato Tapia,Celta Vigo,15.7,50,31,15,31,4,20,50,40.0,30,21,5,16,28,78,43,0
2708,Edmond Tapsoba,Leverkusen,20.2,35,17,24,10,1,20,32,62.5,12,27,15,12,29,64,72,1
2709,Florian Tardieu,Troyes,29.2,58,25,31,21,6,31,71,43.7,40,31,9,22,42,100,38,0
2710,Matt Targett,Aston Villa,15.9,34,18,28,5,1,24,45,53.3,21,16,9,7,23,57,35,0
2711,Matt Targett,Newcastle Utd,16.0,41,26,26,14,1,24,37,64.9,13,15,4,11,25,66,39,1
2712,Oussama Targhalline,Marseille,0.1,0,0,0,0,0,0,0,0.0,0,0,0,0,0,0,0,0
2713,James Tarkowski,Burnley,34.5,65,45,47,17,1,33,47,70.2,14,75,61,14,48,113,186,4
2714,Ciprian Tatarusanu,Milan,6.0,0,0,0,0,0,0,1,0.0,1,0,0,0,0,0,2,1
2715,Niklas Tauer,Mainz 05,5.4,16,9,9,7,0,9,14,64.3,5,6,2,4,9,25,14,0
2716,Nuno Tavares,Arsenal,13.1,21,14,10,7,4,8,18,44.4,10,15,5,10,9,30,33,1
2717,Charlie Taylor,Burnley,30.3,45,26,31,11,3,26,44,59.1,18,42,20,22,58,103,95,2
2718,Loum Tchaouna,Rennes,1.0,3,1,1,2,0,1,5,20.0,4,0,0,0,2,5,0,0
2719,Warren Tchimbembe,Metz,2.3,1,1,0,1,0,0,1,0.0,1,2,1,1,2,3,2,0
2720,Aurelien Tchouameni,Monaco,32.5,86,45,33,49,4,29,55,52.7,26,39,7,32,101,187,34,0
2721,Mathys Tel,Rennes,0.6,2,1,1,1,0,0,0,0.0,0,0,0,0,1,3,2,0
2722,Jordan Tell,Clermont Foot,3.2,5,5,0,3,2,1,4,25.0,3,3,0,3,0,5,1,0
2723,Nathan Tella,Southampton,8.9,13,9,5,7,1,6,17,35.3,11,13,0,13,6,19,9,0
2724,Alex Telles,Manchester Utd,18.4,48,27,35,9,4,27,43,62.8,16,17,4,13,26,74,45,0
2725,Cristian Tello,Betis,9.1,17,11,6,7,4,13,31,41.9,18,9,0,9,10,27,6,0
2726,Nahuel Tenaglia,Alavés,11.9,42,27,30,9,3,24,37,64.9,13,10,2,8,26,68,42,0
2727,Marc Tenas,Alavés,0.6,1,1,1,0,0,1,1,100.0,0,1,0,1,0,1,0,1
2728,Marc-Andre ter Stegen,Barcelona,35.0,0,0,0,0,0,0,1,0.0,1,0,0,0,1,1,13,5
2730,Filippo Terracciano,Hellas Verona,0.1,0,0,0,0,0,0,0,0.0,0,0,0,0,0,0,1,0
2731,Pietro Terracciano,Fiorentina,31.8,0,0,0,0,0,0,4,0.0,4,0,0,0,2,2,20,1
2732,Martin Terrier,Rennes,30.9,55,33,22,16,17,25,43,58.1,18,29,3,26,18,73,17,0
2733,Aleksa Terzic,Fiorentina,3.0,8,5,3,3,2,4,7,57.1,3,7,0,7,4,12,5,0
2734,Robert Tesche,Bochum,3.9,6,4,4,1,1,5,7,71.4,2,6,2,4,5,11,5,1
2735,Tanner Tessmann,Venezia,7.6,11,5,4,6,1,5,14,35.7,9,19,9,10,5,16,22,0
2736,Tete,Lyon,6.5,10,5,4,5,1,3,13,23.1,10,4,0,4,3,13,1,0
2737,Cedric Teuchert,Union Berlin,1.2,3,2,3,0,0,2,6,33.3,4,1,0,1,0,3,0,0
2738,Arthur Theate,Bologna,26.9,33,19,26,3,4,14,31,45.2,17,29,16,13,42,75,69,0
2739,Jan Thielmann,Köln,13.2,24,16,6,12,6,8,23,34.8,15,23,2,21,10,34,11,0
2740,Sada Thioub,Angers,0.0,0,0,0,0,0,0,0,0.0,0,0,0,0,0,0,0,0
2741,Sada Thioub,Saint-Étienne,10.6,13,8,5,8,0,6,14,42.9,8,9,0,9,10,23,8,0
2742,Luke Thomas,Leicester City,21.2,50,31,33,13,4,28,65,43.1,37,35,14,21,40,90,55,0
2743,Romain Thomas,Angers,28.5,49,37,28,21,0,30,57,52.6,27,35,19,16,44,93,126,0
2744,Adrien Thomasson,Strasbourg,26.5,64,31,18,27,19,30,93,32.3,63,56,4,52,29,93,16,1
2745,Erik Thommy,Stuttgart,3.0,2,0,0,2,0,1,2,50.0,1,3,0,3,4,6,0,0
2746,Dominic Thompson,Brentford,1.6,1,0,1,0,0,0,1,0.0,1,2,2,0,2,3,3,0
2747,Morten Thorsby,Sampdoria,32.7,46,26,15,23,8,28,56,50.0,28,37,12,25,25,71,39,0
2748,Thuler,Montpellier,9.5,21,12,17,4,0,8,15,53.3,7,9,7,2,9,30,30,0
2749,Khephren Thuram,Nice,21.1,33,19,11,18,4,17,35,48.6,18,31,11,20,28,61,19,0
2750,Marcus Thuram,M'Gladbach,10.9,6,5,0,5,1,1,4,25.0,3,5,0,5,5,11,5,0
2751,Alexis Tibidi,Stuttgart,4.3,7,3,1,3,3,3,4,75.0,1,4,0,4,3,10,2,0
2752,Cheikh Tidiane Sabaly,Metz,1.7,6,3,1,4,1,2,2,100.0,0,1,0,1,0,6,1,0
2753,Youri Tielemans,Leicester City,29.2,74,38,23,45,6,42,100,42.0,58,47,13,34,21,95,41,3
2754,Kieran Tierney,Arsenal,21.3,18,14,11,7,0,10,11,90.9,1,23,5,18,15,33,54,0
2756,Steffen Tigges,Dortmund,1.2,4,3,1,2,1,2,3,66.7,1,3,1,2,0,4,3,0
2757,Malik Tillman,Bayern Munich,1.2,2,1,0,1,1,0,1,0.0,1,5,1,4,2,4,1,0
2758,Timothy Tillman,Greuther Fürth,22.3,43,26,17,18,8,19,42,45.2,23,33,4,29,12,55,26,0
2759,David Timor,Getafe,3.8,1,1,1,0,0,0,3,0.0,3,3,2,1,1,2,4,1
2760,Mircea Tirlea,Alavés,0.2,0,0,0,0,0,0,0,0.0,0,0,0,0,0,0,1,0
2761,Jean-Clair Todibo,Nice,34.6,59,37,43,15,1,39,60,65.0,21,45,21,24,51,110,130,2
2762,Umut Tohumcu,Hoffenheim,0.1,0,0,0,0,0,0,0,0.0,0,0,0,0,0,0,0,0
2763,Karl Toko Ekambi,Lyon,25.5,13,7,4,6,3,4,21,19.0,17,26,0,26,20,33,5,0
2764,Corentin Tolisso,Bayern Munich,7.8,11,5,1,9,1,7,17,41.2,10,5,1,4,9,20,10,0
2765,Jeremy Toljan,Sassuolo,15.5,18,10,12,4,2,13,20,65.0,7,12,5,7,12,30,41,0
2766,Rafael Toloi,Atalanta,16.0,38,15,12,15,11,24,39,61.5,15,23,11,12,26,64,35,0
2767,Raul de Tomas,Espanyol,32.4,15,11,6,7,2,6,17,35.3,11,12,3,9,6,21,42,1
2768,Tiago Tomas,Stuttgart,11.9,8,4,0,7,1,0,6,0.0,6,3,0,3,4,12,1,0
2769,Takehiro Tomiyasu,Arsenal,18.7,35,17,19,13,3,21,32,65.6,11,22,3,19,24,59,64,2
2770,Takehiro Tomiyasu,Bologna,0.1,0,0,0,0,0,0,0,0.0,0,1,0,1,1,1,0,0
2771,James Tomkins,Crystal Palace,6.1,8,3,6,2,0,6,8,75.0,2,8,8,0,4,12,18,0
2772,Fikayo Tomori,Milan,30.2,73,44,36,34,3,18,26,69.2,8,37,23,14,45,118,84,1
2773,Sandro Tonali,Milan,28.9,54,37,23,25,6,21,41,51.2,20,26,8,18,34,88,19,0
2774,Lorenzo Tonelli,Empoli,9.7,17,9,11,4,2,6,13,46.2,7,14,8,6,19,36,28,2
2775,Ivan Toney,Brentford,32.3,33,21,5,20,8,12,38,31.6,26,16,2,14,14,47,44,1
2776,Ernesto Torregrossa,Sampdoria,1.3,2,1,1,0,1,1,2,50.0,1,0,0,0,0,2,1,0
2777,Lucas Torreira,Fiorentina,24.4,37,29,13,21,3,18,40,45.0,22,18,1,17,26,63,18,0
2778,Raul Torrente,Granada,14.2,31,21,18,11,2,16,29,55.2,13,14,9,5,12,43,69,0
2779,Ferran Torres,Manchester City,3.4,2,2,0,1,1,0,3,0.0,3,2,0,2,0,2,1,0
2780,Ferran Torres,Barcelona,15.7,10,5,3,4,3,3,7,42.9,4,12,3,9,6,16,7,0
2782,Oliver Torres,Sevilla,11.2,22,12,8,7,7,8,25,32.0,17,10,1,9,6,28,4,0
2783,Pau Torres,Villarreal,31.7,32,19,23,7,2,18,25,72.0,7,32,23,9,19,51,105,2
2784,Roberto Torres,Osasuna,9.0,7,4,3,1,3,3,15,20.0,12,8,0,8,8,15,4,0
2785,Lucas Torro,Osasuna,30.3,71,40,25,38,8,29,57,50.9,28,32,11,21,47,118,55,0
2786,Jordan Torunarigha,Hertha BSC,5.4,4,1,1,3,0,4,5,80.0,1,4,2,2,17,21,30,0
2787,Cenk Tosun,Everton,0.1,0,0,0,0,0,0,0,0.0,0,0,0,0,0,0,0,0
2788,Abdoulaye Toure,Genoa,4.8,12,4,3,8,1,5,11,45.5,6,6,1,5,4,16,6,0
2789,Almamy Toure,Eint Frankfurt,5.6,12,9,8,3,1,4,17,23.5,13,10,3,7,5,17,19,0
2790,Lucas Tousart,Hertha BSC,21.8,42,25,15,22,5,10,34,29.4,24,30,6,24,35,77,55,0
2791,Yoann Touzghar,Troyes,16.2,5,2,1,3,1,1,3,33.3,2,3,1,2,3,8,8,0
2792,Andros Townsend,Everton,16.2,31,17,15,6,10,15,40,37.5,25,28,2,26,14,45,6,1
2793,Adama Traore,Wolves,11.9,8,3,6,0,2,3,7,42.9,4,4,1,3,2,10,1,0
2794,Adama Traore,Barcelona,4.2,4,2,0,3,1,3,5,60.0,2,2,0,2,4,8,3,1
2795,Amadou Traore,Bordeaux,0.2,0,0,0,0,0,0,0,0.0,0,0,0,0,0,0,0,0
2796,Bertrand Traore,Aston Villa,2.4,3,3,0,1,2,1,2,50.0,1,0,0,0,0,3,1,0
2797,Boubacar Traore,Metz,19.2,43,26,18,23,2,10,39,25.6,29,29,5,24,25,68,11,1
2798,Charles Traore,Nantes,8.0,16,12,10,4,2,2,13,15.4,11,11,4,7,15,31,30,0
2799,Hamari Traore,Rennes,32.1,63,36,25,26,12,41,59,69.5,18,29,8,21,37,100,81,1
2800,Ismael Traore,Angers,35.7,28,17,16,11,1,13,28,46.4,15,25,17,8,44,72,122,1
2801,Kevin Trapp,Eint Frankfurt,32.0,0,0,0,0,0,0,1,0.0,1,0,0,0,1,1,13,2
2802,Miguel Trauco,Saint-Étienne,12.4,25,18,16,8,1,12,22,54.5,10,13,4,9,23,48,17,0
2803,Oscar Trejo,Rayo Vallecano,22.3,42,24,14,18,10,15,50,30.0,35,26,1,25,13,55,11,0
2804,Trezeguet,Aston Villa,0.1,0,0,0,0,0,0,0,0.0,0,0,0,0,0,0,0,0
2805,Manu Trigueros,Villarreal,24.2,45,25,16,18,11,23,66,34.8,43,19,3,16,13,58,17,0
2806,Simone Trimboli,Sampdoria,0.7,2,1,2,0,0,2,2,100.0,0,0,0,0,2,4,0,0
2808,Christopher Trimmel,Union Berlin,22.1,49,30,25,19,5,26,45,57.8,19,20,3,17,34,83,75,0
2809,Francisco Trincao,Wolves,14.8,28,15,9,13,6,3,19,15.8,16,17,1,16,12,40,1,1
2810,Kieran Trippier,Newcastle Utd,4.8,17,10,8,8,1,10,16,62.5,6,10,3,7,10,27,10,0
2811,Kieran Trippier,Atlético Madrid,10.8,22,12,12,5,5,12,21,57.1,9,12,1,11,10,32,11,0
2812,William Troost-Ekong,Watford,15.4,18,9,11,6,1,10,15,66.7,5,24,14,10,7,25,82,1
2813,Leandro Trossard,Brighton,31.2,34,20,12,9,13,4,31,12.9,27,33,4,29,15,49,10,0
2814,Adrien Truffert,Rennes,18.2,29,21,17,9,3,11,24,45.8,13,25,5,20,19,48,30,0
2815,Philipp Tschauner,RB Leipzig,0.0,0,0,0,0,0,0,0,0.0,0,0,0,0,0,0,0,0
2816,Kostas Tsimikas,Liverpool,9.7,27,12,12,8,7,12,16,75.0,4,6,2,4,10,37,22,2
2817,Axel Tuanzebe,Aston Villa,5.6,5,3,3,2,0,2,5,40.0,3,5,4,1,5,10,12,1
2818,Axel Tuanzebe,Napoli,0.1,0,0,0,0,0,0,0,0.0,0,1,1,0,0,0,0,0
2819,Ozan Tufan,Watford,3.7,3,2,1,1,1,1,5,20.0,4,2,0,2,2,5,4,0
2820,Benat Turrientes,Real Sociedad,2.3,0,0,0,0,0,0,4,0.0,4,1,0,1,2,2,2,0
2821,Tuta,Eint Frankfurt,24.3,46,28,20,22,4,26,47,55.3,21,43,15,28,41,87,76,1
2822,Christos Tzolis,Norwich City,3.7,5,3,3,1,1,2,9,22.2,7,3,0,3,1,6,1,0
2823,Destiny Udogie,Udinese,27.5,64,40,30,27,7,33,60,55.0,27,39,6,33,27,91,42,0
2824,Matthieu Udol,Metz,11.2,23,14,11,10,2,12,18,66.7,6,20,7,13,31,54,29,1
2825,Ike Ugbo,Troyes,9.0,3,1,0,1,2,0,1,0.0,1,4,1,3,2,5,1,0
2826,Lesley Ugochukwu,Rennes,4.5,13,9,5,5,3,9,19,47.4,10,7,2,5,4,17,2,0
2827,Hwang Ui-jo,Bordeaux,27.9,10,4,4,4,2,4,13,30.8,9,9,1,8,5,15,18,0
2828,Anthony Ujah,Union Berlin,0.4,0,0,0,0,0,0,0,0.0,0,0,0,0,0,0,0,0
2829,Maximilian Ullmann,Venezia,2.7,0,0,0,0,0,0,1,0.0,1,4,0,4,2,2,7,0
2830,Sven Ulreich,Bayern Munich,6.0,0,0,0,0,0,0,0,0.0,0,0,0,0,0,0,1,0
2831,Samuel Umtiti,Barcelona,1.0,2,2,2,0,0,1,2,50.0,1,1,1,0,0,2,4,0
2832,Enes Unal,Getafe,31.1,37,22,2,18,17,5,42,11.9,37,25,5,20,5,42,36,0
2834,Cengiz Under,Marseille,24.4,18,13,5,6,7,5,18,27.8,13,13,2,11,14,32,9,0
2835,Dayot Upamecano,Bayern Munich,24.6,66,42,42,21,3,24,36,66.7,12,20,10,10,32,98,71,6
2836,Benjamin Uphoff,Freiburg,2.0,0,0,0,0,0,0,0,0.0,0,0,0,0,0,0,2,2
2837,Kacper Urbanski,Bologna,0.5,3,2,1,2,0,2,2,100.0,0,2,0,2,0,3,0,0
2838,Jere Uronen,Brest,9.8,28,15,15,10,3,14,24,58.3,10,12,3,9,16,44,21,0
2839,Mark Uth,Köln,22.5,32,20,9,14,9,15,49,30.6,34,27,1,26,14,46,13,0
2840,Myrto Uzuni,Granada,9.5,7,4,6,1,0,0,2,0.0,2,13,1,12,10,17,7,0
2841,Antonio Vacca,Venezia,11.8,36,20,24,10,2,14,36,38.9,22,16,8,8,20,56,16,0
2842,Alvaro Vadillo,Espanyol,0.1,1,1,1,0,0,1,2,50.0,1,0,0,0,0,1,1,0
2843,Oscar Valentin,Rayo Vallecano,28.5,102,53,46,51,5,44,105,41.9,61,56,10,46,39,141,43,0
2844,German Valera,Real Sociedad,0.6,3,2,3,0,0,1,1,100.0,0,0,0,0,0,3,1,0
2845,Yan Valery,Southampton,4.1,8,6,4,3,1,4,9,44.4,5,6,3,3,6,14,19,1
2846,Martin Valjent,Mallorca,35.3,31,19,18,12,1,13,24,54.2,11,34,26,8,31,62,173,1
2847,Jesus Vallejo,Real Madrid,3.8,7,5,7,0,0,5,6,83.3,1,9,8,1,6,13,16,0
2848,Manu Vallejo,Alavés,4.1,8,2,1,4,3,4,13,30.8,9,7,0,7,0,8,4,0
2849,Manu Vallejo,Valencia,1.1,2,1,1,1,0,0,1,0.0,1,0,0,0,0,2,1,0
2850,Federico Valverde,Real Madrid,20.4,36,16,11,16,9,12,31,38.7,19,23,5,18,24,60,12,0
2851,Virgil van Dijk,Liverpool,34.0,16,10,11,5,0,11,16,68.8,5,21,14,7,31,47,109,0
2852,Vanderson,Monaco,12.4,35,19,10,19,6,15,23,65.2,8,17,4,13,13,48,12,0
2853,Zinho Vanheusden,Genoa,11.0,18,6,12,5,1,8,14,57.1,6,19,14,5,23,41,42,0
2854,Jonathan Varane,Lens,0.0,0,0,0,0,0,0,0,0.0,0,0,0,0,0,0,0,0
2855,Raphael Varane,Manchester Utd,20.3,28,19,21,6,1,10,22,45.5,12,18,9,9,18,46,82,1
2856,Jamie Vardy,Leicester City,20.1,6,5,0,4,2,1,7,14.3,6,9,0,9,1,7,17,0
2857,Ruben Vargas,Augsburg,22.0,28,21,7,14,7,11,30,36.7,19,9,1,8,16,44,13,0
2858,Sebastian Vasiliadis,Arminia,13.3,31,17,12,15,4,15,42,35.7,27,15,2,13,25,56,31,1
2860,Johan Vasquez,Genoa,25.3,79,46,44,32,3,48,75,64.0,27,32,10,22,42,121,85,0
2861,Denis Vavro,Lazio,0.1,0,0,0,0,0,0,0,0.0,0,0,0,0,0,0,0,0
2862,Jose Luis Garcia Vaya,Levante,22.4,46,27,10,31,5,16,41,39.0,25,24,5,19,38,84,30,0
2863,Jesus Vazquez,Valencia,9.0,24,13,10,8,6,10,22,45.5,12,16,3,13,9,33,19,0
2864,Kevin Vazquez,Celta Vigo,14.8,34,24,12,13,9,14,28,50.0,14,20,7,13,36,70,34,0
2865,Lucas Vazquez,Real Madrid,20.4,43,22,24,9,10,17,35,48.6,18,25,7,18,20,63,41,1
2866,Matias Vecino,Inter,4.2,7,5,2,3,2,3,9,33.3,6,10,1,9,4,11,7,0
2867,Gabriel Veiga,Celta Vigo,1.2,5,4,0,4,1,3,12,25.0,9,2,0,2,4,9,1,0
2868,Miguel Veloso,Hellas Verona,14.9,23,15,4,17,2,10,16,62.5,6,18,5,13,11,34,18,1
2869,Joel Veltman,Brighton,31.9,74,48,47,21,6,21,53,39.6,32,46,16,30,45,119,89,0
2870,Micky van de Ven,Wolfsburg,2.1,4,4,3,1,0,0,1,0.0,1,4,1,3,2,6,8,0
2871,Unai Vencedor Paris,Athletic Club,26.5,26,11,11,9,6,8,42,19.0,34,31,13,18,19,45,22,0
2872,Lorenzo Venuti,Fiorentina,17.5,25,10,13,10,2,14,24,58.3,10,13,4,9,5,30,27,0
2873,Daniele Verde,Spezia,21.7,11,4,8,2,1,9,20,45.0,11,17,2,15,18,29,8,0
2874,Simone Verdi,Torino,0.5,1,1,0,1,0,0,0,0.0,0,0,0,0,0,1,0,0
2875,Simone Verdi,Salernitana,9.2,12,8,5,2,5,9,20,45.0,11,4,0,4,3,15,1,0
2876,Gonzalo Verdu,Elche,15.5,19,9,15,4,0,8,16,50.0,8,20,14,6,13,32,59,1
2877,Jordan Veretout,Roma,25.8,34,25,20,12,2,15,39,38.5,24,12,1,11,27,61,22,1
2878,Edoardo Vergani,Salernitana,1.1,2,2,2,0,0,0,0,0.0,0,2,2,0,0,2,2,0
2879,Vincent Vermeij,Freiburg,0.0,0,0,0,0,0,0,0,0.0,0,1,0,1,0,0,0,0
2880,Marco Verratti,Paris S-G,21.5,60,40,16,30,14,32,64,50.0,32,36,10,26,18,78,14,2
2881,Valerio Verre,Sampdoria,4.7,7,5,1,4,2,4,9,44.4,5,7,0,7,0,7,5,0
2882,Valerio Verre,Empoli,3.4,4,2,3,1,0,2,7,28.6,5,2,0,2,1,5,0,0
2883,Freddie Veseli,Salernitana,6.6,7,2,4,3,0,5,6,83.3,1,10,5,5,4,11,19,0
2884,Mikel Vesga,Athletic Club,15.1,27,14,7,18,2,11,31,35.5,20,16,5,11,20,47,34,2
2886,Jannik Vestergaard,Leicester City,6.3,15,10,12,3,0,8,15,53.3,7,10,8,2,7,22,36,0
2887,Ruben Vezo,Levante,26.9,41,29,28,12,1,26,41,63.4,15,41,25,16,36,77,105,1
2888,Guglielmo Vicario,Empoli,38.0,1,1,1,0,0,1,1,100.0,0,1,0,1,1,2,21,1
2889,Aleix Vidal,Espanyol,21.1,31,25,17,9,5,19,39,48.7,20,19,6,13,25,56,35,2
2890,Arturo Vidal,Inter,8.2,26,10,16,9,1,9,26,34.6,17,13,5,8,7,33,7,1
2891,Nacho Vidal,Osasuna,32.2,83,47,49,25,9,39,77,50.6,38,32,14,18,58,141,79,0
2892,Gabriel Vidovic,Bayern Munich,0.4,0,0,0,0,0,0,0,0.0,0,0,0,0,0,0,0,0
2893,Ronaldo Vieira,Sampdoria,5.5,10,6,6,4,0,5,10,50.0,5,5,2,3,6,16,5,1
2894,Nick Viergever,Greuther Fürth,23.7,32,23,25,7,0,24,34,70.6,10,31,22,9,37,69,119,1
2895,Luca Vignali,Spezia,0.9,1,1,0,1,0,0,3,0.0,3,0,0,0,1,2,1,0
2896,Emanuel Vignato,Bologna,6.6,12,7,5,7,0,6,13,46.2,7,2,0,2,2,14,5,0
2897,Didac Vila,Espanyol,2.3,7,5,2,5,0,4,9,44.4,5,2,1,1,3,10,8,0
2898,Tonny Vilhena,Espanyol,10.3,16,6,7,8,1,7,21,33.3,14,10,2,8,8,24,17,0
2899,Daniel Villahermosa,Espanyol,0.3,0,0,0,0,0,0,0,0.0,0,0,0,0,0,0,1,0
2900,Asier Villalibre,Athletic Club,6.1,4,3,2,1,1,1,2,50.0,1,3,1,2,1,5,7,0
2901,Gonzalo Villar,Getafe,3.3,5,3,4,1,0,2,5,40.0,3,4,1,3,1,6,1,0
2902,Matias Vina,Roma,17.4,46,30,27,14,5,29,59,49.2,30,26,3,23,25,71,33,0
2903,Nicolas Viola,Bologna,1.1,2,2,1,1,0,1,2,50.0,1,1,1,0,0,2,1,0
2904,Mattia Viti,Empoli,16.6,28,16,16,9,3,15,24,62.5,9,28,25,3,29,57,69,1
2905,Vitolo,Getafe,2.5,3,2,1,1,1,2,5,40.0,3,3,0,3,1,4,1,0
2906,Daniel Vivian,Athletic Club,22.1,32,21,24,7,1,17,24,70.8,7,20,15,5,26,58,107,1
2907,Dusan Vlahovic,Fiorentina,20.6,5,0,0,2,3,2,11,18.2,9,6,2,4,1,6,16,0
2908,Dusan Vlahovic,Juventus,12.0,0,0,0,0,0,0,4,0.0,4,3,0,3,0,0,7,0
2909,Nikola Vlasic,West Ham,6.2,11,7,4,6,1,5,20,25.0,15,4,0,4,2,13,1,0
2910,Andreas Voglsammer,Union Berlin,9.8,14,9,8,3,3,6,14,42.9,8,9,2,7,2,16,7,0
2912,Kevin Vogt,Hoffenheim,28.5,21,12,15,6,0,11,21,52.4,10,18,7,11,13,34,101,1
2913,Mergim Vojvoda,Torino,22.0,38,23,23,11,4,20,36,55.6,16,27,8,19,20,58,51,0
2914,Kevin Volland,Monaco,27.1,24,10,2,18,4,6,31,19.4,25,20,0,20,3,27,9,0
2915,Cristian Volpato,Roma,0.4,1,1,0,0,1,1,1,100.0,0,0,0,0,0,1,0,0
2916,Aster Vranckx,Wolfsburg,12.7,34,13,14,16,4,14,26,53.8,12,19,7,12,13,47,16,0
2917,Stefan de Vrij,Inter,26.8,38,29,22,16,0,12,17,70.6,5,17,8,9,32,70,52,0
2918,Sime Vrsaljko,Atlético Madrid,10.2,27,17,14,12,1,12,20,60.0,8,10,1,9,12,39,30,0
2919,Nikola Vukcevic,Levante,1.3,3,2,2,1,0,0,1,0.0,1,2,0,2,2,5,1,0
2920,Matej Vydra,Burnley,7.5,12,7,3,4,5,3,7,42.9,4,5,1,4,0,12,9,0
2921,Elye Wahi,Montpellier,19.8,18,10,9,6,3,6,16,37.5,10,7,0,7,4,22,4,0
2922,Walace,Udinese,33.0,83,49,37,38,8,50,113,44.2,63,51,5,46,54,137,32,1
2923,Theo Walcott,Southampton,4.2,4,2,2,0,2,1,5,20.0,4,3,0,3,5,9,2,0
2924,Luca Waldschmidt,Wolfsburg,8.0,9,1,3,5,1,5,13,38.5,8,5,0,5,8,17,3,0
2925,Kyle Walker,Manchester City,19.5,15,6,7,7,1,8,17,47.1,9,14,4,10,14,29,16,1
2926,Kyle Walker-Peters,Southampton,29.3,57,33,28,21,8,26,38,68.4,12,29,8,21,37,94,53,1
2927,Sebastian Walukiewicz,Cagliari,3.4,9,5,7,2,0,3,5,60.0,2,5,2,3,7,16,14,0
2928,Aaron Wan-Bissaka,Manchester Utd,19.9,49,36,25,18,6,14,20,70.0,6,24,14,10,34,83,41,2
2929,Paul Wanner,Bayern Munich,0.4,2,2,0,2,0,1,1,100.0,0,0,0,0,0,2,0,0
2930,Danny Ward,Leicester City,1.0,0,0,0,0,0,0,0,0.0,0,0,0,0,0,0,1,0
2931,Joel Ward,Crystal Palace,27.6,44,26,30,11,3,30,57,52.6,27,24,11,13,32,76,107,1
2932,James Ward-Prowse,Southampton,35.7,41,24,12,24,5,19,70,27.1,51,43,15,28,40,81,45,1
2933,Magnus Warming,Torino,0.6,1,1,0,1,0,0,0,0.0,0,2,0,2,0,1,0,0
2934,Daniel Wass,Atlético Madrid,0.5,0,0,0,0,0,0,0,0.0,0,0,0,0,0,0,3,0
2935,Daniel Wass,Valencia,17.6,23,13,6,14,3,8,31,25.8,23,13,2,11,13,36,19,0
2936,Ollie Watkins,Aston Villa,32.8,17,13,2,7,8,2,15,13.3,13,25,3,22,12,29,27,0
2938,Timothy Weah,Lille,18.0,19,7,8,8,3,10,20,50.0,10,16,1,15,10,29,7,0
2939,Adam Webster,Brighton,15.9,26,8,17,7,2,13,20,65.0,7,25,17,8,17,43,66,2
2940,Wout Weghorst,Burnley,16.1,17,9,3,9,5,6,19,31.6,13,16,5,11,6,23,13,0
2941,Wout Weghorst,Wolfsburg,17.3,13,7,3,3,7,7,17,41.2,10,10,3,7,2,15,11,1
2942,Noah Weisshaupt,Freiburg,1.1,1,1,1,0,0,1,2,50.0,1,2,0,2,1,2,1,1
2943,Danny Welbeck,Brighton,16.4,14,7,2,8,4,3,10,30.0,7,18,2,16,5,19,18,0
2944,Timo Werner,Chelsea,14.3,8,4,3,3,2,2,20,10.0,18,9,0,9,2,10,4,0
2945,Ashley Westwood,Burnley,25.4,21,12,8,12,1,10,31,32.3,21,21,9,12,30,51,16,1
2946,Ben White,Arsenal,32.0,44,23,30,8,6,28,45,62.2,17,42,24,18,42,86,102,0
2947,Silvan Widmer,Mainz 05,32.4,60,28,32,20,8,36,61,59.0,25,44,16,28,43,103,59,2
2948,Georginio Wijnaldum,Paris S-G,18.4,15,9,2,12,1,11,19,57.9,8,13,3,10,9,24,7,0
2949,Jetro Willems,Greuther Fürth,17.8,30,15,18,10,2,15,26,57.7,11,15,3,12,14,44,42,0
2950,Brandon Williams,Norwich City,23.6,55,37,35,18,2,36,64,56.3,28,26,6,20,44,99,50,0
2951,Inaki Williams,Athletic Club,30.9,14,5,1,6,7,5,17,29.4,12,18,3,15,3,17,20,0
2952,Neco Williams,Liverpool,0.1,0,0,0,0,0,0,0,0.0,0,0,0,0,0,0,0,0
2953,Nico Williams,Athletic Club,14.9,20,10,6,11,3,10,31,32.3,21,18,2,16,5,25,9,0
2954,Joe Willock,Newcastle Utd,22.6,64,37,30,28,6,29,68,42.6,39,37,6,31,21,85,10,1
2955,Callum Wilson,Newcastle Utd,15.4,9,8,1,5,3,1,4,25.0,3,7,2,5,3,12,10,0
2956,Patrick Wimmer,Arminia,22.8,53,31,13,31,9,22,61,36.1,39,30,1,29,27,80,13,0
2957,Jonas Wind,Wolfsburg,13.1,10,6,1,7,2,1,4,25.0,3,8,3,5,6,16,13,0
2958,Marten Winkler,Hertha BSC,0.3,0,0,0,0,0,0,0,0.0,0,0,0,0,0,0,0,0
2959,Harry Winks,Tottenham,10.1,15,10,4,9,2,8,21,38.1,13,14,3,11,16,31,10,2
2960,Frederik Winther,Augsburg,3.6,7,2,7,0,0,5,6,83.3,1,4,1,3,8,15,21,0
2961,Florian Wirtz,Leverkusen,20.6,25,10,6,16,3,10,28,35.7,18,12,1,11,13,38,4,0
2962,Yoane Wissa,Brentford,14.3,12,6,5,4,3,1,16,6.3,15,12,5,7,8,20,6,0
2964,Axel Witsel,Dortmund,21.6,42,27,12,23,7,18,30,60.0,12,24,9,15,27,69,38,0
2965,Hannes Wolf,M'Gladbach,3.4,23,12,4,13,6,10,20,50.0,10,10,0,10,2,25,1,0
2966,Marius Wolf,Dortmund,14.7,26,10,13,9,4,12,24,50.0,12,14,1,13,13,39,8,0
2967,Luca Wollschlager,Hertha BSC,0.2,1,1,0,1,0,0,1,0.0,1,0,0,0,0,1,0,0
2968,Jeong Woo-yeong,Freiburg,19.8,15,9,6,7,2,5,15,33.3,10,8,1,7,7,22,11,0
2969,Chris Wood,Burnley,15.2,7,5,0,3,4,3,10,30.0,7,13,4,9,0,7,3,0
2970,Chris Wood,Newcastle Utd,14.7,2,0,1,1,0,1,2,50.0,1,5,2,3,2,4,9,0
2971,Freddie Woodman,Newcastle Utd,4.0,0,0,0,0,0,0,0,0.0,0,0,0,0,0,0,0,1
2972,Christopher Wooh,Lens,11.7,29,11,20,8,1,11,18,61.1,7,21,14,7,21,50,40,1
2973,Joscha Wosz,RB Leipzig,0.1,0,0,0,0,0,0,0,0.0,0,0,0,0,0,0,0,0
2974,Xeka,Lille,18.0,47,27,18,24,5,27,56,48.2,29,23,3,20,24,71,26,1
2975,Granit Xhaka,Arsenal,25.9,32,18,16,12,4,16,41,39.0,25,21,6,15,21,53,31,0
2976,Sekou Yansane,Paris S-G,0.2,0,0,0,0,0,0,1,0.0,1,0,0,0,0,0,1,0
2977,Andriy Yarmolenko,West Ham,3.5,4,2,2,2,0,2,8,25.0,6,4,2,2,0,4,2,0
2978,Yusuf Yazici,Lille,5.7,10,5,3,6,1,1,9,11.1,8,4,0,4,2,12,1,0
2979,Kelvin Yeboah,Genoa,9.4,14,7,5,7,2,9,19,47.4,10,22,1,21,1,15,7,0
2980,Gerard Yepes,Sampdoria,0.2,1,0,0,1,0,1,1,100.0,0,1,0,1,0,1,0,0
2981,Burak Yilmaz,Lille,24.6,7,2,0,2,5,2,17,11.8,15,8,1,7,2,9,11,0
2982,Okay Yokuslu,Getafe,5.2,9,8,6,2,1,5,5,100.0,0,7,5,2,5,14,17,0
2983,Okay Yokuslu,Celta Vigo,1.6,4,1,2,1,1,2,3,66.7,1,2,1,1,2,6,6,0
2984,Leny Yoro,Lille,0.1,1,0,0,1,0,0,0,0.0,0,1,0,1,0,1,0,0
2985,Maya Yoshida,Sampdoria,20.3,17,10,8,9,0,8,15,53.3,7,27,20,7,28,45,72,1
2986,Ashley Young,Aston Villa,13.9,18,6,9,6,3,11,16,68.8,5,10,4,6,13,31,25,1
2987,Nathan Young-Coombes,Brentford,0.0,0,0,0,0,0,0,0,0.0,0,0,0,0,0,0,0,0
2988,Zaydou Youssouf,Saint-Étienne,17.3,48,26,21,25,2,14,34,41.2,20,11,3,8,17,65,13,0
2990,Mattia Zaccagni,Hellas Verona,2.0,3,1,1,0,2,1,2,50.0,1,1,0,1,4,7,0,0
2991,Mattia Zaccagni,Lazio,20.8,33,16,10,13,10,11,19,57.9,8,17,2,15,20,53,5,0
2992,Dan-Axel Zagadou,Dortmund,10.6,13,7,11,1,1,7,10,70.0,3,14,4,10,15,28,38,2
2993,Wilfried Zaha,Crystal Palace,30.7,40,20,14,15,11,10,31,32.3,21,28,0,28,5,45,5,0
2994,Denis Zakaria,Juventus,6.6,11,7,3,6,2,3,11,27.3,8,16,3,13,11,22,7,0
2995,Denis Zakaria,M'Gladbach,15.5,23,14,9,10,4,12,35,34.3,23,25,5,20,19,42,22,1
2996,Joseba Zaldua,Real Sociedad,13.0,31,22,20,8,3,16,22,72.7,6,14,4,10,13,44,35,0
2997,Nicola Zalewski,Roma,8.8,32,19,17,11,4,21,35,60.0,14,18,1,17,16,48,4,0
2998,Andre-Frank Zambo Anguissa,Napoli,21.4,50,26,24,17,9,25,51,49.0,26,31,5,26,24,74,33,1
2999,Nicolo Zaniolo,Roma,21.9,24,15,0,15,9,6,28,21.4,22,19,0,19,7,31,6,0
3000,Alessandro Zanoli,Napoli,5.1,10,7,6,3,1,3,5,60.0,2,2,1,1,4,14,16,0
3001,Mattia Zanotti,Inter,0.1,1,0,1,0,0,0,1,0.0,1,0,0,0,0,1,0,0
3002,Duvan Zapata,Atalanta,19.1,6,2,0,4,2,4,8,50.0,4,8,1,7,3,9,5,0
3003,Gabriele Zappa,Cagliari,12.7,21,9,12,6,3,6,24,25.0,18,15,5,10,14,35,28,0
3004,Davide Zappacosta,Atalanta,26.1,32,22,12,13,7,19,37,51.4,18,32,2,30,12,44,22,0
3005,Oier Zarraga,Athletic Club,13.0,13,5,4,7,2,3,28,10.7,25,17,10,7,19,32,10,0
3006,Simone Zaza,Torino,1.4,2,2,1,1,0,1,1,100.0,0,3,0,3,0,2,3,0
3007,Akim Zedadka,Clermont Foot,37.1,72,44,34,29,9,37,71,52.1,34,32,8,24,58,130,48,0
3008,Deyovaisio Zeefuik,Hertha BSC,6.3,11,10,6,4,1,6,12,50.0,6,12,4,8,11,22,21,1
3009,Marvin Zeegelaar,Udinese,7.1,15,11,6,8,1,5,14,35.7,9,12,4,8,12,27,22,1
3010,Arber Zeneli,Reims,4.5,1,0,0,0,1,1,5,20.0,4,0,0,0,1,2,1,0
3011,Robin Zentner,Mainz 05,32.0,2,2,2,0,0,2,2,100.0,0,0,0,0,2,4,21,1
3012,Andi Zeqiri,Augsburg,11.3,14,7,3,5,6,3,12,25.0,9,10,1,9,2,16,12,0
3013,Mehdi Zerkane,Bordeaux,0.9,0,0,0,0,0,0,1,0.0,1,1,1,0,2,2,0,0
3014,Edon Zhegrova,Lille,5.3,14,5,2,8,4,5,6,83.3,1,4,1,3,2,16,2,0
3016,Luca Zidane,Rayo Vallecano,7.2,0,0,0,0,0,0,1,0.0,1,0,0,0,0,0,1,1
3017,Piotr Zielinski,Napoli,23.2,19,12,5,9,5,6,21,28.6,15,13,2,11,8,27,4,0
3018,David Zima,Torino,14.6,20,12,8,11,1,9,20,45.0,11,15,13,2,23,43,42,0
3019,Christoph Zimmermann,Norwich City,1.7,6,3,5,1,0,3,4,75.0,1,0,0,0,1,7,4,0
3020,Oleksandr Zinchenko,Manchester City,11.6,20,14,7,10,3,11,20,55.0,9,11,3,8,14,34,15,1
3021,Hakim Ziyech,Chelsea,14.7,19,10,5,12,2,10,36,27.8,26,11,1,10,10,29,10,0
3022,Jeroen Zoet,Spezia,7.0,1,0,1,0,0,1,1,100.0,0,0,0,0,0,1,4,0
3023,Simon Zoller,Bochum,6.6,4,2,2,1,1,1,3,33.3,2,3,0,3,4,8,2,0
3024,Nadir Zortea,Salernitana,15.7,21,15,9,7,5,11,19,57.9,8,14,2,12,7,28,33,0
3025,Tanguy Zoukrou,Troyes,0.9,1,0,1,0,0,1,2,50.0,1,0,0,0,0,1,2,0
3026,Kurt Zouma,West Ham,23.1,11,6,8,3,0,4,7,57.1,3,31,26,5,34,45,132,0
3027,Petar Zovko,Spezia,0.3,0,0,0,0,0,0,0,0.0,0,0,0,0,0,0,1,0
3028,Igor Zubeldia,Real Sociedad,18.3,20,10,12,8,0,12,18,66.7,6,16,6,10,27,47,53,0
3029,Martin Zubimendi,Real Sociedad,28.8,52,25,19,30,3,22,44,50.0,22,30,13,17,49,101,48,1
3030,Szymon Zurkowski,Empoli,25.6,58,33,24,21,13,29,68,42.6,39,43,10,33,35,93,32,1
3031,Martin Odegaard,Arsenal,30.9,49,21,6,24,19,22,61,36.1,39,18,1,17,11,60,11,1
3032,Milan Duric,Salernitana,24.1,1,1,0,1,0,1,3,33.3,2,6,1,5,2,3,32,0
3033,Filip Duricic,Sassuolo,7.5,13,10,7,1,5,5,13,38.5,8,7,1,6,4,17,1,0
3034,Blanco,Real Madrid,0.3,0.0,0,0.0,0.0,0.0,0.0,0.0,0.0,0.0,0.0,0.0,0.0,1,0.0,0.0,0.0
3035,Hugo Guillamon,Valencia,26.2,0.0,26,0.0,0.0,0.0,0.0,0.0,0.0,0.0,0.0,0.0,0.0,29,0.0,0.0,0.0
