,Player,Squad,90s,Tackles - Tkl,Tackles - TklW,Tackles - Def 3rd,Tackles - Mid 3rd,Tackles - Att 3rd,Challenges - Tkl,Challenges - Att,Challenges - Tkl%,Challenges - Lost,Blocks - Blocks,Blocks - Sh,Blocks - Pass,Int,Tkl+Int,Clr,Err
0,Max Aarons,Bournemouth,13.7,29,19,20,7,2,20,34,58.8,14,9,5,4,8,37,27,0
1,Brenden Aaronson,Union Berlin,14.1,32,18,13,13,6,16,32,50.0,16,26,1,25,2,34,4,0
2,Paxten Aaronson,Eint Frankfurt,1.1,2,2,1,1,0,1,1,100.0,0,2,0,2,0,2,0,0
3,Keyliane Abdallah,Marseille,0.0,0,0,0,0,0,0,0,0.0,0,0,0,0,0,0,0,0
4,Yunis Abdelhamid,Reims,30.9,64,35,36,23,5,26,45,57.8,19,51,32,19,39,103,109,2
5,Salis Abdul Samed,Lens,16.9,21,14,8,10,3,8,18,44.4,10,12,1,11,12,33,18,0
6,Nabil Aberdin,Getafe,2.0,0,0,0,0,0,0,1,0.0,1,0,0,0,0,0,4,0
7,Laurent Abergel,Lorient,31.8,85,52,43,34,8,38,96,39.6,58,29,6,23,61,146,61,3
8,Matthis Abline,Nantes,11.6,9,4,4,3,2,3,8,37.5,5,3,0,3,3,12,5,0
9,Abner,Betis,15.6,25,19,15,9,1,17,34,50.0,17,23,5,18,15,40,62,0
10,Zakaria Aboukhlal,Toulouse,8.4,9,8,1,5,3,3,12,25.0,9,9,1,8,1,10,2,0
11,Abdel Abqar,Alavés,25.7,35,19,28,5,2,21,35,60.0,14,31,26,5,23,58,115,0
12,Tammy Abraham,Roma,2.7,3,1,0,1,2,0,0,0.0,0,1,0,1,0,3,4,0
13,Francesco Acerbi,Inter,26.5,22,13,16,6,0,11,14,78.6,3,20,13,7,32,54,77,1
14,Joshua Acheampong,Chelsea,0.1,0,0,0,0,0,0,0,0.0,0,3,3,0,0,0,0,0
15,Marcos Acuna,Sevilla,14.4,33,21,20,12,1,9,14,64.3,5,12,2,10,4,37,25,0
16,Benie Adama Traore,Sheffield Utd,4.3,4,2,1,2,1,0,4,0.0,4,4,1,3,1,5,1,0
17,Benie Adama Traore,Nantes,5.6,8,4,2,5,1,3,7,42.9,4,3,0,3,1,9,1,0
18,Akor Adams,Montpellier,25.0,12,4,3,4,5,3,7,42.9,4,9,2,7,5,17,11,0
19,Tyler Adams,Bournemouth,1.3,4,3,1,3,0,2,3,66.7,1,2,0,2,4,8,2,0
20,Junior Adamu,Freiburg,1.2,5,1,1,2,2,1,2,50.0,1,1,0,1,0,5,2,0
21,Sargis Adamyan,Köln,8.9,14,9,2,9,3,6,11,54.5,5,16,1,15,5,19,7,0
22,Tosin Adarabioyo,Fulham,18.0,21,11,16,5,0,12,21,57.1,9,16,11,5,25,46,80,0
23,Elijah Adebayo,Luton Town,15.8,4,1,1,0,3,1,12,8.3,11,13,2,11,6,10,25,0
24,Karim Adeyemi,Dortmund,10.1,16,14,9,4,3,8,20,40.0,12,11,0,11,3,19,5,0
26,Simon Adingra,Brighton,24.7,45,20,23,11,11,19,42,45.2,23,31,1,30,19,64,22,0
27,Nathaniel Adjei,Lorient,13.8,13,9,8,3,2,6,7,85.7,1,15,8,7,18,31,64,1
28,Amine Adli,Leverkusen,10.0,16,7,2,10,4,7,17,41.2,10,10,2,8,6,22,5,0
29,Yacine Adli,Milan,15.6,34,17,17,13,4,13,35,37.1,22,22,8,14,20,54,15,1
30,Adryelson,Lyon,0.1,0,0,0,0,0,0,0,0.0,0,0,0,0,1,1,3,0
31,Adson,Nantes,2.6,7,6,1,6,0,2,2,100.0,0,5,0,5,2,9,2,0
32,Michel Aebischer,Bologna,24.8,35,20,9,20,6,15,34,44.1,19,28,6,22,12,47,22,0
33,Emmanuel Agbadou,Reims,28.8,65,41,38,23,4,44,64,68.8,20,47,25,22,55,120,116,1
34,Julen Agirrezabala,Athletic Club,2.6,0,0,0,0,0,0,0,0.0,0,0,0,0,0,0,0,0
35,Lucien Agoume,Inter,0.1,0,0,0,0,0,0,0,0.0,0,0,0,0,0,0,0,0
36,Lucien Agoume,Sevilla,8.6,23,18,7,14,2,9,12,75.0,3,6,1,5,7,30,8,0
37,Felix Agu,Werder Bremen,17.9,45,29,28,13,4,29,41,70.7,12,27,7,20,13,58,41,0
38,Nayef Aguerd,West Ham,20.6,26,14,19,7,0,16,22,72.7,6,33,24,9,17,43,85,2
39,Ruben Aguilar,Lens,21.4,53,31,27,23,3,27,45,60.0,18,35,5,30,26,79,46,0
40,Brandon Aguilera,Nott'ham Forest,0.1,0,0,0,0,0,0,0,0.0,0,0,0,0,0,0,0,0
41,Naouirou Ahamada,Crystal Palace,3.9,13,9,5,6,2,8,17,47.1,9,3,0,3,2,15,4,0
42,Anel Ahmedhodzic,Sheffield Utd,29.4,64,36,48,14,2,30,49,61.2,19,43,26,17,35,99,137,2
43,Joseph Aidoo,Celta Vigo,4.5,8,3,6,2,0,4,8,50.0,4,3,1,2,4,12,28,0
44,Ola Aina,Nott'ham Forest,18.8,47,31,31,12,4,29,41,70.7,12,19,3,16,18,65,51,1
45,Rayan Ait-Nouri,Wolves,25.9,71,44,41,23,7,28,49,57.1,21,32,6,26,15,86,38,0
46,Tosin Aiyegun,Lorient,10.0,6,4,2,3,1,3,9,33.3,6,4,1,3,2,8,8,0
47,Kristoffer Ajer,Brentford,20.4,38,21,25,9,4,23,36,63.9,13,26,11,15,25,63,79,1
48,Ludovic Ajorque,Mainz 05,15.1,3,2,1,2,0,2,11,18.2,9,6,2,4,4,7,11,0
49,Manuel Akanji,Manchester City,27.9,42,28,16,18,8,22,39,56.4,17,28,12,16,23,65,70,3
50,Marley Ake,Udinese,0.1,0,0,0,0,0,0,0,0.0,0,0,0,0,0,0,0,0
52,Nathan Ake,Manchester City,22.7,26,16,15,8,3,13,20,65.0,7,17,2,15,14,40,54,0
53,Ilias Akhomach,Villarreal,16.8,36,21,11,16,9,10,20,50.0,10,10,2,8,13,49,13,0
54,Sergio Akieme,Almería,18.6,27,15,18,7,2,13,16,81.3,3,14,4,10,10,37,34,0
55,Sergio Akieme,Reims,9.1,11,5,6,3,2,8,11,72.7,3,9,3,6,10,21,25,0
56,Ebenezer Akinsanmiro,Inter,0.2,0,0,0,0,0,0,1,0.0,1,0,0,0,0,0,0,0
57,Maghnes Akliouche,Monaco,17.9,37,23,12,20,5,12,36,33.3,24,21,0,21,9,46,3,0
58,Paul Akouokou,Betis,0.3,5,3,0,2,3,3,3,100.0,0,3,1,2,1,6,1,0
59,Paul Akouokou,Lyon,3.4,14,9,2,10,2,6,7,85.7,1,5,1,4,6,20,11,0
60,Jean-Daniel Akpa-Akpro,Monza,7.8,20,11,14,4,2,3,9,33.3,6,10,4,6,12,32,15,1
61,David Akpan Ankeye,Genoa,0.6,1,0,0,1,0,0,1,0.0,1,1,0,1,0,1,0,0
62,Kevin Akpoguma,Hoffenheim,12.2,35,18,22,12,1,26,35,74.3,9,28,8,20,18,53,32,0
63,David Alaba,Real Madrid,12.8,13,9,7,5,1,4,8,50.0,4,10,7,3,15,28,34,0
64,Luis Alberto,Lazio,25.7,35,20,16,12,7,15,53,28.3,38,34,4,30,7,42,13,0
65,Raul Albiol,Villarreal,22.6,25,14,15,9,1,18,27,66.7,9,31,24,7,16,41,102,0
66,Thiago Alcantara,Liverpool,0.1,0,0,0,0,0,0,0,0.0,0,0,0,0,0,0,0,0
67,Carlos Alcaraz,Juventus,4.2,6,6,0,6,0,5,10,50.0,5,5,2,3,5,11,4,0
68,Ruben Alcaraz,Cádiz,34.8,97,59,39,52,6,50,121,41.3,71,60,14,46,33,130,55,2
69,Omar Alderete,Getafe,24.4,28,21,15,13,0,19,35,54.3,16,30,18,12,13,41,111,0
70,Ivan Alejo,Cádiz,18.8,40,23,23,11,6,17,57,29.8,40,20,0,20,7,47,17,0
71,Carles Alena,Getafe,11.3,24,8,7,14,3,10,24,41.7,14,14,3,11,4,28,13,0
72,Trent Alexander-Arnold,Liverpool,23.9,39,26,26,11,2,27,87,31.0,60,22,2,20,31,70,48,5
73,Aboubacar Ali,Strasbourg,1.4,2,0,0,2,0,0,0,0.0,0,1,0,1,1,3,2,0
74,Mohamed Ali Cho,Real Sociedad,2.8,4,3,3,1,0,2,7,28.6,5,6,0,6,1,5,1,0
75,Mohamed Ali Cho,Nice,9.6,12,9,4,7,1,3,11,27.3,8,10,0,10,3,15,6,0
76,Faride Alidou,Köln,14.2,10,4,3,6,1,4,18,22.2,14,23,2,21,8,18,15,1
78,Nabil Alioui,Le Havre,11.2,3,2,2,1,0,2,4,50.0,2,6,1,5,3,6,4,0
79,Alisson,Liverpool,28.0,0,0,0,0,0,0,1,0.0,1,0,0,0,0,0,11,4
80,Tadeo Allende,Celta Vigo,3.7,6,1,3,2,1,4,6,66.7,2,3,0,3,3,9,3,0
81,Jim Allevinah,Clermont Foot,20.7,30,18,11,14,5,14,35,40.0,21,20,3,17,13,43,30,0
82,Domingos Andre Ribeiro Almeida,Valencia,10.7,25,15,9,12,4,9,19,47.4,10,13,1,12,6,31,5,0
83,Miguel Almiron,Newcastle Utd,21.5,36,24,13,15,8,11,29,37.9,18,29,2,27,10,46,13,0
84,Pontus Almqvist,Lecce,23.4,45,29,16,22,7,23,51,45.1,28,21,2,19,14,59,10,0
85,Marcos Alonso,Barcelona,2.8,5,3,2,3,0,3,4,75.0,1,2,0,2,4,9,6,0
86,Adria Altimira,Villarreal,8.6,16,7,9,6,1,9,24,37.5,15,18,5,13,5,21,18,0
87,Sergi Altimira,Betis,6.3,15,8,8,6,1,11,23,47.8,12,12,1,11,9,24,10,0
88,Edson Alvarez,West Ham,26.4,80,39,47,26,7,31,66,47.0,35,59,20,39,42,122,81,0
89,Gaston Alvarez,Getafe,28.2,68,37,43,20,5,37,57,64.9,20,40,11,29,35,103,80,0
90,Hugo Alvarez,Celta Vigo,8.5,14,9,8,3,3,9,20,45.0,11,4,1,3,5,19,9,0
91,Julian Alvarez,Manchester City,29.4,24,13,5,8,11,8,32,25.0,24,30,0,30,2,26,14,1
92,Yeray Alvarez,Athletic Club,12.8,18,9,15,3,0,12,19,63.2,7,8,5,3,11,29,34,1
93,Skelly Alvero,Lyon,4.7,8,7,5,2,1,2,9,22.2,7,5,1,4,2,10,5,0
94,Skelly Alvero,Werder Bremen,1.4,6,4,1,5,0,3,3,100.0,0,3,1,2,1,7,1,0
95,Papa Amadou Diallo,Metz,9.9,18,8,10,7,1,7,21,33.3,14,11,1,10,11,29,16,0
96,Selim Amallah,Valencia,6.7,17,12,7,7,3,3,9,33.3,6,13,0,13,11,28,6,0
97,Amath,Mallorca,4.4,9,6,7,2,0,2,10,20.0,8,2,0,2,3,12,6,0
98,Lorenzo Amatucci,Fiorentina,0.2,0,0,0,0,0,0,0,0.0,0,0,0,0,0,0,0,0
99,Jordan Amavi,Brest,1.0,1,1,0,1,0,1,3,33.3,2,2,1,1,3,4,2,0
100,Zeki Amdouni,Burnley,21.7,27,18,1,15,11,7,25,28.0,18,23,10,13,9,36,10,0
101,Kelvin Amian,Nantes,8.9,16,7,12,4,0,11,15,73.3,4,6,0,6,7,23,28,0
102,Bruno Amione,Hellas Verona,6.4,11,3,9,2,0,4,5,80.0,1,4,2,2,9,20,19,2
104,Michael Amir Murillo,Marseille,11.1,23,11,13,6,4,15,23,65.2,8,9,2,7,11,34,34,2
105,Nadiem Amiri,Mainz 05,14.6,22,14,8,10,4,13,19,68.4,6,16,2,14,14,36,18,0
106,Nadiem Amiri,Leverkusen,1.0,4,2,0,3,1,0,3,0.0,3,0,0,0,0,4,1,0
107,Kofi Amoako,Wolfsburg,0.0,0,0,0,0,0,0,0,0.0,0,0,0,0,0,0,0,0
108,Sofyan Amrabat,Manchester Utd,10.4,27,16,17,8,2,17,31,54.8,14,20,7,13,8,35,19,2
109,Joachim Andersen,Crystal Palace,37.9,56,35,33,21,2,29,39,74.4,10,33,18,15,41,97,207,1
110,Elliot Anderson,Newcastle Utd,11.4,24,18,12,9,3,15,29,51.7,14,23,4,19,8,32,23,0
111,Felipe Anderson,Lazio,30.8,78,45,32,33,13,34,90,37.8,56,45,3,42,27,105,23,0
112,Benjamin Andre,Lille,28.6,89,49,39,45,5,43,81,53.1,38,34,5,29,35,124,60,0
113,Komnen Andric,Clermont Foot,1.9,2,1,0,1,1,0,4,0.0,4,2,0,2,0,2,1,0
114,Robert Andrich,Leverkusen,18.8,30,18,8,14,8,13,24,54.2,11,15,4,11,20,50,17,0
115,Miguel Angel Rubio,Granada,17.3,20,12,14,6,0,14,21,66.7,7,31,18,13,28,48,74,2
116,Angelino,Roma,12.7,21,11,12,6,3,11,19,57.9,8,11,5,6,12,33,37,1
117,Fabrizio Angileri,Getafe,1.8,1,1,1,0,0,1,3,33.3,2,0,0,0,4,5,8,0
118,Jaidon Anthony,Bournemouth,1.7,3,1,1,0,2,1,7,14.3,6,3,0,3,1,4,3,0
119,Waldemar Anton,Stuttgart,32.1,39,25,21,16,2,23,42,54.8,19,33,20,13,40,79,150,1
120,Michail Antonio,West Ham,18.8,15,8,5,6,4,3,11,27.3,8,16,3,13,4,19,4,0
121,Antony,Manchester Utd,14.7,40,21,15,19,6,20,40,50.0,20,29,1,28,12,52,9,0
122,Christopher Antwi-Adjei,Bochum,13.5,21,12,10,6,5,12,22,54.5,10,13,2,11,2,23,11,1
123,Houssem Aouar,Roma,8.4,16,11,4,10,2,3,12,25.0,9,5,0,5,4,20,2,1
124,Stredair Appuah,Nantes,0.9,0,0,0,0,0,0,3,0.0,3,0,0,0,1,1,1,0
125,Mauro Arambarri,Getafe,3.8,6,2,3,2,1,1,6,16.7,5,1,0,1,2,8,7,0
126,Jon Aramburu,Real Sociedad,6.0,24,15,12,10,2,15,25,60.0,10,8,3,5,7,31,17,0
127,Asaf Arania,Darmstadt 98,0.1,0,0,0,0,0,0,0,0.0,0,0,0,0,0,0,0,0
128,Julian Araujo,Las Palmas,16.2,41,22,29,7,5,23,33,69.7,10,23,16,7,10,51,52,1
130,Ronald Araujo,Barcelona,22.2,27,22,11,15,1,12,17,70.6,5,20,11,9,12,39,66,2
131,Oliver Arblaster,Sheffield Utd,10.5,23,14,11,8,4,7,15,46.7,8,17,7,10,15,38,9,0
132,Cameron Archer,Sheffield Utd,20.4,18,13,6,6,6,8,18,44.4,10,22,3,19,1,19,11,0
133,Cameron Archer,Aston Villa,0.1,0,0,0,0,0,0,0,0.0,0,0,0,0,0,0,0,0
134,Alphonse Areola,West Ham,30.0,1,1,1,0,0,1,3,33.3,2,0,0,0,1,2,16,0
135,Adu Ares,Athletic Club,2.9,8,4,4,2,2,2,3,66.7,1,1,0,1,1,9,0,0
136,Jesus Areso,Osasuna,29.6,45,24,25,13,7,31,38,81.6,7,36,15,21,18,63,58,0
137,Simone Aresti,Cagliari,0.0,0,0,0,0,0,0,0,0.0,0,0,0,0,0,0,0,0
138,Matias Arezo,Granada,4.1,7,3,2,5,0,1,5,20.0,4,4,1,3,1,8,4,0
139,Inigo Arguibide,Osasuna,0.2,1,0,0,1,0,0,0,0.0,0,0,0,0,0,1,1,0
140,Yoel Armougom,Clermont Foot,2.6,3,3,2,0,1,2,3,66.7,1,1,0,1,1,4,3,0
141,Jose Arnaiz,Osasuna,10.3,14,8,6,4,4,6,21,28.6,15,11,2,9,3,17,2,0
142,Hakon Arnar Haraldsson,Lille,14.3,12,8,4,7,1,5,21,23.8,16,7,2,5,3,15,5,0
143,Marko Arnautovic,Inter,8.9,10,4,3,5,2,4,7,57.1,3,8,1,7,5,15,5,0
144,Maximilian Arnold,Wolfsburg,27.8,51,31,15,27,9,28,57,49.1,29,23,4,19,24,75,60,0
145,Mohamed El Arouch,Lyon,0.0,0,0,0,0,0,0,0,0.0,0,0,0,0,0,0,0,0
146,Sergio Arribas,Almería,22.7,34,17,16,17,1,14,31,45.2,17,20,1,19,16,50,8,1
147,Kepa Arrizabalaga,Real Madrid,13.3,0,0,0,0,0,0,1,0.0,1,0,0,0,0,0,4,0
148,Arthur,Leverkusen,2.0,4,3,2,0,2,2,2,100.0,0,1,1,0,0,4,7,0
149,Takuma Asano,Bochum,22.1,17,6,2,9,6,7,23,30.4,16,17,3,14,4,21,11,0
150,Marco Asensio,Paris S-G,12.4,12,10,4,7,1,4,13,30.8,9,7,0,7,5,17,2,0
151,Kristjan Asllani,Inter,8.7,7,2,3,4,0,2,11,18.2,9,9,3,6,11,18,8,0
152,Joel Asoro,Metz,9.4,13,9,7,6,0,3,10,30.0,7,7,1,6,6,19,9,0
153,Jonathan Asp Jensen,Bayern Munich,0.0,0,0,0,0,0,0,0,0.0,0,0,0,0,0,0,1,0
154,Iago Aspas,Celta Vigo,30.1,11,6,4,6,1,1,15,6.7,14,23,3,20,10,21,8,0
156,Lorenz Assignon,Burnley,13.7,35,17,18,13,4,14,27,51.9,13,22,7,15,19,54,43,1
157,Lorenz Assignon,Rennes,11.2,24,12,12,8,4,9,24,37.5,15,9,4,5,9,33,27,1
158,Youcef Atal,Nice,4.0,9,3,6,2,1,6,8,75.0,2,7,1,6,4,13,1,0
159,Valentin Atangana Edoa,Reims,6.2,19,13,6,9,4,5,13,38.5,8,5,1,4,6,25,9,0
160,Arthur Atta,Metz,10.3,18,14,8,7,3,8,19,42.1,11,13,3,10,10,28,23,0
161,Noah Atubolu,Freiburg,34.0,0,0,0,0,0,0,1,0.0,1,0,0,0,0,0,8,1
162,Pierre-Emerick Aubameyang,Marseille,29.1,22,14,4,11,7,7,26,26.9,19,30,5,25,9,31,26,0
163,Emil Audero,Inter,3.7,0,0,0,0,0,0,0,0.0,0,0,0,0,0,0,1,0
164,Tommaso Augello,Cagliari,26.9,26,19,18,6,2,16,25,64.0,9,21,10,11,17,43,89,0
165,Carlos Augusto,Inter,19.2,29,21,20,9,0,15,22,68.2,7,20,8,12,16,45,52,0
166,Yann Aurel Bisseck,Inter,10.0,14,6,10,3,1,6,9,66.7,3,10,7,3,5,19,23,0
167,Serge Aurier,Nott'ham Forest,9.3,20,14,9,11,0,5,11,45.5,6,10,3,7,9,29,36,1
168,Ezequiel Avila,Osasuna,9.6,3,2,1,1,1,3,11,27.3,8,14,0,14,4,7,8,0
169,Ezequiel Avila,Betis,3.3,2,1,0,2,0,1,3,33.3,2,2,0,2,1,3,4,0
170,Taiwo Awoniyi,Nott'ham Forest,11.6,9,7,1,4,4,1,2,50.0,1,7,2,5,1,10,9,0
171,Andre Ayew,Le Havre,12.3,15,11,7,6,2,6,9,66.7,3,8,3,5,2,17,11,0
172,Jordan Ayew,Crystal Palace,28.3,65,36,23,28,14,21,42,50.0,21,43,2,41,16,81,15,0
173,Neil El Aynaoui,Lens,17.4,37,20,13,20,4,20,46,43.5,26,20,6,14,32,69,21,1
174,Sardar Azmoun,Roma,6.5,8,5,2,5,1,4,8,50.0,4,4,1,3,3,11,6,1
175,Cesar Azpilicueta,Atlético Madrid,15.8,25,14,15,9,1,12,19,63.2,7,25,6,19,16,41,46,0
176,Paulo Azzi,Cagliari,10.6,19,11,10,6,3,9,18,50.0,9,11,2,9,16,35,23,0
177,Oussama El Azzouzi,Bologna,6.1,12,7,4,5,3,7,14,50.0,7,8,2,6,6,18,12,0
178,Abdellah Baallal,Clermont Foot,0.0,0,0,0,0,0,0,0,0.0,0,1,0,1,0,0,0,0
179,Iddrisu Baba,Almería,15.9,46,26,27,18,1,17,39,43.6,22,20,6,14,11,57,27,2
180,Srdan Babic,Almería,1.0,2,2,0,2,0,1,1,100.0,0,1,1,0,0,2,2,0
182,Shavy Babicka,Toulouse,4.1,11,8,2,7,2,2,5,40.0,3,6,1,5,0,11,2,0
183,Aliou Badara Balde,Nice,0.8,4,1,0,3,1,1,1,100.0,0,2,1,1,3,7,0,0
184,Loic Bade,Sevilla,25.3,65,41,53,12,0,30,49,61.2,19,23,15,8,38,103,116,2
185,Milan Badelj,Genoa,28.2,51,27,23,24,4,24,61,39.3,37,45,13,32,50,101,54,1
186,Matthias Bader,Darmstadt 98,20.0,51,25,32,11,8,33,65,50.8,32,22,4,18,25,76,20,0
187,Benoit Badiashile,Chelsea,14.9,21,15,12,9,0,9,14,64.3,5,21,14,7,18,39,66,2
188,Alex Baena,Villarreal,28.7,34,21,10,16,8,20,47,42.6,27,23,2,21,13,47,17,1
189,Jaime Baez,Frosinone,5.6,4,1,0,2,2,0,7,0.0,7,5,0,5,4,8,1,0
190,Nicola Bagnolini,Bologna,0.1,0,0,0,0,0,0,0,0.0,0,0,0,0,0,0,0,0
191,Leon Bailey,Aston Villa,23.0,13,7,7,4,2,5,20,25.0,15,18,1,17,9,22,6,0
192,Eric Bailly,Villarreal,9.3,5,3,4,1,0,2,2,100.0,0,8,8,0,9,14,38,2
193,Stefan Bajcetic,Liverpool,0.3,4,1,3,1,0,3,5,60.0,2,0,0,0,0,4,0,0
194,Nedim Bajrami,Sassuolo,14.6,13,6,6,3,4,5,13,38.5,8,5,1,4,6,19,8,0
195,Cedric Bakambu,Betis,2.2,1,0,0,1,0,0,0,0.0,0,2,0,2,0,1,0,0
196,Tiemoue Bakayoko,Lorient,14.6,34,17,14,17,3,15,28,53.6,13,10,4,6,26,60,15,1
197,Mitchel Bakker,Atalanta,4.2,7,3,6,1,0,2,12,16.7,10,5,0,5,3,10,6,0
198,Ridle Baku,Wolfsburg,22.4,37,20,24,7,6,21,46,45.7,25,27,1,26,21,58,45,1
199,Dilane Bakwa,Strasbourg,24.2,30,22,12,13,5,11,40,27.5,29,26,1,25,20,50,11,0
200,Tommaso Baldanzi,Empoli,8.3,4,2,1,1,2,3,10,30.0,7,7,0,7,2,6,0,0
201,Tommaso Baldanzi,Roma,5.8,9,5,3,4,2,1,1,100.0,0,2,0,2,0,9,4,0
202,Alejandro Balde,Barcelona,15.3,20,11,11,6,3,7,11,63.6,4,14,1,13,5,25,21,1
203,George Baldock,Sheffield Utd,10.8,18,10,10,7,1,6,15,40.0,9,14,8,6,10,28,33,0
204,Carlos Baleba,Brighton,14.7,40,20,17,19,4,23,46,50.0,23,35,7,28,18,58,30,3
205,Carlos Baleba,Lille,0.7,6,2,1,4,1,3,4,75.0,1,0,0,0,2,8,0,0
206,Leonardo Balerdi,Marseille,25.2,79,50,55,23,1,49,67,73.1,18,38,15,23,51,130,91,0
208,Ivan Balliu,Rayo Vallecano,31.9,44,31,20,24,0,22,39,56.4,17,27,11,16,29,73,66,1
209,Fode Ballo-Toure,Fulham,0.8,4,2,1,3,0,1,2,50.0,1,1,0,1,3,7,2,0
210,Folarin Balogun,Monaco,18.8,12,4,3,8,1,5,13,38.5,8,10,0,10,3,15,4,0
211,Jonathan Bamba,Celta Vigo,22.0,14,9,4,8,2,2,17,11.8,15,20,0,20,18,32,12,0
212,Mohamed Bamba,Lorient,12.6,14,9,3,8,3,4,10,40.0,6,7,1,6,2,16,3,0
213,Samuel Bamba,Dortmund,0.5,1,1,1,0,0,1,2,50.0,1,0,0,0,0,1,1,0
214,Lameck Banda,Lecce,15.0,27,23,11,12,4,7,21,33.3,14,18,0,18,3,30,7,0
215,Daniel Bandeira,Hellas Verona,5.0,6,5,1,4,1,3,7,42.9,4,3,0,3,3,9,9,0
216,Mamady Bangre,Toulouse,1.1,4,2,2,2,0,3,4,75.0,1,0,0,0,4,8,3,0
217,Mattia Bani,Genoa,25.6,26,10,18,7,1,11,22,50.0,11,51,31,20,22,48,116,1
218,Leo Baptistao,Almería,20.4,25,16,12,8,5,9,25,36.0,16,13,1,12,11,36,22,0
219,Shandon Baptiste,Brentford,2.5,4,4,2,2,0,1,5,20.0,4,5,1,4,3,7,6,0
220,Antonin Barak,Fiorentina,9.0,6,2,1,3,2,3,7,42.9,4,5,0,5,2,8,4,0
221,Valentin Barco,Brighton,3.4,11,5,4,5,2,6,8,75.0,2,3,0,3,4,15,3,1
222,Bradley Barcola,Lyon,3.0,5,2,0,2,3,1,7,14.3,6,4,0,4,2,7,0,0
223,Bradley Barcola,Paris S-G,15.2,34,16,12,13,9,7,25,28.0,18,27,2,25,10,44,13,1
224,Melvin Bard,Nice,29.5,69,38,28,30,11,37,63,58.7,26,46,12,34,42,111,46,0
225,Nicolo Barella,Inter,31.6,46,30,17,20,9,19,63,30.2,44,31,1,30,10,56,12,1
226,Kike Barja,Osasuna,3.4,6,2,2,2,2,3,8,37.5,5,2,1,1,2,8,2,0
227,Ross Barkley,Luton Town,29.1,47,19,16,21,10,11,48,22.9,37,25,9,16,25,72,51,2
228,Aymen Barkok,Mainz 05,3.6,9,5,2,6,1,3,6,50.0,3,7,0,7,2,11,1,0
229,Harvey Barnes,Newcastle Utd,8.9,6,1,3,2,1,1,2,50.0,1,1,0,1,5,11,3,0
230,Leandro Barreiro Martins,Mainz 05,29.0,65,40,19,37,9,30,50,60.0,20,45,16,29,36,101,53,0
231,Enzo Barrenechea,Frosinone,31.2,65,42,28,29,8,28,70,40.0,42,47,12,35,27,92,61,2
232,Ander Barrenetxea,Real Sociedad,15.9,32,21,7,16,9,10,26,38.5,16,18,1,17,6,38,5,0
234,Pablo Barrios,Atlético Madrid,17.3,45,25,15,29,1,19,40,47.5,21,20,3,17,28,73,24,2
235,Davide Bartesaghi,Milan,0.9,2,0,1,1,0,2,4,50.0,2,1,1,0,0,2,7,0
236,Marc Bartra,Betis,2.5,4,3,3,1,0,4,5,80.0,1,3,1,2,3,7,10,0
237,Federico Baschirotto,Lecce,36.6,21,12,16,5,0,8,15,53.3,7,42,26,16,23,44,144,1
238,Steven Baseya,Strasbourg,0.1,2,1,1,1,0,1,1,100.0,0,0,0,0,0,2,1,0
239,Chris Basham,Sheffield Utd,3.6,7,2,4,3,0,2,9,22.2,7,9,4,5,5,12,17,0
240,Toma Basic,Salernitana,12.9,20,13,10,9,1,10,27,37.0,17,18,6,12,14,34,29,0
241,Calvin Bassey,Fulham,25.6,49,29,33,15,1,21,29,72.4,8,32,11,21,28,77,84,4
242,Alessandro Bastoni,Inter,25.2,46,33,31,12,3,26,40,65.0,14,25,11,14,23,69,48,1
243,Simone Bastoni,Empoli,8.3,22,13,12,7,3,11,22,50.0,11,8,0,8,11,33,18,0
244,Augusto Batalla,Granada,17.0,0,0,0,0,0,0,1,0.0,1,0,0,0,0,0,10,2
245,Daniel Batz,Mainz 05,4.0,0,0,0,0,0,0,0,0.0,0,0,0,0,0,0,3,0
246,Maximilian Bauer,Augsburg,9.0,19,12,13,4,2,9,17,52.9,8,14,8,6,11,30,30,1
247,Elias Baum,Eint Frankfurt,0.3,1,0,0,0,1,0,0,0.0,0,3,2,1,0,1,1,0
248,Oliver Baumann,Hoffenheim,34.0,1,1,1,0,0,1,2,50.0,1,0,0,0,0,1,19,2
249,Christoph Baumgartner,RB Leipzig,12.9,26,13,10,12,4,14,38,36.8,24,20,1,19,5,31,14,0
250,Bebe,Rayo Vallecano,2.4,2,2,1,1,0,1,5,20.0,4,1,0,1,0,2,0,0
251,Ihlas Bebou,Hoffenheim,18.2,22,12,10,8,4,8,16,50.0,8,13,2,11,14,36,15,0
252,Mohamed Bechikh,Strasbourg,0.2,0,0,0,0,0,0,0,0.0,0,0,0,0,0,0,0,0
253,Adrian Beck,Heidenheim,10.8,22,13,8,12,2,9,24,37.5,15,17,0,17,4,26,15,0
254,Owen Beck,Liverpool,0.1,2,1,1,1,0,0,0,0.0,0,0,0,0,0,2,1,0
255,Sheraldo Becker,Real Sociedad,8.6,2,2,0,2,0,0,1,0.0,1,3,0,3,1,3,0,0
256,Sheraldo Becker,Union Berlin,7.2,3,3,0,2,1,0,2,0.0,2,2,0,2,0,3,2,0
257,Chris Bedia,Union Berlin,1.6,2,1,0,2,0,0,1,0.0,1,3,0,3,0,2,2,0
258,Donny van de Beek,Manchester Utd,0.0,0,0,0,0,0,0,0,0.0,0,1,0,1,0,0,0,0
260,Donny van de Beek,Eint Frankfurt,4.0,8,3,3,3,2,3,7,42.9,4,5,1,4,3,11,1,0
261,Yanis Begraoui,Toulouse,3.3,5,3,1,3,1,3,9,33.3,6,4,0,4,5,10,5,0
262,Kevin Behrens,Wolfsburg,6.8,2,1,0,1,1,0,2,0.0,2,9,0,9,3,5,6,0
263,Kevin Behrens,Union Berlin,14.0,13,10,3,7,3,1,4,25.0,3,7,2,5,6,19,19,0
264,Maximilian Beier,Hoffenheim,26.9,20,12,5,11,4,4,19,21.1,15,21,1,20,9,29,12,0
265,Jeremie Bela,Clermont Foot,2.3,1,1,0,1,0,1,3,33.3,2,1,0,1,0,1,1,0
266,Reda Belahyane,Hellas Verona,1.0,1,1,0,1,0,1,1,100.0,0,0,0,0,1,2,0,0
267,Reda Belahyane,Nice,0.3,1,0,0,1,0,1,1,100.0,0,0,0,0,0,1,0,0
268,Amari'i Bell,Luton Town,19.1,50,33,30,19,1,22,35,62.9,13,33,15,18,25,75,60,1
269,Stefan Bell,Mainz 05,7.4,8,8,7,1,0,4,8,50.0,4,7,5,2,6,14,30,0
270,Alaa Bellaarouch,Strasbourg,15.0,0,0,0,0,0,0,0,0.0,0,0,0,0,1,1,11,2
271,Raoul Bellanova,Torino,33.8,36,26,15,17,4,18,31,58.1,13,21,4,17,15,51,36,3
272,Jean-Ricner Bellegarde,Wolves,10.6,17,10,9,6,2,7,15,46.7,8,18,2,16,8,25,14,0
273,Jean-Ricner Bellegarde,Strasbourg,3.0,5,3,3,2,0,3,6,50.0,3,4,0,4,4,9,0,0
274,Hector Bellerin,Betis,19.0,34,22,14,16,4,20,53,37.7,33,13,5,8,22,56,40,1
275,Jude Bellingham,Real Madrid,25.7,42,34,14,18,10,12,36,33.3,24,55,5,50,21,63,17,0
276,Jeanuel Belocian,Rennes,16.1,32,22,23,8,1,22,28,78.6,6,18,10,8,13,45,49,0
277,Andrea Belotti,Fiorentina,10.5,8,3,1,5,2,5,12,41.7,7,8,1,7,2,10,3,0
278,Andrea Belotti,Roma,7.5,8,4,2,3,3,3,6,50.0,3,7,0,7,2,10,3,0
279,Fran Beltran,Celta Vigo,27.0,56,32,22,23,11,24,63,38.1,39,28,2,26,18,74,34,0
280,Lucas Beltran,Fiorentina,18.8,27,14,4,18,5,11,20,55.0,9,29,3,26,2,29,11,0
281,Eliesse Ben Seghir,Monaco,4.8,9,6,2,5,2,3,7,42.9,4,6,0,6,2,11,2,0
282,Anis Ben Slimane,Sheffield Utd,4.7,11,6,5,2,4,4,10,40.0,6,7,1,6,5,16,7,0
283,Wissam Ben Yedder,Monaco,25.7,4,3,1,2,1,1,11,9.1,10,18,0,18,8,12,1,0
284,Carlos Benavidez,Alavés,12.6,56,35,19,26,11,19,34,55.9,15,13,5,8,19,75,31,0
286,Ismael Bennacer,Milan,12.8,29,19,11,16,2,11,22,50.0,11,12,4,8,12,41,9,2
287,Said Benrahma,West Ham,6.9,8,4,5,3,0,4,15,26.7,11,8,0,8,5,13,7,0
288,Said Benrahma,Lyon,8.6,9,7,1,6,2,5,7,71.4,2,7,0,7,1,10,3,0
289,Ramy Bensebaini,Dortmund,11.5,34,21,21,11,2,24,34,70.6,10,22,7,15,16,50,37,0
290,Nabil Bentaleb,Lille,21.9,49,32,29,18,2,22,43,51.2,21,33,12,21,37,86,33,0
291,Rodrigo Bentancur,Tottenham,11.2,23,15,10,11,2,10,24,41.7,14,15,4,11,17,40,16,1
292,Daniel Bentley,Wolves,4.3,0,0,0,0,0,0,1,0.0,1,0,0,0,0,0,1,0
293,Lucas Beraldo,Paris S-G,11.2,22,14,14,8,0,10,25,40.0,15,15,6,9,20,42,25,0
294,Domenico Berardi,Sassuolo,15.9,17,8,7,9,1,2,21,9.5,19,17,0,17,13,30,9,0
295,Yuri Berchiche,Athletic Club,21.4,33,25,13,14,6,19,33,57.6,14,28,9,19,20,53,62,0
296,Alex Berenguer,Athletic Club,17.7,23,14,9,9,5,7,24,29.2,17,23,0,23,5,28,13,0
297,Bartosz Bereszynski,Empoli,19.6,41,25,25,13,3,24,40,60.0,16,22,10,12,21,62,52,0
298,Johann Berg Gudmundsson,Burnley,13.2,13,4,6,5,2,7,16,43.8,9,14,0,14,16,29,16,0
299,Sander Berge,Burnley,33.4,76,46,35,36,5,34,58,58.6,24,49,20,29,23,99,60,2
300,Etrit Berisha,Empoli,14.0,0,0,0,0,0,0,1,0.0,1,0,0,0,0,0,7,1
301,Medon Berisha,Lecce,2.3,3,1,3,0,0,0,2,0.0,2,2,2,0,1,4,0,0
302,Mergim Berisha,Hoffenheim,1.6,0,0,0,0,0,0,0,0.0,0,2,1,1,0,0,0,0
303,Mergim Berisha,Augsburg,1.4,0,0,0,0,0,0,0,0.0,0,1,0,1,0,0,3,0
304,Isaac Bernal,Sevilla,11.5,6,3,2,2,2,5,9,55.6,4,12,0,12,0,6,11,0
305,Bernardo,Bochum,32.5,99,58,56,35,8,45,69,65.2,24,66,30,36,55,154,120,1
306,Victor Bernth Kristiansen,Bologna,25.6,52,34,23,22,7,20,35,57.1,15,35,8,27,12,64,45,1
307,Matus Bero,Bochum,18.5,32,22,13,12,7,13,32,40.6,19,24,3,21,12,44,26,0
308,Luke Berry,Luton Town,3.6,7,2,2,4,1,2,3,66.7,1,6,1,5,0,7,3,0
309,Dimitry Bertaud,Montpellier,4.0,0,0,0,0,0,0,0,0.0,0,0,0,0,0,0,0,0
310,Jan-Niklas Beste,Heidenheim,28.9,77,49,35,24,18,28,55,50.9,27,48,1,47,18,95,31,0
312,Beto,Everton,10.6,14,6,1,6,7,4,12,33.3,8,11,0,11,1,15,14,0
313,Beto,Udinese,0.8,1,0,0,0,1,0,0,0.0,0,0,0,0,0,1,0,0
314,Davide Bettella,Monza,0.0,0,0,0,0,0,0,0,0.0,0,0,0,0,0,0,0,0
315,Sam Beukema,Bologna,28.3,27,11,14,11,2,16,25,64.0,9,35,21,14,15,42,99,2
316,Jordan Beyer,Burnley,13.7,35,20,22,12,1,14,24,58.3,10,22,15,7,16,51,68,1
317,Pep Biel,Augsburg,3.2,4,3,0,2,2,1,3,33.3,2,2,1,1,2,6,2,0
318,Jaka Bijol,Udinese,23.2,43,27,34,9,0,22,35,62.9,13,36,21,15,23,66,140,1
319,El Bilal Toure,Atalanta,4.4,1,1,0,1,0,0,1,0.0,1,0,0,0,1,2,2,0
320,Philip Billing,Bournemouth,15.5,33,16,7,22,4,9,27,33.3,18,31,5,26,20,53,28,1
321,Cristiano Biraghi,Fiorentina,26.2,47,28,20,24,3,28,52,53.8,24,30,5,25,14,61,43,0
322,Davide Biraschi,Genoa,1.0,3,3,1,2,0,1,3,33.3,2,0,0,0,2,5,5,0
323,Samuele Birindelli,Monza,22.4,28,19,16,7,5,14,25,56.0,11,30,11,19,18,46,48,0
324,Tom Bischof,Hoffenheim,2.0,8,4,6,1,1,2,9,22.2,7,3,0,3,1,9,2,0
325,Yves Bissouma,Tottenham,23.0,80,52,32,36,12,41,61,67.2,20,28,5,23,37,117,43,3
326,Leonardo Bittencourt,Werder Bremen,17.5,42,18,20,17,5,15,39,38.5,24,18,1,17,13,55,6,0
327,Marco Bizot,Brest,32.0,0,0,0,0,0,0,1,0.0,1,0,0,0,0,0,18,3
328,Antonio Blanco,Alavés,27.0,61,36,29,27,5,31,86,36.0,55,25,2,23,35,96,30,0
329,Ruben Blanco,Marseille,1.3,0,0,0,0,0,0,0,0.0,0,0,0,0,0,0,0,0
330,Hendry Blank,Dortmund,0.5,1,0,1,0,0,1,1,100.0,0,1,0,1,0,1,4,0
331,Ludovic Blas,Rennes,17.4,30,14,16,13,1,12,28,42.9,16,13,1,12,6,36,9,0
332,Janis Blaswich,RB Leipzig,21.0,1,1,1,0,0,0,0,0.0,0,0,0,0,0,1,7,3
333,Alexis Blin,Lecce,18.2,33,19,11,19,3,15,43,34.9,28,16,2,14,22,55,39,0
334,Daley Blind,Girona,33.0,47,21,33,13,1,29,47,61.7,18,37,19,18,21,68,113,0
335,Myron Boadu,Monaco,0.9,2,2,0,1,1,1,2,50.0,1,2,0,2,0,2,0,0
336,Benicio Boaitey,Brighton,0.4,0,0,0,0,0,0,1,0.0,1,1,0,1,0,0,2,0
338,Jerome Boateng,Salernitana,2.6,0,0,0,0,0,0,0,0.0,0,6,5,1,4,4,21,0
339,Oscar Bobb,Manchester City,3.4,7,3,1,2,4,2,4,50.0,2,4,0,4,5,12,1,0
340,Sacha Boey,Bayern Munich,1.2,2,0,2,0,0,1,2,50.0,1,1,0,1,1,3,2,0
341,Jeremie Boga,Nice,22.2,18,7,6,10,2,10,20,50.0,10,26,2,24,8,26,4,0
342,Jayden Bogle,Sheffield Utd,31.0,66,36,43,21,2,35,70,50.0,35,42,11,31,32,98,97,0
343,Emil Bohinen,Genoa,0.6,1,1,0,1,0,0,0,0.0,0,1,0,1,0,1,3,0
344,Emil Bohinen,Salernitana,5.9,8,6,5,3,0,2,10,20.0,8,8,2,6,14,22,6,1
345,Adama Bojang,Reims,0.9,2,1,1,0,1,0,0,0.0,0,2,1,1,1,3,0,0
346,Daniel Boloca,Sassuolo,22.5,48,33,18,25,5,27,46,58.7,19,23,13,10,14,62,33,2
347,Willy Boly,Nott'ham Forest,16.0,46,29,36,9,1,22,40,55.0,18,32,21,11,25,71,90,0
348,Giacomo Bonaventura,Fiorentina,25.3,26,13,6,10,10,9,21,42.9,12,16,1,15,14,40,10,0
349,Federico Bonazzoli,Hellas Verona,11.3,4,1,1,3,0,1,8,12.5,7,9,1,8,3,7,3,0
350,Warren Bondo,Monza,16.4,29,22,16,10,3,13,17,76.5,4,13,3,10,6,35,13,0
351,Giovanni Bonfanti,Atalanta,1.0,4,2,2,2,0,2,3,66.7,1,1,1,0,1,5,1,0
352,Victor Boniface,Leverkusen,17.2,6,4,0,1,5,1,4,25.0,3,6,1,5,0,6,13,0
353,Kevin Bonifazi,Bologna,1.0,4,0,0,4,0,1,2,50.0,1,0,0,0,0,4,7,1
354,Kevin Bonifazi,Frosinone,3.4,5,3,2,3,0,2,3,66.7,1,1,0,1,3,8,9,0
355,Leonardo Bonucci,Union Berlin,5.1,6,5,2,4,0,4,4,100.0,0,5,3,2,7,13,16,0
356,Angelo Borges,Strasbourg,12.2,24,11,9,7,8,11,31,35.5,20,18,0,18,9,33,2,0
357,Neto Borges,Clermont Foot,28.0,48,24,25,18,5,28,63,44.4,35,28,6,22,57,105,84,0
358,Yvandro Borges Sanches,Gladbach,0.2,0,0,0,0,0,0,0,0.0,0,0,0,0,0,0,0,0
359,Sebastiaan Bornauw,Wolfsburg,15.9,26,12,19,7,0,13,19,68.4,6,21,12,9,18,44,81,0
360,Rafael Borre,Werder Bremen,11.0,10,7,2,4,4,5,16,31.3,11,8,2,6,2,12,10,0
361,Gennaro Borrelli,Frosinone,0.3,0,0,0,0,0,0,0,0.0,0,0,0,0,0,0,0,0
362,Adri Bosch,Granada,0.3,1,1,1,0,0,0,0,0.0,0,0,0,0,0,1,1,0
364,Erik Botheim,Salernitana,3.5,2,0,2,0,0,0,1,0.0,1,3,0,3,0,2,2,0
365,Sven Botman,Newcastle Utd,15.3,20,13,14,6,0,8,13,61.5,5,20,16,4,9,29,61,3
366,Saimon Bouabre,Monaco,0.5,2,2,0,2,0,1,2,50.0,1,1,0,1,0,2,0,0
367,Ayyoub Bouaddi,Lille,1.5,6,2,6,0,0,2,5,40.0,3,2,0,2,1,7,3,0
368,Badredine Bouanani,Nice,1.8,3,2,1,1,1,3,4,75.0,1,5,0,5,3,6,0,0
369,Badredine Bouanani,Lorient,4.9,4,2,1,1,2,2,4,50.0,2,3,0,3,2,6,3,0
370,Mohamed Bouchenna,Clermont Foot,0.3,1,0,1,0,0,0,0,0.0,0,0,0,0,0,1,0,0
371,Hicham Boudaoui,Nice,17.9,41,19,16,22,3,21,30,70.0,9,15,1,14,11,52,15,0
372,Yassine Bounou,Sevilla,1.0,0,0,0,0,0,0,0,0.0,0,0,0,0,0,0,0,0
373,Mehdi Bourabia,Frosinone,2.2,5,4,1,4,0,2,4,50.0,2,3,0,3,0,5,4,0
374,Benjamin Bourigeaud,Rennes,26.9,31,18,14,9,8,13,44,29.5,31,31,2,29,22,53,39,2
375,Bilal Boutobba,Clermont Foot,10.3,22,12,6,10,6,10,23,43.5,13,9,0,9,8,30,3,0
376,Hugo Boutsingkham,Nantes,0.1,0,0,0,0,0,0,0,0.0,0,0,0,0,0,0,1,0
377,Edoardo Bove,Roma,19.8,60,31,16,31,13,27,46,58.7,19,21,1,20,11,71,11,1
378,Jarrod Bowen,West Ham,33.5,42,28,14,14,14,13,35,37.1,22,37,5,32,19,61,14,0
379,Lucas Boye,Granada,28.2,50,25,14,25,11,14,34,41.2,20,35,5,30,10,60,46,0
380,Domagoj Bradaric,Salernitana,30.5,29,20,13,10,6,15,25,60.0,10,22,7,15,32,61,62,1
381,Conor Bradley,Liverpool,8.4,33,25,14,12,7,24,38,63.2,14,17,1,16,10,43,14,0
382,Bilal Brahimi,Nice,0.1,0,0,0,0,0,0,1,0.0,1,0,0,0,0,0,0,0
383,Bilal Brahimi,Brest,2.5,0,0,0,0,0,0,3,0.0,3,3,0,3,0,0,0,0
384,Juan Brandariz,Almería,27.0,34,22,22,12,0,16,26,61.5,10,38,23,15,14,48,107,3
385,Julian Brandt,Dortmund,24.7,17,14,8,8,1,10,27,37.0,17,20,3,17,8,25,18,0
386,Jarrad Branthwaite,Everton,34.6,66,32,42,22,2,45,62,72.6,17,51,36,15,50,116,163,2
387,Darko Brasanac,Osasuna,0.5,1,0,1,0,0,1,1,100.0,0,1,0,1,0,1,0,0
388,Lilian Brassier,Brest,29.7,31,18,18,13,0,12,24,50.0,12,28,21,7,41,72,93,0
390,Brau,Granada,0.3,1,0,1,0,0,1,1,100.0,0,0,0,0,0,1,2,0
391,Claudio Bravo,Betis,7.0,0,0,0,0,0,0,1,0.0,1,0,0,0,0,0,2,0
392,Fabian Bredlow,Stuttgart,4.0,0,0,0,0,0,0,1,0.0,1,0,0,0,0,0,3,0
393,Tim Breithaupt,Augsburg,7.0,20,11,11,9,0,13,21,61.9,8,15,3,12,8,28,10,0
394,Josip Brekalo,Fiorentina,7.2,8,6,6,2,0,2,11,18.2,9,7,0,7,1,9,0,0
395,Gleison Bremer,Juventus,35.9,58,42,32,21,5,21,29,72.4,8,45,27,18,40,98,147,0
396,Brenner,Udinese,2.1,8,7,1,5,2,4,7,57.1,3,2,0,2,0,8,2,0
397,Ben Brereton,Sheffield Utd,12.3,9,4,4,4,1,4,10,40.0,6,9,3,6,3,12,12,0
398,Ben Brereton,Villarreal,3.0,2,2,1,0,1,0,2,0.0,2,0,0,0,0,2,0,0
399,Marco Brescianini,Frosinone,25.8,28,13,13,12,3,9,25,36.0,16,22,5,17,10,38,37,0
400,Maximilian Breunig,Freiburg,0.1,0,0,0,0,0,0,0,0.0,0,1,0,1,0,0,0,0
401,Rhian Brewster,Sheffield Utd,3.8,5,1,1,2,2,0,2,0.0,2,2,0,2,1,6,2,0
402,Bennit Broger,Wolfsburg,0.1,0,0,0,0,0,0,0,0.0,0,0,0,0,0,0,0,0
403,Armando Broja,Chelsea,5.0,3,0,0,1,2,1,2,50.0,1,5,1,4,0,3,3,0
404,Armando Broja,Fulham,1.0,0,0,0,0,0,0,0,0.0,0,1,0,1,0,0,0,0
405,Dylan Bronn,Salernitana,0.6,0,0,0,0,0,0,1,0.0,1,2,0,2,0,0,4,0
406,Andre Brooks,Sheffield Utd,10.4,22,13,7,11,4,9,21,42.9,12,13,1,12,14,36,20,0
407,David Brooks,Bournemouth,3.1,5,4,2,1,2,2,4,50.0,2,3,0,3,2,7,2,0
408,John Brooks,Hoffenheim,17.1,28,15,17,10,1,15,30,50.0,15,29,17,12,27,55,109,1
409,Moritz Broschinski,Bochum,13.9,11,7,2,5,4,2,8,25.0,6,11,2,9,0,11,6,0
410,Jacob Brown,Luton Town,11.3,19,12,7,7,5,7,18,38.9,11,20,1,19,8,27,22,0
411,Josh Brownhill,Burnley,25.0,61,35,23,28,10,27,37,73.0,10,33,8,25,34,95,40,1
412,Alexander Brunst,Darmstadt 98,3.0,0,0,0,0,0,0,2,0.0,2,0,0,0,0,0,2,1
413,Jacob Bruun Larsen,Burnley,13.9,9,4,4,3,2,7,21,33.3,14,16,2,14,7,16,23,0
414,Tajon Buchanan,Inter,1.8,1,1,0,0,1,1,2,50.0,1,1,0,1,0,1,4,0
416,Ante Budimir,Osasuna,27.1,21,15,2,11,8,5,14,35.7,9,19,5,14,5,26,18,0
417,Hugo Bueno,Wolves,8.2,21,14,12,7,2,12,19,63.2,7,17,4,13,6,27,24,0
418,Santiago Bueno,Wolves,9.1,13,7,5,7,1,5,11,45.5,6,22,12,10,6,19,33,0
419,Marius Bulter,Hoffenheim,15.0,18,11,9,5,4,12,23,52.2,11,17,3,14,10,28,20,0
420,Facundo Buonanotte,Brighton,15.2,42,22,13,22,7,14,44,31.8,30,22,3,19,8,50,5,0
421,Alessandro Buongiorno,Torino,28.1,70,39,43,24,3,24,34,70.6,10,20,12,8,69,139,131,0
422,Jonathan Burkardt,Mainz 05,17.1,12,8,2,6,4,4,11,36.4,7,16,3,13,3,15,2,0
423,Oliver Burke,Werder Bremen,0.4,0,0,0,0,0,0,2,0.0,2,0,0,0,0,0,0,0
424,Reece Burke,Luton Town,18.4,37,23,17,14,6,12,26,46.2,14,25,18,7,18,55,78,1
425,Dan Burn,Newcastle Utd,30.3,61,33,37,20,4,26,61,42.6,35,55,25,30,37,98,124,1
426,Rares-Catalin Burnete,Lecce,0.1,0,0,0,0,0,0,0,0.0,0,0,0,0,0,0,0,0
427,Mason Burstow,Chelsea,0.1,0,0,0,0,0,0,0,0.0,0,0,0,0,0,0,0,0
428,Marnon Busch,Heidenheim,6.6,11,9,6,3,2,7,12,58.3,5,9,2,7,10,21,12,0
429,Maxime Busi,Reims,1.8,2,0,0,1,1,0,2,0.0,2,6,1,5,4,6,5,0
430,Pablo Busto,Betis,0.5,1,1,0,0,1,1,1,100.0,0,0,0,0,1,2,3,0
431,Aurelio Buta,Eint Frankfurt,19.4,40,25,19,16,5,21,38,55.3,17,24,5,19,15,55,36,0
432,Marcin Bulka,Nice,34.0,0,0,0,0,0,0,2,0.0,2,0,0,0,0,0,9,3
433,Jamie Bynoe-Gittens,Dortmund,11.8,14,7,6,7,1,2,17,11.8,15,11,2,9,4,18,7,0
434,Remy Cabella,Lille,16.4,54,36,19,20,15,20,54,37.0,34,32,0,32,5,59,5,0
435,Jovane Cabral,Salernitana,7.5,13,9,4,7,2,3,9,33.3,6,3,0,3,1,14,4,0
436,Liberato Cacace,Empoli,21.2,40,24,24,13,3,24,38,63.2,14,23,6,17,19,59,56,0
437,Anthony Caci,Mainz 05,27.6,56,23,30,25,1,27,44,61.4,17,43,7,36,32,88,45,0
438,Moises Caicedo,Chelsea,31.8,91,46,38,42,11,36,60,60.0,24,59,25,34,37,128,44,4
439,Tom Cairney,Fulham,16.5,24,16,10,12,2,13,25,52.0,12,16,4,12,13,37,6,0
440,Jens Cajuste,Napoli,11.3,36,24,13,17,6,20,37,54.1,17,20,3,17,4,40,15,0
442,Davide Calabria,Milan,24.3,70,38,38,25,7,44,72,61.1,28,26,7,19,24,94,49,1
443,Riccardo Calafiori,Bologna,26.1,47,32,28,16,3,22,32,68.8,10,38,13,25,50,97,74,3
444,Mattia Caldara,Milan,0.4,1,1,1,0,0,1,1,100.0,0,1,1,0,1,2,1,0
445,Luca Caldirola,Monza,23.8,25,14,19,4,2,13,22,59.1,9,26,17,9,29,54,53,0
446,Duje Caleta-Car,Lyon,22.1,26,11,19,6,1,18,22,81.8,4,27,14,13,18,44,94,1
447,Hakan Calhanoglu,Inter,28.4,66,33,29,29,8,32,49,65.3,17,29,13,16,24,90,22,0
448,Jose Callejon,Granada,8.9,13,6,10,3,0,8,22,36.4,14,7,1,6,5,18,10,0
449,Dominic Calvert-Lewin,Everton,24.1,13,6,2,6,5,2,15,13.3,13,14,4,10,4,17,38,0
450,Lamine Camara,Metz,25.1,62,42,26,30,6,24,49,49.0,25,35,2,33,28,90,34,0
451,Mahdi Camara,Brest,22.4,55,39,8,40,7,20,49,40.8,29,24,1,23,27,82,19,0
452,Mohamed Camara,Monaco,11.5,35,21,10,20,5,15,29,51.7,14,8,2,6,11,46,7,0
453,Francesco Camarda,Milan,0.2,0,0,0,0,0,0,2,0.0,2,0,0,0,0,0,0,0
454,Eduardo Camavinga,Real Madrid,20.2,76,47,39,29,8,23,39,59.0,16,36,8,28,29,105,29,1
455,Nicolo Cambiaghi,Empoli,28.4,51,39,15,20,16,16,35,45.7,19,26,1,25,14,65,8,0
456,Andrea Cambiaso,Juventus,26.4,47,30,23,15,9,25,43,58.1,18,28,3,25,11,58,26,1
457,Axel Camblan,Brest,1.0,3,1,0,2,1,2,4,50.0,2,2,0,2,0,3,0,0
458,Sergio Camello,Rayo Vallecano,18.5,16,5,3,10,3,6,15,40.0,9,10,2,8,3,19,15,0
459,Jose Campana,Las Palmas,1.9,2,2,1,1,0,0,2,0.0,2,3,2,1,2,4,3,0
460,Emre Can,Dortmund,21.7,63,45,37,23,3,28,48,58.3,20,30,7,23,22,85,41,2
461,Matteo Cancellieri,Empoli,19.9,35,22,12,16,7,13,36,36.1,23,19,0,19,6,41,18,0
462,Joao Cancelo,Barcelona,27.8,64,44,35,21,8,38,58,65.5,20,35,6,29,29,93,59,1
463,Fali Cande,Metz,20.5,40,19,31,9,0,20,35,57.1,15,41,28,13,20,60,107,1
464,Antonio Candreva,Salernitana,30.6,18,13,8,8,2,9,25,36.0,16,9,0,9,7,25,23,0
465,Thomas Cannon,Everton,0.0,0,0,0,0,0,0,0,0.0,0,0,0,0,0,0,0,0
466,Sergi Canos,Valencia,13.7,23,13,7,11,5,10,24,41.7,14,14,2,12,11,34,9,0
468,Luigi Canotto,Frosinone,0.2,0,0,0,0,0,0,0,0.0,0,0,0,0,0,0,0,0
469,Gino Caoki,Lorient,0.1,0,0,0,0,0,0,1,0.0,1,0,0,0,0,0,0,0
470,Etienne Capoue,Villarreal,16.2,32,18,17,12,3,15,22,68.2,7,20,4,16,22,54,24,1
471,Gianluca Caprari,Monza,3.2,2,1,1,1,0,0,1,0.0,1,0,0,0,2,4,0,0
472,Elia Caprile,Empoli,23.0,1,0,1,0,0,1,1,100.0,0,0,0,0,0,1,16,2
473,Francesco Caputo,Empoli,14.1,2,0,0,0,2,0,1,0.0,1,4,0,4,1,3,3,0
474,Maxence Caqueret,Lyon,33.6,91,64,39,37,15,38,107,35.5,69,40,9,31,48,139,26,2
475,Andrea Carboni,Monza,16.5,38,22,24,12,2,20,31,64.5,11,23,13,10,17,55,56,1
476,Valentin Carboni,Monza,13.0,25,15,10,12,3,8,26,30.8,18,12,1,11,7,32,4,0
477,Isaac Carcelen,Cádiz,29.0,50,31,30,15,5,25,45,55.6,20,24,7,17,27,77,87,2
478,Cardenas,Rayo Vallecano,1.0,0,0,0,0,0,0,0,0.0,0,0,0,0,0,0,1,0
479,Irvin Cardona,Augsburg,0.6,1,1,0,0,1,1,3,33.3,2,1,0,1,0,1,1,0
480,Marc Cardona,Las Palmas,8.0,9,8,3,4,2,1,12,8.3,11,5,0,5,2,11,7,0
481,Sergi Cardona,Las Palmas,31.3,90,55,52,29,9,55,96,57.3,41,45,7,38,46,136,102,0
482,Johnny Cardoso,Betis,14.8,48,29,19,24,5,22,33,66.7,11,20,5,15,32,80,31,0
483,Igor Carioca,Lorient,2.9,8,6,6,1,1,4,6,66.7,2,0,0,0,3,11,6,0
484,Diego Carlos,Aston Villa,20.2,27,16,22,4,1,13,21,61.9,8,24,19,5,13,40,78,3
485,Carmona,Getafe,14.6,30,21,13,14,3,9,28,32.1,19,15,2,13,21,51,25,0
486,Marco Carnesecchi,Atalanta,26.9,0,0,0,0,0,0,0,0.0,0,0,0,0,0,0,22,3
487,Yannick Carrasco,Atlético Madrid,2.5,4,4,3,1,0,2,7,28.6,5,2,0,2,1,5,6,0
488,Alvaro Carreras,Granada,5.3,13,8,8,4,1,5,11,45.5,6,5,1,4,7,20,9,1
489,Rasmus Carstensen,Köln,18.4,47,22,23,20,4,31,56,55.4,25,38,9,29,20,67,50,2
490,Antonin Cartillier,Monaco,0.1,0,0,0,0,0,0,0,0.0,0,1,0,1,0,0,0,0
491,Dani Carvajal,Real Madrid,24.1,47,32,28,15,4,23,42,54.8,19,28,9,19,22,69,54,4
492,Fabio Carvalho,RB Leipzig,1.8,3,1,0,2,1,1,3,33.3,2,8,0,8,0,3,1,0
494,William Carvalho,Betis,7.6,20,12,11,7,2,10,16,62.5,6,8,1,7,8,28,9,1
495,Cesare Casadei,Chelsea,0.9,5,3,2,1,2,2,5,40.0,3,1,0,1,0,5,4,0
496,Marc Casado,Barcelona,0.2,1,1,1,0,0,1,1,100.0,0,0,0,0,1,2,2,0
497,Nicolo Casale,Lazio,17.3,15,9,13,2,0,6,15,40.0,9,19,16,3,12,27,61,0
498,Casemiro,Manchester Utd,22.0,83,56,43,32,8,51,106,48.1,55,74,33,41,18,101,71,1
499,Kaelan Casey,West Ham,0.0,0,0,0,0,0,0,0,0.0,0,0,0,0,0,0,1,0
500,Matty Cash,Aston Villa,23.8,54,31,24,24,6,29,59,49.2,30,35,14,21,18,72,59,0
501,Josue Casimir,Le Havre,22.4,31,18,14,14,3,7,18,38.9,11,23,2,21,13,44,25,0
502,Giuseppe Caso,Frosinone,4.6,4,3,2,0,2,2,3,66.7,1,0,0,0,0,4,0,0
503,Cristian Casseres Jr.,Toulouse,21.6,70,34,31,33,6,29,61,47.5,32,34,4,30,27,97,33,1
504,Timothy Castagne,Fulham,29.3,49,24,23,16,10,26,44,59.1,18,38,10,28,38,87,69,1
505,Koen Casteels,Wolfsburg,25.0,2,1,2,0,0,2,3,66.7,1,0,0,0,0,2,16,5
506,Valentin Castellanos,Lazio,18.7,22,10,1,12,9,6,20,30.0,14,22,2,20,2,24,18,0
507,Jean-Charles Castelletto,Nantes,27.4,34,26,22,10,2,18,29,62.1,11,19,10,9,32,66,81,0
508,Samu Castillejo,Sassuolo,6.0,12,10,5,5,2,7,19,36.8,12,16,1,15,1,13,3,0
509,Jonny Castro,Wolves,0.1,0,0,0,0,0,0,1,0.0,1,1,1,0,0,0,0,0
510,Santiago Castro,Bologna,2.7,2,1,0,1,1,1,3,33.3,2,1,0,1,1,3,1,0
511,Gaetano Castrovilli,Fiorentina,4.1,3,2,1,2,0,1,8,12.5,7,4,0,4,2,5,3,0
512,Danilo Cataldi,Lazio,15.1,24,12,7,16,1,8,18,44.4,10,15,7,8,17,41,19,1
513,Catena,Osasuna,28.2,33,18,26,6,1,19,35,54.3,16,24,15,9,15,48,119,3
514,Maximiliano Caufriez,Clermont Foot,18.4,38,28,31,5,2,19,29,65.5,10,18,12,6,18,56,69,2
515,Ivan Cavaleiro,Lille,8.6,10,6,3,4,3,7,20,35.0,13,9,2,7,5,15,6,0
516,Dani Ceballos,Real Madrid,6.6,10,5,4,5,1,5,14,35.7,9,9,2,7,0,10,4,1
517,Emil Ceide,Sassuolo,2.0,2,2,1,1,0,1,1,100.0,0,6,1,5,0,2,0,0
518,Zeki Celik,Roma,7.5,23,16,10,10,3,14,25,56.0,11,12,5,7,8,31,25,0
520,Alex Centelles,Almería,10.9,11,6,9,2,0,8,18,44.4,10,5,2,3,18,29,29,0
521,Fabien Centonze,Hellas Verona,7.5,14,8,10,4,0,5,10,50.0,5,14,2,12,10,24,18,0
522,Fabien Centonze,Nantes,1.0,2,1,2,0,0,2,3,66.7,1,2,1,1,0,2,1,0
523,Vaclav Cerny,Wolfsburg,10.2,8,3,3,4,1,2,14,14.3,12,13,0,13,8,16,6,0
524,Michele Cerofolini,Frosinone,7.5,0,0,0,0,0,0,0,0.0,0,0,0,0,0,0,5,1
525,Alberto Cerri,Empoli,6.1,3,3,1,1,1,2,5,40.0,3,3,1,2,3,6,7,0
526,Leonardo Cerri,Juventus,0.1,0,0,0,0,0,0,0,0.0,0,0,0,0,0,0,0,0
527,Franco Cervi,Celta Vigo,6.1,24,18,13,9,2,13,24,54.2,11,16,0,16,9,33,4,0
528,Julian Chabot,Köln,30.0,59,42,40,17,2,35,59,59.3,24,66,43,23,45,104,145,0
529,El Chadaille Bitshiabu,RB Leipzig,0.4,1,0,1,0,0,0,0,0.0,0,0,0,0,1,2,4,0
530,Fares Chaibi,Toulouse,0.6,0,0,0,0,0,0,0,0.0,0,0,0,0,0,0,2,0
531,Fares Chaibi,Eint Frankfurt,21.2,27,17,7,12,8,8,18,44.4,10,37,1,36,5,32,19,0
532,Trevoh Chalobah,Chelsea,10.6,16,12,10,2,4,10,15,66.7,5,8,7,1,8,24,51,0
533,Muhammed Cham,Clermont Foot,28.4,25,14,10,13,2,11,27,40.7,16,20,2,18,8,33,5,1
534,Calum Chambers,Aston Villa,1.7,3,0,3,0,0,0,1,0.0,1,2,1,1,2,5,4,0
535,Timothy Chandler,Eint Frankfurt,0.2,0,0,0,0,0,0,0,0.0,0,0,0,0,0,0,0,0
536,Brendan Chardonnet,Brest,33.0,57,34,33,22,2,32,63,50.8,31,58,34,24,53,110,139,3
537,Charlys,Hellas Verona,0.3,0,0,0,0,0,0,0,0.0,0,0,0,0,1,1,0,0
538,Pep Chavarria,Rayo Vallecano,13.0,23,18,15,6,2,11,17,64.7,6,15,3,12,6,29,29,1
539,Jhoanner Chavez,Lens,5.3,6,5,2,2,2,3,9,33.3,6,2,0,2,5,11,11,0
540,Walid Cheddira,Frosinone,23.6,12,7,1,8,3,4,8,50.0,4,6,1,5,5,17,10,0
541,Rayan Cherki,Lyon,19.1,28,15,4,16,8,17,46,37.0,29,13,3,10,7,35,1,0
542,Youssef Chermiti,Everton,2.3,3,2,2,1,0,1,5,20.0,4,4,1,3,1,4,2,0
543,Lucas Chevalier,Lille,33.0,3,0,3,0,0,3,4,75.0,1,1,0,1,0,3,11,2
544,Fabio Chiarodia,Gladbach,1.7,8,5,5,1,2,5,7,71.4,2,2,1,1,3,11,9,0
546,Federico Chiesa,Juventus,24.4,20,10,7,6,7,3,13,23.1,10,17,1,16,6,26,4,0
547,Ben Chilwell,Chelsea,8.4,15,10,5,9,1,5,8,62.5,3,11,3,8,4,19,19,1
548,Tawanda Chirewa,Wolves,1.6,7,3,3,3,1,2,3,66.7,1,0,0,0,1,8,0,0
549,Pedro Chirivella,Nantes,28.8,50,28,20,29,1,30,76,39.5,46,22,5,17,31,81,28,0
550,Leon Chiwome,Wolves,1.9,2,1,0,1,1,1,2,50.0,1,3,1,2,0,2,2,0
551,Tahith Chong,Luton Town,22.0,36,22,19,13,4,15,33,45.5,18,30,6,24,8,44,11,1
552,Joris Chotard,Montpellier,28.7,81,52,45,25,11,48,96,50.0,48,47,21,26,44,125,60,0
553,Andreas Christensen,Barcelona,22.0,23,14,7,14,2,16,28,57.1,12,23,10,13,21,44,41,0
554,Jacob Christensen,Köln,2.4,10,6,7,3,0,4,7,57.1,3,8,2,6,4,14,4,0
555,Oliver Christensen,Fiorentina,4.0,0,0,0,0,0,0,0,0.0,0,0,0,0,0,0,1,0
556,Ryan Christie,Bournemouth,32.3,86,44,34,35,17,39,92,42.4,53,52,11,41,52,138,53,1
557,Carney Chukwuemeka,Chelsea,2.5,6,4,3,3,0,1,3,33.3,2,1,1,0,0,6,1,0
558,Samuel Chukwueze,Milan,11.3,18,7,11,5,2,9,17,52.9,8,3,1,2,6,24,3,0
559,Victor Chust,Cádiz,20.7,29,18,23,5,1,18,32,56.3,14,27,21,6,11,40,92,1
560,Pathe Ciss,Rayo Vallecano,18.5,44,24,16,26,2,16,29,55.2,13,27,10,17,30,74,54,0
561,Alphadjo Cisse,Hellas Verona,0.1,0,0,0,0,0,0,0,0.0,0,0,0,0,0,0,0,0
562,Djaoui Cisse,Rennes,0.0,0,0,0,0,0,0,0,0.0,0,0,0,0,0,0,0,0
563,Ibrahim Cissoko,Toulouse,2.7,4,3,3,1,0,1,3,33.3,2,3,0,3,1,5,0,0
564,Giorgio Cittadini,Monza,0.2,1,1,1,0,0,1,1,100.0,0,1,1,0,0,1,0,0
565,Giorgio Cittadini,Genoa,1.2,5,4,4,1,0,3,3,100.0,0,1,0,1,3,8,5,0
566,Patrick Ciurria,Monza,17.8,30,18,13,13,4,13,21,61.9,8,20,5,15,9,39,28,0
567,Bobby Clark,Liverpool,1.0,2,1,1,1,0,1,5,20.0,4,6,2,4,1,3,1,0
568,Jordan Clark,Luton Town,14.5,30,17,14,11,5,11,39,28.2,28,24,3,21,11,41,15,1
569,Alexis Claude-Maurice,Nice,5.6,12,5,3,6,3,1,5,20.0,4,4,1,3,5,17,7,0
570,Jonathan Clauss,Marseille,23.0,47,20,22,19,6,26,49,53.1,23,17,3,14,36,83,46,0
572,Silvi Clua,Girona,0.0,2,0,2,0,0,2,2,100.0,0,1,0,1,0,2,0,0
573,Nathaniel Clyne,Crystal Palace,14.9,24,15,11,11,2,14,21,66.7,7,18,6,12,10,34,33,0
574,Marcus Coco,Nantes,16.5,43,26,29,10,4,28,60,46.7,32,19,1,18,21,64,38,0
575,Saul Coco,Las Palmas,25.5,32,19,25,7,0,11,18,61.1,7,27,15,12,20,52,120,3
576,Seamus Coleman,Everton,7.4,17,14,10,3,4,11,16,68.8,5,12,4,8,7,24,26,1
577,Maxime Colin,Metz,20.4,39,23,25,7,7,16,29,55.2,13,22,7,15,20,59,71,0
578,Nathan Collins,Brentford,29.5,38,20,24,12,2,19,29,65.5,10,46,30,16,44,82,141,4
579,Nnamdi Collins,Eint Frankfurt,1.0,0,0,0,0,0,0,0,0.0,0,0,0,0,2,2,4,0
580,Lorenzo Colombo,Monza,15.1,17,12,3,9,5,8,14,57.1,6,18,5,13,0,17,14,0
581,Andrea Colpani,Monza,29.5,25,15,6,13,6,11,20,55.0,9,11,4,7,14,39,14,0
582,Levi Colwill,Chelsea,20.0,48,30,26,17,5,26,34,76.5,8,28,10,18,26,74,66,0
583,Kingsley Coman,Bayern Munich,12.4,12,7,5,3,4,9,17,52.9,8,15,1,14,2,14,5,0
584,Eray Comert,Nantes,22.2,42,28,28,13,1,28,38,73.7,10,35,18,17,36,78,77,1
585,Santi Comesana,Villarreal,18.4,44,26,15,21,8,19,38,50.0,19,33,9,24,22,66,27,1
586,Pietro Comuzzo,Fiorentina,0.5,1,1,1,0,0,1,1,100.0,0,1,0,1,1,2,2,0
587,Alois Confais,Le Havre,0.1,2,2,1,1,0,1,1,100.0,0,0,0,0,0,2,0,0
588,Andrea Consigli,Sassuolo,35.0,0,0,0,0,0,0,0,0.0,0,1,0,1,1,1,19,1
589,Bambase Conte,Hoffenheim,0.5,3,3,2,0,1,1,1,100.0,0,0,0,0,0,3,0,0
590,Nikita Contini Baranovsky,Napoli,0.2,0,0,0,0,0,0,0,0.0,0,0,0,0,0,0,1,0
591,Lewis Cook,Bournemouth,31.0,61,41,24,30,7,34,63,54.0,29,32,11,21,65,126,46,1
592,Copete,Mallorca,14.8,45,27,27,17,1,30,43,69.8,13,12,6,6,32,77,47,1
593,Diego Coppola,Hellas Verona,18.2,36,22,25,9,2,20,33,60.6,13,26,9,17,27,63,89,1
594,Francis Coquelin,Villarreal,10.1,20,12,8,10,2,5,13,38.5,8,14,4,10,16,36,15,0
595,Tommaso Corazza,Bologna,2.2,10,4,9,1,0,4,9,44.4,5,2,0,2,5,15,3,0
596,Theo Corbeanu,Granada,2.0,5,2,2,3,0,1,3,33.3,2,3,0,3,3,8,2,0
598,Jeppe Corfitzen,Lecce,0.1,1,0,0,1,0,1,1,100.0,0,0,0,0,0,1,0,0
599,Jack Cork,Burnley,0.3,2,0,0,2,0,1,3,33.3,2,0,0,0,1,3,1,0
600,Maxwel Cornet,West Ham,1.2,3,2,3,0,0,1,5,20.0,4,2,0,2,2,5,1,0
601,Giacomo Corona,Empoli,0.1,0,0,0,0,0,0,0,0.0,0,0,0,0,0,0,0,0
602,Jesus Corona,Sevilla,0.2,0,0,0,0,0,0,0,0.0,0,0,0,0,1,1,0,0
603,Angel Correa,Atlético Madrid,17.0,22,15,3,11,8,5,17,29.4,12,13,0,13,2,24,6,0
604,Joaquin Correa,Marseille,4.8,7,5,4,2,1,0,8,0.0,8,2,0,2,1,8,1,0
605,Thierry Correia,Valencia,23.9,63,35,39,20,4,28,49,57.1,21,39,16,23,33,96,61,0
606,Oscar Cortes,Lens,0.5,0,0,0,0,0,0,0,0.0,0,1,0,1,0,0,0,0
607,Danny da Costa,Mainz 05,9.2,18,9,9,7,2,9,19,47.4,10,17,4,13,16,34,24,0
608,David Pereira da Costa,Lens,16.6,18,10,5,12,1,10,23,43.5,13,21,4,17,16,34,8,1
609,Jaume Costa,Mallorca,18.7,38,22,23,10,5,18,29,62.1,11,14,4,10,16,54,35,0
610,Joao Costa,Roma,0.2,0,0,0,0,0,0,0,0.0,0,0,0,0,0,0,0,0
611,Logan Costa,Toulouse,29.4,40,24,31,9,0,15,24,62.5,9,42,27,15,23,63,120,1
612,Samu Costa,Mallorca,25.6,91,50,40,46,5,46,93,49.5,47,28,14,14,39,130,59,3
613,Benoit Costil,Salernitana,13.0,2,1,1,1,0,2,3,66.7,1,0,0,0,0,2,5,1
614,Gregoire Coudert,Brest,2.0,0,0,0,0,0,0,0,0.0,0,0,0,0,0,0,0,0
615,Vladimir Coufal,West Ham,34.8,64,41,50,12,2,38,75,50.7,37,49,15,34,43,107,97,0
616,Lassana Coulibaly,Salernitana,23.1,47,32,20,21,6,22,49,44.9,27,23,5,18,16,63,29,0
617,Mamadou Coulibaly,Salernitana,0.0,0,0,0,0,0,0,0,0.0,0,0,0,0,0,0,0,0
618,Mamadou Coulibaly,Monaco,1.3,7,4,2,3,2,3,8,37.5,5,4,0,4,0,7,0,0
619,Tanguy Coulibaly,Montpellier,6.9,13,11,8,4,1,4,9,44.4,5,11,1,10,2,15,2,0
620,Thibaut Courtois,Real Madrid,3.7,1,0,1,0,0,0,0,0.0,0,0,0,0,0,1,0,0
621,Philippe Coutinho,Aston Villa,0.3,0,0,0,0,0,0,1,0.0,1,0,0,0,0,0,0,0
622,Yan Couto,Girona,24.9,45,34,25,14,6,20,40,50.0,20,14,2,12,10,55,31,1
624,Nicolas Cozza,Nantes,9.9,35,23,23,10,2,17,24,70.8,7,7,0,7,14,49,32,0
625,Nicolas Cozza,Wolfsburg,3.1,8,6,4,4,0,2,7,28.6,5,3,0,3,4,12,6,0
626,Alessio Cragno,Sassuolo,3.0,0,0,0,0,0,0,0,0.0,0,0,0,0,0,0,3,1
627,Crespo,Rayo Vallecano,5.9,16,9,8,6,2,9,17,52.9,8,15,6,9,10,26,7,0
628,Aaron Cresswell,West Ham,4.8,3,2,1,1,1,2,3,66.7,1,5,3,2,3,6,7,0
629,Bryan Cristante,Roma,36.5,72,41,33,28,11,28,50,56.0,22,36,6,30,25,97,55,2
630,Cristian,Valencia,0.6,0,0,0,0,0,0,0,0.0,0,0,0,0,0,0,0,0
631,Juan Cruz Armada,Osasuna,18.5,27,15,16,10,1,17,25,68.0,8,14,7,7,12,39,39,1
632,Juan Cruz,Hellas Verona,1.2,2,2,0,0,2,0,0,0.0,0,1,0,1,1,3,0,0
633,Juan Cruz,Betis,0.8,0,0,0,0,0,0,1,0.0,1,0,0,0,0,0,0,0
634,Juan Cuadrado,Inter,3.0,4,3,2,2,0,3,5,60.0,2,6,1,5,1,5,2,0
635,Pau Cubarsi,Barcelona,17.3,22,14,18,3,1,13,18,72.2,5,20,16,4,12,34,65,0
636,Marc Cucurella,Chelsea,19.8,62,38,36,21,5,34,64,53.1,30,36,13,23,22,84,48,0
637,Ivan Cuellar,Mallorca,1.0,0,0,0,0,0,0,0,0.0,0,0,0,0,0,0,0,0
638,Jorge Cuenca,Villarreal,21.8,42,29,26,10,6,19,30,63.3,11,26,15,11,21,63,114,0
639,Josh Cullen,Burnley,22.9,42,29,15,22,5,26,46,56.5,20,31,19,12,15,57,26,1
640,Matheus Cunha,Wolves,27.1,30,16,8,17,5,13,35,37.1,22,28,7,21,13,43,21,1
641,Marvin Cuni,Frosinone,5.9,8,3,1,3,4,3,4,75.0,1,10,1,9,1,9,0,0
642,Eric Curbelo,Las Palmas,1.1,4,3,2,2,0,3,4,75.0,1,3,1,2,2,6,5,1
643,Sam Curtis,Sheffield Utd,0.3,1,0,1,0,0,1,2,50.0,1,2,0,2,0,1,0,0
644,Tomas Cvancara,Gladbach,10.0,4,3,0,2,2,1,3,33.3,2,5,1,4,2,6,8,0
645,Danilo D'Ambrosio,Monza,17.1,57,34,34,20,3,28,41,68.3,13,22,13,9,14,71,31,0
646,Alberto Dadie,Real Sociedad,0.3,2,1,2,0,0,0,0,0.0,0,1,0,1,0,2,0,0
647,Trevis Dago,Lille,0.3,0,0,0,0,0,0,0,0.0,0,0,0,0,1,1,0,0
648,Finn Dahmen,Augsburg,31.0,1,0,1,0,0,1,3,33.3,2,0,0,0,0,1,17,5
650,Mahmoud Dahoud,Brighton,5.0,9,4,2,4,3,3,9,33.3,6,4,1,3,1,10,5,0
651,Mahmoud Dahoud,Stuttgart,2.5,5,1,1,4,0,3,7,42.9,4,4,0,4,0,5,1,0
652,Ameen Al-Dakhil,Burnley,11.7,12,5,4,7,1,1,10,10.0,9,13,6,7,12,24,38,2
653,Thijs Dallinga,Toulouse,27.9,29,15,6,11,12,9,15,60.0,6,11,4,7,3,32,35,0
654,Diogo Dalot,Manchester Utd,35.3,81,51,58,12,11,51,74,68.9,23,44,16,28,37,118,111,0
655,Mikkel Damsgaard,Brentford,9.4,29,17,13,9,7,14,40,35.0,26,23,1,22,11,40,10,1
656,Flavius Daniliuc,Salernitana,8.3,19,11,12,5,2,9,19,47.4,10,13,4,9,8,27,15,0
657,Danilo,Nott'ham Forest,19.9,36,18,22,12,2,21,46,45.7,25,33,8,25,35,71,42,0
658,Danilo,Juventus,27.2,60,36,38,18,4,32,48,66.7,16,34,15,19,37,97,94,0
659,Arnaut Danjuma,Everton,6.6,6,4,2,3,1,1,4,25.0,3,4,0,4,3,9,0,0
660,Jayden Danns,Liverpool,0.1,0,0,0,0,0,0,0,0.0,0,0,0,0,0,0,0,0
661,Kevin Danso,Lens,29.5,24,14,12,11,1,15,30,50.0,15,43,30,13,23,47,115,1
662,Dante,Nice,31.6,62,30,44,16,2,38,52,73.1,14,43,22,21,37,99,77,2
663,Raimane Daou,Marseille,0.3,1,1,1,0,0,1,2,50.0,1,0,0,0,0,1,2,0
664,Mohammed Daramy,Reims,18.3,10,9,4,4,2,6,16,37.5,10,5,1,4,4,14,4,0
665,Sergi Darder,Mallorca,24.0,39,26,13,21,5,12,31,38.7,19,20,4,16,16,55,16,0
666,Achraf Dari,Brest,1.3,1,1,1,0,0,0,2,0.0,2,2,0,2,5,6,9,1
667,Matteo Darmian,Inter,26.7,48,22,23,15,10,20,53,37.7,33,27,11,16,13,61,55,0
668,Lukas Daschner,Bochum,6.0,9,4,2,3,4,4,9,44.4,5,7,0,7,2,11,2,0
669,Josh Dasilva,Brentford,0.3,2,1,0,1,1,0,0,0.0,0,0,0,0,0,2,0,0
670,David Datro Fofana,Burnley,9.8,10,5,3,5,2,3,6,50.0,3,9,3,6,1,11,2,0
671,David Datro Fofana,Union Berlin,7.6,10,7,3,5,2,4,9,44.4,5,4,0,4,0,10,5,0
672,Juan David Cabal,Hellas Verona,16.6,36,27,19,14,3,18,29,62.1,11,30,9,21,26,62,55,2
673,Jonathan David,Lille,29.2,26,15,6,13,7,8,26,30.8,18,16,0,16,9,35,4,0
674,Alphonso Davies,Bayern Munich,22.9,47,24,29,13,5,30,53,56.6,23,30,4,26,26,73,49,1
676,Ben Davies,Tottenham,12.1,24,17,13,8,3,16,21,76.2,5,17,15,2,10,34,35,0
677,Tom Davies,Sheffield Utd,2.5,10,5,4,3,3,3,9,33.3,6,2,1,1,3,13,6,1
678,Keinan Davis,Udinese,2.1,0,0,0,0,0,0,0,0.0,0,0,0,0,0,0,3,0
679,Pawel Dawidowicz,Hellas Verona,23.8,53,30,33,18,2,17,29,58.6,12,17,9,8,24,77,114,1
680,Craig Dawson,Wolves,24.5,30,20,23,6,1,22,34,64.7,12,51,39,12,16,46,120,1
681,Kevin De Bruyne,Manchester City,13.6,14,9,1,5,8,7,20,35.0,13,5,0,5,4,18,4,0
682,Charles De Ketelaere,Atalanta,22.5,33,21,3,12,18,10,20,50.0,10,30,2,28,7,40,6,0
683,Rodrigo De Paul,Atlético Madrid,23.1,31,21,11,14,6,15,38,39.5,23,28,1,27,11,42,15,2
684,Mattia De Sciglio,Juventus,0.5,0,0,0,0,0,0,0,0.0,0,1,0,1,1,1,2,0
685,Lorenzo De Silvestri,Bologna,7.5,10,8,5,2,3,4,7,57.1,3,9,4,5,6,16,27,0
686,Thibault De Smet,Reims,20.3,56,35,36,16,4,33,59,55.9,26,25,5,20,21,77,51,1
687,Koni De Winter,Genoa,26.4,44,25,26,13,5,21,31,67.7,10,30,10,20,21,65,78,0
688,Gregoire Defrel,Sassuolo,8.4,17,8,7,5,5,7,15,46.7,8,10,0,10,3,20,9,0
689,Alessandro Deiola,Cagliari,17.9,33,19,13,16,4,18,47,38.3,29,16,6,10,9,42,37,0
690,Romain Del Castillo,Brest,27.7,46,29,14,18,14,18,70,25.7,52,33,1,32,9,55,8,0
691,Thomas Delaine,Strasbourg,22.7,38,19,29,8,1,20,42,47.6,22,18,2,16,17,55,51,0
692,Sacha Delaye,Montpellier,1.4,7,2,2,2,3,1,6,16.7,5,2,0,2,0,7,1,0
693,Hannes Delcroix,Burnley,6.5,10,6,6,4,0,3,4,75.0,1,9,3,6,9,19,26,0
694,Alessandro Dellavalle,Torino,0.2,0,0,0,0,0,0,0,0.0,0,1,1,0,1,1,0,0
695,Olivier Deman,Werder Bremen,15.2,28,15,21,4,3,18,38,47.4,20,24,8,16,14,42,49,1
696,Karamoko Dembele,Brest,0.2,0,0,0,0,0,0,0,0.0,0,0,0,0,0,0,0,0
697,Ousmane Dembele,Paris S-G,16.7,19,14,2,7,10,6,13,46.2,7,11,0,11,5,24,4,1
698,Jessy Deminguet,Strasbourg,7.7,14,9,6,8,0,6,18,33.3,12,8,0,8,9,23,5,1
699,Ermedin Demirovic,Augsburg,31.9,24,14,5,16,3,12,40,30.0,28,28,2,26,11,35,26,0
700,Diego Demme,Napoli,0.8,1,1,0,1,0,0,1,0.0,1,0,0,0,0,1,0,0
702,Sepp van den Berg,Mainz 05,31.5,38,23,20,15,3,15,26,57.7,11,66,36,30,43,81,159,2
703,Leander Dendoncker,Aston Villa,1.3,6,4,3,2,1,4,5,80.0,1,5,2,3,2,8,3,1
704,Leander Dendoncker,Napoli,0.3,0,0,0,0,0,0,0,0.0,0,1,1,0,0,0,0,0
705,Remy Descamps,Nantes,6.0,0,0,0,0,0,0,0,0.0,0,0,0,0,0,0,7,0
706,Mikkel Desler,Toulouse,17.2,18,12,8,7,3,9,17,52.9,8,32,13,19,19,37,38,0
707,Arthur Desmas,Le Havre,33.0,0,0,0,0,0,0,2,0.0,2,0,0,0,0,0,13,1
708,Mattia Destro,Empoli,4.1,2,1,0,2,0,1,1,100.0,0,4,0,4,2,4,3,0
709,Samuele Di Benedetto,Stuttgart,0.1,0,0,0,0,0,0,0,0.0,0,0,0,0,1,1,0,0
710,Federico Di Francesco,Lecce,0.2,1,0,0,1,0,0,0,0.0,0,0,0,0,0,1,0,0
711,Raffaele Di Gennaro,Inter,0.3,0,0,0,0,0,0,0,0.0,0,0,0,0,0,0,0,0
712,Michele Di Gregorio,Monza,31.9,1,0,1,0,0,1,4,25.0,3,1,0,1,1,2,10,2
713,Giovanni Di Lorenzo,Napoli,35.9,58,36,26,26,6,32,68,47.1,36,43,16,27,24,82,45,0
714,Alessandro Di Pardo,Cagliari,4.0,4,1,3,0,1,0,3,0.0,3,9,2,7,5,9,7,0
715,Boulaye Dia,Salernitana,12.7,4,2,2,2,0,1,3,33.3,2,5,0,5,3,7,7,0
716,Moussa Diaby,Aston Villa,24.2,12,5,5,4,3,4,22,18.2,18,8,1,7,9,21,6,0
717,Lamine Diack,Nantes,0.0,0,0,0,0,0,0,0,0.0,0,0,0,0,0,0,0,0
718,Mouctar Diakhaby,Valencia,11.9,18,11,9,9,0,11,13,84.6,2,17,7,10,11,29,62,0
719,Mamadou Diakhon,Reims,2.3,5,3,2,1,2,3,9,33.3,6,1,0,1,1,6,1,0
720,Bafode Diakite,Lille,18.8,29,20,12,15,2,24,32,75.0,8,16,8,8,21,50,49,1
721,Ibrahim Diakite,Reims,1.2,1,0,0,1,0,0,1,0.0,1,3,0,3,2,3,5,0
722,Moussa Diakite,Cádiz,0.0,0,0,0,0,0,0,0,0.0,0,0,0,0,0,0,0,0
723,Oumar Diakite,Reims,17.6,25,12,10,9,6,7,21,33.3,14,13,0,13,7,32,7,0
724,Amad Diallo,Manchester Utd,4.3,10,3,1,6,3,3,7,42.9,4,3,1,2,1,11,6,0
725,Amadou Diallo,Newcastle Utd,0.0,0,0,0,0,0,0,0,0.0,0,0,0,0,0,0,0,0
726,Assane Diao,Betis,11.6,20,12,5,9,6,6,17,35.3,11,22,4,18,7,27,7,0
728,Habib Diarra,Strasbourg,25.6,30,23,8,20,2,9,33,27.3,24,23,4,19,17,47,15,0
729,Moussa Diarra,Toulouse,15.5,32,12,16,15,1,13,27,48.1,14,30,14,16,20,52,43,0
730,Ruben Dias,Manchester City,28.4,39,20,14,21,4,19,26,73.1,7,32,17,15,30,69,77,0
731,Krepin Diatta,Monaco,13.4,37,20,17,16,4,27,49,55.1,22,17,2,15,16,53,22,0
732,Mory Diaw,Clermont Foot,30.0,1,1,1,0,0,1,2,50.0,1,0,0,0,1,2,13,5
733,Mahamadou Diawara,Lyon,4.0,9,6,4,5,0,3,11,27.3,8,4,1,3,4,13,4,0
734,Brahim Diaz,Real Madrid,17.2,29,19,4,16,9,6,13,46.2,7,16,1,15,5,34,2,0
735,Luis Diaz,Liverpool,29.2,35,25,5,17,13,7,30,23.3,23,15,0,15,3,38,8,0
736,Victor Diaz,Granada,1.8,5,3,2,3,0,1,3,33.3,2,1,0,1,1,6,8,0
737,Famara Diedhiou,Granada,1.0,1,1,0,1,0,0,1,0.0,1,0,0,0,0,1,2,0
738,Justin Diehl,Köln,1.9,0,0,0,0,0,0,0,0.0,0,1,1,0,0,0,0,1
739,Bamba Dieng,Lorient,6.1,3,3,0,3,0,1,3,33.3,2,3,0,3,0,3,7,0
740,Eric Dier,Tottenham,2.2,2,1,2,0,0,2,2,100.0,0,3,3,0,2,4,12,0
741,Eric Dier,Bayern Munich,13.0,11,8,5,5,1,5,6,83.3,1,20,12,8,10,21,48,1
742,Guillaume Dietsch,Metz,0.8,0,0,0,0,0,0,0,0.0,0,0,0,0,0,0,0,0
743,Florian Dietz,Köln,0.8,0,0,0,0,0,0,0,0.0,0,1,0,1,0,0,0,0
744,Lucas Digne,Aston Villa,26.8,47,19,35,9,3,25,44,56.8,19,20,2,18,26,73,67,0
745,Federico Dimarco,Inter,23.1,42,25,19,14,9,17,35,48.6,18,18,3,15,9,51,34,1
746,Stole Dimitrievski,Rayo Vallecano,37.0,1,1,1,0,0,1,1,100.0,0,0,0,0,0,1,17,3
747,Junior Dina Ebimbe,Eint Frankfurt,21.7,44,29,15,17,12,18,41,43.9,23,28,7,21,9,53,39,1
748,Eren Dinkci,Heidenheim,29.4,32,18,16,13,3,19,48,39.6,29,40,4,36,12,44,21,0
749,Sinaly Diomande,Lyon,9.9,10,4,5,3,2,9,16,56.3,7,12,9,3,15,25,26,1
750,Edan Diop,Monaco,1.8,10,8,6,3,1,7,9,77.8,2,3,0,3,1,11,5,0
751,Issa Diop,Fulham,15.8,30,16,23,5,2,15,20,75.0,5,28,19,9,17,47,80,1
752,Sofiane Diop,Nice,5.5,8,6,3,4,1,4,10,40.0,6,4,0,4,3,11,3,0
754,Andy Diouf,Lens,14.6,28,19,12,11,5,14,22,63.6,8,13,3,10,3,31,5,1
755,Yehvann Diouf,Reims,34.0,0,0,0,0,0,0,1,0.0,1,0,0,0,1,1,19,3
756,Axel Disasi,Chelsea,28.7,33,19,20,10,3,23,30,76.7,7,26,19,7,18,51,102,2
757,Tiago Djalo,Juventus,0.2,0,0,0,0,0,0,0,0.0,0,1,0,1,0,0,1,0
758,Chaim El Djebali,Lyon,0.1,0,0,0,0,0,0,0,0.0,0,0,0,0,0,0,0,0
759,Djene,Getafe,27.6,34,19,18,13,3,15,26,57.7,11,31,15,16,23,57,70,0
760,Koffi Djidji,Torino,8.4,14,9,9,5,0,3,4,75.0,1,10,5,5,10,24,20,0
761,Berat Djimsiti,Atalanta,31.5,42,24,29,12,1,19,31,61.3,12,53,33,20,57,99,100,0
762,Marko Dmitrovic,Sevilla,13.0,1,1,1,0,0,1,2,50.0,1,0,0,0,1,2,5,0
763,Ben Doak,Liverpool,0.2,0,0,0,0,0,0,0,0.0,0,0,0,0,0,0,0,0
764,Ritsu Doan,Freiburg,25.0,50,27,21,19,10,21,36,58.3,15,30,3,27,9,59,29,0
765,Lewis Dobbin,Everton,2.6,9,7,3,5,1,5,9,55.6,4,5,1,4,1,10,0,0
766,Dodo,Fiorentina,5.8,5,3,1,4,0,2,5,40.0,3,2,0,2,5,10,11,0
767,Danilho Doekhi,Union Berlin,24.0,34,23,18,16,0,15,21,71.4,6,46,25,21,38,72,111,1
768,Matt Doherty,Wolves,12.8,31,18,17,10,4,12,23,52.2,11,15,5,10,7,38,47,0
769,Josh Doig,Hellas Verona,9.2,16,9,9,7,0,13,17,76.5,4,12,3,9,4,20,17,1
770,Josh Doig,Sassuolo,14.9,25,17,16,9,0,15,27,55.6,12,31,10,21,16,41,38,0
771,Jeremy Doku,Manchester City,17.7,39,22,13,12,14,9,20,45.0,11,14,0,14,9,48,5,0
772,Jeremy Doku,Rennes,1.2,2,2,1,0,1,1,1,100.0,0,0,0,0,0,2,0,0
773,Jaume Domenech,Valencia,0.9,0,0,0,0,0,0,0,0.0,0,0,0,0,0,0,0,0
774,Carlos Dominguez,Celta Vigo,17.6,33,21,17,9,7,23,37,62.2,14,24,12,12,22,55,78,0
775,Mario Dominguez,Valencia,0.3,0,0,0,0,0,0,0,0.0,0,0,0,0,0,0,0,0
776,Nicolas Dominguez,Nott'ham Forest,16.6,63,34,35,27,1,23,48,47.9,25,31,5,26,18,81,24,0
777,Nicolas Dominguez,Bologna,1.1,1,0,1,0,0,0,2,0.0,2,3,0,3,0,1,2,0
778,Giulio Donati,Monza,0.4,0,0,0,0,0,0,0,0.0,0,0,0,0,0,0,1,1
780,Jamie Donley,Tottenham,0.0,0,0,0,0,0,0,0,0.0,0,0,0,0,0,0,3,0
781,Gianluigi Donnarumma,Paris S-G,24.1,0,0,0,0,0,0,0,0.0,0,0,0,0,1,1,9,4
782,Patrick Dorgu,Lecce,17.4,43,22,22,17,4,22,34,64.7,12,16,5,11,9,52,45,2
783,Niklas Dorsch,Augsburg,15.4,35,24,13,21,1,13,33,39.4,20,15,9,6,16,51,27,0
784,Alberto Dossena,Cagliari,33.1,55,35,43,12,0,32,48,66.7,16,50,27,23,45,100,172,2
785,Carlos Dotor,Celta Vigo,7.9,14,7,3,8,3,4,13,30.8,9,12,2,10,4,18,4,0
786,Abdoulaye Doucoure,Everton,29.2,43,27,20,14,9,18,46,39.1,28,23,3,20,15,58,19,0
787,Cheick Doucoure,Crystal Palace,10.2,34,17,15,13,6,18,30,60.0,12,13,2,11,20,54,12,0
788,Sirine Doucoure,Lorient,4.7,8,6,0,4,4,3,3,100.0,0,4,0,4,1,9,6,0
789,Desire Doue,Rennes,18.1,32,18,11,14,7,10,33,30.3,23,30,1,29,14,46,8,0
790,Guela Doue,Rennes,13.7,28,21,14,12,2,22,32,68.8,10,12,1,11,15,43,65,1
791,Alfie Doughty,Luton Town,32.5,63,40,29,18,16,37,82,45.1,45,51,9,42,31,94,43,4
792,Douglas,Nantes,19.7,70,42,34,30,6,30,59,50.8,29,22,8,14,26,96,30,0
793,Ismael Doukoure,Strasbourg,18.4,23,16,7,14,2,13,21,61.9,8,19,7,12,19,42,29,2
794,Kamory Doumbia,Brest,9.8,28,18,8,10,10,10,29,34.5,19,14,0,14,9,37,6,0
795,Anastasios Douvikas,Celta Vigo,10.1,15,7,2,6,7,3,8,37.5,5,6,3,3,2,17,9,0
796,Artem Dovbyk,Girona,28.7,4,3,2,1,1,0,2,0.0,2,8,1,7,0,4,17,0
797,Nikola Dovedan,Heidenheim,7.3,14,9,2,10,2,5,25,20.0,20,9,0,9,1,15,3,0
798,Damion Downs,Köln,2.0,1,1,1,0,0,1,2,50.0,1,1,0,1,0,1,1,0
799,Tommy Doyle,Wolves,13.6,26,13,11,10,5,14,23,60.9,9,22,9,13,12,38,18,0
800,Radu Dragusin,Tottenham,4.8,5,3,5,0,0,3,3,100.0,0,5,4,1,8,13,19,0
801,Radu Dragusin,Genoa,19.0,16,11,9,6,1,8,9,88.9,1,18,12,6,21,37,87,3
802,Dion Drena Beljo,Augsburg,6.5,0,0,0,0,0,0,2,0.0,2,8,1,7,1,1,4,0
803,Tim Drexler,Hoffenheim,6.4,16,9,12,4,0,8,17,47.1,9,12,8,4,8,24,14,0
804,Domingos Duarte,Getafe,10.1,7,4,6,0,1,5,7,71.4,2,7,5,2,8,15,27,0
806,Ruben Duarte,Alavés,20.9,39,20,21,16,2,21,31,67.7,10,21,6,15,23,62,69,0
807,Martin Dubravka,Newcastle Utd,22.1,0,0,0,0,0,0,4,0.0,4,0,0,0,0,0,8,1
808,Marvin Ducksch,Werder Bremen,30.0,8,3,4,3,1,6,14,42.9,8,2,0,2,4,12,25,0
809,Ondrej Duda,Hellas Verona,27.3,59,39,17,35,7,31,52,59.6,21,29,12,17,26,85,21,0
810,Denzel Dumfries,Inter,18.2,22,13,9,11,2,9,23,39.1,14,15,6,9,12,34,33,1
811,Paul Dummett,Newcastle Utd,0.2,1,0,1,0,0,1,1,100.0,0,0,0,0,0,1,1,0
812,Alfred Duncan,Fiorentina,21.0,35,22,13,15,7,15,35,42.9,20,27,5,22,11,46,13,0
813,Lewis Dunk,Brighton,31.9,27,14,17,9,1,13,36,36.1,23,49,37,12,31,58,90,1
814,Jhon Duran,Aston Villa,5.3,6,5,3,1,2,1,6,16.7,5,6,0,6,1,7,10,0
815,Julien Duranville,Dortmund,0.1,1,0,0,1,0,1,1,100.0,0,0,0,0,0,1,0,0
816,Hugo Duro,Valencia,33.1,16,8,5,8,3,9,29,31.0,20,24,5,19,5,21,27,0
817,Jean-Kevin Duverne,Nantes,15.0,37,19,16,17,4,18,44,40.9,26,17,5,12,18,55,34,0
818,Paulo Dybala,Roma,21.8,22,13,3,10,9,2,18,11.1,16,12,0,12,3,25,6,1
819,Aron Donnum,Toulouse,17.7,16,10,3,8,5,7,22,31.8,15,13,0,13,8,24,16,1
820,George Earthy,West Ham,0.4,0,0,0,0,0,0,1,0.0,1,0,0,0,1,1,0,0
821,Simon Ebonog,Le Havre,0.2,1,1,0,1,0,1,1,100.0,0,1,1,0,0,1,1,0
822,Festy Ebosele,Udinese,18.9,33,20,23,9,1,21,35,60.0,14,33,2,31,10,43,27,0
823,Enzo Ebosse,Udinese,0.1,1,1,1,0,0,0,1,0.0,1,0,0,0,1,2,0,0
824,Tyronne Ebuehi,Empoli,12.2,14,9,9,5,0,7,11,63.6,4,9,4,5,6,20,27,1
825,Ederson,Manchester City,30.9,0,0,0,0,0,0,1,0.0,1,0,0,0,0,0,10,1
826,Ederson,Atalanta,31.9,83,49,38,38,7,44,63,69.8,19,48,8,40,41,124,33,1
827,Odsonne Edouard,Crystal Palace,17.3,24,12,8,8,8,4,19,21.1,15,17,1,16,6,30,19,0
828,John Egan,Sheffield Utd,5.4,6,4,4,2,0,4,11,36.4,7,10,4,6,13,19,39,1
829,Maximilian Eggestein,Freiburg,32.4,49,24,25,19,5,15,36,41.7,21,53,19,34,28,77,40,1
830,Lilian Egloff,Stuttgart,1.2,4,1,3,1,0,2,4,50.0,2,3,1,2,1,5,0,0
832,Kingsley Ehizibue,Udinese,10.6,22,14,16,4,2,11,18,61.1,7,21,3,18,8,30,36,0
833,Hjalmar Ekdal,Burnley,4.9,4,2,2,2,0,2,4,50.0,2,10,5,5,6,10,21,0
834,Hugo Ekitike,Paris S-G,0.1,0,0,0,0,0,0,0,0.0,0,0,0,0,0,0,0,0
835,Hugo Ekitike,Eint Frankfurt,8.0,11,7,3,6,2,4,6,66.7,2,10,0,10,2,13,4,0
836,Emmanuel Ekong,Empoli,0.1,0,0,0,0,0,0,0,0.0,0,0,0,0,0,0,0,0
837,Caleb Ekuban,Genoa,12.6,8,4,2,4,2,5,9,55.6,4,11,3,8,1,9,7,0
838,Anthony Elanga,Nott'ham Forest,27.0,33,19,20,6,7,17,36,47.2,19,22,2,20,8,41,20,1
839,Simon Elisor,Metz,8.5,9,2,3,2,4,2,6,33.3,4,6,1,5,0,9,9,0
840,Harvey Elliott,Liverpool,15.0,27,17,8,14,5,10,31,32.3,21,27,0,27,6,33,7,0
841,Elif Elmas,Napoli,3.8,4,3,1,3,0,2,2,100.0,0,2,0,2,2,6,8,0
842,Elif Elmas,RB Leipzig,3.0,8,6,1,6,1,6,8,75.0,2,5,0,5,1,9,2,0
843,Mohamed Elneny,Arsenal,0.3,0,0,0,0,0,0,1,0.0,1,0,0,0,1,1,0,0
844,Aritz Elustondo,Real Sociedad,9.0,11,7,5,4,2,6,14,42.9,8,12,10,2,7,18,26,0
845,Nico Elvedi,Gladbach,27.6,33,18,22,10,1,18,24,75.0,6,40,25,15,43,76,150,2
846,Adri Embarba,Almería,27.5,55,37,29,15,11,26,53,49.1,27,37,1,36,15,70,12,0
847,Breel Embolo,Monaco,2.0,3,3,0,2,1,1,4,25.0,3,1,0,1,1,4,2,0
848,Emanuel Emegha,Strasbourg,23.1,8,5,2,4,2,4,9,44.4,5,13,3,10,2,10,25,0
849,Emerson,Tottenham,12.9,36,24,23,10,3,21,43,48.8,22,23,10,13,20,56,50,1
850,Youssef En-Nesyri,Sevilla,28.6,10,7,3,4,3,0,10,0.0,10,9,1,8,7,17,29,1
851,Julio Enciso,Brighton,5.3,6,2,3,2,1,2,7,28.6,5,11,0,11,0,6,3,0
852,Wataru Endo,Liverpool,19.1,48,28,11,31,6,20,61,32.8,41,24,2,22,20,68,31,3
853,Arne Engels,Augsburg,15.6,33,18,15,14,4,12,29,41.4,17,23,1,22,15,48,21,0
854,Christian Eriksen,Manchester Utd,12.7,18,13,5,10,3,12,33,36.4,21,17,6,11,4,22,13,0
855,Martin Erlic,Sassuolo,29.1,37,22,26,8,3,20,30,66.7,10,31,16,15,28,65,128,1
856,Gonzalo Escalante,Cádiz,18.9,39,24,16,14,9,20,55,36.4,35,23,5,18,26,65,33,2
858,Aaron Escandell,Las Palmas,1.7,0,0,0,0,0,0,0,0.0,0,0,0,0,0,0,1,1
859,Alfonso Espino,Rayo Vallecano,27.9,67,45,43,22,2,30,82,36.6,52,26,4,22,40,107,63,0
860,Bernardo Espinosa,Girona,0.0,1,1,1,0,0,1,1,100.0,0,0,0,0,0,1,2,0
861,Maxime Esteve,Burnley,14.5,27,10,15,12,0,18,32,56.3,14,21,10,11,27,54,56,0
862,Maxime Esteve,Montpellier,11.1,16,12,11,5,0,10,15,66.7,5,13,9,4,18,34,50,0
863,Oscar Estupinan,Metz,2.9,5,4,0,3,2,1,2,50.0,1,2,0,2,0,5,0,0
864,Pervis Estupinan,Brighton,13.8,26,13,12,11,3,14,30,46.7,16,14,4,10,21,47,20,0
865,Karl Etta,Cádiz,0.2,1,1,0,1,0,0,0,0.0,0,0,0,0,0,1,0,0
866,Jonny Evans,Manchester Utd,15.5,22,14,20,2,0,12,21,57.1,9,25,18,7,23,45,76,0
867,Eberechi Eze,Crystal Palace,22.8,35,17,4,18,13,15,31,48.4,16,27,2,25,11,46,6,0
868,Abde Ezzalzouli,Barcelona,0.8,1,1,0,0,1,0,1,0.0,1,1,0,1,0,1,0,0
869,Abde Ezzalzouli,Betis,9.6,17,14,7,5,5,4,14,28.6,10,10,0,10,5,22,5,0
870,Giovanni Fabbian,Bologna,11.7,17,10,9,7,1,7,12,58.3,5,5,2,3,7,24,11,0
871,Lukasz Fabianski,West Ham,8.0,1,0,1,0,0,1,2,50.0,1,0,0,0,1,2,4,0
872,Nicolo Fagioli,Juventus,4.9,5,3,1,3,1,3,7,42.9,4,3,0,3,4,9,1,0
873,Romain Faivre,Bournemouth,0.5,1,1,0,1,0,0,3,0.0,3,0,0,0,0,1,0,0
874,Romain Faivre,Lorient,16.1,13,6,5,4,4,6,15,40.0,9,6,1,5,7,20,3,1
875,Ilhan Fakili,Clermont Foot,1.0,0,0,0,0,0,0,1,0.0,1,1,0,1,1,1,0,0
876,Radamel Falcao,Rayo Vallecano,4.5,7,5,1,5,1,1,3,33.3,2,2,0,2,3,10,4,0
877,Wladimiro Falcone,Lecce,38.0,0,0,0,0,0,0,0,0.0,0,1,0,1,1,1,21,2
878,Fali,Cádiz,28.3,41,26,29,11,1,21,36,58.3,15,38,24,14,27,68,120,0
879,Davide Faraoni,Hellas Verona,6.7,13,10,5,6,2,7,10,70.0,3,9,5,4,6,19,21,0
880,Davide Faraoni,Fiorentina,4.4,9,4,5,2,2,5,11,45.5,6,3,1,2,5,14,14,0
881,Ansu Fati,Brighton,5.8,5,3,1,2,2,1,11,9.1,10,8,0,8,3,8,3,0
882,Ansu Fati,Barcelona,0.6,0,0,0,0,0,0,1,0.0,1,0,0,0,0,0,0,0
884,Khalil Fayad,Montpellier,11.4,28,15,17,7,4,9,22,40.9,13,15,3,12,14,42,6,0
885,Federico Fazio,Salernitana,15.1,18,11,14,4,0,8,14,57.1,6,22,19,3,17,35,99,1
886,Jacopo Fazzini,Empoli,13.7,49,25,27,13,9,30,53,56.6,23,21,3,18,12,61,18,0
887,Peter Federico,Valencia,7.2,5,3,3,1,1,1,10,10.0,9,11,0,11,7,12,10,0
888,Nabil Fekir,Betis,11.7,15,10,5,7,3,5,10,50.0,5,9,0,9,7,22,3,0
889,Felipe,Nott'ham Forest,4.2,12,9,9,3,0,9,12,75.0,3,4,1,3,4,16,12,0
890,Luiz Felipe,Betis,4.0,7,3,5,2,0,4,5,80.0,1,10,4,6,4,11,16,0
891,Joao Felix,Barcelona,17.1,22,16,9,7,6,8,22,36.4,14,14,1,13,10,32,11,0
892,Ohis Felix Uduokhai,Augsburg,32.5,37,21,18,14,5,16,25,64.0,9,45,35,10,46,83,178,2
893,Kiko Femenia,Villarreal,17.6,35,25,19,13,3,19,34,55.9,15,21,6,15,31,66,45,0
894,Evan Ferguson,Brighton,15.2,14,6,4,7,3,5,14,35.7,9,10,3,7,2,16,8,0
895,Lewis Ferguson,Bologna,30.1,37,21,16,17,4,16,37,43.2,21,25,8,17,17,54,27,1
896,Bruno Fernandes,Manchester Utd,34.6,68,38,27,25,16,30,88,34.1,58,49,6,43,27,95,50,2
897,Edimilson Fernandes,Mainz 05,14.3,25,16,15,9,1,16,24,66.7,8,14,6,8,22,47,52,0
898,Aitor Fernandez,Osasuna,6.1,0,0,0,0,0,0,1,0.0,1,0,0,0,0,0,5,1
899,Alex Fernandez,Cádiz,14.3,19,9,10,9,0,11,22,50.0,11,17,5,12,15,34,30,0
900,Carlos Fernandez,Real Sociedad,4.5,11,7,3,6,2,0,2,0.0,2,4,0,4,0,11,5,0
901,Enzo Fernandez,Chelsea,24.5,50,22,22,18,10,27,65,41.5,38,36,13,23,17,67,28,0
902,Raul Fernandez,Granada,3.1,0,0,0,0,0,0,1,0.0,1,0,0,0,0,0,1,2
903,Valery Fernandez,Girona,5.6,11,9,4,7,0,6,8,75.0,2,6,1,5,1,12,4,0
904,Fernando,Almería,4.0,0,0,0,0,0,0,0,0.0,0,1,0,1,0,0,2,0
905,Fernando,Sevilla,5.1,9,8,2,4,3,5,9,55.6,4,2,0,2,7,16,9,0
906,Ichem Ferrah,Lille,0.0,0,0,0,0,0,0,0,0.0,0,0,0,0,0,0,0,0
907,Andrea Ferraris,Monza,0.1,1,1,1,0,0,0,0,0.0,0,0,0,0,0,1,0,0
908,Andre Ferreira,Granada,14.9,0,0,0,0,0,0,1,0.0,1,0,0,0,0,0,9,2
910,Joao Ferreira,Udinese,20.2,58,42,36,18,4,34,58,58.6,24,27,6,21,29,87,89,0
911,Jordan Ferri,Montpellier,22.6,36,22,16,17,3,20,67,29.9,47,19,1,18,13,49,23,0
912,Nacho Ferri,Eint Frankfurt,0.8,3,3,1,2,0,2,3,66.7,1,0,0,0,0,3,2,0
913,Rachad Fettal,Almería,0.2,1,1,1,0,0,0,0,0.0,0,0,0,0,0,1,0,0
914,Seydou Fini,Genoa,0.4,0,0,0,0,0,0,0,0.0,0,0,0,0,0,0,0,0
915,Max Finkgrafe,Köln,19.5,65,39,40,25,0,39,74,52.7,35,35,10,25,22,87,39,0
916,Vincenzo Fiorillo,Salernitana,4.0,0,0,0,0,0,0,0,0.0,0,0,0,0,0,0,0,1
917,Kilian Fischer,Wolfsburg,3.2,8,6,4,3,1,2,5,40.0,3,8,1,7,1,9,12,0
918,John Fleck,Sheffield Utd,1.0,1,0,0,1,0,0,1,0.0,1,0,0,0,0,1,1,0
919,Mark Flekken,Brentford,36.5,1,1,1,0,0,1,5,20.0,4,1,0,1,0,1,17,1
920,Alessandro Florenzi,Milan,19.2,43,21,26,12,5,26,48,54.2,22,16,9,7,20,63,25,1
921,Phil Foden,Manchester City,31.7,31,20,11,10,10,13,31,41.9,18,30,0,30,13,44,18,1
922,Wes Foderingham,Sheffield Utd,29.4,5,3,5,0,0,5,6,83.3,1,0,0,0,0,5,18,6
923,Malick Fofana,Lyon,6.2,5,4,3,1,1,4,9,44.4,5,3,0,3,5,10,9,0
924,Youssouf Fofana,Monaco,30.0,61,39,19,36,6,30,66,45.5,36,35,7,28,37,98,31,1
925,Jonas Fohrenbach,Heidenheim,31.0,44,24,24,14,6,19,36,52.8,17,34,19,15,31,75,70,0
926,Thomas Foket,Reims,20.4,32,17,21,8,3,20,45,44.4,25,34,12,22,25,57,36,0
927,Michael Folorunsho,Hellas Verona,30.9,50,28,21,22,7,23,57,40.4,34,45,12,33,17,67,44,2
928,Tiago Fonseca Morais,Lille,0.5,1,1,0,1,0,0,0,0.0,0,0,0,0,1,2,0,0
929,Pablo Fornals,West Ham,4.7,10,6,4,3,3,5,16,31.3,11,8,1,7,6,16,7,0
930,Pablo Fornals,Betis,12.8,24,16,8,11,5,12,22,54.5,10,14,0,14,22,46,10,2
931,Emil Forsberg,RB Leipzig,5.2,7,3,2,5,0,5,12,41.7,7,7,0,7,0,7,5,0
932,Omari Forson,Manchester Utd,0.8,2,0,0,2,0,1,1,100.0,0,0,0,0,0,2,0,0
933,Philipp Forster,Bochum,4.3,9,5,3,4,2,2,6,33.3,4,3,0,3,7,16,3,0
934,Hector Fort,Barcelona,3.5,6,5,5,1,0,4,10,40.0,6,0,0,0,2,8,4,0
936,Lyle Foster,Burnley,21.1,19,10,5,6,8,6,17,35.3,11,13,3,10,3,22,34,0
937,Dimitri Foulquier,Valencia,20.5,39,22,22,13,4,18,26,69.2,8,10,1,9,16,55,49,1
938,Juan Foyth,Villarreal,11.8,26,15,18,8,0,12,27,44.4,15,17,4,13,12,38,44,0
939,Matheus Franca,Crystal Palace,2.6,3,3,2,1,0,1,7,14.3,6,4,0,4,1,4,1,0
940,Bartol Franjic,Darmstadt 98,13.7,15,12,4,10,1,7,28,25.0,21,12,4,8,30,45,29,2
941,Przemyslaw Frankowski,Lens,24.4,60,39,25,26,9,31,74,41.9,43,30,7,23,25,85,36,0
942,Nathan Fraser,Wolves,2.1,5,2,2,1,2,1,3,33.3,2,2,1,1,1,6,2,0
943,Davide Frattesi,Inter,10.6,10,6,3,7,0,4,8,50.0,4,9,3,6,5,15,19,0
944,Jean Frederic N'Guessan,Metz,1.2,3,1,0,3,0,0,3,0.0,3,3,0,3,1,4,0,0
945,Morten Frendrup,Genoa,34.9,133,72,47,70,16,55,91,60.4,36,55,14,41,51,184,42,1
946,Remo Freuler,Bologna,29.2,78,50,41,32,5,38,69,55.1,31,37,9,28,36,114,53,2
947,Marco Friedl,Werder Bremen,24.4,53,32,38,15,0,36,48,75.0,12,45,29,16,35,88,129,0
948,Marvin Friedrich,Gladbach,17.4,23,15,16,6,1,12,20,60.0,8,28,20,8,17,40,87,0
949,Jeremie Frimpong,Leverkusen,25.0,26,17,12,7,7,8,20,40.0,12,26,0,26,7,33,17,0
950,Jorge de Frutos,Rayo Vallecano,17.2,19,8,5,8,6,7,22,31.8,15,12,0,12,7,26,18,0
951,Chris Fuhrich,Stuttgart,28.5,30,19,6,14,10,16,37,43.2,21,31,0,31,7,37,7,0
952,Shio Fukuda,Gladbach,0.4,2,0,1,1,0,1,2,50.0,1,0,0,0,1,3,0,0
953,Angelo Fulgini,Lens,15.3,23,14,6,13,4,11,19,57.9,8,22,1,21,8,31,11,0
954,Niclas Fullkrug,Werder Bremen,2.0,1,1,0,1,0,1,1,100.0,0,2,1,1,0,1,1,0
955,Niclas Fullkrug,Dortmund,24.6,7,2,1,6,0,2,8,25.0,6,17,4,13,2,9,25,0
956,Gerardo Fusco,Salernitana,0.2,0,0,0,0,0,0,0,0.0,0,0,0,0,0,0,0,0
957,Daniel Fuzato,Getafe,0.1,0,0,0,0,0,0,0,0.0,0,0,0,0,0,0,1,0
958,Matteo Gabbia,Milan,14.2,29,20,15,13,1,18,24,75.0,6,11,6,5,10,39,48,0
959,Matteo Gabbia,Villarreal,5.3,10,6,4,6,0,5,8,62.5,3,5,2,3,8,18,36,1
960,Gianluca Gaetano,Cagliari,8.3,7,4,0,4,3,2,7,28.6,5,4,0,4,3,10,4,0
962,Gianluca Gaetano,Napoli,1.8,4,1,0,4,0,2,4,50.0,2,5,2,3,1,5,4,0
963,Roberto Gagliardini,Monza,26.2,61,30,27,25,9,31,50,62.0,19,30,11,19,31,92,38,0
964,Cody Gakpo,Liverpool,18.3,27,17,8,14,5,8,25,32.0,17,21,4,17,14,41,7,0
965,Javi Galan,Atlético Madrid,1.0,5,4,2,2,1,4,5,80.0,1,1,0,1,1,6,3,0
966,Javi Galan,Real Sociedad,11.9,38,22,15,19,4,15,30,50.0,15,24,1,23,14,52,17,1
967,Inigo Ruiz de Galarreta,Athletic Club,23.2,49,31,15,26,8,24,49,49.0,25,18,5,13,12,61,17,0
968,Pablo Galdames Millan,Genoa,0.1,0,0,0,0,0,0,0,0.0,0,1,0,1,0,0,0,0
969,Conor Gallagher,Chelsea,34.8,85,52,37,31,17,33,77,42.9,44,50,11,39,43,128,34,0
970,Antonino Gallo,Lecce,27.7,43,27,31,11,1,31,49,63.3,18,34,9,25,25,68,67,0
971,Cristian Gamboa,Bochum,13.2,24,18,12,11,1,14,33,42.4,19,20,7,13,15,39,34,1
972,Kevin Gameiro,Strasbourg,15.0,10,10,5,3,2,2,17,11.8,15,9,0,9,3,13,7,0
973,Idrissa Gana Gueye,Everton,20.9,73,44,32,27,14,29,46,63.0,17,24,7,17,28,101,16,0
974,Ignatius Ganago,Nantes,2.0,0,0,0,0,0,0,1,0.0,1,1,0,1,1,1,1,0
975,Aleix Garcia,Girona,35.5,49,28,17,26,6,28,54,51.9,26,45,17,28,36,85,53,3
976,Alvaro Garcia,Rayo Vallecano,27.5,34,25,15,10,9,7,34,20.6,27,35,0,35,36,70,33,0
977,Dani Garcia,Athletic Club,8.3,17,11,4,7,6,12,24,50.0,12,9,3,6,8,25,11,0
978,David Garcia,Osasuna,25.9,29,18,19,9,1,16,26,61.5,10,40,19,21,18,47,115,2
979,Eric Garcia,Barcelona,0.6,0,0,0,0,0,0,0,0.0,0,1,1,0,0,0,0,0
980,Eric Garcia,Girona,29.3,55,37,34,18,3,34,49,69.4,15,36,18,18,30,85,79,2
981,Fran Garcia,Real Madrid,15.5,25,17,11,12,2,13,31,41.9,18,16,3,13,19,44,28,1
982,Francisco Jesus Crespo Garcia,Las Palmas,5.6,12,8,3,6,3,6,18,33.3,12,4,0,4,2,14,5,0
983,Gonzalo Garcia,Real Madrid,0.2,0,0,0,0,0,0,1,0.0,1,1,1,0,0,0,1,0
984,Jastin Garcia,Girona,0.4,1,0,0,0,1,0,0,0.0,0,0,0,0,0,1,1,0
985,Raul Garcia,Athletic Club,4.7,9,6,2,4,3,4,9,44.4,5,10,1,9,3,12,9,0
986,Ruben Garcia,Osasuna,17.2,32,18,8,17,7,13,33,39.4,20,23,3,20,12,44,23,0
988,Santiago Garcia,Getafe,0.3,1,0,0,0,1,1,1,100.0,0,0,0,0,0,1,0,0
989,Ulisses Garcia,Marseille,10.1,21,16,6,13,2,13,20,65.0,7,8,3,5,7,28,13,2
990,Unai Garcia,Osasuna,6.2,12,9,9,2,1,5,10,50.0,5,7,1,6,8,20,18,0
991,Alejandro Garnacho,Manchester Utd,28.5,22,15,7,6,9,12,45,26.7,33,26,2,24,18,40,18,0
992,James Garner,Everton,33.4,83,44,32,38,13,35,82,42.7,47,45,14,31,45,128,47,1
993,Luca Garritano,Frosinone,5.4,10,5,7,2,1,5,15,33.3,10,13,0,13,4,14,8,1
994,Johan Gastien,Clermont Foot,25.1,43,22,18,21,4,23,81,28.4,58,31,9,22,36,79,24,4
995,Federico Gatti,Juventus,29.3,33,19,16,16,1,19,24,79.2,5,26,15,11,19,52,90,1
996,Federico Gattoni,Sevilla,0.1,1,0,1,0,0,1,1,100.0,0,0,0,0,0,1,1,0
997,Gavi,Barcelona,10.5,39,21,20,14,5,18,36,50.0,18,19,3,16,8,47,16,1
998,Paulo Gazzaniga,Girona,38.0,2,2,2,0,0,2,4,50.0,2,0,0,0,0,2,12,1
999,Yann Gboho,Toulouse,13.3,14,4,6,6,2,8,23,34.8,15,21,1,20,4,18,2,0
1000,Dennis Geiger,Hoffenheim,0.7,1,0,1,0,0,0,0,0.0,0,1,1,0,0,1,0,0
1001,Gelabert,Toulouse,8.4,14,8,5,6,3,7,20,35.0,13,8,2,6,5,19,8,0
1002,Francesco Gelli,Frosinone,17.3,19,13,8,4,7,10,24,41.7,14,19,3,16,11,30,27,1
1003,Luca Gemello,Torino,2.0,0,0,0,0,0,0,1,0.0,1,0,0,0,0,0,1,1
1004,Valentin Gendrey,Lecce,33.8,55,33,35,16,4,30,46,65.2,16,40,11,29,35,90,99,0
1005,Denis Genreau,Toulouse,5.2,12,9,6,6,0,8,15,53.3,7,8,1,7,6,18,8,0
1006,Yannick Gerhardt,Wolfsburg,18.1,31,20,16,12,3,9,32,28.1,23,15,2,13,7,38,35,0
1007,Anwar El Ghazi,Mainz 05,0.6,0,0,0,0,0,0,1,0.0,1,0,0,0,0,0,0,0
1008,Fares Ghedjemis,Frosinone,2.0,2,0,1,0,1,0,2,0.0,2,2,0,2,1,3,2,0
1009,Saman Ghoddos,Brentford,8.2,28,19,19,7,2,17,31,54.8,14,9,2,7,5,33,12,0
1010,Lautaro Gianetti,Udinese,7.0,9,4,7,2,0,4,5,80.0,1,10,6,4,19,28,39,0
1011,Morgan Gibbs-White,Nott'ham Forest,35.1,36,24,6,20,10,14,33,42.4,19,31,8,23,17,53,21,0
1012,Samuel Gigot,Marseille,19.2,33,22,16,13,4,13,19,68.4,6,28,18,10,25,58,93,1
1014,Bryan Gil,Tottenham,2.3,1,0,0,0,1,1,4,25.0,3,3,0,3,3,4,4,0
1015,David Gil,Cádiz,4.1,0,0,0,0,0,0,1,0.0,1,0,0,0,0,0,3,0
1016,Mario Gila,Lazio,20.1,32,14,23,8,1,19,34,55.9,15,27,14,13,20,52,69,0
1017,Alfie Gilchrist,Chelsea,2.3,4,0,4,0,0,2,5,40.0,3,6,3,3,3,7,11,0
1018,Billy Gilmour,Brighton,23.6,26,16,14,10,2,11,35,31.4,24,23,9,14,11,37,14,1
1019,Benedikt Gimber,Heidenheim,22.5,40,24,25,14,1,19,35,54.3,16,27,17,10,16,56,101,1
1020,Gvidas Gineitis,Torino,6.0,11,7,3,8,0,4,7,57.1,3,10,4,6,4,15,9,1
1021,Matthias Ginter,Freiburg,21.3,29,15,19,9,1,16,29,55.2,13,40,26,14,16,45,93,0
1022,Olivier Giroud,Milan,26.3,17,11,6,6,5,2,14,14.3,12,14,3,11,6,23,22,0
1023,Klaus Gjasula,Darmstadt 98,15.1,44,22,18,25,1,17,30,56.7,13,26,14,12,19,63,42,2
1024,Serge Gnabry,Bayern Munich,4.8,8,5,0,5,3,2,13,15.4,11,5,0,5,3,11,2,0
1025,Ben Godfrey,Everton,12.4,30,20,17,8,5,15,28,53.6,13,14,8,6,16,46,57,0
1026,Edoardo Goldaniga,Cagliari,11.2,12,7,9,3,0,4,10,40.0,6,11,7,4,15,27,37,1
1027,Pierluigi Gollini,Napoli,7.0,1,1,1,0,0,1,1,100.0,0,0,0,0,1,2,2,0
1028,Aleksandr Golovin,Monaco,23.9,42,30,14,22,6,15,42,35.7,27,37,3,34,21,63,14,0
1029,Andre Gomes,Everton,5.6,7,4,2,3,2,3,13,23.1,10,10,1,9,3,10,4,1
1030,Angel Gomes,Lille,28.6,26,13,4,15,7,14,32,43.8,18,23,6,17,18,44,28,1
1031,Joao Gomes,Wolves,29.4,128,74,67,49,12,44,99,44.4,55,51,8,43,18,146,29,2
1032,Toti Gomes,Wolves,30.8,44,25,32,8,4,24,37,64.9,13,40,19,21,26,70,93,2
1033,Joe Gomez,Liverpool,19.8,47,31,24,16,7,30,63,47.6,33,26,4,22,19,66,50,2
1034,Maxi Gomez,Cádiz,12.9,6,4,2,3,1,3,5,60.0,2,8,3,5,3,9,3,0
1035,Moi Gomez,Osasuna,22.3,30,19,7,19,4,9,24,37.5,15,15,1,14,11,41,22,0
1036,Papu Gomez,Monza,0.5,0,0,0,0,0,0,2,0.0,2,0,0,0,1,1,0,0
1037,Sergio Gomez,Manchester City,0.6,1,0,0,1,0,1,2,50.0,1,0,0,0,1,2,0,0
1038,Unai Gomez,Athletic Club,9.7,12,10,2,6,4,5,10,50.0,5,13,2,11,2,14,9,0
1040,Iron Gomis,Salernitana,1.5,4,1,2,2,0,0,1,0.0,1,2,0,2,2,6,2,0
1041,Maxime Gonalons,Clermont Foot,14.4,47,33,14,27,6,25,57,43.9,32,18,3,15,20,67,11,0
1042,Edgar Gonzalez,Almería,28.0,45,21,22,20,3,25,49,51.0,24,48,28,20,38,83,130,3
1043,Enso Gonzalez,Wolves,0.0,0,0,0,0,0,0,1,0.0,1,0,0,0,0,0,0,0
1044,Fabio Gonzalez,Las Palmas,1.4,2,2,2,0,0,1,2,50.0,1,2,0,2,0,2,0,0
1045,Giovanni Gonzalez,Mallorca,27.4,73,45,37,32,4,40,81,49.4,41,24,3,21,31,104,60,2
1046,Hugo Gonzalez,Valencia,1.0,2,1,0,2,0,0,0,0.0,0,0,0,0,0,2,0,0
1047,Inaki Gonzalez,Las Palmas,0.1,1,0,1,0,0,0,0,0.0,0,0,0,0,0,1,1,0
1048,Joan Gonzalez,Lecce,14.3,31,18,16,12,3,17,28,60.7,11,20,3,17,5,36,9,0
1049,Nicolas Gonzalez,Fiorentina,21.3,28,18,15,8,5,8,28,28.6,20,26,1,25,12,40,9,0
1050,Urko Gonzalez,Real Sociedad,1.7,4,1,0,3,1,2,2,100.0,0,1,0,1,1,5,6,0
1051,Anthony Gordon,Newcastle Utd,32.1,55,34,16,28,11,22,64,34.4,42,27,0,27,7,62,7,0
1052,Kaide Gordon,Liverpool,0.0,0,0,0,0,0,0,0,0.0,0,0,0,0,0,0,0,0
1053,Daniel Gore,Manchester Utd,0.0,1,1,0,1,0,1,1,100.0,0,0,0,0,1,2,0,0
1054,Leon Goretzka,Bayern Munich,24.9,41,23,18,14,9,24,54,44.4,30,44,8,36,31,72,42,1
1055,Mathieu Gorgelin,Le Havre,1.0,0,0,0,0,0,0,0,0.0,0,0,0,0,0,0,0,0
1056,Andoni Gorosabel,Alavés,31.7,62,42,40,17,5,38,75,50.7,37,24,8,16,28,90,69,0
1057,Robin Gosens,Union Berlin,25.4,63,44,25,31,7,30,44,68.2,14,52,9,43,36,99,75,0
1058,Mario Gotze,Eint Frankfurt,23.0,51,34,18,25,8,28,62,45.2,34,19,3,16,14,65,10,0
1059,Amine Gouiri,Rennes,23.0,20,10,4,11,5,8,19,42.1,11,18,1,17,14,34,12,0
1060,Jeffrey Gouweleeuw,Augsburg,28.8,35,23,13,17,5,16,25,64.0,9,44,24,20,35,70,108,0
1061,Pablo Gozalbez,Valencia,1.1,1,0,0,0,1,1,6,16.7,5,0,0,0,1,2,2,0
1062,Jonathan Gradit,Lens,23.5,32,20,15,14,3,19,35,54.3,16,30,17,13,37,69,61,0
1063,Jens Grahl,Eint Frankfurt,2.0,0,0,0,0,0,0,0,0.0,0,0,0,0,0,0,3,0
1064,Samuel Grandsir,Le Havre,6.7,16,12,5,9,2,8,18,44.4,10,4,0,4,3,19,3,1
1066,Alberto Grassi,Empoli,20.1,30,18,13,13,4,10,26,38.5,16,26,11,15,41,71,37,0
1067,Ryan Gravenberch,Liverpool,12.5,26,12,5,13,8,12,29,41.4,17,20,2,18,14,40,11,0
1068,Ryan Gravenberch,Bayern Munich,0.1,0,0,0,0,0,0,0,0.0,0,0,0,0,0,0,0,0
1069,Adrian Grbic,Lorient,0.3,0,0,0,0,0,0,0,0.0,0,0,0,0,0,0,0,0
1070,Ivo Grbic,Sheffield Utd,8.6,0,0,0,0,0,0,1,0.0,1,1,0,1,0,0,9,1
1071,Jack Grealish,Manchester City,11.2,13,8,6,7,0,6,12,50.0,6,13,2,11,6,19,5,0
1072,Mason Greenwood,Getafe,29.6,11,6,3,5,3,4,21,19.0,17,9,0,9,4,15,4,0
1073,Michael Gregoritsch,Freiburg,18.7,16,12,8,5,3,2,14,14.3,12,17,4,13,9,25,27,0
1074,Dominik Greif,Mallorca,1.0,0,0,0,0,0,0,0,0.0,0,0,0,0,0,0,0,0
1075,Antoine Griezmann,Atlético Madrid,29.4,33,19,14,14,5,15,41,36.6,26,34,3,31,10,43,23,1
1076,Vincenzo Grifo,Freiburg,25.8,31,20,14,11,6,14,31,45.2,17,22,1,21,15,46,20,0
1077,Florian Grillitsch,Hoffenheim,25.5,54,28,31,19,4,22,54,40.7,32,41,20,21,52,106,90,2
1078,Alex Grimaldo,Leverkusen,30.9,45,24,26,10,9,30,55,54.5,25,32,7,25,22,67,41,0
1079,Christian Gross,Werder Bremen,8.9,21,16,11,9,1,11,25,44.0,14,17,6,11,13,34,28,1
1080,Pascal Gross,Brighton,34.6,70,46,33,21,16,31,72,43.1,41,41,8,33,22,92,32,3
1081,Brajan Gruda,Mainz 05,18.2,22,14,5,11,6,14,24,58.3,10,15,0,15,5,27,4,0
1082,Ilia Gruev,Werder Bremen,0.0,0,0,0,0,0,0,0,0.0,0,0,0,0,0,0,0,0
1083,Vicente Guaita,Celta Vigo,26.7,1,1,1,0,0,1,2,50.0,1,0,0,0,0,1,9,1
1084,Andres Guardado,Betis,5.0,17,12,5,9,3,7,14,50.0,7,4,2,2,6,23,5,0
1085,Sergi Guardiola,Cádiz,5.5,10,7,2,6,2,4,9,44.4,5,10,0,10,0,10,4,0
1086,Nemanja Gudelj,Sevilla,19.4,31,24,18,10,3,17,31,54.8,14,17,9,8,27,58,56,0
1087,Gabriel Gudmundsson,Lille,14.1,22,16,7,13,2,12,20,60.0,8,14,3,11,15,37,25,0
1088,Goncalo Guedes,Villarreal,10.6,6,4,1,2,3,2,7,28.6,5,8,0,8,2,8,3,0
1089,Axel Gueguin,Montpellier,1.5,9,5,6,2,1,2,6,33.3,4,2,0,2,2,11,6,0
1090,Marc Guehi,Crystal Palace,22.5,28,19,21,7,0,14,24,58.3,10,22,17,5,18,46,89,1
1092,Matteo Guendouzi,Lazio,26.3,34,15,11,18,5,21,49,42.9,28,24,6,18,21,55,24,1
1093,Matteo Guendouzi,Marseille,0.2,0,0,0,0,0,0,0,0.0,0,1,1,0,0,0,0,0
1094,Javier Guerra,Valencia,27.8,54,24,25,22,7,22,58,37.9,36,27,7,20,18,72,44,0
1095,Raphael Guerreiro,Bayern Munich,13.2,19,16,6,9,4,9,15,60.0,6,7,1,6,15,34,5,1
1096,Axel Guessand,Udinese,0.5,1,1,0,1,0,1,1,100.0,0,1,0,1,0,1,0,0
1097,Evann Guessand,Nice,17.3,16,7,2,7,7,6,7,85.7,1,12,1,11,12,28,7,0
1098,Ander Guevara,Alavés,32.6,59,32,28,25,6,31,64,48.4,33,34,12,22,13,72,46,1
1099,Pape Gueye,Marseille,8.5,33,21,11,19,3,13,19,68.4,6,17,3,14,13,46,12,0
1100,Josuha Guilavogui,Mainz 05,4.5,15,10,10,5,0,6,7,85.7,1,13,7,6,13,28,21,0
1101,Morgan Guilavogui,Lens,6.3,21,10,4,12,5,5,11,45.5,6,11,2,9,4,25,7,0
1102,Frederic Guilbert,Strasbourg,27.7,87,50,49,30,8,47,72,65.3,25,39,10,29,71,158,99,1
1103,Hugo Guillamon,Valencia,14.6,24,15,7,14,3,11,17,64.7,6,8,3,5,12,36,25,2
1104,Bruno Guimaraes,Newcastle Utd,36.3,88,53,45,32,11,40,77,51.9,37,52,14,38,35,123,20,0
1105,Serhou Guirassy,Stuttgart,24.5,6,3,1,4,1,2,5,40.0,3,8,1,7,6,12,29,0
1106,Marc Guiu,Barcelona,0.8,1,0,0,1,0,0,0,0.0,0,0,0,0,0,1,0,0
1107,Peter Gulacsi,RB Leipzig,13.0,0,0,0,0,0,0,0,0.0,0,0,0,0,0,0,8,1
1108,Manuel Gulde,Freiburg,22.7,37,23,23,13,1,17,23,73.9,6,24,14,10,25,62,82,0
1109,Arda Guler,Real Madrid,4.2,6,4,1,3,2,5,8,62.5,3,0,0,0,2,8,5,0
1110,Gerard Gumbau,Granada,29.7,55,34,21,30,4,23,62,37.1,39,24,5,19,25,80,30,2
1111,Robert Gumny,Augsburg,5.3,6,5,1,3,2,1,5,20.0,4,13,5,8,7,13,15,0
1112,Ilkay Gundogan,Barcelona,33.3,32,22,14,16,2,12,39,30.8,27,19,4,15,21,53,18,1
1113,Christian Gunter,Freiburg,11.8,20,12,9,11,0,7,18,38.9,11,9,3,6,2,22,16,0
1114,Jon Guridi,Alavés,29.8,42,24,10,27,5,12,45,26.7,33,23,3,20,22,64,22,0
1115,Gorka Guruzeta,Athletic Club,24.6,34,23,6,25,3,9,30,30.0,21,36,2,34,17,51,23,0
1116,Malo Gusto,Chelsea,19.5,55,27,34,15,6,35,52,67.3,17,28,4,24,17,72,43,1
1118,Miguel Gutierrez,Girona,33.7,29,18,11,14,4,13,35,37.1,22,27,11,16,22,51,66,2
1119,Albert Gudmundsson,Genoa,33.5,23,10,8,10,5,12,44,27.3,32,15,2,13,11,34,13,0
1120,Josko Gvardiol,Manchester City,25.9,55,33,21,24,10,21,38,55.3,17,36,12,24,27,82,37,3
1121,Emmanuel Gyasi,Empoli,20.9,34,17,18,13,3,15,32,46.9,17,30,12,18,5,39,27,1
1122,Norbert Gyomber,Salernitana,19.6,36,18,30,6,0,20,26,76.9,6,33,23,10,23,59,77,2
1123,Erling Haaland,Manchester City,28.4,6,3,0,3,3,2,3,66.7,1,11,1,10,2,8,16,0
1124,Nicolas Haas,Empoli,1.0,5,3,1,2,2,3,3,100.0,0,1,0,1,1,6,1,0
1125,Janik Haberer,Union Berlin,13.6,36,24,16,13,7,22,45,48.9,23,21,4,17,12,48,18,0
1126,Robin Hack,Gladbach,15.0,15,8,6,7,2,4,17,23.5,13,16,0,16,14,29,21,0
1127,Antwoine Hackford,Sheffield Utd,0.1,0,0,0,0,0,0,0,0.0,0,0,0,0,0,0,0,0
1128,Munir El Haddadi,Las Palmas,27.2,40,27,18,17,5,17,38,44.7,21,27,1,26,11,51,16,0
1129,Jaouen Hadjam,Nantes,1.2,6,4,5,1,0,1,2,50.0,1,0,0,0,3,9,2,0
1130,Ianis Hagi,Alavés,8.9,17,12,2,14,1,5,12,41.7,7,8,0,8,5,22,4,0
1131,Amadou Haidara,RB Leipzig,17.0,42,27,24,16,2,23,41,56.1,18,28,6,22,21,63,37,0
1132,Massadio Haidara,Lens,8.2,9,8,5,3,1,4,6,66.7,2,7,2,5,11,20,32,3
1133,Oualid El Hajjam,Le Havre,4.4,8,7,5,2,1,2,9,22.2,7,5,1,4,6,14,10,0
1134,Achraf Hakimi,Paris S-G,21.5,29,19,14,9,6,17,34,50.0,17,28,4,24,12,41,28,2
1135,Lewis Hall,Newcastle Utd,8.7,28,18,17,10,1,17,28,60.7,11,17,2,15,12,40,22,1
1136,Sebastien Haller,Dortmund,4.4,1,0,0,1,0,1,1,100.0,0,4,1,3,0,1,7,0
1137,Gustavo Hamer,Sheffield Utd,32.3,39,21,17,15,7,16,59,27.1,43,33,9,24,29,68,35,0
1138,Andreas Hanche-Olsen,Mainz 05,11.0,20,12,10,8,2,10,16,62.5,6,10,4,6,11,31,41,0
1139,Isak Hansen-Aaroen,Werder Bremen,0.3,0,0,0,0,0,0,1,0.0,1,1,0,1,1,1,0,0
1140,Ridgeciano Haps,Genoa,8.6,7,6,3,2,2,5,8,62.5,3,3,0,3,6,13,11,1
1141,Genki Haraguchi,Stuttgart,0.3,1,1,1,0,0,0,0,0.0,0,0,0,0,0,1,1,0
1142,Amine Harit,Marseille,20.2,28,16,8,17,3,13,37,35.1,24,31,4,27,12,40,4,0
1144,Luke Harris,Fulham,0.8,1,1,1,0,0,0,1,0.0,1,0,0,0,0,1,0,0
1145,Jack Harrison,Everton,24.6,37,22,12,12,13,17,49,34.7,32,25,5,20,12,49,24,0
1146,Abdou Harroui,Frosinone,11.3,23,11,11,11,1,8,16,50.0,8,19,3,16,5,28,8,0
1147,Makoto Hasebe,Eint Frankfurt,2.4,4,2,2,2,0,3,6,50.0,3,2,1,1,2,6,5,0
1148,Daiki Hashioka,Luton Town,6.6,11,5,6,4,1,5,11,45.5,6,12,7,5,8,19,20,0
1149,Hans Hateboer,Atalanta,12.4,12,5,8,2,2,5,15,33.3,10,21,7,14,4,16,21,0
1150,Pantelis Hatzidiakos,Cagliari,9.5,22,10,12,10,0,10,17,58.8,7,14,5,9,13,35,30,1
1151,Kai Havertz,Arsenal,29.3,35,15,7,21,7,14,39,35.9,25,26,1,25,20,55,22,0
1152,Thorgan Hazard,Dortmund,0.1,0,0,0,0,0,0,0,0.0,0,0,0,0,0,0,0,0
1153,Jan Paul van Hecke,Brighton,26.3,47,26,25,19,3,27,45,60.0,18,49,27,22,30,77,76,4
1154,Hwang Hee-chan,Wolves,23.5,20,10,11,8,1,9,24,37.5,15,19,1,18,10,30,9,0
1155,Silvan Hefti,Genoa,1.3,6,1,2,3,1,4,7,57.1,3,2,0,2,0,6,1,0
1156,Silvan Hefti,Montpellier,7.9,21,15,10,7,4,15,29,51.7,14,7,2,5,8,29,11,0
1157,Dominique Heintz,Köln,6.3,12,5,6,6,0,8,12,66.7,4,6,1,5,3,15,28,0
1158,Dean Henderson,Crystal Palace,18.0,1,1,1,0,0,1,2,50.0,1,0,0,0,0,1,8,2
1159,Liam Henderson,Empoli,0.1,0,0,0,0,0,0,0,0.0,0,0,0,0,0,0,0,0
1160,Benjamin Henrichs,RB Leipzig,28.1,68,39,32,26,10,27,58,46.6,31,49,4,45,33,101,37,0
1161,Henrique,Lyon,6.7,10,6,6,4,0,6,11,54.5,5,8,2,6,10,20,3,0
1162,Luis Henrique,Marseille,8.7,8,7,4,1,3,4,7,57.1,3,9,0,9,8,16,3,0
1163,Luiz Henrique,Betis,6.8,15,11,4,10,1,9,14,64.3,5,11,0,11,5,20,8,0
1164,Matheus Henrique,Sassuolo,27.8,43,29,21,18,4,18,43,41.9,25,18,8,10,25,68,31,6
1165,Rico Henry,Brentford,4.5,7,5,3,3,1,6,7,85.7,1,8,3,5,5,12,5,1
1166,Thomas Henry,Hellas Verona,3.7,0,0,0,0,0,0,0,0.0,0,0,0,0,0,0,5,0
1167,Christophe Herelle,Metz,18.0,32,15,24,7,1,13,23,56.5,10,16,9,7,18,50,68,2
1168,Mario Hermoso,Atlético Madrid,28.4,46,25,29,13,4,28,51,54.9,23,27,9,18,30,76,93,0
1170,Javi Hernandez,Cádiz,27.9,43,24,26,12,5,25,46,54.3,21,34,9,25,19,62,72,1
1171,Aridane Hernandez,Rayo Vallecano,18.8,10,8,5,4,1,4,11,36.4,7,19,14,5,14,24,98,1
1172,Lucas Hernandez,Paris S-G,21.2,52,36,28,15,9,29,50,58.0,21,21,5,16,27,79,38,0
1173,Luis Hernandez,Cádiz,8.0,7,3,4,3,0,4,8,50.0,4,3,2,1,8,15,25,0
1174,Theo Hernandez,Milan,31.0,30,17,19,11,0,11,22,50.0,11,33,13,20,23,53,42,1
1175,Yarek Hernandis,Valencia,8.2,22,12,14,5,3,13,19,68.4,6,15,8,7,15,37,50,1
1176,Jorge Herrando,Osasuna,18.3,29,19,23,6,0,12,19,63.2,7,20,11,9,15,44,69,1
1177,Ander Herrera,Athletic Club,11.4,44,32,11,26,7,20,36,55.6,16,16,6,10,15,59,18,1
1178,Cristian Herrera,Las Palmas,1.8,1,1,0,1,0,1,2,50.0,1,1,0,1,0,1,2,0
1179,Sergio Herrera,Osasuna,31.9,2,2,2,0,0,2,3,66.7,1,0,0,0,0,2,22,3
1180,Yangel Herrera,Girona,23.4,64,37,28,30,6,30,56,53.6,26,30,8,22,24,88,45,1
1181,Patrick Herrmann,Gladbach,1.0,4,4,2,1,1,2,2,100.0,0,1,0,1,1,5,2,0
1182,Juan Herzog,Las Palmas,3.2,6,5,5,1,0,3,6,50.0,3,4,1,3,2,8,17,0
1183,Son Heung-min,Tottenham,32.6,21,13,6,7,8,10,21,47.6,11,4,1,3,8,29,4,0
1184,Aaron Hickey,Brentford,7.9,16,9,9,3,4,7,7,100.0,0,7,3,4,3,19,10,0
1185,Isak Hien,Hellas Verona,9.6,17,10,10,7,0,10,19,52.6,9,12,5,7,7,24,33,1
1186,Isak Hien,Atalanta,10.4,18,12,8,10,0,7,15,46.7,8,12,5,7,14,32,33,0
1187,James Hill,Bournemouth,0.8,3,2,1,2,0,1,1,100.0,0,3,2,1,3,6,8,0
1188,Piero Hincapie,Leverkusen,16.5,35,22,14,17,4,13,17,76.5,4,18,7,11,13,48,43,0
1189,Jack Hinshelwood,Brighton,9.7,14,5,7,4,3,5,13,38.5,8,6,2,4,14,28,18,0
1190,Adam Hlozek,Leverkusen,5.1,10,4,2,4,4,3,7,42.9,4,4,1,3,2,12,1,0
1191,Nicolas Hofler,Freiburg,25.9,63,40,36,20,7,22,49,44.9,27,30,16,14,31,94,45,0
1192,Jonas Hofmann,Leverkusen,24.5,20,14,6,9,5,10,24,41.7,14,18,0,18,8,28,6,0
1193,Philipp Hofmann,Bochum,17.5,10,5,4,5,1,4,7,57.1,3,11,2,9,4,14,17,0
1194,Lucas Holer,Freiburg,25.6,32,24,14,10,8,4,23,17.4,19,19,4,15,15,47,35,0
1196,Mason Holgate,Sheffield Utd,7.9,12,7,5,6,1,5,12,41.7,7,12,5,7,11,23,40,0
1197,Fabian Holland,Darmstadt 98,20.4,47,26,18,21,8,20,37,54.1,17,22,12,10,24,71,29,0
1198,Benedict Hollerbach,Union Berlin,14.2,17,11,5,7,5,7,22,31.8,15,28,0,28,4,21,3,0
1199,Emil Holm,Atalanta,10.5,28,19,17,9,2,16,36,44.4,20,25,3,22,7,35,25,0
1200,Gerrit Holtmann,Darmstadt 98,4.4,8,5,3,4,1,7,10,70.0,3,7,0,7,2,10,4,1
1201,Martin Hongla,Hellas Verona,12.0,24,13,9,13,2,8,11,72.7,3,8,3,5,7,31,24,0
1202,Martin Hongla,Granada,6.2,7,3,2,5,0,3,9,33.3,6,6,3,3,6,13,13,1
1203,Franck Honorat,Gladbach,26.1,25,13,13,10,2,11,20,55.0,9,22,3,19,9,34,35,1
1204,Mathias Honsak,Darmstadt 98,11.3,14,7,7,6,1,6,20,30.0,14,14,2,12,8,22,25,0
1205,Sydney van Hooijdonk,Bologna,2.4,3,0,0,2,1,1,2,50.0,1,1,1,0,1,4,4,0
1206,Fraser Hornby,Darmstadt 98,2.4,0,0,0,0,0,0,1,0.0,1,2,1,1,0,0,4,0
1207,Lukas Hradecky,Leverkusen,33.0,0,0,0,0,0,0,1,0.0,1,1,0,1,0,0,10,2
1208,Xabier Huarte Armendariz,Osasuna,0.1,0,0,0,0,0,0,0,0.0,0,0,0,0,0,0,0,0
1209,Timo Hubers,Köln,30.9,68,47,51,14,3,49,80,61.3,31,54,28,26,63,131,168,1
1210,Callum Hudson-Odoi,Nott'ham Forest,20.6,18,8,4,5,9,7,28,25.0,21,16,1,15,7,25,12,1
1211,Will Hughes,Crystal Palace,21.0,61,33,30,20,11,24,48,50.0,24,36,14,22,21,82,25,0
1212,Dean Huijsen,Roma,5.7,10,5,5,5,0,1,4,25.0,3,7,4,3,4,14,26,2
1213,Dean Huijsen,Juventus,0.1,0,0,0,0,0,0,0,0.0,0,0,0,0,0,0,1,0
1214,Mats Hummels,Dortmund,17.6,52,34,34,12,6,30,53,56.6,23,33,11,22,33,85,82,0
1215,Denis Huseinbasic,Köln,18.1,38,18,17,15,6,20,31,64.5,11,26,1,25,13,51,14,0
1216,Elseid Hysaj,Lazio,13.3,24,14,8,13,3,15,24,62.5,9,16,6,10,17,41,31,0
1217,Pierre Hojbjerg,Tottenham,14.6,32,18,13,17,2,13,34,38.2,21,21,7,14,19,51,30,3
1218,Rasmus Hojlund,Manchester Utd,24.0,11,7,2,3,6,5,13,38.5,8,9,1,8,1,12,19,0
1219,Iago,Augsburg,18.0,36,17,22,10,4,17,33,51.5,16,39,8,31,18,54,43,0
1220,Pablo Ibanez,Osasuna,12.8,18,9,5,7,6,5,21,23.8,16,26,3,23,9,27,17,0
1222,Arijon Ibrahimovic,Frosinone,5.3,7,6,4,2,1,1,9,11.1,8,4,0,4,1,8,3,0
1223,Iglesias,Getafe,15.7,41,22,25,11,5,21,33,63.6,12,18,7,11,16,57,53,0
1224,Borja Iglesias,Betis,4.5,0,0,0,0,0,0,3,0.0,3,0,0,0,2,2,2,0
1225,Borja Iglesias,Leverkusen,2.8,1,0,0,1,0,0,1,0.0,1,2,0,2,1,2,1,0
1226,Igor,Brighton,18.2,25,18,7,16,2,17,29,58.6,12,22,9,13,14,39,52,1
1227,Jonathan Ikone,Fiorentina,18.7,22,11,7,9,6,10,17,58.8,7,12,0,12,3,25,8,0
1228,Chukwubuikem Ikwuemesi,Salernitana,11.8,3,1,0,2,1,2,6,33.3,4,1,1,0,1,4,8,0
1229,Andrej Ilic,Lille,0.1,0,0,0,0,0,0,0,0.0,0,0,0,0,0,0,0,0
1230,Ivan Ilic,Torino,23.3,22,8,9,10,3,13,27,48.1,14,20,7,13,20,42,31,0
1231,Samuel Iling-Junior,Juventus,9.0,23,13,9,11,3,11,18,61.1,7,17,5,12,6,29,19,0
1232,Imanol,Athletic Club,5.8,7,5,1,5,1,5,18,27.8,13,6,0,6,7,14,15,0
1233,Joel Imasuen,Werder Bremen,0.0,0,0,0,0,0,0,0,0.0,0,0,0,0,0,0,0,0
1234,Ciro Immobile,Lazio,18.4,11,9,2,5,4,3,14,21.4,11,9,3,6,5,16,11,0
1235,Gino Infantino,Fiorentina,1.1,1,1,0,1,0,0,1,0.0,1,4,0,4,3,4,1,0
1236,Danny Ings,West Ham,4.5,6,2,0,6,0,4,13,30.8,9,4,1,3,3,9,7,0
1237,Bonke Innocent,Lorient,2.3,6,4,2,2,2,2,9,22.2,7,2,1,1,4,10,2,0
1238,Tim Iroegbunam,Aston Villa,1.8,7,5,4,2,1,4,9,44.4,5,3,0,3,2,9,3,0
1239,Alexander Isak,Newcastle Utd,25.1,5,0,2,1,2,2,8,25.0,6,16,1,15,6,11,13,0
1240,Gustav Isaksen,Lazio,11.9,4,3,2,1,1,1,9,11.1,8,11,1,10,4,8,4,0
1241,Isco,Betis,25.8,41,27,15,21,5,14,38,36.8,24,19,1,18,10,51,7,0
1242,Thomas Isherwood,Darmstadt 98,7.1,11,5,7,3,1,5,9,55.6,4,10,7,3,10,21,34,0
1243,Ismaily,Lille,27.4,72,47,34,25,13,31,60,51.7,29,33,6,27,32,104,77,0
1244,Ardian Ismajli,Empoli,22.7,26,16,18,6,2,18,23,78.3,5,28,17,11,23,49,126,1
1245,Yanis Issoufou,Montpellier,0.1,0,0,0,0,0,0,0,0.0,0,0,0,0,0,0,0,0
1246,Ko Itakura,Gladbach,17.7,34,21,17,15,2,16,26,61.5,10,32,18,14,22,56,62,0
1248,Hiroki Ito,Stuttgart,24.8,19,18,13,6,0,11,26,42.3,15,29,17,12,29,48,86,2
1249,Junya Ito,Reims,30.2,33,15,11,14,8,10,36,27.8,26,23,1,22,14,47,7,0
1250,Diego Iturralde,Sevilla,0.4,0,0,0,0,0,0,0,0.0,0,1,1,0,0,0,2,0
1251,Alex Iwobi,Everton,1.6,2,0,1,0,1,2,3,66.7,1,2,0,2,1,3,0,0
1252,Alex Iwobi,Fulham,24.4,29,18,12,15,2,12,25,48.0,13,16,0,16,14,43,9,0
1253,Armando Izzo,Monza,18.3,27,17,17,9,1,16,27,59.3,11,20,16,4,27,54,49,1
1254,Nicolas Jackson,Chelsea,31.1,21,13,5,8,8,5,24,20.8,19,20,5,15,4,25,17,0
1255,Jeremy Jacquet,Rennes,0.1,1,1,1,0,0,0,1,0.0,1,0,0,0,1,2,0,0
1256,Jeremy Jacquet,Clermont Foot,2.8,4,3,4,0,0,3,3,100.0,0,7,3,4,6,10,10,0
1257,Lee Jae-sung,Mainz 05,23.5,33,20,11,16,6,13,39,33.3,26,22,2,20,27,60,23,0
1258,Paul Jaeckel,Union Berlin,2.6,7,2,4,3,0,5,9,55.6,4,3,2,1,4,11,7,0
1259,Filip Jagiello,Genoa,0.4,0,0,0,0,0,0,1,0.0,1,1,1,0,1,1,0,0
1260,Kristijan Jakic,Augsburg,11.7,28,14,14,10,4,15,33,45.5,18,13,1,12,20,48,15,0
1261,Kristijan Jakic,Eint Frankfurt,2.2,3,3,1,2,0,1,3,33.3,2,1,0,1,2,5,2,0
1262,Ismail Jakobs,Monaco,16.3,57,41,27,21,9,29,47,61.7,18,19,2,17,11,68,40,0
1263,Ablie Jallow,Metz,10.2,8,5,2,3,3,3,5,60.0,2,4,0,4,8,16,3,0
1264,Reece James,Chelsea,4.7,14,9,10,3,1,8,10,80.0,2,4,4,0,3,17,7,1
1265,Vitaly Janelt,Brentford,33.9,63,38,29,25,9,32,64,50.0,32,35,9,26,36,99,64,3
1266,Jakub Jankto,Cagliari,9.7,12,9,9,1,2,8,20,40.0,12,5,1,4,5,17,20,0
1267,Tony Jantschke,Gladbach,0.3,1,1,1,0,0,1,1,100.0,0,2,2,0,1,2,4,0
1268,Adnan Januzaj,Sevilla,2.1,3,3,2,0,1,0,1,0.0,1,2,0,2,1,4,0,0
1269,Nuha Jatta,RB Leipzig,0.0,0,0,0,0,0,0,0,0.0,0,0,0,0,0,0,0,0
1270,Mikel Jauregizar,Athletic Club,1.7,0,0,0,0,0,0,6,0.0,6,5,0,5,0,0,2,0
1271,Luis Javier Suarez,Almería,10.2,7,5,2,5,0,2,6,33.3,4,11,0,11,0,7,13,0
1272,Danley Jean-Jacques,Metz,29.8,54,28,24,21,9,19,56,33.9,37,48,7,41,44,98,44,0
1274,Salim El Jebari,Atlético Madrid,0.1,1,0,0,1,0,0,0,0.0,0,0,0,0,0,1,1,0
1275,Daniel Jebbison,Sheffield Utd,0.2,0,0,0,0,0,0,0,0.0,0,1,0,1,0,0,0,0
1276,Jeffinho,Lyon,3.4,11,4,3,5,3,4,11,36.4,7,1,0,1,0,11,0,0
1277,Fredrik Jensen,Augsburg,14.9,23,11,9,8,6,14,28,50.0,14,30,1,29,12,35,21,0
1278,Mathias Jensen,Brentford,24.5,54,32,25,22,7,26,95,27.4,69,41,6,35,23,77,25,1
1279,Moritz Jenz,Wolfsburg,19.4,34,24,21,11,2,14,21,66.7,7,29,17,12,26,60,94,0
1280,Gabriel Jesus,Arsenal,16.4,24,17,11,5,8,5,18,27.8,13,23,1,22,13,37,12,0
1281,Juan Jesus,Napoli,23.5,42,19,28,12,2,23,33,69.7,10,23,12,11,23,65,67,1
1282,Alejandro Jimenez,Milan,0.8,2,1,2,0,0,2,5,40.0,3,0,0,0,0,2,4,0
1283,Raul Jimenez,Fulham,15.5,18,12,4,8,6,7,20,35.0,13,11,3,8,4,22,13,0
1284,Joao Pedro,Brighton,22.7,31,14,10,13,8,14,24,58.3,10,15,2,13,11,42,28,0
1285,Joelinton,Newcastle Utd,14.2,39,27,21,15,3,14,38,36.8,24,23,7,16,19,58,11,1
1286,Ryan John Giles,Luton Town,5.6,8,6,4,3,1,2,7,28.6,5,2,0,2,4,12,22,0
1287,Ben Johnson,West Ham,6.0,11,7,7,3,1,9,14,64.3,5,2,1,1,5,16,14,0
1288,Brennan Johnson,Tottenham,23.2,26,15,14,5,7,12,31,38.7,19,37,1,36,10,36,12,1
1289,Brennan Johnson,Nott'ham Forest,2.6,4,1,1,1,2,2,4,50.0,2,4,1,3,0,4,0,0
1290,Joseph Johnson,Luton Town,0.9,0,0,0,0,0,0,1,0.0,1,0,0,0,0,0,0,0
1291,Sam Johnstone,Crystal Palace,20.0,1,0,1,0,0,1,1,100.0,0,0,0,0,1,2,5,0
1292,Curtis Jones,Liverpool,13.0,27,14,12,12,3,10,23,43.5,13,22,0,22,7,34,8,0
1293,Frenkie de Jong,Barcelona,18.2,43,26,14,23,6,8,19,42.1,11,18,8,10,14,57,28,1
1294,Joan Jordan,Sevilla,4.2,8,7,3,3,2,7,15,46.7,8,4,2,2,4,12,2,0
1295,Jordi,Getafe,6.4,16,11,3,11,2,7,15,46.7,8,7,2,5,8,24,7,0
1296,Jeremy Jorge,Getafe,0.0,0,0,0,0,0,0,0,0.0,0,0,0,0,0,0,0,0
1297,Kaio Jorge,Frosinone,9.0,6,4,0,1,5,3,4,75.0,1,6,0,6,1,7,0,0
1298,Jorginho,Arsenal,10.2,24,10,6,10,8,11,23,47.8,12,17,1,16,12,36,7,1
1300,Willian Jose,Betis,21.9,7,3,1,2,4,2,5,40.0,3,8,2,6,2,9,15,0
1301,Joselu,Real Madrid,18.7,6,3,1,4,1,0,7,0.0,7,11,1,10,6,12,11,0
1302,Diogo Jota,Liverpool,12.7,23,13,6,13,4,10,23,43.5,13,9,1,8,7,30,4,0
1303,Antoine Joujou,Le Havre,8.7,20,12,7,7,6,11,21,52.4,10,11,2,9,7,27,5,0
1304,Luka Jovic,Milan,9.7,6,4,0,3,3,4,6,66.7,2,3,0,3,1,7,9,0
1305,Kamil Jozwiak,Granada,6.3,13,10,4,6,3,9,17,52.9,8,4,0,4,2,15,6,0
1306,Juanmi,Cádiz,9.7,9,4,2,7,0,2,9,22.2,7,6,0,6,6,15,3,0
1307,Juanpe,Girona,8.3,11,8,8,3,0,9,10,90.0,1,17,11,6,7,18,50,1
1308,Mads Juel Andersen,Luton Town,4.4,6,5,4,2,0,4,4,100.0,0,9,6,3,8,14,29,0
1309,Christopher Jullien,Montpellier,13.7,16,12,11,5,0,6,17,35.3,11,25,20,5,12,28,106,2
1310,Anthony Jung,Werder Bremen,28.7,37,23,21,14,2,18,33,54.5,15,39,17,22,24,61,102,0
1311,Eli Junior Kroupi,Lorient,12.0,7,4,2,2,3,1,9,11.1,8,6,0,6,10,17,5,0
1312,Hamed Junior Traore,Bournemouth,0.5,1,0,1,0,0,1,3,33.3,2,3,0,3,0,1,0,0
1313,Hamed Junior Traore,Napoli,4.2,4,2,2,0,2,1,6,16.7,5,3,0,3,2,6,1,1
1314,Vinicius Junior,Real Madrid,20.7,18,13,5,5,8,3,12,25.0,9,13,0,13,1,19,3,2
1315,Josip Juranovic,Union Berlin,14.4,20,14,11,7,2,10,21,47.6,11,17,3,14,12,32,27,1
1316,David Jurasek,Hoffenheim,5.5,14,11,13,1,0,7,17,41.2,10,7,2,5,3,17,22,1
1317,Julian Justvan,Hoffenheim,0.5,1,0,1,0,0,1,2,50.0,1,1,0,1,0,1,0,0
1318,Julian Justvan,Darmstadt 98,11.4,10,4,2,7,1,3,17,17.6,14,12,2,10,11,21,6,1
1319,Filip Jorgensen,Villarreal,36.0,3,1,3,0,0,3,4,75.0,1,0,0,0,2,5,10,3
1320,Mathias Jorgensen,Brentford,12.1,17,12,15,1,1,11,19,57.9,8,9,5,4,12,29,40,0
1321,Mohamed Kaba,Lecce,15.3,39,23,15,16,8,17,34,50.0,17,22,4,18,12,51,13,0
1322,Sory Kaba,Las Palmas,8.0,2,0,0,2,0,0,5,0.0,5,6,0,6,0,2,9,0
1323,Ozan Kabak,Hoffenheim,25.4,48,35,32,14,2,19,33,57.6,14,43,21,22,46,94,106,2
1324,Christian Kabasele,Udinese,9.6,10,7,4,5,1,2,11,18.2,9,15,9,6,12,22,56,0
1326,Issa Kabore,Luton Town,19.2,52,28,23,21,8,24,45,53.3,21,22,11,11,16,68,56,2
1327,Abdoul Kader Bamba,Nantes,6.8,10,7,2,5,3,5,15,33.3,10,4,0,4,4,14,4,1
1328,Yaya Kader Fofana,Reims,0.4,3,3,1,1,1,0,1,0.0,1,0,0,0,1,4,0,0
1329,Pavel Kaderabek,Hoffenheim,26.8,31,19,10,15,6,18,40,45.0,22,22,8,14,23,54,68,0
1330,Tino Kadewere,Lyon,3.3,1,1,0,1,0,1,5,20.0,4,3,1,2,5,6,7,0
1331,Tino Kadewere,Nantes,8.7,9,4,3,3,3,6,11,54.5,5,10,1,9,10,19,8,0
1332,Kaiky,Almería,5.8,7,4,6,0,1,3,6,50.0,3,9,7,2,3,10,29,1
1333,Florian Kainz,Köln,24.4,28,20,8,13,7,17,39,43.6,22,20,6,14,13,41,23,1
1334,Sasa Kalajdzic,Wolves,1.8,6,2,3,2,1,1,2,50.0,1,3,0,3,1,7,6,0
1335,Sasa Kalajdzic,Eint Frankfurt,3.6,2,2,0,2,0,0,0,0.0,0,2,2,0,2,4,6,0
1336,Arnaud Kalimuendo,Rennes,23.8,5,4,2,2,1,2,5,40.0,3,13,2,11,4,9,4,0
1337,Yayah Kallon,Hellas Verona,0.0,0,0,0,0,0,0,0,0.0,0,0,0,0,0,0,0,0
1338,Gedeon Kalulu,Lorient,10.8,23,17,13,8,2,12,22,54.5,10,18,2,16,5,28,30,0
1339,Pierre Kalulu,Milan,4.2,5,1,2,3,0,1,2,50.0,1,4,3,1,1,6,12,1
1340,Daichi Kamada,Lazio,17.2,53,36,22,22,9,28,52,53.8,24,24,5,19,18,71,7,0
1341,Waren Kamanzi,Toulouse,13.2,36,24,16,16,4,13,23,56.5,10,11,3,8,9,45,35,0
1342,Boubacar Kamara,Aston Villa,18.4,43,29,16,21,6,24,47,51.1,23,21,7,14,21,64,16,0
1343,Hassane Kamara,Udinese,24.7,45,32,26,13,6,25,38,65.8,13,29,2,27,26,71,66,0
1344,Willy Kambwala,Manchester Utd,3.7,3,1,1,2,0,1,3,33.3,2,6,3,3,4,7,14,1
1345,Jakub Kaminski,Wolfsburg,5.3,14,5,12,2,0,3,6,50.0,3,3,0,3,2,16,5,0
1346,Thomas Kaminski,Luton Town,37.8,2,1,2,0,0,2,6,33.3,4,1,0,1,0,2,14,2
1347,Kevin Kampl,RB Leipzig,15.1,19,8,8,9,2,10,21,47.6,11,19,7,12,11,30,14,1
1348,Harry Kane,Bayern Munich,31.5,13,9,4,4,5,6,18,33.3,12,12,4,8,6,19,14,0
1349,Lee Kang-in,Paris S-G,16.3,26,13,7,9,10,15,36,41.7,21,7,0,7,6,32,3,0
1350,Yann Karamoh,Torino,1.8,1,0,0,0,1,0,0,0.0,0,0,0,0,0,1,1,0
1352,Yann Karamoh,Montpellier,3.2,1,0,0,0,1,1,2,50.0,1,3,0,3,0,1,0,0
1353,Atakan Karazor,Stuttgart,29.1,72,44,23,38,11,29,60,48.3,31,37,8,29,27,99,43,0
1354,Ayman Kari,Lorient,9.9,18,14,9,9,0,12,19,63.2,7,19,2,17,6,24,9,1
1355,Emir Karic,Darmstadt 98,19.8,45,27,23,14,8,21,33,63.6,12,42,11,31,13,58,43,0
1356,Loris Karius,Newcastle Utd,1.0,0,0,0,0,0,0,0,0.0,0,0,0,0,0,0,1,0
1357,Jesper Karlsson,Bologna,3.8,3,3,2,1,0,2,8,25.0,6,4,0,4,4,7,1,0
1358,Jon Karrikaburu,Alavés,0.2,0,0,0,0,0,0,0,0.0,0,0,0,0,0,0,0,0
1359,Rick Karsdorp,Roma,13.2,25,18,11,8,6,16,24,66.7,8,13,4,9,9,34,16,0
1360,Grigoris Kastanos,Salernitana,16.4,23,14,8,9,6,9,20,45.0,11,13,4,9,8,31,9,0
1361,Silas Katompa,Stuttgart,10.0,5,3,3,2,0,3,12,25.0,9,9,0,9,0,5,4,0
1362,Panos Katseris,Lorient,11.6,26,20,16,8,2,16,25,64.0,9,20,4,16,8,34,18,0
1363,Mikkel Kaufmann,Union Berlin,5.4,6,3,2,3,1,3,10,30.0,7,12,0,12,1,7,4,0
1364,Michael Kayode,Fiorentina,22.9,53,30,27,15,11,35,48,72.9,13,25,12,13,18,71,46,2
1365,Moise Kean,Juventus,7.3,7,4,3,2,2,1,3,33.3,2,4,1,3,2,9,5,0
1366,Michael Keane,Everton,4.9,7,3,3,3,1,1,7,14.3,6,5,4,1,5,12,18,1
1367,Ibrahima Kebe,Girona,0.1,1,1,0,1,0,0,0,0.0,0,1,0,1,1,2,0,0
1368,Kevin Keben Biakolo,Toulouse,5.8,4,2,4,0,0,3,6,50.0,3,7,0,7,8,12,17,0
1369,Yassine Kechta,Le Havre,20.5,46,24,24,19,3,31,73,42.5,42,20,3,17,23,69,16,1
1370,Thilo Kehrer,West Ham,0.2,1,1,0,1,0,0,0,0.0,0,2,2,0,0,1,0,0
1371,Thilo Kehrer,Monaco,14.7,32,22,22,7,3,22,39,56.4,17,18,6,12,30,62,55,0
1372,Habib Keita,Clermont Foot,14.2,34,19,14,15,5,17,28,60.7,11,27,10,17,29,63,30,0
1373,Naby Keita,Werder Bremen,1.2,1,1,1,0,0,0,1,0.0,1,2,0,2,2,3,1,0
1374,Yannik Keitel,Freiburg,10.2,20,15,14,5,1,10,15,66.7,5,17,8,9,12,32,44,3
1375,Caoimhin Kelleher,Liverpool,10.0,0,0,0,0,0,0,0,0.0,0,0,0,0,0,0,4,1
1376,Thomas Keller,Heidenheim,0.0,0,0,0,0,0,0,0,0.0,0,0,0,0,0,0,0,0
1378,Lloyd Kelly,Bournemouth,17.3,24,19,10,9,5,14,25,56.0,11,22,12,10,13,37,67,0
1379,Omari Kellyman,Aston Villa,0.4,1,0,0,1,0,1,2,50.0,1,0,0,0,0,1,0,0
1380,Aljoscha Kemlein,Union Berlin,0.3,0,0,0,0,0,0,3,0.0,3,1,0,1,0,0,0,0
1381,Tobias Kempe,Darmstadt 98,15.0,20,13,9,8,3,8,24,33.3,16,16,4,12,9,29,12,0
1382,Milos Kerkez,Bournemouth,21.9,47,26,31,13,3,30,42,71.4,12,31,11,20,20,67,60,2
1383,Kaine Kesler-Hayden,Aston Villa,0.1,0,0,0,0,0,0,0,0.0,0,0,0,0,0,0,0,0
1384,Reda Khadra,Reims,15.2,16,10,5,4,7,8,20,40.0,12,8,2,6,3,19,13,0
1385,Wahbi Khazri,Montpellier,12.6,24,17,8,12,4,14,35,40.0,21,10,0,10,3,27,7,0
1386,Rani Khedira,Union Berlin,14.9,35,22,15,19,1,17,26,65.4,9,12,5,7,22,57,38,0
1387,Abdukodir Khusanov,Lens,9.0,21,12,13,8,0,9,17,52.9,8,13,8,5,13,34,32,2
1388,Kike,Alavés,15.8,8,4,2,3,3,4,9,44.4,5,16,5,11,1,9,12,0
1389,Luca Kilian,Köln,7.1,16,9,15,1,0,9,14,64.3,5,12,5,7,7,23,28,0
1390,Max Kilman,Wolves,38.0,47,21,40,6,1,24,32,75.0,8,64,37,27,39,86,182,4
1391,Joshua Kimmich,Bayern Munich,24.2,45,33,25,15,5,26,39,66.7,13,32,4,28,14,59,28,1
1392,Jakub Kiwior,Arsenal,10.5,20,12,11,8,1,14,19,73.7,5,11,3,8,8,28,28,1
1393,Simon Kjaer,Milan,13.0,24,15,11,11,2,14,22,63.6,8,22,16,6,14,38,46,2
1394,Davy Klaassen,Inter,2.3,4,2,0,4,0,1,3,33.3,2,5,1,4,3,7,4,0
1395,Christoph Klarer,Darmstadt 98,26.2,37,22,30,4,3,24,36,66.7,12,31,20,11,21,58,94,1
1396,Tim Kleindienst,Heidenheim,31.9,21,12,6,11,4,7,25,28.0,18,32,8,24,12,33,58,0
1397,Lukas Klostermann,RB Leipzig,16.0,15,10,7,7,1,4,13,30.8,9,25,12,13,13,28,64,1
1398,Justin Kluivert,Bournemouth,21.3,28,14,5,12,11,8,30,26.7,22,16,1,15,8,36,11,0
1399,Ansgar Knauff,Eint Frankfurt,23.4,43,26,17,16,10,17,31,54.8,14,40,3,37,20,63,15,0
1400,Robin Knoche,Union Berlin,21.3,34,22,27,7,0,19,30,63.3,11,27,19,8,13,47,73,0
1401,Gregor Kobel,Dortmund,26.3,0,0,0,0,0,0,1,0.0,1,0,0,0,0,0,11,0
1402,Robin Koch,Eint Frankfurt,30.4,38,23,26,12,0,17,27,63.0,10,33,24,9,32,70,136,2
1404,Philipp Kohn,Monaco,22.0,1,1,1,0,0,1,1,100.0,0,0,0,0,1,2,5,3
1405,Dominik Kohr,Mainz 05,24.3,65,42,36,25,4,36,57,63.2,21,27,6,21,43,108,58,0
1406,Koke,Atlético Madrid,27.7,66,44,27,32,7,36,79,45.6,43,37,12,25,16,82,34,1
1407,Sead Kolasinac,Atalanta,24.2,44,32,23,19,2,30,49,61.2,19,22,9,13,21,65,47,0
1408,Luca Koleosho,Burnley,10.8,7,4,2,5,0,2,10,20.0,8,13,0,13,2,9,0,0
1409,Randal Kolo Muani,Paris S-G,14.1,10,8,5,3,2,5,13,38.5,8,5,0,5,4,14,10,0
1410,Randal Kolo Muani,Eint Frankfurt,1.7,0,0,0,0,0,0,0,0.0,0,0,0,0,0,0,1,0
1411,Mert Komur,Augsburg,1.3,3,3,3,0,0,3,5,60.0,2,0,0,0,0,3,1,0
1412,Cheick Konate,Clermont Foot,11.9,26,15,17,9,0,20,36,55.6,16,16,2,14,13,39,21,0
1413,Ibrahima Konate,Liverpool,17.5,36,22,22,13,1,18,24,75.0,6,18,12,6,20,56,51,1
1414,Geoffrey Kondogbia,Marseille,16.3,48,31,18,25,5,13,32,40.6,19,21,4,17,30,78,25,0
1415,Abdoul Kone,Reims,2.1,7,7,5,2,0,4,11,36.4,7,2,0,2,2,9,9,0
1416,Amadou Kone,Reims,5.3,13,8,11,2,0,6,10,60.0,4,8,3,5,10,23,10,0
1417,Ibrahima Kone,Almería,3.1,1,0,1,0,0,1,1,100.0,0,1,0,1,0,1,4,0
1418,Ibrahima Kone,Lorient,0.4,0,0,0,0,0,0,1,0.0,1,0,0,0,0,0,0,0
1419,Manu Kone,Gladbach,17.3,45,26,20,20,5,17,25,68.0,8,22,1,21,15,60,16,1
1420,Ezri Konsa,Aston Villa,34.1,54,32,28,23,3,23,27,85.2,4,36,20,16,28,82,73,3
1421,Teun Koopmeiners,Atalanta,29.2,39,24,12,22,5,17,50,34.0,33,33,3,30,10,49,35,0
1422,Odilon Kossonou,Leverkusen,20.1,30,20,11,12,7,15,26,57.7,11,27,3,24,27,57,43,1
1423,Filip Kostic,Juventus,20.2,37,23,20,13,4,17,33,51.5,16,29,8,21,9,46,43,0
1424,Christian Kouame,Fiorentina,12.1,13,4,7,6,0,6,10,60.0,4,16,0,16,2,15,10,0
1425,Rominigue Kouame,Cádiz,9.1,14,9,6,7,1,7,15,46.7,8,10,2,8,13,27,10,1
1426,Koffi Kouao,Metz,9.6,20,13,12,7,1,11,17,64.7,6,9,6,3,13,33,38,1
1427,Tomas Koubek,Augsburg,3.0,0,0,0,0,0,0,0,0.0,0,0,0,0,0,0,1,1
1428,Therence Koudou,Reims,3.5,2,2,1,1,0,0,2,0.0,2,4,3,1,4,6,9,0
1430,Jules Kounde,Barcelona,32.2,37,23,22,10,5,28,51,54.9,23,32,12,20,25,62,83,5
1431,Boubakar Kouyate,Montpellier,21.4,49,30,39,8,2,28,51,54.9,23,31,20,11,29,78,123,1
1432,Cheikhou Kouyate,Nott'ham Forest,2.4,8,5,3,3,2,1,4,25.0,3,4,1,3,2,10,10,0
1433,Mateo Kovacic,Manchester City,17.2,36,25,16,15,5,18,28,64.3,10,23,1,22,10,46,10,0
1434,Viktor Kovalenko,Empoli,6.8,5,2,2,2,1,2,8,25.0,6,12,2,10,1,6,7,0
1435,Matej Kovar,Leverkusen,1.0,0,0,0,0,0,0,0,0.0,0,0,0,0,0,0,0,0
1436,Dawid Kownacki,Werder Bremen,4.2,1,1,1,0,0,1,4,25.0,3,3,1,2,0,1,1,0
1437,Emil Krafth,Newcastle Utd,10.1,21,14,10,7,4,12,25,48.0,13,8,3,5,9,30,21,0
1438,Alex Kral,Union Berlin,15.2,19,14,7,10,2,8,20,40.0,12,15,4,11,11,30,30,0
1439,Andrej Kramaric,Hoffenheim,24.4,11,2,5,4,2,6,13,46.2,7,14,2,12,10,21,12,2
1440,Christoph Kramer,Gladbach,2.8,10,5,5,5,0,2,14,14.3,12,7,1,6,4,14,6,0
1441,Frans Kratzig,Bayern Munich,0.6,2,0,2,0,0,1,2,50.0,1,0,0,0,0,2,0,0
1442,Tom Krauss,Mainz 05,15.0,57,33,22,31,4,21,58,36.2,37,33,4,29,17,74,28,0
1443,Rasmus Kristensen,Roma,19.4,36,19,25,8,3,28,50,56.0,22,27,7,20,8,44,50,0
1444,Thomas Kristensen,Udinese,23.3,35,24,25,10,0,21,33,63.6,12,29,20,9,29,64,118,0
1445,Toni Kroos,Real Madrid,23.6,53,34,19,25,9,24,59,40.7,35,22,4,18,17,70,11,1
1446,Nikola Krstovic,Lecce,26.4,17,6,3,9,5,6,10,60.0,4,12,4,8,4,21,22,0
1447,Rade Krunic,Milan,7.6,10,8,3,6,1,4,9,44.4,5,7,3,4,11,21,14,0
1448,Lukas Kubler,Freiburg,20.5,50,24,35,13,2,26,42,61.9,16,36,14,22,37,87,57,1
1449,Takefusa Kubo,Real Sociedad,23.9,26,17,15,6,5,9,23,39.1,14,21,2,19,11,37,8,1
1450,Mahmut Kucuksahin,Augsburg,0.0,0,0,0,0,0,0,0,0.0,0,0,0,0,0,0,0,0
1451,Mohammed Kudus,West Ham,27.6,65,47,27,27,11,20,40,50.0,20,25,0,25,11,76,9,1
1452,Christian Kuhlwetter,Heidenheim,0.1,0,0,0,0,0,0,0,0.0,0,0,0,0,0,0,0,0
1453,Dejan Kulusevski,Tottenham,30.7,62,33,19,20,23,25,67,37.3,42,24,1,23,18,80,2,1
1454,Sael Kumbedi,Lyon,10.3,30,20,14,12,4,9,22,40.9,13,12,3,9,14,44,18,2
1456,Marash Kumbulla,Sassuolo,4.0,3,2,2,1,0,1,2,50.0,1,8,6,2,0,3,22,0
1457,Justin Kumi,Sassuolo,0.0,0,0,0,0,0,0,0,0.0,0,0,0,0,0,0,0,0
1458,Layvin Kurzawa,Paris S-G,0.1,0,0,0,0,0,0,0,0.0,0,0,0,0,0,0,0,0
1459,Berkan Kutlu,Genoa,2.2,6,4,5,1,0,3,6,50.0,3,3,0,3,4,10,5,0
1460,Daler Kuzyaev,Le Havre,23.2,34,19,11,13,10,15,43,34.9,28,18,5,13,22,56,18,1
1461,Khvicha Kvaratskhelia,Napoli,30.4,42,21,11,19,12,15,49,30.6,34,15,1,14,13,55,9,0
1462,Giorgi Kvernadze,Frosinone,0.7,3,0,2,0,1,2,2,100.0,0,1,0,1,1,4,0,0
1463,Moritz-Broni Kwarteng,Bochum,3.1,3,0,0,3,0,1,7,14.3,6,4,0,4,2,5,0,0
1464,Grejohn Kyei,Clermont Foot,11.4,6,4,2,2,2,2,3,66.7,1,5,1,4,1,7,10,0
1465,Giorgos Kyriakopoulos,Monza,19.0,19,10,16,3,0,11,24,45.8,13,18,1,17,13,32,28,0
1466,Luca de la Torre,Celta Vigo,21.7,39,21,12,22,5,22,43,51.2,21,23,4,19,12,51,17,0
1467,Gaetan Laborde,Nice,21.2,18,12,8,4,6,11,30,36.7,19,20,2,18,6,24,8,1
1468,Alexandre Lacazette,Lyon,25.5,19,12,8,9,2,5,17,29.4,12,22,3,19,8,27,9,0
1469,Maxence Lacroix,Wolfsburg,26.2,48,29,28,18,2,29,41,70.7,12,35,12,23,24,72,121,0
1470,Alban Lafont,Nantes,27.7,0,0,0,0,0,0,2,0.0,2,0,0,0,0,0,14,0
1471,Yoel Lago,Celta Vigo,1.0,2,0,2,0,0,0,0,0.0,0,1,0,1,0,2,2,0
1472,Aissa Laidouni,Union Berlin,11.9,21,12,4,12,5,4,12,33.3,8,26,2,24,12,33,14,2
1473,Konrad Laimer,Bayern Munich,19.7,56,36,25,20,11,22,52,42.3,30,42,6,36,18,74,13,2
1474,Stefan Lainer,Gladbach,8.3,23,16,15,8,0,14,24,58.3,10,13,6,7,5,28,28,0
1475,Kenny Lala,Brest,33.0,78,51,39,28,11,30,56,53.6,26,27,6,21,28,106,75,1
1476,Adam Lallana,Brighton,9.4,8,3,4,4,0,0,4,0.0,4,2,1,1,3,11,1,0
1477,Mathis Lambourde,Rennes,0.1,0,0,0,0,0,0,1,0.0,1,1,0,1,0,0,1,0
1478,Erik Lamela,Sevilla,5.1,21,14,4,10,7,10,15,66.7,5,12,0,12,1,22,5,0
1479,Mohamed Lamine Bayo,Le Havre,15.4,13,5,2,5,6,2,10,20.0,8,8,1,7,2,15,11,0
1480,Didier Lamkel Ze,Metz,6.1,7,2,2,4,1,2,5,40.0,3,4,0,4,0,7,11,0
1482,Tariq Lamptey,Brighton,10.2,21,14,14,5,2,13,22,59.1,9,7,3,4,6,27,6,0
1483,Bruno Langa,Almería,9.1,17,12,10,5,2,6,14,42.9,8,11,4,7,4,21,33,2
1484,Gianluca Lapadula,Cagliari,13.4,1,1,0,0,1,1,10,10.0,9,2,1,1,2,3,5,0
1485,Aymeric Laporte,Manchester City,0.1,0,0,0,0,0,0,0,0.0,0,1,1,0,0,0,1,0
1486,Julien Laporte,Lorient,20.2,23,14,15,7,1,16,36,44.4,20,36,26,10,11,34,116,1
1487,Cyle Larin,Mallorca,20.3,17,8,6,4,7,2,7,28.6,5,16,5,11,3,20,17,0
1488,Yasser Larouci,Sheffield Utd,5.9,17,9,10,5,2,10,14,71.4,4,6,1,5,7,24,20,1
1489,Hugo Larsson,Eint Frankfurt,21.0,32,18,18,10,4,15,28,53.6,13,34,7,27,29,61,30,1
1490,Jamaal Lascelles,Newcastle Utd,12.0,14,9,7,7,0,6,11,54.5,5,17,12,5,5,19,42,0
1491,Juanmi Latasa,Getafe,17.3,9,7,0,6,3,1,11,9.1,10,9,0,9,4,13,21,0
1492,Toni Lato,Mallorca,17.2,38,23,19,13,6,16,27,59.3,11,17,3,14,17,55,27,0
1493,Armand Lauriente,Sassuolo,32.3,31,20,8,14,9,13,44,29.5,31,29,4,25,15,46,11,0
1494,Romeo Lavia,Chelsea,0.4,1,0,0,1,0,0,0,0.0,0,0,0,0,0,1,1,0
1495,Lazaro,Almería,3.2,4,1,2,0,2,2,8,25.0,6,4,0,4,1,5,1,0
1496,Valentino Lazaro,Torino,22.2,18,11,7,9,2,13,19,68.4,6,14,1,13,8,26,29,0
1497,Darko Lazovic,Hellas Verona,21.4,26,16,11,6,9,16,31,51.6,15,10,1,9,6,32,14,0
1498,Manuel Lazzari,Lazio,18.6,26,18,13,10,3,18,28,64.3,10,20,4,16,12,38,37,1
1499,Theo Le Bris,Lorient,16.8,35,22,25,7,3,19,40,47.5,21,24,3,21,12,47,42,0
1500,Julien Le Cardinal,Brest,5.3,19,11,11,7,1,8,12,66.7,4,6,3,3,13,32,26,0
1501,Julien Le Cardinal,Lens,0.6,6,2,4,2,0,4,9,44.4,5,2,1,1,0,6,0,0
1502,Jeremy Le Douaron,Brest,18.0,21,10,7,9,5,11,26,42.3,15,14,1,13,2,23,10,0
1503,Enzo Le Fee,Rennes,17.0,50,35,23,17,10,23,47,48.9,24,17,3,14,19,69,20,0
1504,Vincent Le Goff,Lorient,6.0,5,0,4,0,1,4,8,50.0,4,11,3,8,3,8,10,0
1505,Robin Le Normand,Real Sociedad,27.4,31,22,16,15,0,17,30,56.7,13,26,15,11,28,59,96,1
1506,Nicola Leali,Genoa,2.0,0,0,0,0,0,0,0,0.0,0,0,0,0,0,0,0,0
1508,Rafael Leao,Milan,27.9,16,10,3,8,5,8,13,61.5,5,15,1,14,9,25,19,0
1509,Adrien Lebeau,Brest,0.6,0,0,0,0,0,0,3,0.0,3,2,1,1,0,0,1,0
1510,Jean-Louis Leca,Lens,1.0,0,0,0,0,0,0,0,0.0,0,0,0,0,0,0,1,0
1511,Benjamin Lecomte,Montpellier,30.0,0,0,0,0,0,0,1,0.0,1,0,0,0,0,0,16,1
1512,Jeremias Ledesma,Cádiz,33.9,1,1,1,0,0,1,4,25.0,3,0,0,0,0,1,15,3
1513,Pierre Lees-Melou,Brest,28.0,96,67,51,41,4,49,129,38.0,80,61,11,50,43,139,64,3
1514,Diogo Leite,Union Berlin,30.0,52,36,31,15,6,25,51,49.0,26,48,22,26,47,99,155,1
1515,Maxim Leitsch,Mainz 05,4.2,6,3,5,1,0,3,6,50.0,3,2,0,2,4,10,13,0
1516,Florian Lejeune,Rayo Vallecano,37.0,39,25,26,11,2,19,30,63.3,11,33,18,15,23,62,155,1
1517,Stefan Lekovic,Villarreal,0.3,0,0,0,0,0,0,0,0.0,0,1,1,0,0,0,1,0
1518,Inigo Lekue,Athletic Club,22.2,40,22,25,10,5,27,53,50.9,26,24,6,18,15,55,50,0
1519,Thomas Lemar,Atlético Madrid,1.8,3,1,2,1,0,1,2,50.0,1,0,0,0,0,3,0,0
1520,Mario Lemina,Wolves,33.0,90,58,46,33,11,25,47,53.2,22,36,9,27,41,131,64,0
1521,Alvaro Lemos,Las Palmas,2.8,4,1,1,3,0,0,2,0.0,2,3,1,2,2,6,4,0
1522,Ruben Lendinez,Valencia,0.1,2,2,0,2,0,1,1,100.0,0,0,0,0,0,2,1,0
1523,Clement Lenglet,Aston Villa,12.8,13,9,7,5,1,7,13,53.8,6,19,11,8,7,20,47,1
1524,Bernd Leno,Fulham,38.0,0,0,0,0,0,0,0,0.0,0,0,0,0,0,0,14,1
1525,Christopher Lenz,RB Leipzig,0.5,2,1,2,0,0,1,1,100.0,0,0,0,0,2,4,2,0
1526,Christopher Lenz,Eint Frankfurt,0.1,1,1,0,1,0,1,1,100.0,0,0,0,0,0,1,1,0
1527,Johann Lepenant,Lyon,2.8,4,3,2,2,0,1,8,12.5,7,5,0,5,4,8,0,0
1528,Jefferson Lerma,Crystal Palace,26.7,42,25,15,23,4,19,40,47.5,21,31,12,19,36,78,72,0
1529,Leo Leroy,Montpellier,5.5,19,10,8,8,3,6,21,28.6,15,12,3,9,7,26,8,0
1530,Robert Lewandowski,Barcelona,30.6,8,5,0,6,2,4,12,33.3,8,13,4,9,9,17,18,0
1531,Jamie Leweling,Stuttgart,16.9,18,10,4,6,8,5,17,29.4,12,21,1,20,5,23,13,0
1532,Rico Lewis,Manchester City,9.0,10,7,4,4,2,3,7,42.9,4,7,1,6,4,14,6,0
1534,Keane Lewis-Potter,Brentford,16.0,17,7,5,11,1,7,15,46.7,8,10,2,8,7,24,23,0
1535,Philipp Lienhart,Freiburg,14.1,20,13,14,5,1,13,23,56.5,10,18,11,7,14,34,51,0
1536,Matthijs de Ligt,Bayern Munich,15.4,15,12,4,8,3,6,11,54.5,5,14,10,4,19,34,52,0
1537,Victor Lindelof,Manchester Utd,14.8,15,10,8,7,0,5,13,38.5,8,18,9,9,12,27,40,1
1538,Jesper Lindstrom,Napoli,4.8,8,3,2,3,3,4,8,50.0,4,3,0,3,2,10,6,0
1539,Jesper Lindstrom,Eint Frankfurt,0.9,1,1,1,0,0,0,0,0.0,0,0,0,0,0,1,0,0
1540,Karol Linetty,Torino,20.6,30,21,9,20,1,9,29,31.0,20,24,8,16,23,53,27,1
1541,Samuel Lino,Atlético Madrid,23.1,61,34,32,17,12,35,70,50.0,35,37,1,36,14,75,27,0
1542,Luca Lipani,Sassuolo,4.3,9,7,4,3,2,3,11,27.3,8,9,2,7,6,15,7,0
1543,Pol Lirola,Frosinone,17.1,30,18,14,15,1,17,35,48.6,18,12,1,11,19,49,41,1
1544,Marcin Listkowski,Lecce,0.1,0,0,0,0,0,0,0,0.0,0,0,0,0,0,0,0,0
1545,Valentino Livramento,Newcastle Utd,14.6,23,13,15,6,2,10,21,47.6,11,16,7,9,25,48,41,1
1546,Dejan Ljubicic,Köln,22.8,43,27,20,18,5,20,43,46.5,23,22,2,20,18,61,11,0
1547,Javier Llabres,Mallorca,2.7,3,1,1,1,1,1,2,50.0,1,1,0,1,3,6,4,0
1548,Diego Llorente,Roma,24.1,31,19,20,10,1,11,24,45.8,13,40,27,13,22,53,79,0
1549,Marcos Llorente,Atlético Madrid,28.5,40,23,18,17,5,16,44,36.4,28,36,11,25,14,54,35,0
1550,Gautier Lloris,Le Havre,30.9,50,28,40,9,1,28,42,66.7,14,50,30,20,32,82,142,1
1551,Abou Lo,Metz,2.2,3,1,2,1,0,1,4,25.0,3,5,2,3,4,7,8,0
1552,Giovani Lo Celso,Tottenham,5.6,22,13,10,8,4,9,14,64.3,5,4,1,3,5,27,2,0
1553,Stanislav Lobotka,Napoli,36.5,61,39,18,30,13,24,60,40.0,36,30,8,22,30,91,29,0
1554,Manuel Locatelli,Juventus,33.4,69,43,24,35,10,31,58,53.4,27,43,17,26,25,94,65,0
1555,Bradley Locko,Brest,32.9,97,55,57,34,6,47,80,58.8,33,28,1,27,40,137,69,0
1556,Tom Lockyer,Luton Town,13.0,25,16,17,6,2,15,22,68.2,7,23,13,10,23,48,68,0
1557,Renan Lodi,Marseille,13.7,24,16,8,13,3,13,21,61.9,8,7,2,5,16,40,35,0
1558,Ruben Loftus-Cheek,Milan,23.0,28,18,7,14,7,15,27,55.6,12,24,12,12,9,37,10,1
1560,Andy Logbo,Le Havre,2.8,0,0,0,0,0,0,3,0.0,3,7,3,4,0,0,2,0
1561,Enzo Loiodice,Las Palmas,19.9,62,35,15,34,13,20,42,47.6,22,20,2,18,12,74,16,1
1562,Sean Longstaff,Newcastle Utd,30.5,54,30,17,29,8,24,63,38.1,39,43,7,36,17,71,23,0
1563,Ademola Lookman,Atalanta,21.0,20,15,2,11,7,8,22,36.4,14,19,0,19,9,29,0,1
1564,Noah Loosli,Bochum,3.8,10,7,6,4,0,7,14,50.0,7,7,1,6,7,17,18,0
1565,Anthony Lopes,Lyon,31.0,0,0,0,0,0,0,0,0.0,0,0,0,0,0,0,16,0
1566,David Lopez,Girona,21.8,33,20,21,12,0,17,22,77.3,5,28,19,9,20,53,63,4
1567,Diego Lopez,Valencia,29.5,37,25,14,16,7,13,56,23.2,43,23,1,22,20,57,12,0
1568,Fermin Lopez,Barcelona,16.1,41,21,15,18,8,14,40,35.0,26,14,1,13,4,45,9,0
1569,Javi Lopez,Alavés,26.5,23,12,11,9,3,15,26,57.7,11,25,9,16,10,33,77,1
1570,Maxime Lopez,Fiorentina,8.9,18,9,5,10,3,6,12,50.0,6,3,1,2,7,25,6,0
1571,Maxime Lopez,Sassuolo,1.6,2,1,1,1,0,1,2,50.0,1,1,1,0,2,4,0,0
1572,Pau Lopez,Marseille,32.7,0,0,0,0,0,0,2,0.0,2,0,0,0,0,0,10,1
1573,Unai Lopez,Rayo Vallecano,23.4,48,24,18,23,7,21,53,39.6,32,24,3,21,16,64,15,2
1574,Dion Lopy,Almería,21.3,62,37,36,20,6,17,44,38.6,27,23,5,18,15,77,22,2
1575,Anthony Losilla,Bochum,28.6,63,37,15,40,8,23,51,45.1,28,37,8,29,25,88,51,0
1576,Jordan Lotomba,Nice,20.0,36,28,18,9,9,25,35,71.4,10,30,9,21,16,52,26,1
1577,Tom Louchet,Nice,4.5,14,5,6,6,2,7,11,63.6,4,7,3,4,3,17,9,0
1578,Imran Louza,Lorient,9.6,13,7,2,8,3,2,8,25.0,6,8,1,7,9,22,4,0
1579,Matteo Lovato,Torino,6.0,10,7,5,5,0,4,5,80.0,1,9,5,4,13,23,10,0
1580,Matteo Lovato,Salernitana,10.5,27,14,17,8,2,16,24,66.7,8,14,7,7,18,45,41,1
1581,Dejan Lovren,Lyon,8.0,9,7,6,3,0,3,7,42.9,4,6,5,1,12,21,37,0
1582,Sandi Lovric,Udinese,22.1,25,12,9,11,5,9,23,39.1,14,21,2,19,21,46,24,0
1583,Max Lowe,Sheffield Utd,5.6,21,10,13,5,3,8,15,53.3,7,10,4,6,5,26,15,0
1584,Anthony Lozano,Getafe,1.0,0,0,0,0,0,0,1,0.0,1,0,0,0,0,0,1,0
1586,Anthony Lozano,Almería,8.6,7,5,2,5,0,4,7,57.1,3,6,1,5,2,9,12,0
1587,Lucas,Cádiz,17.1,47,27,32,11,4,32,55,58.2,23,27,4,23,17,64,45,0
1588,Lorenzo Lucca,Udinese,28.8,19,11,4,11,4,5,20,25.0,15,18,3,15,3,22,36,1
1589,Jhon Lucumi,Bologna,24.6,48,29,31,17,0,27,36,75.0,9,32,17,15,16,64,68,2
1590,Jose Luis Gaya,Valencia,19.9,71,36,44,23,4,43,67,64.2,24,18,3,15,11,82,42,0
1591,Jose Luis Morales,Villarreal,11.6,5,3,1,4,0,3,13,23.1,10,9,1,8,7,12,4,0
1592,Jose Luis Palomino,Atalanta,0.3,2,1,1,1,0,1,1,100.0,0,2,1,1,1,3,6,0
1593,Douglas Luiz,Aston Villa,33.3,58,38,21,27,10,25,53,47.2,28,32,8,24,23,81,18,2
1594,Romelu Lukaku,Roma,29.3,6,5,1,2,3,2,4,50.0,2,7,1,6,0,6,19,1
1595,Castello Lukeba,RB Leipzig,24.3,19,12,10,9,0,10,12,83.3,2,35,13,22,12,31,94,2
1596,Dodi Lukebakio,Sevilla,12.5,5,2,2,2,1,1,6,16.7,5,9,2,7,2,7,5,0
1597,Sasa Lukic,Fulham,12.5,33,19,9,17,7,18,39,46.2,21,18,5,13,16,49,19,1
1598,Karlo Lulic,Frosinone,0.2,0,0,0,0,0,0,0,0.0,0,1,0,1,1,1,0,0
1599,Andriy Lunin,Real Madrid,21.0,0,0,0,0,0,0,1,0.0,1,0,0,0,0,0,15,1
1600,Sebastiano Luperto,Empoli,37.8,37,26,25,10,2,15,24,62.5,9,46,35,11,32,69,157,1
1601,Mateus Lusuardi,Frosinone,2.4,2,1,1,1,0,1,3,33.3,2,4,2,2,4,6,8,0
1602,Andreas Luthe,Bochum,1.0,0,0,0,0,0,0,0,0.0,0,0,0,0,0,0,1,0
1603,Zito Luvumbo,Cagliari,21.6,9,6,5,2,2,4,15,26.7,11,19,0,19,1,10,2,0
1604,Charalambos Lykogiannis,Bologna,10.0,10,6,5,4,1,5,10,50.0,5,15,5,10,5,15,30,0
1605,Senne Lynen,Werder Bremen,20.0,64,38,33,27,4,30,70,42.9,40,41,8,33,41,105,56,0
1606,Joshua M'Bahia,Clermont Foot,0.2,0,0,0,0,0,0,0,0.0,0,0,0,0,0,0,0,0
1607,Othmane Maamma,Montpellier,1.0,3,3,2,0,1,1,1,100.0,0,3,0,3,0,3,0,0
1608,Ian Maatsen,Chelsea,2.3,3,2,1,1,1,0,4,0.0,4,4,0,4,3,6,10,0
1609,Ian Maatsen,Dortmund,14.0,30,22,15,9,6,16,30,53.3,14,22,4,18,13,43,26,0
1610,Alexis Mac Allister,Liverpool,28.9,99,55,35,50,14,59,125,47.2,66,65,8,57,35,134,25,1
1612,Deiver Machado,Lens,12.5,24,18,10,10,4,15,20,75.0,5,13,2,11,7,31,8,0
1613,Darwin Machis,Cádiz,8.7,23,14,7,9,7,13,24,54.2,11,8,1,7,4,27,2,0
1614,James Maddison,Tottenham,23.7,33,19,5,18,10,15,29,51.7,14,15,3,12,13,46,10,1
1615,Noni Madueke,Chelsea,11.7,16,10,8,4,4,11,34,32.4,23,11,0,11,4,20,14,0
1616,Pablo Maffeo,Mallorca,16.2,35,22,18,13,4,23,40,57.5,17,12,2,10,10,45,23,0
1617,Gabriel Magalhaes,Arsenal,33.8,48,28,24,22,2,17,22,77.3,5,44,33,11,31,79,100,1
1618,Soungoutou Magassa,Monaco,15.0,56,26,22,32,2,26,48,54.2,22,21,4,17,21,77,36,2
1619,Giulio Maggiore,Salernitana,20.0,49,29,26,22,1,20,42,47.6,22,27,5,22,24,73,38,0
1620,Matej Maglica,Darmstadt 98,18.9,35,21,25,10,0,22,36,61.1,14,29,11,18,22,57,92,5
1621,Giangiacomo Magnani,Hellas Verona,27.2,33,18,23,10,0,15,25,60.0,10,50,28,22,45,78,118,0
1622,Hugo Magnetti,Brest,26.0,49,27,18,26,5,24,58,41.4,34,19,1,18,18,67,18,0
1623,Yohann Magnin,Clermont Foot,18.7,49,31,12,32,5,22,47,46.8,25,38,13,25,19,68,26,1
1624,Frank Magri,Toulouse,16.0,22,14,5,12,5,15,21,71.4,6,16,4,12,4,26,17,0
1625,Harry Maguire,Manchester Utd,18.4,24,17,14,10,0,12,22,54.5,10,33,24,9,25,49,83,1
1626,Jon Magunacelaya,Real Sociedad,1.3,5,3,2,3,0,4,8,50.0,4,3,0,3,0,5,2,0
1627,Adel Mahamoud,Nantes,0.1,0,0,0,0,0,0,1,0.0,1,0,0,0,0,0,0,0
1628,Arne Maier,Augsburg,11.1,14,9,5,8,1,5,14,35.7,9,19,2,17,6,20,11,0
1629,Habib Maiga,Metz,1.6,2,2,1,0,1,1,3,33.3,2,2,0,2,4,6,2,0
1630,Mike Maignan,Milan,29.0,1,0,1,0,0,1,1,100.0,0,1,0,1,1,2,4,3
1631,Linton Maina,Köln,21.1,18,15,11,5,2,9,28,32.1,19,12,1,11,6,24,12,0
1632,Patrick Mainka,Heidenheim,34.0,85,49,58,24,3,38,74,51.4,36,66,32,34,49,134,158,1
1633,Kobbie Mainoo,Manchester Utd,21.4,47,27,20,16,11,21,45,46.7,24,20,12,8,22,69,30,1
1634,Ainsley Maitland-Niles,Lyon,15.9,34,18,12,14,8,19,37,51.4,18,16,6,10,17,51,29,1
1635,Radoslaw Majecki,Monaco,12.0,0,0,0,0,0,0,0,0.0,0,1,0,1,0,0,5,1
1636,Lovro Majer,Rennes,0.2,0,0,0,0,0,0,0,0.0,0,0,0,0,0,0,1,0
1638,Lovro Majer,Wolfsburg,23.4,39,18,17,22,0,12,31,38.7,19,20,1,19,12,51,13,0
1639,Jean-Victor Makengo,Lorient,5.3,5,4,3,2,0,2,6,33.3,4,12,1,11,8,13,5,0
1640,Jordy Makengo,Freiburg,11.4,17,11,11,5,1,6,10,60.0,4,16,4,12,11,28,37,0
1641,Antoine Makoumbou,Cagliari,30.0,41,24,21,15,5,15,30,50.0,15,23,4,19,16,57,27,2
1642,Nemanja Maksimovic,Getafe,36.3,65,43,26,31,8,23,41,56.1,18,56,23,33,46,111,61,0
1643,Julian Malatini,Werder Bremen,6.7,18,13,12,3,3,16,24,66.7,8,8,1,7,13,31,26,0
1644,Daniel Maldini,Monza,3.7,3,2,0,2,1,3,6,50.0,3,2,0,2,2,5,1,0
1645,Daniel Maldini,Empoli,2.9,4,2,0,2,2,2,2,100.0,0,5,0,5,2,6,2,0
1646,Youssef Maleh,Empoli,28.9,74,48,30,36,8,23,52,44.2,29,62,7,55,25,99,29,0
1647,Donyell Malen,Dortmund,19.8,11,7,5,3,3,2,6,33.3,4,11,4,7,2,13,8,0
1648,Ruslan Malinovskyi,Genoa,17.2,35,20,18,11,6,17,41,41.5,24,22,8,14,5,40,16,0
1649,Lennard Maloney,Heidenheim,25.4,43,26,14,24,5,25,59,42.4,34,33,9,24,25,68,88,0
1650,Aaron Malouda,Lille,0.0,0,0,0,0,0,0,0,0.0,0,0,0,0,0,0,0,0
1651,Giorgi Mamardashvili,Valencia,36.5,4,3,4,0,0,4,4,100.0,0,1,0,1,2,6,22,2
1652,David Mamutovic,Mainz 05,0.1,1,1,0,1,0,1,1,100.0,0,0,0,0,0,1,0,0
1653,Wilson Manafa,Granada,2.7,6,4,3,2,1,4,7,57.1,3,1,0,1,1,7,4,1
1654,Hianga Mananga Mbock,Brest,0.1,1,0,0,0,1,1,2,50.0,1,0,0,0,1,2,0,0
1655,Gianluca Mancini,Roma,31.9,34,20,21,11,2,11,27,40.7,16,38,26,12,36,70,77,1
1656,Marco Mancosu,Cagliari,1.7,3,0,0,2,1,1,2,50.0,1,0,0,0,0,3,0,0
1657,Steve Mandanda,Rennes,34.0,2,0,2,0,0,2,4,50.0,2,0,0,0,0,2,6,1
1658,Christos Mandas,Lazio,8.0,0,0,0,0,0,0,1,0.0,1,0,0,0,1,1,3,1
1659,Reinildo Mandava,Atlético Madrid,8.1,30,22,16,11,3,19,22,86.4,3,10,2,8,15,45,21,0
1660,Aissa Mandi,Villarreal,12.4,13,8,8,5,0,7,14,50.0,7,10,7,3,8,21,41,0
1661,Rolando Mandragora,Fiorentina,17.6,26,11,8,13,5,10,22,45.5,12,14,3,11,9,35,18,1
1662,Orel Mangala,Nott'ham Forest,17.4,27,13,16,10,1,14,29,48.3,15,12,6,6,26,53,32,0
1664,Orel Mangala,Lyon,4.4,5,3,0,2,3,1,3,33.3,2,3,2,1,5,10,6,0
1665,Vito Mannone,Lille,1.0,0,0,0,0,0,0,0,0.0,0,0,0,0,0,0,0,0
1666,Kostas Manolas,Salernitana,5.4,9,5,6,3,0,6,8,75.0,2,10,7,3,2,11,20,0
1667,Javier Manquillo,Celta Vigo,8.3,15,11,6,5,4,8,15,53.3,7,14,3,11,3,18,17,0
1668,Braydon Manu,Darmstadt 98,1.9,2,0,0,1,1,0,0,0.0,0,1,0,1,0,2,0,0
1669,Benson Manuel,Burnley,1.3,3,2,2,1,0,0,0,0.0,0,1,0,1,0,3,0,0
1670,Faitout Maouassa,Granada,2.5,8,5,6,1,1,4,5,80.0,1,6,0,6,1,9,3,0
1671,Faitout Maouassa,Lens,0.8,1,1,1,0,0,1,1,100.0,0,1,0,1,0,1,3,0
1672,Marcao,Sevilla,3.9,9,6,5,4,0,6,10,60.0,4,8,6,2,4,13,11,1
1673,Solly March,Brighton,6.2,19,14,9,7,3,8,14,57.1,6,5,0,5,11,30,8,0
1674,Riccardo Marchizza,Frosinone,12.8,7,6,4,3,0,3,13,23.1,10,10,2,8,7,14,33,0
1675,Gian Marco Ferrari,Sassuolo,25.2,22,10,11,11,0,12,18,66.7,6,28,17,11,25,47,76,0
1676,Oscar de Marcos,Athletic Club,25.1,56,39,26,24,6,42,71,59.2,29,28,6,22,15,71,44,0
1677,Alberto Mari,Valencia,3.1,4,2,0,1,3,1,1,100.0,0,3,0,3,0,4,5,0
1678,Jose Mari,Cádiz,0.2,2,1,0,2,0,1,2,50.0,1,0,0,0,0,2,0,0
1679,Pablo Mari,Monza,29.1,41,25,34,7,0,22,34,64.7,12,40,25,15,37,78,115,1
1680,Jose Maria Gimenez,Atlético Madrid,14.7,18,10,10,7,1,5,16,31.3,11,16,12,4,10,28,95,0
1681,Mariano,Sevilla,2.7,1,1,0,1,0,0,1,0.0,1,1,0,1,0,1,2,0
1682,Mirko Maric,Monza,3.2,4,0,2,1,1,0,2,0.0,2,4,0,4,2,6,3,0
1683,Rafa Marin,Alavés,27.1,32,20,23,9,0,14,27,51.9,13,34,21,13,33,65,129,2
1684,Razvan Marin,Empoli,20.2,40,22,13,23,4,19,29,65.5,10,16,4,12,6,46,30,2
1685,Diego Marino,Almería,1.0,0,0,0,0,0,0,0,0.0,0,0,0,0,0,0,1,0
1686,Guillermo Maripan,Monaco,19.6,22,8,15,6,1,10,27,37.0,17,26,13,13,30,52,106,4
1687,Mika Marmol,Las Palmas,35.3,70,42,44,24,2,35,53,66.0,18,39,19,20,44,114,147,2
1688,Omar Marmoush,Eint Frankfurt,25.6,21,11,7,8,6,6,16,37.5,10,13,0,13,11,32,7,0
1690,Marquinhos,Nantes,1.7,3,2,2,0,1,1,4,25.0,3,7,2,5,6,9,1,0
1691,Marquinhos,Paris S-G,17.1,19,11,10,7,2,11,17,64.7,6,29,19,10,17,36,58,1
1692,Unai Marrero,Real Sociedad,1.6,0,0,0,0,0,0,0,0.0,0,0,0,0,0,0,0,0
1693,Agustin Martegani,Salernitana,8.1,13,7,7,3,3,6,18,33.3,12,4,1,3,4,17,7,1
1694,Eric Martel,Köln,27.3,70,43,32,34,4,37,67,55.2,30,65,19,46,43,113,80,0
1695,Roger Marti,Cádiz,15.1,12,6,1,9,2,2,7,28.6,5,16,1,15,7,19,4,0
1696,Anthony Martial,Manchester Utd,5.0,4,1,1,1,2,1,1,100.0,0,4,0,4,0,4,3,0
1697,Aaron Martin,Genoa,15.3,21,10,7,10,4,9,22,40.9,13,12,4,8,9,30,15,0
1698,Ivan Martin,Girona,30.3,44,25,22,15,7,22,57,38.6,35,25,3,22,21,65,14,0
1699,Jon Martin,Real Sociedad,0.3,0,0,0,0,0,0,0,0.0,0,0,0,0,0,0,3,0
1700,Jonas Martin,Brest,13.4,43,27,17,24,2,21,36,58.3,15,16,2,14,9,52,28,2
1701,Mario Martin,Real Madrid,0.2,5,1,0,2,3,3,4,75.0,1,2,1,1,0,5,0,0
1702,Gabriel Martinelli,Arsenal,22.4,30,24,9,12,9,13,32,40.6,19,23,1,22,5,35,9,1
1703,Tommaso Martinelli,Fiorentina,1.0,0.0,0,0.0,0.0,0.0,0.0,0.0,0.0,0.0,0.0,0.0,0.0,0,0.0,0.0,0.0
1704,Arnau Martinez,Girona,13.8,25,16,17,6,2,15,32,46.9,17,15,5,10,10,35,41,3
1705,Emiliano Martinez,Aston Villa,33.5,0,0,0,0,0,0,0,0.0,0,0,0,0,0,0,12,3
1706,Inigo Martinez,Barcelona,14.4,10,7,9,1,0,6,8,75.0,2,13,10,3,11,21,50,0
1707,Josep Martinez,Genoa,36.0,0,0,0,0,0,0,0,0.0,0,0,0,0,1,1,21,3
1708,Lautaro Martinez,Inter,29.5,22,16,4,13,5,4,19,21.1,15,30,1,29,20,42,10,0
1709,Lisandro Martinez,Manchester Utd,7.2,12,8,8,4,0,5,12,41.7,7,10,8,2,5,17,26,0
1710,Marc Martinez,Granada,3.0,0,0,0,0,0,0,1,0.0,1,0,0,0,0,0,1,0
1711,Lucas Martinez Quarta,Fiorentina,25.5,75,47,43,28,4,36,54,66.7,18,38,14,24,30,105,69,4
1712,Adam Marusic,Lazio,34.4,45,31,24,19,2,27,49,55.1,22,27,7,20,29,74,63,2
1713,Marvin,Las Palmas,20.6,39,25,18,17,4,18,36,50.0,18,28,2,26,14,53,18,1
1714,Omar Mascarell,Mallorca,17.5,33,16,16,17,0,18,35,51.4,17,24,8,16,31,64,30,1
1716,Adam Masina,Udinese,0.7,4,0,2,2,0,2,4,50.0,2,2,1,1,2,6,5,0
1717,Adam Masina,Torino,11.4,17,12,8,8,1,5,20,25.0,15,12,6,6,11,28,30,0
1718,Erhan Masovic,Bochum,24.7,64,40,37,22,5,37,70,52.9,33,32,10,22,25,89,75,2
1719,Han-Noah Massengo,Burnley,0.2,1,1,1,0,0,0,0,0.0,0,1,0,1,0,1,0,0
1720,Roberto Massimo,Stuttgart,0.9,1,0,1,0,0,1,2,50.0,1,0,0,0,0,1,1,0
1721,Clinton Mata,Lyon,24.7,43,24,29,8,6,23,40,57.5,17,35,16,19,40,83,61,0
1722,Jaime Mata,Getafe,19.9,24,15,12,8,4,11,26,42.3,15,18,1,17,17,41,31,0
1723,Pape Matar Sarr,Tottenham,23.0,34,24,11,17,6,15,36,41.7,21,21,5,16,31,65,28,1
1724,Eliot Matazo,Monaco,1.1,3,1,0,3,0,2,4,50.0,2,1,1,0,3,6,0,0
1725,Jean-Philippe Mateta,Crystal Palace,25.4,22,15,4,11,7,6,10,60.0,4,13,4,9,4,26,14,0
1726,Nemanja Matic,Rennes,11.4,19,10,7,9,3,9,12,75.0,3,15,7,8,27,46,19,0
1727,Nemanja Matic,Lyon,13.9,17,11,8,7,2,9,19,47.4,10,17,6,11,16,33,17,1
1728,Joel Matip,Liverpool,8.7,12,6,7,4,1,8,12,66.7,4,16,12,4,9,21,43,0
1729,Alex Matos,Chelsea,0.0,0,0,0,0,0,0,0,0.0,0,0,0,0,0,0,0,0
1730,Chrislain Matsima,Clermont Foot,13.1,18,11,11,7,0,10,18,55.6,8,14,10,4,13,31,74,1
1731,Chrislain Matsima,Monaco,3.3,9,7,5,3,1,2,7,28.6,5,4,1,3,4,13,4,0
1732,Jean Matteo Bahoya,Eint Frankfurt,2.0,3,1,0,3,0,1,4,25.0,3,2,0,2,1,4,1,0
1733,Remi Matthews,Crystal Palace,0.0,0,0,0,0,0,0,0,0.0,0,0,0,0,0,0,1,0
1734,Alan Matturro,Genoa,1.2,1,1,1,0,0,1,1,100.0,0,6,3,3,2,3,4,0
1735,Azor Matusiwa,Reims,15.4,39,27,17,19,3,22,32,68.8,10,21,3,18,33,72,32,1
1736,Azor Matusiwa,Rennes,8.8,7,3,3,4,0,4,7,57.1,3,9,2,7,11,18,17,0
1737,Neal Maupay,Brentford,14.7,10,7,4,5,1,3,13,23.1,10,11,0,11,2,12,3,0
1738,Neal Maupay,Everton,1.2,0,0,0,0,0,0,1,0.0,1,2,0,2,0,0,1,0
1739,Aiman Maurer,Clermont Foot,0.6,1,1,1,0,0,1,3,33.3,2,0,0,0,0,1,0,0
1740,Konstantinos Mavropanos,West Ham,16.7,28,16,17,9,2,17,21,81.0,4,21,13,8,23,51,79,3
1742,Christian Mawissa,Toulouse,12.4,22,15,14,4,4,9,23,39.1,14,22,11,11,22,44,41,1
1743,Philipp Max,Eint Frankfurt,15.0,26,17,6,18,2,19,26,73.1,7,18,1,17,7,33,18,2
1744,Eric Maxim Choupo-Moting,Bayern Munich,8.0,17,12,8,5,4,6,14,42.9,8,5,0,5,7,24,7,0
1745,Luis Maximiano,Almería,33.0,0,0,0,0,0,0,1,0.0,1,0,0,0,0,0,19,2
1746,Noam Mayoka-Tika,Marseille,0.0,0,0,0,0,0,0,0,0.0,0,0,0,0,0,0,0,0
1747,Borja Mayoral,Getafe,23.9,9,5,2,2,5,5,22,22.7,17,7,0,7,4,13,16,0
1748,Senny Mayulu,Paris S-G,3.6,13,8,6,6,1,6,7,85.7,1,1,0,1,3,16,0,0
1749,Youssef Maziz,Metz,1.4,0,0,0,0,0,0,2,0.0,2,1,0,1,1,1,2,0
1750,Noussair Mazraoui,Bayern Munich,13.3,32,21,14,11,7,13,21,61.9,8,14,1,13,20,52,27,1
1751,Luca Mazzitelli,Frosinone,24.6,45,23,15,24,6,26,49,53.1,23,23,7,16,19,64,62,0
1752,Pasquale Mazzocchi,Salernitana,14.1,25,19,14,10,1,16,29,55.2,13,14,6,8,5,30,31,0
1753,Pasquale Mazzocchi,Napoli,4.8,5,2,1,2,2,2,3,66.7,1,5,1,4,1,6,13,0
1754,Kevin Mbabu,Augsburg,22.7,51,39,25,18,8,23,40,57.5,17,29,9,20,24,75,48,0
1755,Noah Mbamba,Leverkusen,0.2,0,0,0,0,0,0,0,0.0,0,0,0,0,1,1,0,0
1756,Ethan Mbappe,Paris S-G,0.5,0,0,0,0,0,0,2,0.0,2,1,0,1,0,0,0,0
1757,Kylian Mbappe,Paris S-G,24.0,4,1,1,1,2,4,9,44.4,5,4,0,4,2,6,2,0
1758,Malick Mbaye,Metz,1.7,5,1,0,1,4,1,2,50.0,1,1,0,1,1,6,2,0
1759,Mamadou Mbaye,Cádiz,3.2,6,3,3,3,0,2,5,40.0,3,10,7,3,5,11,26,0
1760,Chancel Mbemba,Marseille,24.5,33,21,25,7,1,17,30,56.7,13,21,13,8,13,46,95,1
1761,Nolan Mbemba,Le Havre,0.2,2,1,0,1,1,1,2,50.0,1,0,0,0,0,2,0,0
1762,Bryan Mbeumo,Brentford,21.8,15,10,6,6,3,5,19,26.3,14,26,2,24,7,22,13,0
1763,Christ Mbondi,Reims,0.0,1,1,1,0,0,1,1,100.0,0,0,0,0,0,1,0,0
1764,Jordi Mboula,Hellas Verona,3.4,4,4,1,2,1,4,7,57.1,3,4,1,3,1,5,0,0
1765,Nathanael Mbuku,Augsburg,0.1,0,0,0,0,0,0,0,0.0,0,1,0,1,0,0,0,0
1766,James Mcatee,Sheffield Utd,20.2,32,21,9,13,10,13,33,39.4,20,20,0,20,11,43,18,0
1768,James Mcatee,Manchester City,0.0,0,0,0,0,0,0,0,0.0,0,1,0,1,0,0,0,0
1769,Oliver McBurnie,Sheffield Utd,14.2,17,7,4,7,6,5,12,41.7,7,18,2,16,5,22,28,0
1770,James McConnell,Liverpool,0.0,0,0,0,0,0,0,0,0.0,0,1,0,1,1,1,0,0
1771,John McGinn,Aston Villa,33.3,59,35,18,34,7,32,77,41.6,45,33,4,29,21,80,21,0
1772,Scott McKenna,Nott'ham Forest,4.6,4,0,3,1,0,2,3,66.7,1,6,4,2,5,9,27,0
1773,Weston McKennie,Juventus,28.8,48,29,31,11,6,17,27,63.0,10,28,7,21,18,66,69,0
1774,Dwight McNeil,Everton,32.1,44,27,16,14,14,24,55,43.6,31,44,7,37,22,66,37,0
1775,Scott McTominay,Manchester Utd,21.1,49,25,23,24,2,22,33,66.7,11,34,12,22,14,63,54,0
1776,Facundo Medina,Lens,30.2,64,38,25,31,8,44,69,63.8,25,38,13,25,24,88,59,2
1777,Ben Mee,Brentford,14.1,26,15,12,12,2,17,22,77.3,5,21,13,8,13,39,63,1
1778,Marvin Mehlem,Darmstadt 98,16.5,28,21,10,14,4,11,27,40.7,16,21,2,19,33,61,15,0
1779,Bamo Meite,Marseille,7.1,16,10,13,3,0,8,12,66.7,4,11,5,6,11,27,35,0
1780,Bamo Meite,Lorient,1.6,2,1,2,0,0,0,1,0.0,1,3,2,1,3,5,9,0
1781,Hannibal Mejbri,Manchester Utd,1.5,3,3,1,2,0,1,3,33.3,2,1,1,0,0,3,0,0
1782,Hannibal Mejbri,Sevilla,1.2,3,3,1,2,0,0,1,0.0,1,1,0,1,0,3,0,0
1783,Oscar Melendo,Granada,12.5,14,6,4,10,0,4,12,33.3,8,13,0,13,5,19,4,1
1784,Gonzalo Melero,Almería,12.3,14,8,7,5,2,7,19,36.8,12,12,4,8,4,18,11,0
1785,Birger Meling,Rennes,0.2,1,1,1,0,0,1,1,100.0,0,1,0,1,0,1,0,0
1786,Arthur Melo,Fiorentina,22.1,45,30,17,24,4,26,42,61.9,16,27,3,24,18,63,8,0
1787,Memphis,Atlético Madrid,9.9,5,2,0,3,2,3,6,50.0,3,2,0,2,1,6,0,0
1788,Houboulang Mendes,Almería,4.4,16,13,11,5,0,8,16,50.0,8,4,2,2,1,17,17,1
1789,Nuno Mendes,Paris S-G,3.0,5,5,4,1,0,4,7,57.1,3,4,0,4,4,9,2,0
1790,Tomas Mendes,Alavés,0.1,0,0,0,0,0,0,0,0.0,0,0,0,0,0,0,0,0
1791,Brais Mendez,Real Sociedad,26.8,42,28,13,20,9,15,43,34.9,28,23,4,19,12,54,21,0
1792,Bruno Mendez,Granada,14.8,36,17,19,12,5,21,37,56.8,16,24,6,18,26,62,45,0
1794,Diego Mendez,Rayo Vallecano,0.1,1,1,1,0,0,1,1,100.0,0,0,0,0,1,2,0,0
1795,Leonardo Mendicino,Atalanta,0.0,0,0,0,0,0,0,0,0.0,0,0,0,0,0,0,0,0
1796,Antoine Mendy,Nice,4.6,7,5,4,3,0,3,7,42.9,4,4,1,3,8,15,16,0
1797,Benjamin Mendy,Lorient,7.9,3,1,2,1,0,1,5,20.0,4,8,2,6,7,10,20,0
1798,Ferland Mendy,Real Madrid,19.1,15,10,12,2,1,11,14,78.6,3,12,2,10,13,28,26,1
1799,Formose Mendy,Lorient,14.0,33,19,24,8,1,20,33,60.6,13,23,12,11,20,53,59,1
1800,Nampalys Mendy,Lens,11.7,29,18,10,13,6,16,20,80.0,4,11,4,7,14,43,14,1
1801,Teden Mengi,Luton Town,27.4,54,22,33,20,1,19,30,63.3,11,39,27,12,57,111,140,1
1802,Chris Mepham,Bournemouth,6.9,12,11,9,3,0,9,14,64.3,5,13,6,7,7,19,30,1
1803,Jorge Mere,Cádiz,7.5,8,7,6,2,0,4,7,57.1,3,5,3,2,8,16,33,0
1804,Alex Meret,Napoli,30.8,1,0,1,0,0,1,2,50.0,1,0,0,0,0,1,10,1
1805,Mikel Merino,Real Sociedad,27.6,77,43,25,34,18,22,48,45.8,26,36,11,25,16,93,55,3
1806,Quentin Merlin,Marseille,7.8,13,12,7,5,1,8,20,40.0,12,4,0,4,6,19,14,0
1807,Quentin Merlin,Nantes,14.3,29,20,15,12,2,16,25,64.0,9,22,1,21,18,47,22,0
1808,Junior Messias,Genoa,11.7,26,20,19,5,2,8,19,42.1,11,9,1,8,5,31,22,0
1809,Thomas Meunier,Dortmund,6.5,5,1,3,2,0,3,13,23.1,10,8,2,6,4,9,22,0
1810,Bastien Meupiyou,Nantes,0.1,0,0,0,0,0,0,0,0.0,0,0,0,0,0,0,1,0
1811,Alexander Meyer,Dortmund,7.7,1,1,1,0,0,1,1,100.0,0,0,0,0,0,1,2,1
1812,Omenuke Mfulu,Las Palmas,0.9,4,3,3,1,0,0,1,0.0,1,1,1,0,2,6,5,0
1813,Lucas Michal,Monaco,0.1,0,0,0,0,0,0,0,0.0,0,0,0,0,0,0,0,0
1814,Sven Michel,Augsburg,6.5,7,5,2,1,4,2,7,28.6,5,1,0,1,0,7,4,0
1815,Miguel,Alavés,0.7,0,0,0,0,0,0,0,0.0,0,2,0,2,0,0,0,0
1816,Georges Mikautadze,Metz,19.4,4,3,1,2,1,0,9,0.0,9,11,0,11,8,12,3,0
1817,Nikola Milenkovic,Fiorentina,27.9,41,21,24,14,3,22,36,61.1,14,22,14,8,27,68,95,1
1818,Lewis Miley,Newcastle Utd,13.4,33,21,6,20,7,15,32,46.9,17,20,3,17,8,41,18,2
1820,Arkadiusz Milik,Juventus,10.2,9,5,2,5,2,3,5,60.0,2,7,1,6,5,14,3,0
1821,Vanja Milinkovic-Savic,Torino,36.0,1,0,1,0,0,1,1,100.0,0,0,0,0,1,2,14,4
1822,Eder Militao,Real Madrid,5.5,7,3,4,3,0,6,9,66.7,3,4,3,1,4,11,19,1
1823,Luis Milla,Getafe,23.5,57,33,19,28,10,28,47,59.6,19,20,1,19,32,89,10,0
1824,Enzo Millot,Stuttgart,24.9,40,22,9,21,10,18,39,46.2,21,24,2,22,16,56,7,1
1825,James Milner,Brighton,8.6,20,14,9,10,1,9,14,64.3,5,9,0,9,8,28,16,0
1826,Jovan Milosevic,Stuttgart,0.3,0,0,0,0,0,0,0,0.0,0,0,0,0,0,0,0,0
1827,Marko Milovanovic,Almería,3.4,4,4,1,3,0,2,4,50.0,2,2,0,2,0,4,5,0
1828,Kim Min-jae,Bayern Munich,21.9,37,24,21,11,5,12,24,50.0,12,29,19,10,45,82,70,2
1829,Yerry Mina,Fiorentina,0.5,1,1,1,0,0,1,2,50.0,1,0,0,0,0,1,2,0
1830,Yerry Mina,Cagliari,13.5,20,13,14,6,0,13,19,68.4,6,23,14,9,4,24,77,0
1831,Takumi Minamino,Monaco,23.5,34,17,10,13,11,16,54,29.6,38,29,1,28,11,45,8,0
1832,Lucas Mincarelli,Montpellier,10.9,29,16,19,6,4,17,34,50.0,17,17,4,13,8,37,27,0
1833,Tyrone Mings,Aston Villa,0.3,0,0,0,0,0,0,0,0.0,0,0,0,0,1,1,1,0
1834,Oscar Mingueza,Celta Vigo,33.3,62,38,44,11,7,37,80,46.3,43,38,7,31,17,79,49,2
1835,Ignasi Miquel,Granada,33.2,47,30,39,6,2,23,40,57.5,17,32,16,16,45,92,132,4
1836,Rafa Mir,Sevilla,4.3,2,2,1,1,0,1,2,50.0,1,2,0,2,1,3,1,0
1837,Ignacio Miramon,Lille,0.4,1,0,0,1,0,0,1,0.0,1,1,0,1,0,1,0,0
1838,Aleksei Miranchuk,Atalanta,13.1,12,6,6,4,2,5,13,38.5,8,6,1,5,2,14,5,1
1839,Juan Miranda,Betis,20.6,38,24,21,13,4,17,31,54.8,14,31,6,25,19,57,62,0
1840,Kevin Miranda,Sassuolo,0.2,0,0,0,0,0,0,0,0.0,0,0,0,0,0,0,1,0
1841,Antonio Mirante,Milan,2.0,0,0,0,0,0,0,0,0.0,0,0,0,0,0,0,1,0
1842,Fabio Miretti,Juventus,12.3,18,14,6,8,4,10,26,38.5,16,10,1,9,7,25,6,0
1843,Filippo Missori,Sassuolo,3.0,6,3,2,4,0,4,11,36.4,7,3,2,1,4,10,8,0
1844,Tyrick Mitchell,Crystal Palace,35.6,105,60,75,21,9,43,60,71.7,17,63,10,53,26,131,104,0
1846,Kaoru Mitoma,Brighton,16.5,13,6,3,7,3,5,19,26.3,14,15,1,14,5,18,12,0
1847,Aleksandar Mitrovic,Fulham,0.4,0,0,0,0,0,0,0,0.0,0,0,0,0,0,0,0,0
1848,Stefan Mitrovic,Hellas Verona,4.3,6,3,0,5,1,2,5,40.0,3,6,1,5,0,6,4,0
1849,Stefan Mitrovic,Getafe,7.8,9,3,7,2,0,4,8,50.0,4,3,2,1,6,15,26,0
1850,Maximilian Mittelstadt,Stuttgart,23.4,91,51,46,39,6,53,89,59.6,36,36,6,30,46,137,65,0
1851,Henrikh Mkhitaryan,Inter,30.9,62,34,18,35,9,24,49,49.0,25,23,4,19,29,91,43,0
1852,Marko Mladenovic,Eint Frankfurt,0.1,0,0,0,0,0,0,0,0.0,0,0,0,0,0,0,0,0
1853,Jakub Moder,Brighton,6.9,19,10,9,5,5,9,18,50.0,9,8,2,6,2,21,12,0
1854,Luka Modric,Real Madrid,18.8,22,15,10,6,6,9,25,36.0,16,13,4,9,21,43,9,0
1855,Max Moerstedt,Hoffenheim,0.1,0,0,0,0,0,0,1,0.0,1,0,0,0,0,0,0,0
1856,Terem Moffi,Nice,21.7,7,4,0,5,2,3,12,25.0,9,14,1,13,3,10,15,0
1857,Mostafa Mohamed,Nantes,22.2,21,14,7,11,3,6,28,21.4,22,21,5,16,12,33,29,0
1858,Dion Moise Sahi,Strasbourg,7.0,5,5,1,2,2,0,3,0.0,3,11,1,10,1,6,7,0
1859,Johan Mojica,Osasuna,22.7,30,22,11,15,4,16,25,64.0,9,15,2,13,21,51,40,2
1860,Alberto Moleiro,Las Palmas,20.0,15,6,4,7,4,6,30,20.0,24,11,0,11,7,22,10,0
1861,Nahuel Molina,Atlético Madrid,20.6,38,22,16,18,4,26,54,48.1,28,19,3,16,9,47,36,1
1862,Florent Mollet,Nantes,23.1,18,11,8,6,4,10,31,32.3,21,18,5,13,13,31,17,0
1863,Jon Moncayola,Osasuna,20.0,27,18,14,10,3,17,42,40.5,25,31,5,26,15,42,21,0
1864,Enzo Mongo,Nantes,0.1,1,1,1,0,0,1,2,50.0,1,1,1,0,1,2,0,0
1865,Ilario Monterisi,Frosinone,16.3,23,13,14,7,2,12,26,46.2,14,22,18,4,8,31,63,0
1866,Cesar Montes,Almería,19.9,22,13,13,9,0,9,18,50.0,9,21,9,12,11,33,94,0
1867,Gonzalo Montiel,Nott'ham Forest,8.9,22,19,12,8,2,16,29,55.2,13,8,3,5,9,31,31,1
1868,Lorenzo Montipo,Hellas Verona,37.0,1,1,1,0,0,1,3,33.3,2,0,0,0,0,1,25,2
1869,Kieffer Moore,Bournemouth,1.2,0,0,0,0,0,0,0,0.0,0,0,0,0,0,0,0,0
1870,Mikey Moore,Tottenham,0.0,0,0,0,0,0,0,0,0.0,0,0,0,0,0,0,1,0
1872,Alvaro Morata,Atlético Madrid,21.2,16,10,4,7,5,3,5,60.0,2,18,3,15,1,17,26,0
1873,Diego Moreira,Lyon,3.0,0,0,0,0,0,0,3,0.0,3,3,0,3,2,2,5,0
1874,Alberto Moreno,Villarreal,16.5,31,21,19,10,2,10,30,33.3,20,12,2,10,24,55,33,0
1875,Alex Moreno,Aston Villa,11.5,18,12,18,0,0,12,19,63.2,7,11,2,9,13,31,37,0
1876,Gerard Moreno,Villarreal,24.6,25,12,10,7,8,11,25,44.0,14,24,7,17,9,34,24,0
1877,Jorge Moreno,Osasuna,0.2,0,0,0,0,0,0,0,0.0,0,1,0,1,0,0,3,0
1878,Mateu Morey,Dortmund,1.2,2,2,1,1,0,2,4,50.0,2,3,1,2,1,3,3,0
1879,Ilaix Moriba,Getafe,6.7,20,11,3,11,6,4,9,44.4,5,3,1,2,4,24,10,0
1880,Manu Morlanes,Mallorca,17.9,50,29,23,26,1,23,53,43.4,30,13,1,12,20,70,21,0
1881,Nikola Moro,Bologna,9.3,21,16,8,12,1,8,15,53.3,7,14,1,13,7,28,10,0
1882,Carlton Morris,Luton Town,31.8,15,8,4,6,5,9,15,60.0,6,24,5,19,1,16,53,0
1883,Cristhian Mosquera,Valencia,34.2,57,34,36,18,3,25,39,64.1,14,42,23,19,36,93,137,2
1884,Yerson Mosquera,Villarreal,13.7,27,13,18,7,2,12,15,80.0,3,12,2,10,17,44,65,0
1885,Dany Mota,Monza,22.8,13,7,2,5,6,8,17,47.1,9,4,1,3,2,15,18,0
1886,Lebo Mothiba,Strasbourg,6.9,5,2,1,4,0,3,4,75.0,1,6,1,5,0,5,11,0
1887,Youssoufa Moukoko,Dortmund,6.9,4,1,2,2,0,3,7,42.9,4,4,1,3,2,6,4,0
1888,Steve Mounie,Brest,19.7,8,7,0,3,5,3,11,27.3,8,13,3,10,2,10,18,0
1889,Mason Mount,Manchester Utd,5.7,22,14,6,10,6,6,16,37.5,10,6,1,5,6,28,3,0
1890,Samuel Moutoussamy,Nantes,12.3,38,20,14,17,7,17,37,45.9,20,16,3,13,11,49,13,0
1891,Loris Mouyokolo,Lorient,1.0,4,1,4,0,0,1,1,100.0,0,1,0,1,0,4,3,0
1892,Divin Mubama,West Ham,0.9,0,0,0,0,0,0,0,0.0,0,0,0,0,0,0,0,0
1893,Mykhailo Mudryk,Chelsea,17.5,21,12,9,7,5,10,32,31.3,22,14,1,13,9,30,9,0
1894,Francois Mughe,Marseille,2.0,0,0,0,0,0,0,3,0.0,3,2,0,2,1,1,1,0
1895,Nordi Mukiele,Paris S-G,8.8,12,8,6,5,1,8,15,53.3,7,17,4,13,14,26,28,0
1896,Samuele Mulattieri,Sassuolo,5.1,1,1,0,0,1,1,2,50.0,1,7,2,5,1,2,2,0
1898,Andreas Muller,Darmstadt 98,3.9,14,9,8,5,1,4,9,44.4,5,5,2,3,4,18,5,0
1899,Jannik Muller,Darmstadt 98,12.6,33,16,21,9,3,16,27,59.3,11,24,12,12,17,50,39,1
1900,Kevin Muller,Heidenheim,34.0,3,0,3,0,0,3,5,60.0,2,0,0,0,0,3,6,1
1901,Marcus Muller,Mainz 05,0.2,0,0,0,0,0,0,0,0.0,0,0,0,0,0,0,0,0
1902,Thomas Muller,Bayern Munich,18.4,26,16,5,10,11,13,35,37.1,22,22,0,22,3,29,6,0
1903,Abdul Mumin,Rayo Vallecano,18.8,19,10,13,4,2,8,10,80.0,2,27,19,8,22,41,82,1
1904,Marshall Munetsi,Reims,24.1,61,39,18,34,9,33,61,54.1,28,21,7,14,14,75,33,0
1905,Iker Muniain,Athletic Club,6.6,5,1,2,3,0,1,3,33.3,2,4,1,3,0,5,0,0
1906,Rodrigo Muniz,Fulham,17.7,7,3,1,5,1,1,6,16.7,5,9,3,6,6,13,20,0
1907,Aihen Munoz,Real Sociedad,12.5,36,21,20,10,6,24,35,68.6,11,16,8,8,9,45,33,0
1908,Alvaro Munoz,Real Madrid,0.0,0,0,0,0,0,0,0,0.0,0,0,0,0,0,0,1,0
1909,Daniel Munoz,Crystal Palace,16.0,55,35,31,14,10,19,38,50.0,19,29,7,22,24,79,47,0
1910,Iker Munoz,Osasuna,20.6,32,18,13,17,2,15,31,48.4,16,16,5,11,11,43,50,0
1911,Javier Munoz,Las Palmas,29.3,42,23,14,22,6,16,44,36.4,28,40,4,36,20,62,29,1
1912,Finley Munroe,Aston Villa,0.0,0,0,0,0,0,0,0,0.0,0,0,0,0,0,0,0,0
1913,Arijanet Muric,Burnley,10.0,1,1,1,0,0,1,1,100.0,0,0,0,0,0,1,10,4
1914,Luis Muriel,Atalanta,4.5,3,2,0,2,1,1,1,100.0,0,4,0,4,1,4,0,0
1915,Murillo,Nott'ham Forest,31.0,50,31,36,13,1,19,33,57.6,14,41,24,17,37,87,188,0
1916,Vedat Muriqi,Mallorca,25.9,11,6,4,3,4,2,14,14.3,12,11,4,7,6,17,26,0
1917,Alex Murphy,Newcastle Utd,0.1,1,1,0,1,0,1,2,50.0,1,1,0,1,1,2,0,0
1918,Jacob Murphy,Newcastle Utd,13.2,20,10,8,4,8,12,26,46.2,14,17,0,17,6,26,16,0
1919,Yunus Musah,Milan,16.4,25,14,15,6,4,8,15,53.3,7,18,4,14,10,35,16,1
1920,Jamal Musiala,Bayern Munich,19.5,40,25,9,21,10,14,36,38.9,22,25,1,24,16,56,5,0
1921,Florent Muslija,Freiburg,1.2,5,4,3,2,0,2,5,40.0,3,1,0,1,0,5,2,0
1922,Juan Musso,Atalanta,11.0,1,0,1,0,0,1,1,100.0,0,0,0,0,0,1,6,0
1924,Kingstone Mutandwa,Cagliari,0.4,1,0,1,0,0,1,4,25.0,3,1,0,1,0,1,2,0
1925,Yvon Mvogo,Lorient,34.0,0,0,0,0,0,0,1,0.0,1,0,0,0,0,0,15,3
1926,Joel Mvuka,Lorient,2.2,5,3,3,1,1,3,7,42.9,4,1,0,1,2,7,1,0
1927,Junior Mwanga,Strasbourg,16.1,40,20,23,12,5,12,24,50.0,12,20,5,15,18,58,19,0
1928,Phillipp Mwene,Mainz 05,22.2,34,15,15,16,3,16,33,48.5,17,27,3,24,17,51,47,0
1929,Vitaliy Mykolenko,Everton,27.4,69,38,46,21,2,41,66,62.1,25,36,11,25,36,105,92,0
1930,Joakim Maehle,Wolfsburg,27.2,62,39,33,18,11,41,64,64.1,23,43,5,38,29,91,65,0
1931,Obite N'Dicka,Roma,24.1,32,18,12,19,1,12,20,60.0,8,30,16,14,16,48,75,0
1932,Kevin N'Doram,Metz,17.8,31,22,20,9,2,17,38,44.7,21,17,8,9,27,58,38,0
1933,Nathan N'Goumou,Gladbach,15.4,37,22,17,18,2,16,34,47.1,18,22,0,22,5,42,17,1
1934,Stanley N'Soki,Hoffenheim,7.0,21,10,12,8,1,17,29,58.6,12,13,2,11,8,29,33,0
1935,Nacho,Real Madrid,19.4,18,10,9,7,2,6,13,46.2,7,23,13,10,18,36,56,0
1936,Bilal Nadir,Marseille,1.3,4,3,2,2,0,1,2,50.0,1,0,0,0,2,6,2,0
1937,Mahamadou Nagida,Rennes,1.2,1,1,0,0,1,0,2,0.0,2,2,1,1,4,5,0,0
1938,Marvelous Nakamba,Luton Town,12.6,40,24,24,14,2,24,42,57.1,18,23,6,17,11,51,11,1
1939,Keito Nakamura,Reims,15.3,28,11,9,10,9,17,37,45.9,20,15,2,13,6,34,7,0
1940,Nahitan Nandez,Cagliari,26.0,59,40,27,23,9,27,64,42.2,37,25,2,23,19,78,32,0
1941,Matija Nastasic,Mallorca,25.1,35,17,26,9,0,24,32,75.0,8,33,20,13,29,64,114,0
1942,Natan,Napoli,10.6,14,10,10,3,1,5,10,50.0,5,12,9,3,8,22,32,0
1943,Lapo Nava,Milan,0.0,0,0,0,0,0,0,0,0.0,0,0,0,0,0,0,0,0
1944,Roberto Navarro,Cádiz,21.0,46,29,20,21,5,22,43,51.2,21,33,0,33,19,65,7,1
1945,Jesus Navas,Sevilla,22.3,37,27,21,14,2,22,40,55.0,18,15,7,8,22,59,48,0
1946,Keylor Navas,Paris S-G,4.0,0,0,0,0,0,0,0,0.0,0,0,0,0,0,0,2,0
1947,Michel Ndary Adopo,Atalanta,1.2,4,3,0,3,1,1,1,100.0,0,0,0,0,0,4,2,1
1948,Youssouf Ndayishimiye,Nice,19.0,31,20,17,12,2,12,23,52.2,11,19,11,8,12,43,47,1
1950,Bassirou Ndiaye,Lorient,1.7,5,2,2,2,1,3,5,60.0,2,1,1,0,1,6,0,0
1951,Iliman Ndiaye,Marseille,18.0,21,18,5,11,5,11,29,37.9,18,14,2,12,6,27,6,0
1952,Massamba Ndiaye,Clermont Foot,4.0,0,0,0,0,0,0,0,0.0,0,0,0,0,0,0,2,0
1953,Rassoul Ndiaye,Le Havre,5.8,25,17,8,16,1,12,24,50.0,12,2,1,1,4,29,5,0
1954,Michael Ndiweni,Newcastle Utd,0.0,0,0,0,0,0,0,0,0.0,0,0,0,0,0,0,0,0
1955,Cher Ndour,Paris S-G,0.3,2,2,0,2,0,1,2,50.0,1,0,0,0,0,2,0,0
1956,Dan Ndoye,Bologna,19.7,30,15,17,11,2,17,39,43.6,22,20,1,19,10,40,14,0
1957,Joseph Nduquidi,Metz,8.3,11,4,6,3,2,1,9,11.1,8,11,3,8,11,22,15,1
1958,Loic Nego,Le Havre,17.3,37,26,21,12,4,18,30,60.0,12,12,2,10,16,53,17,0
1959,Alvaro Negredo,Cádiz,0.6,0,0,0,0,0,0,0,0.0,0,1,0,1,1,1,0,0
1960,Reiss Nelson,Arsenal,3.0,9,6,5,1,3,8,10,80.0,2,5,1,4,1,10,5,0
1961,Zack Nelson,Luton Town,0.1,1,0,1,0,0,0,0,0.0,0,0,0,0,0,1,0,0
1962,Neto,Bournemouth,32.0,0,0,0,0,0,0,0,0.0,0,1,0,1,1,1,12,3
1963,Pedro Neto,Wolves,16.8,7,3,3,2,2,5,15,33.3,10,5,1,4,5,12,2,0
1964,Luca Netz,Gladbach,24.7,38,22,19,16,3,23,43,53.5,20,36,10,26,22,60,76,1
1965,Manuel Neuer,Bayern Munich,22.8,1,1,1,0,0,0,0,0.0,0,0,0,0,0,1,14,3
1966,Florian Neuhaus,Gladbach,13.6,15,12,7,8,0,8,26,30.8,18,8,6,2,14,29,8,0
1967,Carlos Neva,Granada,35.0,32,21,22,9,1,17,40,42.5,23,39,14,25,30,62,108,2
1968,Jessic Ngankam,Mainz 05,2.0,1,1,0,1,0,0,0,0.0,0,3,1,2,3,4,0,0
1969,Jessic Ngankam,Eint Frankfurt,3.1,3,2,1,1,1,0,0,0.0,0,0,0,0,0,3,1,0
1970,Cyril Ngonge,Hellas Verona,15.9,14,9,5,3,6,5,14,35.7,9,7,1,6,4,18,10,0
1971,Cyril Ngonge,Napoli,3.5,5,3,1,4,0,2,2,100.0,0,2,0,2,0,5,2,0
1972,Steve Ngoura,Le Havre,2.5,2,1,1,1,0,1,4,25.0,3,0,0,0,0,2,3,0
1973,Moussa Niakhate,Nott'ham Forest,16.2,42,25,33,9,0,20,25,80.0,5,19,12,7,14,56,51,0
1974,M'Baye Niang,Empoli,7.9,3,1,0,1,2,0,6,0.0,6,7,1,6,3,6,10,0
1976,Tanguy Nianzou,Sevilla,3.5,12,8,9,2,1,8,11,72.7,3,2,0,2,3,15,9,1
1977,Shamar Nicholson,Clermont Foot,16.5,6,2,0,4,2,1,4,25.0,3,6,2,4,0,6,15,0
1978,Rasmus Nicolaisen,Toulouse,32.5,50,30,39,11,0,26,44,59.1,18,44,33,11,42,92,158,1
1979,Moritz Nicolas,Gladbach,27.0,1,0,1,0,0,1,3,33.3,2,0,0,0,0,1,12,5
1980,Hans Nicolussi Caviglia,Juventus,3.0,5,2,1,3,1,4,6,66.7,2,5,1,4,0,5,2,0
1981,Saul Niguez,Atlético Madrid,15.3,64,39,29,29,6,30,49,61.2,19,36,9,27,14,78,56,0
1982,Justin Njinmah,Werder Bremen,11.3,5,1,2,2,1,3,9,33.3,6,9,1,8,2,7,6,0
1983,Eddie Nketiah,Arsenal,12.0,12,7,2,6,4,2,7,28.6,5,11,0,11,4,16,4,0
1984,Niels Nkounkou,Eint Frankfurt,14.5,54,30,34,17,3,29,64,45.3,35,30,2,28,16,70,30,0
1985,Christopher Nkunku,Chelsea,4.9,5,4,0,4,1,1,2,50.0,1,4,1,3,2,7,4,0
1986,Felix Nmecha,Dortmund,11.3,19,13,7,8,4,11,22,50.0,11,18,5,13,11,30,19,0
1987,Lukas Nmecha,Wolfsburg,0.5,1,1,0,0,1,0,0,0.0,0,1,0,1,0,1,0,0
1988,Peru Nolaskoain,Athletic Club,0.1,1,1,1,0,0,1,1,100.0,0,0,0,0,0,1,1,0
1989,Joseph Nonge,Juventus,0.3,0,0,0,0,0,0,0,0.0,0,0,0,0,0,0,1,0
1990,Jonathan Norbye,RB Leipzig,0.0,0,0,0,0,0,0,0,0.0,0,0,0,0,0,0,0,0
1991,Arnaud Nordin,Montpellier,13.8,12,6,3,5,4,6,16,37.5,10,11,0,11,2,14,10,0
1992,Rhys Norrington-Davies,Sheffield Utd,1.2,1,1,1,0,0,0,1,0.0,1,2,0,2,1,2,2,0
1993,Oliver Norwood,Sheffield Utd,16.0,41,26,18,18,5,20,47,42.6,27,24,9,15,21,62,39,0
1994,Tijjani Noslin,Hellas Verona,14.9,18,8,5,7,6,6,16,37.5,10,17,2,15,2,20,14,0
1995,Randy Nteka,Rayo Vallecano,6.4,11,4,1,6,4,4,10,40.0,6,6,1,5,2,13,11,1
1996,Ernest Nuamah,Lyon,20.4,28,14,18,6,4,12,38,31.6,26,15,1,14,8,36,9,0
1997,Alexander Nubel,Stuttgart,30.0,2,2,2,0,0,2,4,50.0,2,0,0,0,0,2,13,4
1998,Kasim Nuhu,Hoffenheim,0.1,0,0,0,0,0,0,0,0.0,0,0,0,0,0,0,0,0
1999,Matheus Nunes,Wolves,2.0,3,1,3,0,0,2,6,33.3,4,0,0,0,6,9,1,0
2000,Matheus Nunes,Manchester City,7.3,10,4,1,7,2,5,16,31.3,11,7,1,6,1,11,8,1
2002,Darwin Nunez,Liverpool,22.7,22,12,2,10,10,11,23,47.8,12,18,6,12,3,25,9,0
2003,Unai Nunez,Celta Vigo,31.1,51,28,30,19,2,23,49,46.9,26,38,24,14,52,103,153,3
2004,Fabian Nurnberger,Darmstadt 98,16.8,29,22,22,6,1,22,41,53.7,19,11,1,10,17,46,26,0
2005,Ethan Nwaneri,Arsenal,0.2,0,0,0,0,0,0,0,0.0,0,1,0,1,0,0,0,0
2006,Simeon Nwankwo,Salernitana,7.6,6,3,0,2,4,1,3,33.3,2,7,0,7,0,6,4,0
2007,Gerzino Nyamsi,Strasbourg,12.1,18,14,13,5,0,12,18,66.7,6,19,11,8,10,28,43,0
2008,Orjan Nyland,Sevilla,24.0,0,0,0,0,0,0,1,0.0,1,0,0,0,0,0,9,1
2009,Rabby Nzingoula,Strasbourg,1.5,3,3,0,3,0,3,4,75.0,1,4,0,4,5,8,0,0
2010,M'Bala Nzola,Fiorentina,17.2,11,8,1,4,6,6,7,85.7,1,10,1,9,0,11,22,0
2011,Christian Norgaard,Brentford,27.8,81,50,42,31,8,32,87,36.8,55,48,6,42,54,135,50,0
2012,Jake O'Brien,Lyon,26.3,22,16,16,5,1,14,20,70.0,6,23,18,5,12,34,98,1
2013,Mark O'Mahony,Brighton,0.7,1,0,1,0,0,1,2,50.0,1,2,1,1,0,1,1,0
2014,Dara O'Shea,Burnley,32.1,39,20,22,14,3,11,26,42.3,15,41,30,11,35,74,158,2
2015,Michael Obafemi,Burnley,0.2,0,0,0,0,0,0,0,0.0,0,1,0,1,0,0,0,0
2016,Adam Obert,Cagliari,10.5,17,9,8,8,1,8,17,47.1,9,13,7,6,21,38,41,1
2017,Pedro Obiang,Sassuolo,5.0,8,4,3,4,1,2,10,20.0,8,6,4,2,8,16,10,0
2018,Jan Oblak,Atlético Madrid,38.0,0,0,0,0,0,0,0,0.0,0,0,0,0,0,0,10,0
2019,Brian Ocampo,Cádiz,2.8,4,3,1,3,0,2,5,40.0,3,4,0,4,3,7,0,0
2020,Lucas Ocampos,Sevilla,31.9,66,47,22,27,17,29,58,50.0,29,34,1,33,21,87,29,0
2021,Guillermo Ochoa,Salernitana,21.0,0,0,0,0,0,0,1,0.0,1,0,0,0,0,0,9,1
2022,Jens Odgaard,Bologna,4.8,4,4,1,1,2,1,3,33.3,2,9,0,9,1,5,3,0
2023,Wilson Odobert,Burnley,23.3,17,13,8,5,4,6,22,27.3,16,26,2,24,6,23,14,0
2024,Alvaro Odriozola,Real Sociedad,4.4,9,7,7,1,1,5,5,100.0,0,2,1,1,8,17,7,0
2025,Tim Oermann,Bochum,7.9,19,11,11,4,4,9,14,64.3,5,15,6,9,2,21,22,0
2026,Odeluga Offiah,Brighton,1.4,1,0,1,0,0,1,1,100.0,0,0,0,0,1,2,0,0
2028,Chiedozie Ogbene,Luton Town,22.2,17,10,10,7,0,12,22,54.5,10,14,3,11,7,24,34,2
2029,Angelo Ogbonna,West Ham,7.1,11,5,9,2,0,6,7,85.7,1,13,10,3,3,14,29,0
2030,Florent Ogier,Clermont Foot,10.5,19,9,13,6,0,11,18,61.1,7,25,19,6,9,28,35,3
2031,Noah Okafor,Milan,9.9,6,4,1,4,1,3,10,30.0,7,8,1,7,0,6,10,0
2032,David Okereke,Torino,2.8,3,1,1,1,1,0,3,0.0,3,2,0,2,1,4,0,0
2033,Caleb Okoli,Frosinone,32.4,56,34,33,22,1,29,44,65.9,15,48,32,16,29,85,156,4
2034,Maduka Okoye,Udinese,21.0,0,0,0,0,0,0,0,0.0,0,0,0,0,1,1,4,2
2035,Masaya Okugawa,Augsburg,0.4,0,0,0,0,0,0,0,0.0,0,0,0,0,0,0,2,0
2036,Joseph Okumu,Reims,19.4,44,28,28,14,2,24,38,63.2,14,27,19,8,35,79,112,2
2037,Aingeru Olabarrieta,Athletic Club,0.1,0,0,0,0,0,0,0,0.0,0,0,0,0,0,0,0,0
2038,Michael Olakigbe,Brentford,0.7,3,0,2,1,0,2,4,50.0,2,7,0,7,1,4,0,1
2039,Olasagasti,Real Sociedad,4.0,16,13,4,7,5,5,8,62.5,3,2,0,2,3,19,5,1
2040,Finn Ole Becker,Hoffenheim,6.7,10,9,8,2,0,4,17,23.5,13,9,1,8,1,11,10,0
2041,Mathias Olesen,Köln,1.2,0,0,0,0,0,0,0,0.0,0,0,0,0,2,2,2,0
2042,Michael Olise,Crystal Palace,14.2,19,10,7,10,2,8,24,33.3,16,21,0,21,11,30,9,0
2043,Mathias Olivera,Napoli,17.4,50,29,29,15,6,23,39,59.0,16,35,6,29,20,70,25,0
2044,Dani Olmo,RB Leipzig,16.1,26,18,14,8,4,10,22,45.5,12,7,0,7,13,39,12,1
2045,Robin Olsen,Aston Villa,4.5,0,0,0,0,0,0,0,0.0,0,0,0,0,0,0,1,0
2046,Warmed Omari,Rennes,23.0,32,19,23,7,2,16,28,57.1,12,30,20,10,33,65,77,2
2047,Becir Omeragic,Montpellier,25.7,48,29,31,13,4,20,33,60.6,13,51,29,22,27,75,65,0
2048,Jonas Omlin,Gladbach,7.0,1,0,1,0,0,1,1,100.0,0,0,0,0,0,1,3,0
2049,Andrew Omobamidele,Nott'ham Forest,8.7,10,3,9,1,0,5,8,62.5,3,12,8,4,13,23,42,1
2050,Samu Omorodion,Alavés,21.3,6,3,1,4,1,0,4,0.0,4,11,2,9,1,7,14,0
2051,Samu Omorodion,Granada,0.9,1,1,0,1,0,1,1,100.0,0,0,0,0,0,1,0,0
2052,Amadou Onana,Everton,23.2,71,38,32,31,8,21,42,50.0,21,25,6,19,21,92,31,0
2054,Andre Onana,Manchester Utd,38.0,2,0,2,0,0,2,2,100.0,0,0,0,0,0,2,11,2
2055,Jean Onana,Marseille,6.3,23,14,6,14,3,13,25,52.0,12,10,2,8,11,34,11,1
2056,Ryan One,Sheffield Utd,0.1,0,0,0,0,0,0,0,0.0,0,0,0,0,0,0,0,0
2057,Karim Onisiwo,Mainz 05,16.6,17,8,4,6,7,6,11,54.5,5,18,4,14,2,19,7,0
2058,Tyler Onyango,Everton,0.0,0,0,0,0,0,0,0,0.0,0,0,0,0,0,0,0,0
2059,Fred Onyedinma,Luton Town,4.5,10,6,7,3,0,5,12,41.7,7,3,0,3,1,11,13,0
2060,Frank Onyeka,Brentford,12.9,37,24,9,23,5,16,29,55.2,13,15,7,8,23,60,17,0
2061,Lois Openda,RB Leipzig,30.0,3,3,0,1,2,0,6,0.0,6,19,3,16,5,8,14,0
2062,Royce Openda Owaga,Lorient,0.2,0,0,0,0,0,0,0,0.0,0,0,0,0,0,0,0,0
2063,Christopher Operi,Le Havre,27.2,55,36,37,15,3,32,59,54.2,27,45,7,38,35,90,68,1
2064,Leon Opitz,Werder Bremen,0.2,2,2,1,1,0,2,3,66.7,1,0,0,0,0,2,0,0
2065,Gift Orban,Lyon,5.3,4,3,0,1,3,1,4,25.0,3,2,0,2,1,5,2,1
2066,Willi Orban,RB Leipzig,17.6,20,12,8,10,2,9,18,50.0,9,22,13,9,16,36,76,1
2067,Ivan Ordets,Bochum,20.9,19,14,11,6,2,10,17,58.8,7,41,29,12,31,50,130,0
2068,Divock Origi,Nott'ham Forest,6.7,6,4,5,0,1,0,0,0.0,0,6,0,6,2,8,4,0
2069,Gaetano Oristanio,Cagliari,12.3,20,10,5,14,1,5,17,29.4,12,11,0,11,9,29,8,0
2070,Aimar Oroz,Osasuna,26.0,43,26,18,20,5,13,37,35.1,24,27,2,25,16,59,11,0
2071,Riccardo Orsolini,Bologna,19.9,23,14,13,4,6,9,30,30.0,21,25,3,22,8,31,19,1
2072,Stefan Ortega,Manchester City,7.1,0,0,0,0,0,0,0,0.0,0,0,0,0,0,0,2,1
2073,Eneko Ortiz,Alavés,0.2,0,0,0,0,0,0,0,0.0,0,0,0,0,0,0,0,0
2074,Asier Osambela,Osasuna,0.1,2,1,0,1,1,0,0,0.0,0,0,0,0,0,2,0,0
2075,Ben Osborn,Sheffield Utd,15.2,22,9,11,9,2,8,17,47.1,9,18,2,16,8,30,30,0
2076,Gabriel Osho,Luton Town,20.5,41,22,21,19,1,16,27,59.3,11,37,20,17,31,72,92,0
2077,Victor Osimhen,Napoli,22.0,9,5,0,4,5,2,4,50.0,2,5,1,4,2,11,18,0
2078,Milutin Osmajic,Cádiz,0.1,0,0,0,0,0,0,0,0.0,0,0,0,0,0,0,0,0
2080,Patrick Osterhage,Bochum,20.7,38,26,14,23,1,17,36,47.2,19,36,9,27,27,65,32,1
2081,William Osula,Sheffield Utd,8.7,2,2,1,0,1,1,2,50.0,1,3,1,2,2,4,9,0
2082,Dango Ouattara,Bournemouth,13.7,45,27,22,11,12,19,34,55.9,15,18,3,15,22,67,35,0
2083,Kassoum Ouattara,Monaco,7.1,17,12,8,5,4,9,20,45.0,11,11,0,11,13,30,20,0
2084,Remi Oudin,Lecce,20.2,26,14,12,12,2,12,19,63.2,7,13,1,12,20,46,22,0
2085,Alexandre Oukidja,Metz,33.2,2,1,2,0,0,1,2,50.0,1,1,0,1,3,5,24,3
2086,Azzedine Ounahi,Marseille,13.4,25,11,9,14,2,11,32,34.4,21,6,1,5,11,36,8,0
2087,Adam Ounas,Lille,4.6,4,3,2,2,0,2,7,28.6,5,2,0,2,6,10,1,0
2088,Patrick Ouotro,Strasbourg,0.1,0,0,0,0,0,0,0,0.0,0,0,0,0,0,0,0,0
2089,Aiham Ousou,Cádiz,4.8,8,5,6,2,0,5,5,100.0,0,1,0,1,7,15,15,0
2090,Jesus Owono,Alavés,4.0,0,0,0,0,0,0,0,0.0,0,0,0,0,0,0,3,0
2091,Mikel Oyarzabal,Real Sociedad,24.0,23,18,7,11,5,7,21,33.3,14,25,4,21,4,27,12,0
2092,Anthony Oyono,Frosinone,13.3,37,26,21,14,2,23,34,67.6,11,17,3,14,9,46,32,0
2093,Salih Ozcan,Dortmund,13.2,20,12,11,8,1,10,18,55.6,8,28,3,25,17,37,18,1
2094,Cenk Ozkacar,Valencia,17.8,26,15,22,4,0,15,23,65.2,8,18,7,11,18,44,84,1
2095,David Ozoh,Crystal Palace,1.7,10,6,3,6,1,5,6,83.3,1,2,0,2,0,10,2,0
2096,Jon Pacheco,Real Sociedad,17.0,25,15,21,4,0,14,22,63.6,8,17,6,11,10,35,53,1
2097,Willian Pacho,Eint Frankfurt,33.0,62,37,38,23,1,31,53,58.5,22,51,22,29,47,109,152,2
2098,Goncalo Paciencia,Bochum,7.2,8,4,2,2,4,3,6,50.0,3,5,0,5,0,8,7,0
2099,Simone Pafundi,Udinese,0.1,0,0,0,0,0,0,0,0.0,0,0,0,0,0,0,0,0
2100,Riccardo Pagano,Roma,0.6,2,2,1,1,0,0,6,0.0,6,3,2,1,0,2,2,0
2101,Pablo Pagis,Lorient,1.8,10,6,5,4,1,6,10,60.0,4,2,0,2,3,13,1,0
2102,Exequiel Palacios,Leverkusen,20.3,60,34,28,26,6,26,53,49.1,27,24,0,24,29,89,20,2
2103,Isaac Palazon Camacho,Rayo Vallecano,31.0,46,25,16,21,9,20,58,34.5,38,29,2,27,16,62,41,0
2104,Joao Palhinha,Fulham,30.0,152,75,80,60,12,103,152,67.8,49,57,9,48,46,198,58,0
2106,Nicolas Pallois,Nantes,17.7,34,19,21,11,2,19,35,54.3,16,37,26,11,26,60,111,0
2107,Cole Palmer,Chelsea,29.0,23,12,9,6,8,8,19,42.1,11,20,2,18,20,43,13,2
2108,Cole Palmer,Manchester City,0.1,0,0,0,0,0,0,0,0.0,0,0,0,0,0,0,0,0
2109,Emerson Palmieri,West Ham,34.9,106,68,48,42,16,57,90,63.3,33,47,15,32,43,149,96,0
2110,Joaquin Panichelli,Alavés,2.5,3,3,1,1,1,1,2,50.0,1,1,0,1,1,4,4,0
2111,Milos Pantovic,Union Berlin,0.2,0,0,0,0,0,0,0,0.0,0,0,0,0,0,0,0,0
2112,Antonios Papadopoulos,Dortmund,1.3,6,3,6,0,0,6,7,85.7,1,3,2,1,2,8,7,0
2113,Christos Papadopoulos,Genoa,0.0,0,0,0,0,0,0,1,0.0,1,0,0,0,0,0,0,0
2114,Sokratis Papastathopoulos,Betis,12.6,21,14,16,5,0,13,17,76.5,4,15,9,6,6,27,60,0
2115,Matondo-Merveille Papela,Mainz 05,2.9,5,4,2,3,0,0,4,0.0,4,1,0,1,4,9,2,0
2116,Leart Paqarada,Köln,11.9,21,11,9,9,3,11,22,50.0,11,17,5,12,10,31,30,1
2117,Lucas Paqueta,West Ham,29.1,71,48,38,26,7,25,52,48.1,27,28,1,27,21,92,28,2
2118,Victor Parada,Alavés,0.0,1,1,0,1,0,1,1,100.0,0,0,0,0,0,1,0,0
2119,Aitor Paredes,Athletic Club,30.0,20,11,11,9,0,7,14,50.0,7,23,11,12,33,53,104,0
2120,Kevin Paredes,Wolfsburg,15.9,42,21,22,13,7,20,34,58.8,14,27,2,25,23,65,26,0
2121,Leandro Paredes,Roma,29.3,57,36,30,22,5,33,77,42.9,44,26,7,19,29,86,43,1
2122,Daniel Parejo,Villarreal,28.7,43,30,16,21,6,20,46,43.5,26,25,9,16,21,64,29,3
2123,Fabiano Parisi,Fiorentina,16.2,30,15,11,12,7,15,26,57.7,11,21,5,16,17,47,26,0
2124,Ben Parkinson,Newcastle Utd,0.3,0,0,0,0,0,0,0,0.0,0,1,0,1,0,0,1,0
2125,Thomas Partey,Arsenal,8.8,14,11,9,4,1,5,10,50.0,5,9,3,6,11,25,9,0
2126,Mario Pasalic,Atalanta,22.8,28,17,9,18,1,14,31,45.2,17,29,6,23,16,44,34,0
2127,Triantafyllos Pasaridis,Salernitana,5.0,11,7,9,2,0,9,14,64.3,5,7,3,4,3,14,19,0
2128,Pascu,Villarreal,0.2,0,0,0,0,0,0,0,0.0,0,0,0,0,0,0,0,0
2129,Felix Passlack,Bochum,10.7,21,14,9,10,2,14,24,58.3,10,13,2,11,10,31,21,0
2130,Patric,Lazio,17.9,13,8,10,3,0,8,18,44.4,10,15,9,6,6,19,44,0
2132,Rui Patricio,Roma,23.0,0,0,0,0,0,0,1,0.0,1,1,0,1,0,0,3,1
2133,Nathan Patterson,Everton,11.2,34,24,21,11,2,14,37,37.8,23,14,3,11,9,43,33,0
2134,Gabriel Paulista,Atlético Madrid,4.5,7,5,4,3,0,3,4,75.0,1,5,3,2,4,11,27,0
2135,Gabriel Paulista,Valencia,15.5,10,7,8,2,0,6,11,54.5,5,15,7,8,24,34,78,0
2136,Benjamin Pavard,Inter,18.6,34,21,21,11,2,20,24,83.3,4,25,15,10,32,66,44,1
2137,Jiri Pavlenka,Werder Bremen,7.0,0,0,0,0,0,0,0,0.0,0,0,0,0,0,0,2,0
2138,Aleksandar Pavlovic,Bayern Munich,13.6,28,16,10,14,4,17,33,51.5,16,13,3,10,17,45,12,0
2139,Leonardo Pavoletti,Cagliari,7.0,1,1,0,0,1,0,1,0.0,1,2,1,1,0,1,7,0
2140,Martin Payero,Udinese,20.0,54,32,28,19,7,19,46,41.3,27,25,7,18,15,69,21,0
2141,Nicolas Paz,Real Madrid,0.3,0,0,0,0,0,0,0,0.0,0,2,0,2,1,1,0,0
2142,Myles Peart-Harris,Brentford,0.1,0,0,0,0,0,0,0,0.0,0,0,0,0,0,0,1,0
2143,Sydie Peck,Sheffield Utd,0.1,0,0,0,0,0,0,0,0.0,0,0,0,0,0,0,0,0
2144,Mads Pedersen,Augsburg,19.8,64,39,31,27,6,24,44,54.5,20,20,3,17,19,83,46,0
2145,Marcus Pedersen,Sassuolo,17.9,36,24,25,5,6,21,25,84.0,4,19,5,14,10,46,51,0
2146,Alfonso Pedraza,Villarreal,12.4,25,9,18,5,2,9,17,52.9,8,16,7,9,13,38,19,0
2147,Pedri,Barcelona,16.4,33,24,16,13,4,8,27,29.6,19,27,3,24,14,47,10,0
2148,Pedro,Lazio,9.1,16,12,5,7,4,3,12,25.0,9,16,2,14,3,19,1,0
2149,Adria Pedrosa,Sevilla,19.5,46,26,28,14,4,23,34,67.6,11,26,6,20,15,61,54,0
2150,Jordan Pefok,Gladbach,15.8,10,4,0,8,2,3,8,37.5,5,12,3,9,5,15,28,0
2151,Jordan Pefok,Union Berlin,0.3,0,0,0,0,0,0,0,0.0,0,1,1,0,0,0,0,0
2152,Dzenan Pejcinovic,Wolfsburg,0.4,0,0,0,0,0,0,0,0.0,0,1,0,1,0,0,0,0
2153,Pietro Pellegri,Torino,8.4,5,1,1,4,0,1,5,20.0,4,4,1,3,2,7,3,0
2154,Lorenzo Pellegrini,Roma,20.7,35,20,14,16,5,17,51,33.3,34,28,5,23,20,55,22,0
2155,Luca Pellegrini,Lazio,8.7,18,13,7,10,1,9,17,52.9,8,7,3,4,9,27,20,0
2156,Marco Pellegrino,Salernitana,6.1,8,6,4,3,1,5,10,50.0,5,11,6,5,10,18,28,0
2158,Marco Pellegrino,Milan,0.8,1,1,0,0,1,0,2,0.0,2,1,1,0,1,2,2,0
2159,Facundo Pellistri,Manchester Utd,1.9,5,3,4,1,0,1,3,33.3,2,7,1,6,1,6,5,0
2160,Facundo Pellistri,Granada,13.7,29,19,12,10,7,6,21,28.6,15,18,0,18,4,33,7,0
2161,Andy Pelmard,Clermont Foot,33.2,51,38,41,9,1,32,40,80.0,8,37,20,17,33,84,99,2
2162,Aurelien Pelon,Lorient,1.0,1,0,1,0,0,0,2,0.0,2,2,2,0,0,1,7,0
2163,Faris Pemi Moumbagna,Marseille,6.1,2,1,0,2,0,0,3,0.0,3,4,0,4,3,5,1,0
2164,Inaki Pena,Barcelona,10.0,0,0,0,0,0,0,1,0.0,1,0,0,0,0,0,5,1
2165,Marcos Pena,Almería,4.9,19,14,12,7,0,6,12,50.0,6,9,3,6,13,32,8,0
2166,Ruben Pena,Osasuna,23.2,47,25,22,18,7,20,49,40.8,29,37,8,29,30,77,39,3
2167,Pepin,Monza,2.7,6,1,1,4,1,2,4,50.0,2,5,2,3,0,6,6,0
2168,Alberto Perea,Granada,0.0,0,0,0,0,0,0,2,0.0,2,0,0,0,0,0,0,0
2169,Andreas Pereira,Fulham,29.0,25,12,4,12,9,11,41,26.8,30,16,2,14,4,29,12,0
2170,Danilo Pereira,Paris S-G,22.2,22,12,14,6,2,9,17,52.9,8,29,26,3,23,45,100,1
2171,Mathias Pereira Lage,Brest,13.2,21,15,7,8,6,7,28,25.0,21,14,5,9,10,31,13,0
2172,Pedro Pereira,Monza,9.3,19,13,14,4,1,9,17,52.9,8,15,2,13,4,23,18,0
2173,Daniel Peretz,Bayern Munich,0.2,0,0,0,0,0,0,0,0.0,0,0,0,0,0,0,0,0
2174,Roberto Pereyra,Udinese,20.6,19,9,11,5,3,11,29,37.9,18,20,4,16,7,26,18,0
2175,Ayoze Perez,Betis,25.5,59,32,16,33,10,21,49,42.9,28,42,4,38,22,81,18,0
2176,Carles Perez,Celta Vigo,8.6,13,5,6,5,2,7,18,38.9,11,14,1,13,5,18,8,0
2177,Francisco Perez,Valencia,22.8,30,17,10,14,6,15,44,34.1,29,19,0,19,14,44,5,0
2178,Kike Perez,Rayo Vallecano,9.3,27,11,11,15,1,11,23,47.8,12,11,0,11,8,35,6,0
2179,Nehuen Perez,Udinese,36.0,72,48,42,28,2,39,48,81.3,9,53,26,27,45,117,158,1
2180,Matteo Perez Vinlof,Bayern Munich,0.2,0,0,0,0,0,0,0,0.0,0,0,0,0,1,1,0,0
2181,Simone Perilli,Hellas Verona,1.0,0,0,0,0,0,0,0,0.0,0,0,0,0,0,0,0,0
2182,Mattia Perin,Juventus,2.5,0,0,0,0,0,0,0,0.0,0,0,0,0,0,0,1,0
2184,Samuele Perisan,Empoli,1.0,0,0,0,0,0,0,0,0.0,0,0,0,0,0,0,0,0
2185,Ivan Perisic,Tottenham,1.1,3,2,1,1,1,3,5,60.0,2,1,0,1,2,5,1,0
2186,Romain Perraud,Nice,4.1,7,6,5,1,1,4,11,36.4,7,4,0,4,6,13,15,1
2187,Lucas Perrin,Strasbourg,30.3,47,30,33,14,0,28,46,60.9,18,45,32,13,28,75,113,0
2188,Maximo Perrone,Las Palmas,18.0,42,21,17,22,3,19,39,48.7,20,27,4,23,24,66,21,0
2189,Pavao Pervan,Wolfsburg,9.0,0,0,0,0,0,0,0,0.0,0,0,0,0,0,0,4,0
2190,Matteo Pessina,Monza,35.8,44,25,20,20,4,23,49,46.9,26,29,11,18,27,71,46,1
2191,Andrea Petagna,Cagliari,11.1,4,2,1,0,3,1,2,50.0,1,6,3,3,1,5,4,0
2192,Denis Petric,Nantes,0.3,0,0,0,0,0,0,0,0.0,0,0,0,0,0,0,0,0
2193,Njegos Petrovic,Granada,1.7,5,2,4,1,0,2,3,66.7,1,2,0,2,1,6,3,0
2194,Dorde Petrovic,Chelsea,22.1,0,0,0,0,0,0,0,0.0,0,0,0,0,0,0,12,3
2195,Jens Petter Hauge,Eint Frankfurt,1.6,2,1,1,0,1,2,7,28.6,5,5,1,4,0,2,1,0
2196,German Pezzella,Betis,30.7,34,24,24,10,0,23,38,60.5,15,31,18,13,31,65,150,0
2197,Giuseppe Pezzella,Empoli,12.1,25,14,19,5,1,20,28,71.4,8,17,6,11,2,27,35,0
2198,Luca Pfeiffer,Darmstadt 98,18.0,11,6,2,6,3,5,11,45.5,6,5,1,4,2,13,21,0
2199,Patric Pfeiffer,Augsburg,5.7,11,7,6,4,1,5,6,83.3,1,10,6,4,11,22,21,0
2200,Maximilian Philipp,Freiburg,3.6,8,5,4,4,0,1,6,16.7,5,7,0,7,1,9,3,0
2201,Kalvin Phillips,West Ham,3.4,11,6,2,8,1,5,9,55.6,4,4,1,3,4,15,2,1
2202,Kalvin Phillips,Manchester City,1.0,3,3,1,1,1,0,0,0.0,0,0,0,0,2,5,2,0
2203,Jaden Philogene Bidace,Aston Villa,0.0,0,0,0,0,0,0,0,0.0,0,0,0,0,0,0,0,0
2204,Kamil Piatkowski,Granada,5.6,18,10,16,1,1,10,14,71.4,4,6,5,1,8,26,28,1
2205,Roberto Piccoli,Empoli,0.4,1,1,0,0,1,1,1,100.0,0,0,0,0,0,1,0,0
2206,Roberto Piccoli,Lecce,15.3,10,6,3,5,2,1,4,25.0,3,17,1,16,4,14,16,0
2207,Florian Pick,Heidenheim,3.6,4,4,3,0,1,2,3,66.7,1,2,0,2,2,6,2,0
2208,Jordan Pickford,Everton,38.0,1,0,1,0,0,1,1,100.0,0,3,0,3,0,1,19,1
2210,Amos Pieper,Werder Bremen,6.6,14,11,8,6,0,7,13,53.8,6,12,7,5,9,23,36,1
2211,Marvin Pieringer,Heidenheim,16.8,19,12,5,11,3,8,20,40.0,12,28,4,24,12,31,21,0
2212,Santiago Pierotti,Lecce,2.2,8,8,2,5,1,2,8,25.0,6,5,0,5,1,9,0,0
2213,Niccolo Pierozzi,Salernitana,9.7,17,11,13,4,0,11,22,50.0,11,24,7,17,11,28,36,0
2214,Ronael Pierre-Gabriel,Nantes,6.6,15,9,12,2,1,5,7,71.4,2,13,4,9,8,23,25,0
2215,Andrea Pinamonti,Sassuolo,34.2,13,8,1,6,6,5,22,22.7,17,19,2,17,1,14,40,0
2216,Ethan Pinnock,Brentford,28.0,35,23,22,13,0,9,20,45.0,11,40,24,16,43,78,170,3
2217,Yeremi Pino,Villarreal,5.3,25,18,12,10,3,9,18,50.0,9,11,1,10,5,30,5,0
2218,Carlo Pinsoglio,Juventus,0.5,0,0,0,0,0,0,0,0.0,0,0,0,0,0,0,0,0
2219,Lorenzo Pirola,Salernitana,22.1,39,23,25,14,0,15,28,53.6,13,46,30,16,25,64,93,1
2220,Niccolo Pisilli,Roma,0.1,0,0,0,0,0,0,0,0.0,0,0,0,0,0,0,0,0
2221,Alassane Plea,Gladbach,21.3,17,7,5,8,4,7,15,46.7,8,11,0,11,2,19,6,0
2222,Tommaso Pobega,Milan,3.5,16,9,11,5,0,6,13,46.2,7,10,2,8,6,22,7,0
2223,Paul Pogba,Juventus,0.6,1,1,0,1,0,1,1,100.0,0,0,0,0,1,2,1,0
2224,Ole Pohlmann,Dortmund,0.6,1,0,0,1,0,1,2,50.0,1,0,0,0,0,1,1,0
2225,Matteo Politano,Napoli,26.2,19,8,8,7,4,11,34,32.4,23,9,1,8,15,34,11,1
2226,Sebastian Polter,Darmstadt 98,5.0,1,0,1,0,0,0,1,0.0,1,5,1,4,0,1,4,0
2227,Julien Ponceau,Lorient,24.9,32,15,12,14,6,9,30,30.0,21,22,1,21,19,51,20,0
2228,Marin Pongracic,Lecce,35.8,43,30,22,20,1,19,25,76.0,6,37,26,11,51,94,130,1
2229,Nick Pope,Newcastle Utd,14.9,0,0,0,0,0,0,1,0.0,1,0,0,0,0,0,7,2
2230,Pedro Porro,Tottenham,34.3,91,63,43,34,14,62,120,51.7,58,63,18,45,34,125,102,3
2231,Portu,Getafe,1.1,5,3,4,0,1,5,6,83.3,1,0,0,0,0,5,0,0
2232,Portu,Girona,13.2,18,13,3,10,5,3,18,16.7,15,9,1,8,4,22,6,0
2233,Stefan Posch,Bologna,26.8,77,46,35,38,4,49,88,55.7,39,27,8,19,18,95,72,0
2234,Yussuf Poulsen,RB Leipzig,13.5,13,8,1,9,3,4,14,28.6,10,13,3,10,4,17,15,0
2236,Jose Pozo,Rayo Vallecano,0.2,1,1,0,1,0,1,1,100.0,0,1,0,1,0,1,0,0
2237,Alejandro Pozo Pozo,Almería,10.8,19,12,11,6,2,12,20,60.0,8,14,4,10,7,26,21,0
2238,Benat Prados,Athletic Club,16.1,45,28,11,23,11,23,42,54.8,19,32,5,27,23,68,27,0
2239,Matteo Prati,Cagliari,21.9,45,25,15,27,3,26,42,61.9,16,29,6,23,15,60,26,1
2240,Abdon Prats,Mallorca,14.1,6,4,2,2,2,3,5,60.0,2,6,3,3,2,8,12,0
2241,Sanjin Prcic,Strasbourg,1.0,0,0,0,0,0,0,1,0.0,1,2,1,1,3,3,1,0
2242,Grischa Promel,Hoffenheim,23.8,32,18,11,15,6,14,32,43.8,18,22,6,16,22,54,36,0
2243,Ivan Provedel,Lazio,30.0,1,0,1,0,0,1,3,33.3,2,0,0,0,0,1,12,1
2244,Marc Pubill,Almería,20.9,47,23,35,8,4,22,39,56.4,17,20,8,12,15,62,83,1
2245,Gustavo Puerta,Leverkusen,0.5,5,3,2,2,1,1,2,50.0,1,2,0,2,0,5,0,0
2246,Antonio Puertas,Granada,8.1,12,8,6,5,1,6,15,40.0,9,5,0,5,6,18,4,0
2247,Arnau Puigmal,Almería,2.8,2,1,1,1,0,1,3,33.3,2,3,0,3,3,5,2,0
2248,Christian Pulisic,Milan,28.9,35,26,14,11,10,17,30,56.7,13,20,1,19,10,45,10,1
2249,George Puscas,Genoa,2.1,0,0,0,0,0,0,3,0.0,3,1,0,1,0,0,1,0
2250,Jarell Quansah,Liverpool,13.2,25,22,17,7,1,14,20,70.0,6,16,8,8,17,42,39,1
2251,Domingos Quina,Udinese,0.1,1,1,1,0,0,0,0,0.0,0,0,0,0,0,1,0,0
2252,Adrien Rabiot,Juventus,29.5,58,39,22,30,6,30,45,66.7,15,26,6,20,25,83,34,0
2253,Uros Racic,Sassuolo,9.1,10,4,6,4,0,0,9,0.0,9,16,7,9,7,17,22,0
2254,Nemanja Radonjic,Torino,4.2,1,1,0,0,1,1,3,33.3,2,3,0,3,0,1,0,0
2255,Nemanja Radonjic,Mallorca,3.9,4,2,1,3,0,1,4,25.0,3,2,0,2,3,7,3,0
2256,Aleksandar Radovanovic,Almería,6.3,8,7,7,1,0,6,6,100.0,0,8,8,0,11,19,48,0
2257,Ionut Radu,Bournemouth,2.0,0,0,0,0,0,0,0,0.0,0,0,0,0,0,0,0,0
2258,Boris Radunovic,Cagliari,7.0,0,0,0,0,0,0,0,0.0,0,0,0,0,1,1,1,2
2259,Hamza Rafia,Lecce,13.4,44,31,13,27,4,13,30,43.3,17,27,1,26,11,55,13,0
2260,Abdellah Raihani,Atlético Madrid,0.1,0,0,0,0,0,0,1,0.0,1,0,0,0,0,0,0,0
2262,Antonio Raillo,Mallorca,24.4,30,23,18,12,0,17,23,73.9,6,44,30,14,37,67,104,2
2263,Luca Raimund,Stuttgart,0.3,3,1,2,1,0,0,0,0.0,0,2,0,2,0,3,0,0
2264,Predrag Rajkovic,Mallorca,36.0,2,1,2,0,0,2,2,100.0,0,0,0,0,0,2,14,0
2265,Jesurun Rak Sakyi,Crystal Palace,1.5,4,1,3,1,0,2,3,66.7,1,2,0,2,3,7,1,0
2266,Ivan Rakitic,Sevilla,15.8,30,16,9,12,9,11,19,57.9,8,16,5,11,14,44,12,0
2267,Ylber Ramadani,Lecce,33.0,68,41,32,29,7,37,96,38.5,59,54,13,41,44,112,44,0
2268,Largie Ramazani,Almería,17.3,12,7,5,6,1,6,26,23.1,20,16,2,14,34,46,10,0
2269,Benito Ramirez,Las Palmas,4.3,5,3,2,3,0,3,6,50.0,3,7,1,6,3,8,0,0
2270,Sandro Ramirez,Las Palmas,20.1,12,8,4,6,2,6,15,40.0,9,13,1,12,4,16,14,1
2271,Chris Ramos,Cádiz,29.0,28,15,9,15,4,8,27,29.6,19,23,7,16,9,37,44,0
2272,Goncalo Ramos,Paris S-G,15.8,25,15,4,12,9,6,20,30.0,14,12,2,10,5,30,16,0
2273,Sergio Ramos,Sevilla,28.0,45,30,32,11,2,27,40,67.5,13,35,30,5,41,86,156,0
2274,Aaron Ramsdale,Arsenal,6.0,0,0,0,0,0,0,0,0.0,0,0,0,0,0,0,3,2
2275,Aaron Ramsey,Burnley,5.9,17,14,7,5,5,8,16,50.0,8,11,2,9,1,18,10,0
2276,Jacob Ramsey,Aston Villa,9.5,16,8,7,6,3,5,15,33.3,10,15,2,13,3,19,8,0
2277,Luca Ranieri,Fiorentina,22.9,14,10,11,1,2,8,13,61.5,5,25,11,14,29,43,64,0
2278,Filippo Ranocchia,Empoli,5.3,16,11,7,9,0,7,16,43.8,9,9,1,8,3,19,14,0
2279,Grant Ranos,Gladbach,0.5,1,0,0,0,1,0,0,0.0,0,0,0,0,0,1,0,0
2280,Raphinha,Barcelona,15.2,14,8,6,6,2,4,18,22.2,14,17,1,16,13,27,11,0
2281,Nicolai Rapp,Werder Bremen,0.8,3,2,2,1,0,2,2,100.0,0,2,0,2,2,5,8,0
2282,Elba Rashani,Clermont Foot,13.1,30,18,4,17,9,11,24,45.8,13,17,3,14,12,42,15,0
2283,Marcus Rashford,Manchester Utd,25.2,19,12,9,4,6,9,26,34.6,17,15,1,14,4,23,21,0
2284,Giacomo Raspadori,Napoli,17.6,21,10,6,10,5,6,15,40.0,9,15,1,14,3,24,7,0
2285,Andrei Ratiu,Rayo Vallecano,7.0,12,4,6,5,1,8,15,53.3,7,4,1,3,0,12,12,0
2286,Raul,Osasuna,15.1,10,4,4,2,4,2,10,20.0,8,9,1,8,5,15,11,0
2288,David Raum,RB Leipzig,30.4,58,35,24,29,5,34,58,58.6,24,51,9,42,27,85,82,2
2289,Federico Ravaglia,Bologna,5.9,0,0,0,0,0,0,0,0.0,0,0,0,0,0,0,2,0
2290,David Raya,Arsenal,32.0,1,1,1,0,0,1,1,100.0,0,0,0,0,0,1,8,5
2291,Tim Ream,Fulham,16.7,20,9,13,5,2,9,18,50.0,9,23,15,8,25,45,61,2
2292,Abderrahman Rebbach,Alavés,8.0,9,5,4,2,3,5,15,33.3,10,10,1,9,3,12,7,0
2293,Nathan Redmond,Burnley,1.6,2,1,0,0,2,1,4,25.0,3,1,0,1,0,2,3,0
2294,Harrison Reed,Fulham,14.7,29,18,9,17,3,13,31,41.9,18,19,9,10,11,40,24,0
2295,Sergio Reguilon,Manchester Utd,4.6,13,8,6,2,5,8,17,47.1,9,10,0,10,5,18,7,0
2296,Sergio Reguilon,Brentford,12.4,45,20,26,18,1,24,40,60.0,16,23,6,17,16,61,41,1
2297,Bobby Reid,Fulham,15.8,22,14,5,15,2,4,16,25.0,12,24,2,22,5,27,14,0
2298,Tijjani Reijnders,Milan,31.3,46,25,10,31,5,21,43,48.8,22,26,8,18,18,64,26,0
2299,Pepe Reina,Villarreal,2.0,0,0,0,0,0,0,0,0.0,0,0,0,0,0,0,1,0
2300,Reinier,Frosinone,11.8,21,10,6,12,3,5,17,29.4,12,24,4,20,10,31,5,0
2301,Rocco Reitz,Gladbach,23.7,61,36,28,29,4,28,55,50.9,27,61,20,41,44,105,31,1
2302,Alex Remiro,Real Sociedad,36.4,0,0,0,0,0,0,0,0.0,0,0,0,0,0,0,24,2
2303,Guillaume Restes,Toulouse,34.0,0,0,0,0,0,0,3,0.0,3,0,0,0,0,0,19,1
2304,Mateo Retegui,Genoa,24.6,17,9,7,8,2,6,20,30.0,14,18,2,16,0,17,30,0
2305,Marco Reus,Dortmund,17.8,37,25,20,14,3,12,27,44.4,15,17,2,15,5,42,18,0
2306,Elvis Rexhbecaj,Augsburg,22.1,30,19,14,13,3,18,36,50.0,18,32,7,25,20,50,20,0
2307,Gio Reyna,Nott'ham Forest,2.6,7,3,4,0,3,3,6,50.0,3,3,0,3,2,9,0,0
2308,Gio Reyna,Dortmund,3.1,9,6,3,4,2,2,5,40.0,3,5,1,4,2,11,5,0
2309,Chadi Riad,Betis,24.0,35,24,17,18,0,17,27,63.0,10,23,14,9,23,58,108,0
2310,Alexsandro Ribeiro,Lille,24.7,32,22,24,8,0,16,31,51.6,15,25,15,10,35,67,116,5
2311,Rodrigo Ribeiro,Nott'ham Forest,0.2,0,0,0,0,0,0,1,0.0,1,1,0,1,1,1,0,0
2312,Samuele Ricci,Torino,26.6,33,18,17,12,4,15,23,65.2,8,21,3,18,27,60,25,0
2314,Declan Rice,Arsenal,35.8,83,51,37,38,8,32,57,56.1,25,37,11,26,44,127,52,0
2315,Chris Richards,Crystal Palace,23.3,46,28,21,22,3,20,30,66.7,10,32,12,20,27,73,109,0
2316,Amir Richardson,Reims,15.0,33,23,12,18,3,10,22,45.5,12,26,5,21,15,48,30,0
2317,Richarlison,Tottenham,16.6,16,11,4,8,4,2,10,20.0,8,32,6,26,8,24,23,0
2318,Marco Richter,Mainz 05,8.0,10,4,5,3,2,4,11,36.4,7,9,0,9,2,12,1,0
2319,Diego Rico,Getafe,28.2,64,48,32,23,9,41,76,53.9,35,25,8,17,41,105,76,0
2320,Clemens Riedel,Darmstadt 98,8.4,22,13,16,5,1,15,24,62.5,9,11,3,8,11,33,26,0
2321,Fabian Rieder,Rennes,4.1,13,7,2,9,2,6,11,54.5,5,3,1,2,5,18,2,0
2322,Jairo Riedewald,Crystal Palace,2.6,9,3,2,4,3,3,6,50.0,3,0,0,0,2,11,2,0
2323,Manuel Riemann,Bochum,33.0,2,1,2,0,0,2,4,50.0,2,0,0,0,1,3,25,1
2324,Luis Rioja,Alavés,27.8,27,19,10,12,5,14,43,32.6,29,28,1,27,16,43,28,0
2325,Remy Riou,Lyon,3.0,0,0,0,0,0,0,1,0.0,1,0,0,0,0,0,1,1
2326,Rodrigo Riquelme,Atlético Madrid,17.0,30,19,18,4,8,18,46,39.1,28,19,0,19,9,39,20,0
2327,Alberto Risco,Getafe,1.5,2,2,1,1,0,0,4,0.0,4,0,0,0,0,2,1,0
2328,Mihailo Ristic,Celta Vigo,9.0,15,9,9,6,0,9,12,75.0,3,9,2,7,10,25,23,0
2329,Matt Ritchie,Newcastle Utd,1.4,5,3,2,2,1,2,4,50.0,2,3,2,1,1,6,5,0
2330,Gorka Rivera Alonso,Getafe,0.0,0,0,0,0,0,0,0,0.0,0,0,0,0,0,0,0,0
2331,Sergi Roberto,Barcelona,9.6,15,10,4,10,1,3,11,27.3,8,7,2,5,8,23,7,1
2332,Lucas Robertone,Almería,26.5,61,33,28,23,10,25,50,50.0,25,43,9,34,51,112,43,0
2333,Connor Roberts,Burnley,9.1,12,5,6,4,2,8,17,47.1,9,8,6,2,4,16,25,2
2334,Andrew Robertson,Liverpool,18.8,35,24,21,11,3,26,43,60.5,17,20,6,14,13,48,40,0
2335,Antonee Robinson,Fulham,36.3,93,58,60,26,7,52,110,47.3,58,56,8,48,80,173,117,3
2336,Jack Robinson,Sheffield Utd,32.1,43,28,29,14,0,25,39,64.1,14,49,33,16,33,76,132,2
2337,Marc Roca,Betis,22.0,52,36,17,29,6,30,53,56.6,23,29,6,23,17,69,23,1
2338,Sebastian Rode,Eint Frankfurt,0.7,6,4,0,5,1,4,6,66.7,2,0,0,0,1,7,1,0
2340,Sergio Rodelas,Granada,1.4,3,2,1,0,2,0,3,0.0,3,0,0,0,0,3,0,0
2341,Rodri,Manchester City,32.6,70,43,25,33,12,29,60,48.3,31,32,8,24,26,96,41,4
2342,Rodri,Betis,11.7,17,10,6,7,4,8,21,38.1,13,11,0,11,8,25,2,0
2343,Oscar Rodriguez Arnaiz,Getafe,10.7,24,13,2,15,7,9,15,60.0,6,12,1,11,5,29,5,0
2344,Damian Rodriguez,Celta Vigo,2.9,6,3,1,3,2,1,3,33.3,2,4,2,2,1,7,2,0
2345,Dani Rodriguez,Mallorca,29.1,47,24,21,20,6,21,45,46.7,24,34,5,29,15,62,21,0
2346,Guido Rodriguez,Betis,20.5,53,30,21,24,8,34,55,61.8,21,27,6,21,29,82,44,0
2347,Jay Rodriguez,Burnley,9.1,14,9,7,4,3,7,13,53.8,6,11,1,10,1,15,8,0
2348,Kirian Rodriguez,Las Palmas,35.7,52,32,22,25,5,24,67,35.8,43,39,3,36,28,80,23,1
2349,Miguel Rodriguez,Celta Vigo,3.3,6,3,3,1,2,3,9,33.3,6,8,0,8,4,10,0,0
2350,Ricardo Rodriguez,Torino,30.8,45,26,21,22,2,28,45,62.2,17,22,9,13,24,69,64,2
2351,Rodrygo,Real Madrid,26.4,16,15,2,9,5,5,19,26.3,14,14,0,14,8,24,6,0
2352,Mads Roerslev,Brentford,22.1,48,31,34,9,5,27,54,50.0,27,15,3,12,19,67,71,0
2353,Rogerio,Wolfsburg,10.1,14,6,7,5,2,10,14,71.4,4,16,5,11,5,19,23,1
2354,Morgan Rogers,Aston Villa,7.1,8,1,3,2,3,2,11,18.2,9,11,0,11,3,11,11,0
2355,Merlin Rohl,Freiburg,16.4,21,13,10,9,2,8,21,38.1,13,27,3,24,9,30,22,0
2356,Alessio Romagnoli,Lazio,26.8,25,18,14,11,0,16,24,66.7,8,29,17,12,29,54,115,0
2357,Simone Romagnoli,Frosinone,30.2,35,15,23,11,1,15,20,75.0,5,51,36,15,29,64,147,0
2358,Carlos Romero,Villarreal,2.9,11,5,8,1,2,7,12,58.3,5,3,0,3,1,12,11,0
2359,Cristian Romero,Tottenham,31.0,66,40,35,25,6,32,44,72.7,12,46,22,24,44,110,106,1
2360,Luka Romero,Milan,1.0,0,0,0,0,0,0,3,0.0,3,2,0,2,0,0,0,0
2361,Luka Romero,Almería,4.9,5,1,2,3,0,2,4,50.0,2,12,1,11,1,6,2,1
2362,Oriol Romeu,Barcelona,10.4,34,20,17,14,3,13,24,54.2,11,12,2,10,10,44,18,0
2363,Valentin Rongier,Marseille,9.5,23,12,9,12,2,14,26,53.8,12,16,4,12,15,38,18,0
2364,Frank Ronstadt,Darmstadt 98,0.8,1,0,0,1,0,0,1,0.0,1,1,0,1,1,2,3,0
2366,Marten de Roon,Atalanta,28.9,80,43,36,32,12,35,82,42.7,47,36,10,26,40,120,54,0
2367,Unai Ropero,Alavés,0.1,0,0,0,0,0,0,0,0.0,0,0,0,0,0,0,0,0
2368,Vitor Roque,Barcelona,3.6,3,2,2,0,1,0,2,0.0,2,3,0,3,0,3,5,0
2369,Pablo Rosario,Nice,22.3,36,25,15,16,5,23,34,67.6,11,27,13,14,29,65,39,0
2370,Valentin Rosier,Nice,0.6,1,0,1,0,0,0,0,0.0,0,1,0,1,2,3,5,0
2371,Francesco Rossi,Atalanta,0.1,0,0,0,0,0,0,0,0.0,0,0,0,0,0,0,0,0
2372,Joe Rothwell,Bournemouth,4.3,7,2,4,2,1,2,8,25.0,6,4,2,2,3,10,2,0
2373,Anthony Rouault,Stuttgart,11.2,21,12,14,5,2,13,21,61.9,8,14,8,6,8,29,28,0
2374,Jerome Roussillon,Union Berlin,8.4,16,9,6,7,3,8,12,66.7,4,13,4,9,5,21,26,0
2375,Nicolo Rovella,Lazio,14.6,46,28,25,17,4,16,36,44.4,20,27,6,21,23,69,29,0
2376,Amir Rrahmani,Napoli,28.9,33,27,17,14,2,16,32,50.0,16,24,10,14,20,53,90,0
2377,Ruan,Sassuolo,16.8,25,15,11,10,4,10,18,55.6,8,18,15,3,24,49,68,2
2378,Pelly Ruddock Mpanzu,Luton Town,12.2,13,5,6,6,1,5,9,55.6,4,15,7,8,9,22,16,3
2379,Antonio Rudiger,Real Madrid,30.1,26,15,18,4,4,16,20,80.0,4,27,20,7,11,37,89,0
2380,Fabian Rudlin,Freiburg,0.1,1,0,0,0,1,0,0,0.0,0,0,0,0,0,1,0,0
2381,Javier Rueda Garcia,Celta Vigo,0.2,0,0,0,0,0,0,0,0.0,0,0,0,0,0,0,0,0
2382,Daniele Rugani,Juventus,13.2,11,9,7,3,1,4,5,80.0,1,11,4,7,9,20,42,0
2383,Matteo Ruggeri,Atalanta,27.2,29,15,14,7,8,16,30,53.3,14,46,4,42,23,52,44,0
2384,Mario Rui,Napoli,13.4,27,15,17,5,5,14,21,66.7,7,17,2,15,15,42,19,0
2385,Aitor Ruibal,Betis,11.3,46,27,28,13,5,32,59,54.2,27,12,1,11,14,60,33,1
2386,Fabian Ruiz Pena,Paris S-G,13.3,34,23,17,14,3,23,42,54.8,19,8,2,6,11,45,21,2
2387,Sergio Ruiz,Granada,27.7,83,46,43,36,4,38,84,45.2,46,24,6,18,28,111,43,1
2388,Julian Ryerson,Dortmund,19.6,41,23,26,11,4,27,47,57.4,20,31,7,24,10,51,35,3
2389,Frederik Ronnow,Union Berlin,33.0,1,1,1,0,0,0,0,0.0,0,0,0,0,1,2,20,2
2390,Jose Sa,Wolves,33.7,0,0,0,0,0,0,1,0.0,1,3,0,3,0,0,21,5
2392,Youssouf Sabaly,Betis,11.6,16,11,12,3,1,8,12,66.7,4,6,3,3,11,27,27,0
2393,Emmanuel Sabbi,Le Havre,17.6,38,19,15,15,8,16,39,41.0,23,26,2,24,19,57,7,0
2394,Stefano Sabelli,Genoa,27.0,50,24,28,19,3,15,46,32.6,31,27,6,21,23,73,35,0
2395,Marcel Sabitzer,Dortmund,21.8,39,24,18,20,1,23,42,54.8,19,31,12,19,12,51,34,0
2396,Falaye Sacko,Montpellier,15.4,28,16,13,10,5,21,32,65.6,11,19,7,12,24,52,37,0
2397,Dominic Sadi,Bournemouth,0.0,0,0,0,0,0,0,0,0.0,0,0,0,0,0,0,0,0
2398,Umar Sadiq,Real Sociedad,12.0,15,10,2,8,5,4,8,50.0,4,9,0,9,0,15,10,0
2399,Alexis Saelemaekers,Bologna,21.0,32,22,13,14,5,12,27,44.4,15,13,1,12,13,45,10,1
2400,Pablo Saenz,Granada,0.2,3,3,2,0,1,1,3,33.3,2,0,0,0,0,3,0,0
2401,Modibo Sagnan,Montpellier,11.7,34,22,23,9,2,15,25,60.0,10,13,9,4,15,49,67,0
2402,Wesley Said,Lens,11.3,8,4,1,2,5,2,9,22.2,7,4,0,4,4,12,3,0
2403,Theo Sainte-Luce,Montpellier,3.8,17,7,10,6,1,11,19,57.9,8,9,4,5,3,20,15,0
2404,Bukayo Saka,Arsenal,32.4,66,35,22,24,20,26,59,44.1,33,43,2,41,15,81,24,1
2405,Mamadou Sakho,Montpellier,0.1,1,1,1,0,0,1,1,100.0,0,0,0,0,0,1,1,0
2406,Ibrahim Salah,Rennes,5.8,15,7,5,6,4,11,18,61.1,7,4,0,4,10,25,5,0
2407,Mohamed Salah,Liverpool,28.2,17,11,1,8,8,6,21,28.6,15,19,1,18,2,19,1,0
2408,Amine Salama,Reims,3.5,0,0,0,0,0,0,0,0.0,0,1,0,1,1,1,1,0
2409,Kike Salas,Sevilla,17.8,41,23,26,12,3,22,36,61.1,14,25,14,11,26,67,91,1
2410,William Saliba,Arsenal,38.0,41,26,28,12,1,20,27,74.1,7,32,17,15,29,70,81,3
2411,Mohammed Salisu,Monaco,11.5,27,12,11,13,3,17,26,65.4,9,21,12,9,22,49,44,0
2412,Roland Sallai,Freiburg,20.4,17,10,5,5,7,8,20,40.0,12,21,1,20,6,23,23,0
2413,Yoann Salmier,Le Havre,17.4,22,10,13,6,3,13,20,65.0,7,21,15,6,21,43,57,0
2414,Salvi,Rayo Vallecano,0.3,0,0,0,0,0,0,4,0.0,4,0,0,0,1,1,0,0
2415,Lazar Samardzic,Udinese,26.4,40,19,18,18,4,16,39,41.0,23,26,6,20,10,50,25,0
2416,Diadie Samassekou,Cádiz,1.0,5,3,2,2,1,5,6,83.3,1,0,0,0,3,8,1,0
2418,Diadie Samassekou,Hoffenheim,0.0,0,0,0,0,0,0,0,0.0,0,0,0,0,1,1,0,0
2419,Mama Samba Balde,Lyon,6.1,8,5,1,2,5,3,9,33.3,6,0,0,0,3,11,1,1
2420,Brice Samba,Lens,33.0,1,1,1,0,0,1,1,100.0,0,0,0,0,0,1,10,3
2421,Albert Sambi Lokonga,Luton Town,14.5,29,18,14,12,3,17,24,70.8,7,23,13,10,11,40,14,0
2422,Junior Sambia,Salernitana,11.5,12,5,8,1,3,6,11,54.5,5,15,7,8,11,23,28,0
2423,Fede San Emeterio,Cádiz,1.7,3,2,2,1,0,1,4,25.0,3,3,2,1,2,5,1,0
2424,Antonio Sanabria,Torino,23.7,18,15,5,9,4,4,9,44.4,5,7,1,6,6,24,12,0
2425,Oihan Sancet,Athletic Club,21.9,19,11,3,10,6,8,21,38.1,13,5,1,4,10,29,5,0
2426,Renato Sanches,Roma,1.6,2,1,1,1,0,2,3,66.7,1,2,0,2,0,2,1,0
2427,Ricard Sanchez,Granada,25.5,29,18,15,8,6,12,24,50.0,12,32,4,28,13,42,64,0
2428,Alexis Sanchez,Inter,8.5,7,6,0,5,2,1,4,25.0,3,4,1,3,1,8,3,0
2429,Antonio Sanchez,Mallorca,16.1,25,11,13,10,2,11,32,34.4,21,24,5,19,13,38,13,0
2430,Davinson Sanchez,Tottenham,0.9,0,0,0,0,0,0,0,0.0,0,3,2,1,1,1,2,0
2431,Juanlu Sanchez,Sevilla,13.1,56,35,34,18,4,34,58,58.6,24,24,7,17,12,68,36,0
2432,Manu Sanchez,Celta Vigo,19.7,54,28,21,25,8,31,55,56.4,24,23,3,20,19,73,65,0
2433,Robert Sanchez,Chelsea,15.9,0,0,0,0,0,0,0,0.0,0,0,0,0,0,0,11,3
2434,Jadon Sancho,Manchester Utd,0.9,1,0,1,0,0,1,3,33.3,2,1,0,1,1,2,0,0
2435,Jadon Sancho,Dortmund,10.5,5,4,1,3,1,0,4,0.0,4,11,0,11,4,9,6,0
2436,Alex Sandro,Juventus,8.0,13,7,7,6,0,4,5,80.0,1,13,7,6,15,28,23,0
2437,Ibou Sane,Metz,1.4,6,4,2,1,3,2,2,100.0,0,3,0,3,1,7,2,0
2438,Leroy Sane,Bayern Munich,23.7,15,8,6,6,3,4,19,21.1,15,12,0,12,7,22,3,0
2439,Sadibou Sane,Metz,9.4,19,12,16,2,1,6,7,85.7,1,14,9,5,8,27,64,0
2440,Arouna Sangante,Le Havre,29.9,53,33,27,23,3,24,40,60.0,16,35,18,17,66,119,93,2
2441,Ibrahim Sangare,Nott'ham Forest,11.5,42,23,25,13,4,12,29,41.4,17,24,7,17,16,58,21,0
2442,Morgan Sanson,Nice,21.8,26,19,12,7,7,12,31,38.7,19,34,5,29,20,46,16,0
2444,Nicola Sansone,Lecce,8.5,11,6,6,2,3,5,16,31.3,11,7,1,6,4,15,5,2
2445,Baptiste Santamaria,Rennes,21.4,52,33,21,25,6,29,46,63.0,17,15,6,9,34,86,33,1
2446,Jesus Santiago,Getafe,7.3,17,8,8,5,4,4,7,57.1,3,3,0,3,0,17,8,0
2447,Andrey Santos,Nott'ham Forest,0.1,0,0,0,0,0,0,0,0.0,0,1,0,1,0,0,0,0
2448,Andrey Santos,Strasbourg,9.2,29,18,15,13,1,17,26,65.4,9,8,0,8,10,39,11,1
2449,Tiago Santos,Lille,26.3,63,42,31,19,13,30,52,57.7,22,24,5,19,15,78,37,0
2450,Paco Sanz,Almería,0.3,0,0,0,0,0,0,1,0.0,1,0,0,0,0,0,4,0
2451,Riccardo Saponara,Hellas Verona,3.8,3,1,2,0,1,1,7,14.3,6,4,0,4,0,3,2,0
2452,Pablo Sarabia,Wolves,19.4,20,13,8,8,4,12,36,33.3,24,17,1,16,10,30,9,0
2453,Amin Sarr,Lyon,1.1,1,0,0,1,0,0,0,0.0,0,1,0,1,0,1,1,0
2454,Amin Sarr,Wolfsburg,4.3,3,2,1,2,0,1,2,50.0,1,6,1,5,2,5,1,0
2455,Bouna Sarr,Bayern Munich,1.2,2,0,1,1,0,2,2,100.0,0,3,0,3,0,2,1,0
2456,Ismaila Sarr,Marseille,16.1,14,8,2,10,2,6,17,35.3,11,21,6,15,13,27,11,0
2457,Mamadou Sarr,Lyon,0.1,0,0,0,0,0,0,0,0.0,0,0,0,0,0,0,0,0
2458,Martin Satriano,Brest,20.7,24,16,6,13,5,10,25,40.0,15,19,7,12,7,31,28,0
2459,Teji Savanier,Montpellier,30.7,37,20,16,15,6,14,63,22.2,49,36,8,28,33,70,28,1
2460,Stefan Savic,Atlético Madrid,18.1,27,19,16,7,4,15,30,50.0,15,29,15,14,27,54,61,1
2461,Savio,Girona,33.1,42,25,14,22,6,16,28,57.1,12,34,0,34,18,60,11,1
2462,Zanos Savva,Torino,0.3,1,1,0,1,0,1,3,33.3,2,0,0,0,0,1,1,0
2463,Saba Sazonov,Torino,4.0,9,7,4,5,0,3,3,100.0,0,8,5,3,3,12,22,0
2464,Joe Scally,Gladbach,24.8,41,28,21,17,3,23,40,57.5,17,31,11,20,18,59,78,2
2465,Giorgio Scalvini,Atalanta,28.3,53,33,29,19,5,19,40,47.5,21,44,17,27,59,112,71,0
2466,Gianluca Scamacca,Atalanta,16.1,15,9,4,5,6,7,14,50.0,7,7,1,6,4,19,9,0
2467,Dane Scarlett,Tottenham,0.2,1,1,0,0,1,0,1,0.0,1,0,0,0,0,1,0,0
2468,Kevin Schade,Brentford,3.7,3,1,1,2,0,0,5,0.0,5,2,0,2,1,4,4,0
2470,Andras Schafer,Union Berlin,13.5,29,16,9,15,5,11,20,55.0,9,25,4,21,20,49,25,0
2471,Fabian Schar,Newcastle Utd,33.9,42,24,27,13,2,18,40,45.0,22,50,38,12,36,78,133,1
2472,Patrik Schick,Leverkusen,11.8,6,4,0,3,3,1,5,20.0,4,2,0,2,1,7,7,0
2473,Stefan Schimmer,Heidenheim,1.7,1,1,0,1,0,0,3,0.0,3,2,0,2,1,2,6,0
2474,Xaver Schlager,RB Leipzig,27.5,81,50,35,38,8,21,53,39.6,32,41,8,33,19,100,27,0
2475,Keven Schlotterbeck,Bochum,24.3,42,22,26,14,2,25,30,83.3,5,33,23,10,33,75,104,2
2476,Nico Schlotterbeck,Dortmund,31.8,70,50,36,27,7,41,65,63.1,24,52,25,27,45,115,101,3
2477,Jeffrey Schlupp,Crystal Palace,15.0,38,24,14,16,8,9,18,50.0,9,13,2,11,8,46,24,0
2478,Romano Schmid,Werder Bremen,28.9,35,20,7,22,6,14,46,30.4,32,36,7,29,11,46,17,2
2479,Kenneth Schmidt,Freiburg,0.8,2,2,2,0,0,2,4,50.0,2,1,0,1,1,3,2,0
2480,Niklas Schmidt,Toulouse,14.1,36,21,13,19,4,16,33,48.5,17,14,7,7,4,40,13,0
2481,Benno Schmitz,Köln,12.8,27,15,20,7,0,17,34,50.0,17,19,4,15,7,34,29,0
2482,Fabian Schnellhardt,Darmstadt 98,2.6,4,1,2,1,1,1,3,33.3,2,1,0,1,4,8,5,0
2483,Jan Schoppner,Heidenheim,22.2,48,26,26,20,2,21,42,50.0,21,37,7,30,26,74,57,0
2484,Marcel Schuhen,Darmstadt 98,31.0,1,0,1,0,0,1,3,33.3,2,0,0,0,2,3,11,4
2485,Perr Schuurs,Torino,8.6,20,12,11,8,1,3,9,33.3,6,10,2,8,9,29,23,0
2486,Marvin Schwabe,Köln,34.0,1,0,1,0,0,1,1,100.0,0,0,0,0,0,1,10,1
2487,Alexander Schwolow,Union Berlin,1.0,0,0,0,0,0,0,0,0.0,0,0,0,0,0,0,2,0
2488,Alex Scott,Bournemouth,11.3,24,15,8,10,6,12,28,42.9,16,14,4,10,12,36,18,2
2489,Simone Scuffet,Cagliari,31.0,1,0,1,0,0,1,2,50.0,1,1,0,1,1,2,9,0
2490,Jeremy Sebas,Strasbourg,4.4,7,1,2,3,2,3,5,60.0,2,3,1,2,1,8,1,0
2491,Manuel Sebastian,Sevilla,1.3,4,2,4,0,0,3,3,100.0,0,3,0,3,0,4,1,0
2492,Demba Seck,Torino,4.7,5,3,1,4,0,3,4,75.0,1,1,0,1,1,6,0,0
2493,Demba Seck,Frosinone,3.3,7,4,2,3,2,4,5,80.0,1,3,0,3,1,8,1,0
2494,Aleksandar Sedlar,Alavés,10.5,14,10,10,4,0,10,16,62.5,6,8,4,4,13,27,43,0
2496,Alidu Seidu,Rennes,6.6,21,9,17,3,1,14,19,73.7,5,11,3,8,10,31,13,0
2497,Alidu Seidu,Clermont Foot,12.6,32,24,17,15,0,24,31,77.4,7,15,7,8,25,57,37,0
2498,Nicolas Seiwald,RB Leipzig,8.0,33,18,16,15,2,16,25,64.0,9,12,2,10,8,41,15,0
2499,Nikola Sekulov,Juventus,0.1,0,0,0,0,0,0,0,0.0,0,0,0,0,0,0,0,0
2500,Davie Selke,Köln,14.1,4,2,1,3,0,0,2,0.0,2,5,3,2,0,4,20,0
2501,Matz Sels,Nott'ham Forest,16.0,0,0,0,0,0,0,0,0.0,0,0,0,0,0,0,11,1
2502,Matz Sels,Strasbourg,19.0,0,0,0,0,0,0,0,0.0,0,2,0,2,0,0,13,1
2503,Nelson Semedo,Wolves,34.3,79,48,52,19,8,38,64,59.4,26,44,8,36,36,115,85,1
2504,Vivaldo Semedo,Udinese,0.1,0,0,0,0,0,0,0,0.0,0,0,0,0,0,0,0,0
2505,Antoine Semenyo,Bournemouth,23.4,24,17,7,9,8,9,27,33.3,18,39,2,37,6,30,21,0
2506,Marvin Senaya,Strasbourg,23.8,72,53,38,25,9,42,68,61.8,26,40,13,27,41,113,68,0
2507,Marcos Senesi,Bournemouth,24.9,55,32,28,23,4,24,56,42.9,32,50,23,27,35,90,109,1
2508,Stefano Sensi,Inter,0.5,1,1,0,1,0,1,3,33.3,2,1,0,1,1,2,0,0
2509,Suat Serdar,Hellas Verona,18.4,51,39,24,23,4,22,45,48.9,23,29,7,22,20,71,25,1
2510,Benjamin Sesko,RB Leipzig,17.0,13,5,2,7,4,2,9,22.2,7,23,2,21,3,16,27,0
2511,Kevin Sessa,Heidenheim,11.2,17,10,9,6,2,7,16,43.8,9,12,1,11,4,21,17,0
2512,Aaron Seydel,Darmstadt 98,6.9,3,2,0,2,1,0,3,0.0,3,8,2,6,1,4,9,0
2513,Andres Sfait,Salernitana,0.3,1,1,1,0,0,1,2,50.0,1,0,0,0,0,1,0,0
2514,Stephan El Shaarawy,Roma,19.3,21,13,14,4,3,6,15,40.0,9,11,4,7,13,34,15,2
2515,Luke Shaw,Manchester Utd,10.7,11,8,7,3,1,9,15,60.0,6,18,11,7,6,17,39,0
2516,James Shea,Luton Town,0.2,0,0,0,0,0,0,0,0.0,0,0,0,0,0,0,2,0
2517,Eldor Shomurodov,Cagliari,10.4,11,4,2,6,3,6,10,60.0,4,5,0,5,4,15,4,0
2518,Steven Shpendi,Empoli,4.6,0,0,0,0,0,0,4,0.0,4,2,1,1,1,1,0,0
2519,Sofiane Sidi Ali,Marseille,0.2,2,0,0,2,0,1,2,50.0,1,1,0,1,2,4,0,0
2520,Vincent Sierro,Toulouse,25.1,41,24,15,20,6,27,77,35.1,50,37,13,24,27,68,33,0
2522,Tim Siersleben,Heidenheim,10.1,27,11,21,6,0,8,20,40.0,12,16,10,6,21,48,29,1
2523,Kiliann Sildillia,Freiburg,20.1,43,19,28,8,7,26,42,61.9,16,33,15,18,22,65,64,0
2524,Andre Silva,Real Sociedad,8.1,2,2,0,0,2,0,4,0.0,4,3,0,3,1,3,3,0
2525,Bernardo Silva,Manchester City,28.6,51,23,13,25,13,25,57,43.9,32,32,4,28,17,68,15,1
2526,Caio Henrique Oliveira Silva,Monaco,6.9,13,7,3,7,3,6,9,66.7,3,8,2,6,6,19,9,0
2527,Fabio Silva,Wolves,2.9,7,4,3,4,0,2,3,66.7,1,1,0,1,2,9,0,0
2528,Rui Silva,Betis,27.5,0,0,0,0,0,0,3,0.0,3,0,0,0,1,1,13,1
2529,Thiago Silva,Chelsea,28.1,29,15,22,6,1,20,34,58.8,14,33,24,9,26,55,153,4
2530,Marco Silvestri,Udinese,17.0,0,0,0,0,0,0,3,0.0,3,1,0,1,0,0,5,3
2531,Mohamed Simakan,RB Leipzig,23.8,48,29,28,19,1,32,44,72.7,12,36,14,22,29,77,69,0
2532,Giovanni Simeone,Napoli,8.9,12,4,1,3,8,3,12,25.0,9,11,0,11,1,13,7,0
2533,Giuliano Simeone,Alavés,7.0,7,5,2,3,2,5,17,29.4,12,10,0,10,5,12,3,0
2534,Jan-Carlo Simic,Milan,1.6,1,1,1,0,0,0,0,0.0,0,5,4,1,0,1,3,0
2535,Moses Simon,Nantes,19.9,7,5,2,5,0,2,8,25.0,6,9,1,8,3,10,5,1
2536,Unai Simon,Athletic Club,35.4,2,1,1,1,0,2,3,66.7,1,0,0,0,1,3,9,0
2537,Xavi Simons,RB Leipzig,29.5,30,17,10,11,9,15,31,48.4,16,23,0,23,16,46,4,0
2538,Wilfried Singo,Monaco,24.3,34,25,18,14,2,17,26,65.4,9,27,14,13,51,85,81,2
2539,Luis Sinisterra,Bournemouth,7.8,23,12,9,10,4,9,16,56.3,7,18,0,18,8,31,4,0
2540,Daley Sinkgraven,Las Palmas,4.3,11,5,6,5,0,2,8,25.0,6,5,3,2,6,17,9,0
2541,Jailson Siqueira,Celta Vigo,10.0,27,18,22,5,0,13,24,54.2,11,13,5,8,12,39,32,0
2542,Ayanda Sishuba,Lens,0.7,3,1,0,2,1,1,2,50.0,1,1,0,1,0,3,0,0
2543,Ibrahima Sissoko,Strasbourg,18.2,47,33,13,25,9,23,30,76.7,7,21,8,13,19,66,30,0
2544,Moussa Sissoko,Nantes,20.2,27,16,13,8,6,12,25,48.0,13,8,2,6,12,39,31,0
2545,Antonio Sivera,Alavés,34.0,0,0,0,0,0,0,1,0.0,1,0,0,0,0,0,17,1
2546,Tim Skarke,Darmstadt 98,26.7,26,16,12,10,4,10,28,35.7,18,25,2,23,6,32,20,0
2548,Ellyes Skhiri,Eint Frankfurt,24.1,44,24,18,19,7,19,36,52.8,17,33,4,29,39,83,47,2
2549,Oliver Skipp,Tottenham,7.9,18,12,9,6,3,11,18,61.1,7,12,1,11,3,21,9,0
2550,Leo Skiri Ostigard,Napoli,18.1,24,12,13,10,1,6,11,54.5,5,18,12,6,16,40,65,0
2551,Lukasz Skorupski,Bologna,32.0,2,2,2,0,0,2,3,66.7,1,0,0,0,1,3,11,3
2552,Robert Skov,Hoffenheim,14.0,24,16,15,8,1,17,36,47.2,19,17,4,13,10,34,23,1
2553,Milan Skriniar,Paris S-G,18.1,24,18,17,7,0,14,22,63.6,8,19,10,9,12,36,51,2
2554,Naatan Skytta,Toulouse,1.3,4,4,2,1,1,1,1,100.0,0,0,0,0,0,4,0,0
2555,Chris Smalling,Roma,4.3,1,1,1,0,0,1,4,25.0,3,6,5,1,5,6,8,0
2556,Adam Smith,Bournemouth,23.9,37,23,18,11,8,19,39,48.7,20,28,11,17,21,58,62,0
2557,Emile Smith Rowe,Arsenal,3.9,4,1,2,2,0,2,4,50.0,2,3,1,2,3,7,1,0
2558,Hrvoje Smolcic,Eint Frankfurt,3.9,7,3,7,0,0,4,5,80.0,1,3,1,2,6,13,23,1
2559,Cedric Soares,Arsenal,0.7,0,0,0,0,0,0,0,0.0,0,0,0,0,0,0,0,0
2560,Danilo Soares,Bochum,3.9,10,6,5,3,2,5,8,62.5,3,6,0,6,7,17,11,0
2561,Eduard Sobol,Strasbourg,0.3,0,0,0,0,0,0,0,0.0,0,0,0,0,0,0,1,0
2562,Ruben Sobrino,Cádiz,18.3,52,28,18,26,8,22,51,43.1,29,26,2,24,16,68,18,0
2563,Andrea Sodero,Empoli,0.1,0,0,0,0,0,0,0,0.0,0,0,0,0,0,0,0,0
2564,Emran Soglo,Marseille,1.2,2,1,0,2,0,1,3,33.3,2,6,0,6,1,3,3,0
2565,Alex Sola,Alavés,14.0,27,15,11,9,7,14,26,53.8,12,18,2,16,11,38,16,0
2566,Alex Sola,Real Sociedad,0.3,0,0,0,0,0,0,0,0.0,0,0,0,0,1,1,2,0
2567,Dominic Solanke,Bournemouth,36.9,23,11,3,13,7,10,29,34.5,19,24,5,19,7,30,43,0
2568,Ola Solbakken,Roma,0.3,0,0,0,0,0,0,0,0.0,0,0,0,0,0,0,0,0
2569,Carlos Soler,Paris S-G,12.1,15,10,9,2,4,6,21,28.6,15,10,3,7,5,20,11,1
2570,Jhon Solis,Girona,4.3,10,8,4,5,1,4,12,33.3,8,8,3,5,8,18,7,1
2571,Manor Solomon,Tottenham,2.2,3,3,1,1,1,1,2,50.0,1,4,0,4,3,6,2,0
2572,Daniele Sommariva,Genoa,0.1,0,0,0,0,0,0,0,0.0,0,0,0,0,0,0,0,0
2574,Yann Sommer,Inter,34.0,2,1,2,0,0,2,2,100.0,0,1,0,1,0,2,7,1
2575,Brandon Soppy,Torino,2.0,2,2,1,1,0,2,6,33.3,4,2,0,2,0,2,3,1
2576,David Soria,Getafe,37.9,0,0,0,0,0,0,2,0.0,2,0,0,0,0,0,21,6
2577,Alberto Soro,Granada,0.1,0,0,0,0,0,0,0,0.0,0,0,0,0,0,0,0,0
2578,Alessandro Sorrentino,Monza,6.1,0,0,0,0,0,0,0,0.0,0,0,0,0,0,0,0,0
2579,Borna Sosa,Stuttgart,0.5,0,0,0,0,0,0,1,0.0,1,0,0,0,0,0,0,0
2580,Hugo Sotelo,Celta Vigo,8.0,19,17,3,13,3,8,20,40.0,12,7,1,6,2,21,5,0
2581,Florian Sotoca,Lens,28.9,33,22,9,21,3,17,38,44.7,21,41,4,37,20,53,34,0
2582,Riccardo Sottil,Fiorentina,12.3,10,5,5,1,4,3,8,37.5,5,12,0,12,2,12,2,0
2583,Tomas Soucek,West Ham,31.9,53,35,24,26,3,21,47,44.7,26,55,28,27,37,90,109,0
2584,Matias Soule,Frosinone,34.7,41,27,12,14,15,19,40,47.5,21,38,4,34,18,59,9,0
2585,Boubakary Soumare,Sevilla,25.4,39,28,24,14,1,14,26,53.8,12,25,7,18,26,65,20,1
2586,Issa Soumare,Le Havre,2.6,2,0,2,0,0,0,4,0.0,4,0,0,0,0,2,2,0
2587,Vinicius Souza,Sheffield Utd,29.6,125,76,59,51,15,41,74,55.4,33,57,17,40,32,157,75,1
2588,Djibril Sow,Sevilla,16.2,28,21,15,8,5,9,25,36.0,16,20,3,17,17,45,8,1
2589,Saidou Sow,Strasbourg,8.0,20,12,17,3,0,9,13,69.2,4,7,4,3,12,32,36,3
2590,Caglar Soyuncu,Atlético Madrid,1.3,1,1,1,0,0,0,0,0.0,0,1,0,1,1,2,7,0
2591,Djed Spence,Genoa,9.5,16,10,12,4,0,8,10,80.0,2,20,5,15,8,24,28,0
2592,Stijn Spierings,Toulouse,16.8,53,40,26,20,7,29,52,55.8,23,22,5,17,26,79,32,0
2593,Stijn Spierings,Lens,1.3,1,0,0,1,0,1,1,100.0,0,2,1,1,2,3,1,0
2594,Leonardo Spinazzola,Roma,14.6,15,7,10,5,0,8,18,44.4,10,8,2,6,3,18,15,0
2595,Marco Sportiello,Milan,7.0,0,0,0,0,0,0,0,0.0,0,0,0,0,0,0,2,0
2596,Anton Stach,Hoffenheim,25.8,73,42,40,27,6,33,63,52.4,30,38,12,26,72,145,67,1
2597,Anton Stach,Mainz 05,1.9,3,0,2,0,1,2,4,50.0,2,5,0,5,2,5,5,0
2598,Jens Stage,Werder Bremen,25.9,52,22,21,23,8,18,50,36.0,32,42,23,19,23,75,55,0
2600,Benjamin Stambouli,Reims,3.2,9,7,3,5,1,6,11,54.5,5,3,1,2,2,11,8,0
2601,Josip Stanisic,Leverkusen,14.0,38,20,19,13,6,22,33,66.7,11,18,3,15,9,47,26,0
2602,Carl Starfelt,Celta Vigo,24.6,36,30,30,5,1,19,28,67.9,9,35,28,7,34,70,159,2
2603,Niklas Stark,Werder Bremen,12.1,26,15,13,11,2,12,18,66.7,6,14,7,7,19,45,61,1
2604,Jason Steele,Brighton,17.0,0,0,0,0,0,0,3,0.0,3,0,0,0,0,0,8,1
2605,Pascal Stenzel,Stuttgart,11.8,18,8,7,9,2,10,30,33.3,20,22,8,14,15,33,26,0
2606,Leonidas Stergiou,Stuttgart,6.6,15,8,7,7,1,9,13,69.2,4,8,1,7,5,20,13,0
2607,Raheem Sterling,Chelsea,22.0,21,10,7,8,6,12,26,46.2,14,13,0,13,13,34,9,1
2608,Trivante Stewart,Salernitana,1.1,0,0,0,0,0,0,0,0.0,0,1,0,1,0,0,0,0
2609,Angelo Stiller,Hoffenheim,0.9,0,0,0,0,0,0,1,0.0,1,2,0,2,0,0,3,0
2610,Angelo Stiller,Stuttgart,29.9,55,33,15,34,6,24,42,57.1,18,41,13,28,28,83,25,2
2611,Kevin Stoger,Bochum,29.6,49,30,21,21,7,25,63,39.7,38,46,4,42,19,68,18,0
2612,Filip Stojilkovic,Darmstadt 98,1.7,1,1,0,0,1,0,0,0.0,0,0,0,0,0,1,1,0
2613,John Stones,Manchester City,11.8,2,1,1,0,1,0,3,0.0,3,11,7,4,10,12,21,0
2614,Thomas Strakosha,Brentford,1.5,0,0,0,0,0,0,0,0.0,0,0,0,0,0,0,0,0
2615,Jorgen Strand Larsen,Celta Vigo,31.8,21,11,1,15,5,8,38,21.1,30,15,1,14,5,26,17,0
2616,Gabriel Strefezza,Lecce,12.4,24,17,8,7,9,14,20,70.0,6,17,0,17,7,31,11,0
2617,Kevin Strootman,Genoa,13.4,34,19,13,18,3,15,31,48.4,16,20,6,14,7,41,22,0
2618,Cristhian Stuani,Girona,8.9,14,11,4,6,4,4,7,57.1,3,9,2,7,5,19,13,0
2619,Alex Suarez,Las Palmas,28.5,53,36,33,15,5,31,37,83.8,6,33,14,19,18,71,84,0
2620,Damian Suarez,Getafe,14.4,36,21,16,16,4,26,45,57.8,19,13,3,10,10,46,31,0
2621,Denis Suarez,Villarreal,1.5,0,0,0,0,0,0,2,0.0,2,2,2,0,0,0,4,0
2622,Gabriel Suazo,Toulouse,26.2,66,32,40,19,7,38,86,44.2,48,37,4,33,26,92,33,0
2623,Isaac Success,Udinese,9.8,6,4,0,5,1,1,3,33.3,2,6,1,5,2,8,11,0
2624,Niklas Sule,Dortmund,16.8,18,10,14,3,1,11,16,68.8,5,25,14,11,25,43,58,2
2626,Ibrahim Sulemana,Cagliari,14.9,36,14,15,15,6,17,27,63.0,10,24,5,19,7,43,23,0
2627,Tomas Suslov,Hellas Verona,23.2,42,30,11,22,9,15,47,31.9,32,15,0,15,6,48,8,0
2628,Suso,Sevilla,16.9,24,17,14,8,2,8,28,28.6,20,9,0,9,5,29,4,0
2629,Mattias Svanberg,Wolfsburg,19.1,37,17,8,19,10,12,38,31.6,26,25,5,20,21,58,28,0
2630,Max Svensson,Osasuna,0.0,1,0,0,0,1,0,0,0.0,0,0,0,0,0,1,0,0
2631,Mile Svilar,Roma,15.0,0,0,0,0,0,0,0,0.0,0,0,0,0,0,0,2,1
2632,Williot Swedberg,Celta Vigo,4.9,9,4,3,6,0,5,8,62.5,3,11,1,10,0,9,4,0
2633,Karol Swiderski,Hellas Verona,5.6,7,3,1,3,3,2,3,66.7,1,6,4,2,1,8,8,0
2634,Abakar Sylla,Strasbourg,19.9,54,23,30,19,5,29,40,72.5,11,40,11,29,26,80,70,2
2635,Dembo Sylla,Lorient,0.5,1,1,0,1,0,0,0,0.0,0,0,0,0,1,2,2,0
2636,Issiaga Sylla,Montpellier,16.2,28,17,20,6,2,16,34,47.1,18,21,7,14,23,51,53,0
2637,Mamadou Sylla,Alavés,0.2,0,0,0,0,0,0,0,0.0,0,1,1,0,0,0,1,0
2638,Attila Szalai,Hoffenheim,3.2,3,1,3,0,0,1,4,25.0,3,6,2,4,1,4,7,0
2639,Attila Szalai,Freiburg,1.1,1,1,1,0,0,1,2,50.0,1,5,2,3,1,2,11,1
2640,Wojciech Szczesny,Juventus,35.0,0,0,0,0,0,0,0,0.0,0,0,0,0,1,1,11,2
2641,Dominik Szoboszlai,Liverpool,23.4,32,19,12,12,8,16,50,32.0,34,37,2,35,15,47,16,1
2642,Przemyslaw Szyminski,Frosinone,0.1,0,0,0,0,0,0,0,0.0,0,1,1,0,0,0,0,0
2643,Alexander Sorloth,Villarreal,27.7,6,3,1,2,3,2,6,33.3,4,9,4,5,0,6,26,0
2644,Musa Al-Taamari,Montpellier,21.4,20,16,10,5,5,9,21,42.9,12,18,2,16,4,24,5,0
2645,Nicolas Tagliafico,Lyon,23.6,54,34,23,22,9,22,49,44.9,27,25,8,17,28,82,43,0
2646,Jonathan Tah,Leverkusen,29.2,19,9,10,7,2,5,16,31.3,11,28,23,5,23,42,97,1
2647,Montassar Talbi,Lorient,24.5,38,22,23,13,2,19,32,59.4,13,39,23,16,32,70,114,0
2648,Yassin Tallal,Getafe,0.0,0,0,0,0,0,0,0,0.0,0,0,0,0,0,0,0,0
2649,Adrien Tameze,Torino,23.8,35,16,13,18,4,18,37,48.6,19,24,11,13,47,82,25,2
2650,Renato Tapia,Celta Vigo,14.9,41,29,19,19,3,14,25,56.0,11,31,7,24,21,62,50,1
2652,Edmond Tapsoba,Leverkusen,23.2,34,25,17,15,2,17,24,70.8,7,21,10,11,24,58,52,3
2653,Matt Targett,Newcastle Utd,0.9,2,0,1,1,0,1,1,100.0,0,1,0,1,0,2,2,0
2654,Oussama Targhalline,Le Havre,11.4,23,11,16,7,0,15,25,60.0,10,9,3,6,20,43,14,2
2655,James Tarkowski,Everton,38.0,61,42,46,14,1,27,48,56.3,21,82,56,26,56,117,191,2
2656,Cesar Tarrega,Valencia,0.1,0,0,0,0,0,0,0,0.0,0,0,0,0,0,0,2,0
2657,Jimi Tauriainen,Chelsea,0.0,0,0,0,0,0,0,0,0.0,0,0,0,0,0,0,0,0
2658,Nuno Tavares,Nott'ham Forest,5.1,11,7,9,1,1,8,9,88.9,1,6,0,6,1,12,21,0
2659,Marcus Tavernier,Bournemouth,23.5,53,34,25,22,6,26,48,54.2,22,31,3,28,5,58,23,0
2660,Elayis Tavsan,Hellas Verona,0.6,0,0,0,0,0,0,1,0.0,1,0,0,0,0,0,1,0
2661,Charlie Taylor,Burnley,25.9,35,20,19,14,2,17,35,48.6,18,27,11,16,19,54,78,0
2662,Marciano Tchami,Almería,0.5,0,0,0,0,0,0,0,0.0,0,0,0,0,0,0,0,0
2663,Loum Tchaouna,Salernitana,23.3,20,10,5,13,2,10,20,50.0,10,20,1,19,4,24,16,1
2664,Jackson Tchatchoua,Hellas Verona,19.2,39,26,25,12,2,23,48,47.9,25,17,7,10,23,62,49,2
2665,Enzo Tchato,Montpellier,12.5,26,17,18,4,4,11,25,44.0,14,20,7,13,11,37,25,0
2666,Aurelien Tchouameni,Real Madrid,22.1,38,23,19,17,2,9,18,50.0,9,21,13,8,28,66,52,1
2667,Mathys Tel,Bayern Munich,11.7,12,2,3,4,5,4,6,66.7,2,11,0,11,6,18,6,0
2668,Nathan Tella,Leverkusen,9.1,13,8,6,5,2,5,10,50.0,5,10,0,10,3,16,8,0
2669,Nahuel Tenaglia,Alavés,12.7,29,19,22,4,3,16,28,57.1,12,14,8,6,12,41,59,0
2670,Arnau Tenas,Paris S-G,5.9,0,0,0,0,0,0,0,0.0,0,0,0,0,0,0,0,0
2671,Marc-Andre ter Stegen,Barcelona,28.0,0,0,0,0,0,0,0,0.0,0,0,0,0,0,0,3,3
2672,Filippo Terracciano,Hellas Verona,14.4,30,19,23,6,1,17,31,54.8,14,24,6,18,20,50,17,0
2673,Filippo Terracciano,Milan,0.8,2,2,1,1,0,1,3,33.3,2,3,0,3,0,2,1,0
2674,Pietro Terracciano,Fiorentina,33.0,1,1,1,0,0,1,3,33.3,2,1,0,1,0,1,8,0
2675,Ramon Terrats,Villarreal,8.7,17,13,8,8,1,7,15,46.7,8,11,1,10,3,20,9,0
2676,Martin Terrier,Rennes,17.0,14,9,3,8,3,6,14,42.9,8,21,4,17,9,23,17,0
2678,Kenny Tete,Fulham,9.6,27,17,19,6,2,11,19,57.9,8,10,3,7,16,43,35,0
2679,Benjamin Tetteh,Metz,3.1,6,6,1,5,0,4,7,57.1,3,0,0,0,0,6,1,0
2680,Teddy Teuma,Reims,23.5,54,36,19,21,14,25,62,40.3,37,33,4,29,20,74,6,0
2681,Florian Thauvin,Udinese,19.0,7,4,2,4,1,4,13,30.8,9,9,1,8,3,10,2,0
2682,Arthur Theate,Rennes,25.5,30,17,19,6,5,24,37,64.9,13,40,23,17,31,61,90,2
2683,Norman Theuerkauf,Heidenheim,14.0,24,16,13,7,4,13,22,59.1,9,16,6,10,14,38,21,0
2684,Malick Thiaw,Milan,18.0,34,17,15,17,2,12,25,48.0,13,23,13,10,13,47,55,0
2685,Jan Thielmann,Köln,17.5,28,18,13,9,6,12,24,50.0,12,31,6,25,8,36,28,0
2686,Denis Thomalla,Heidenheim,5.0,9,6,4,4,1,5,11,45.5,6,3,2,1,4,13,13,0
2687,Luke Thomas,Sheffield Utd,10.2,20,9,13,6,1,8,14,57.1,6,23,5,18,10,30,27,0
2688,Adrien Thomasson,Lens,13.3,25,14,4,16,5,11,34,32.4,23,14,0,14,9,34,10,1
2689,Morten Thorsby,Genoa,12.9,19,11,9,8,2,7,14,50.0,7,21,5,16,4,23,20,0
2690,Kristian Thorstvedt,Sassuolo,26.6,40,22,7,28,5,22,44,50.0,22,25,9,16,21,61,36,0
2691,Khephren Thuram,Nice,23.4,42,29,13,23,6,20,40,50.0,20,21,10,11,18,60,37,0
2692,Marcus Thuram,Inter,29.9,23,15,9,9,5,4,13,30.8,9,26,3,23,4,27,19,0
2693,Cheikh Tidiane Sabaly,Metz,15.3,40,20,23,12,5,16,40,40.0,24,19,2,17,10,50,14,0
2694,Youri Tielemans,Aston Villa,18.0,41,20,17,18,6,16,40,40.0,24,23,3,20,15,56,9,0
2695,Kieran Tierney,Real Sociedad,13.8,37,24,16,18,3,18,27,66.7,9,22,8,14,10,47,45,0
2696,Phillip Tietz,Augsburg,26.5,23,14,7,13,3,6,15,40.0,9,17,3,14,6,29,35,0
2697,Steffen Tigges,Köln,8.1,10,6,4,5,1,3,7,42.9,4,4,2,2,1,11,12,0
2698,Antonio Tikvic,Udinese,0.0,0,0,0,0,0,0,0,0.0,0,0,0,0,0,0,0,0
2699,Jurrien Timber,Arsenal,0.8,2,2,1,1,0,0,0,0.0,0,1,0,1,0,2,1,0
2700,Jean-Clair Todibo,Nice,29.5,58,28,35,17,6,34,56,60.7,22,34,15,19,38,96,97,1
2701,Harry Toffolo,Nott'ham Forest,16.2,26,14,20,6,0,15,24,62.5,9,34,13,21,14,40,49,0
2702,Umut Tohumcu,Hoffenheim,11.2,16,12,9,7,0,6,19,31.6,13,11,1,10,6,22,12,0
2704,Corentin Tolisso,Lyon,19.3,33,21,13,11,9,14,33,42.4,19,26,9,17,10,43,18,0
2705,Jeremy Toljan,Sassuolo,23.1,13,10,8,4,1,9,15,60.0,6,17,5,12,16,29,49,1
2706,Rafael Toloi,Atalanta,10.7,20,9,7,8,5,14,27,51.9,13,9,4,5,13,33,29,0
2707,Raul de Tomas,Rayo Vallecano,14.1,9,5,4,3,2,3,6,50.0,3,3,0,3,1,10,8,0
2708,Tiago Tomas,Wolfsburg,11.5,5,2,3,0,2,1,6,16.7,5,13,0,13,3,8,9,0
2709,Takehiro Tomiyasu,Arsenal,12.8,20,9,15,4,1,11,18,61.1,7,10,4,6,18,38,33,0
2710,James Tomkins,Crystal Palace,0.1,0,0,0,0,0,0,0,0.0,0,0,0,0,1,1,0,0
2711,Fikayo Tomori,Milan,23.6,42,24,29,10,3,18,29,62.1,11,34,23,11,26,68,75,1
2712,Sandro Tonali,Newcastle Utd,4.9,7,7,4,2,1,3,9,33.3,6,3,0,3,2,9,4,0
2713,Ivan Toney,Brentford,16.1,15,5,2,7,6,6,14,42.9,8,5,1,4,10,25,18,0
2714,Pablo Torre,Girona,7.8,5,2,0,5,0,4,10,40.0,6,10,2,8,4,9,6,1
2715,Raul Torrente,Granada,13.9,29,16,20,9,0,17,22,77.3,5,16,10,6,11,40,68,2
2716,Ferran Torres,Barcelona,13.5,9,6,1,6,2,5,16,31.3,11,7,1,6,5,14,6,0
2717,Oliver Torres,Sevilla,18.0,37,22,17,15,5,22,57,38.6,35,40,4,36,6,43,6,0
2718,Pau Torres,Aston Villa,27.4,29,18,17,11,1,14,30,46.7,16,28,12,16,14,43,75,0
2719,Lucas Torro,Osasuna,19.9,25,15,11,8,6,11,28,39.3,17,10,2,8,33,58,37,0
2720,Fabio Torsiello,Darmstadt 98,1.7,1,0,1,0,0,1,8,12.5,7,1,0,1,1,2,1,0
2721,Ahmed Touba,Lecce,3.1,6,4,3,3,0,3,4,75.0,1,4,3,1,7,13,20,0
2722,Abdoulaye Toure,Le Havre,25.4,47,28,22,22,3,30,60,50.0,30,30,8,22,25,72,33,0
2723,Souleymane Toure,Lorient,22.8,25,12,16,9,0,8,14,57.1,6,38,20,18,36,61,101,2
2724,Lucas Tousart,Union Berlin,17.5,35,20,14,17,4,17,37,45.9,20,32,9,23,25,60,41,0
2725,Andros Townsend,Luton Town,13.4,21,13,11,2,8,13,27,48.1,14,12,0,12,5,26,10,0
2726,James Trafford,Burnley,28.0,2,1,2,0,0,2,2,100.0,0,0,0,0,1,3,18,1
2727,Adama Traore,Fulham,4.2,4,3,1,2,1,3,6,50.0,3,2,0,2,1,5,2,0
2728,Bertrand Traore,Aston Villa,0.1,1,1,1,0,0,0,0,0.0,0,0,0,0,0,1,1,0
2730,Bertrand Traore,Villarreal,6.3,5,4,2,1,2,1,4,25.0,3,6,0,6,1,6,2,0
2731,Boubacar Traore,Wolves,9.1,35,23,16,17,2,9,21,42.9,12,12,2,10,5,40,7,0
2732,Chaka Traore,Milan,0.2,2,1,2,0,0,1,2,50.0,1,1,1,0,0,2,0,0
2733,Daouda Traore,Nice,0.2,0,0,0,0,0,0,0,0.0,0,0,0,0,0,0,0,0
2734,Hamari Traore,Real Sociedad,25.5,44,19,24,17,3,25,43,58.1,18,27,8,19,24,68,59,2
2735,Ismael Traore,Metz,24.7,19,12,13,6,0,8,21,38.1,13,33,20,13,30,49,86,0
2736,Omar Traore,Heidenheim,27.5,60,33,33,21,6,32,56,57.1,24,32,7,25,40,100,54,1
2737,Kevin Trapp,Eint Frankfurt,32.0,0,0,0,0,0,0,0,0.0,0,0,0,0,1,1,9,1
2738,Mark Travers,Bournemouth,4.0,0,0,0,0,0,0,0,0.0,0,0,0,0,0,0,2,0
2739,Oscar Trejo,Rayo Vallecano,15.3,27,15,11,9,7,13,21,61.9,8,21,1,20,5,32,9,0
2740,Mike Tresor,Burnley,4.7,10,6,9,1,0,8,18,44.4,10,5,0,5,1,11,1,0
2741,Manu Trigueros,Villarreal,3.4,7,5,6,1,0,4,10,40.0,6,1,1,0,3,10,9,0
2742,Christopher Trimmel,Union Berlin,18.3,23,15,12,10,1,13,33,39.4,20,16,3,13,13,36,57,0
2743,Kieran Trippier,Newcastle Utd,24.8,57,27,30,16,11,37,77,48.1,40,41,8,33,24,81,57,3
2744,Leandro Trossard,Arsenal,18.3,27,16,8,9,10,9,25,36.0,16,27,1,26,8,35,6,0
2745,Adrien Truffert,Rennes,23.8,39,21,23,10,6,25,40,62.5,15,31,5,26,19,58,49,0
2746,Auston Trusty,Sheffield Utd,28.6,47,30,31,13,3,21,43,48.8,22,41,22,19,35,82,153,3
2747,Kostas Tsimikas,Liverpool,7.5,19,13,9,6,4,9,15,60.0,6,9,1,8,6,25,10,0
2748,Viktor Tsyhankov,Girona,22.8,29,20,11,13,5,14,26,53.8,12,18,1,17,12,41,24,0
2749,Stefano Turati,Frosinone,30.5,0,0,0,0,0,0,0,0.0,0,0,0,0,0,0,6,3
2750,Matt Turner,Nott'ham Forest,17.0,0,0,0,0,0,0,0,0.0,0,0,0,0,0,0,8,4
2751,Benat Turrientes,Real Sociedad,18.7,31,17,6,20,5,13,30,43.3,17,19,8,11,6,37,17,0
2752,Tuta,Eint Frankfurt,28.9,63,33,38,19,6,39,59,66.1,20,29,12,17,36,99,99,0
2753,Destiny Udogie,Tottenham,26.6,68,33,41,16,11,27,49,55.1,22,27,8,19,37,105,80,5
2754,Matthieu Udol,Metz,30.0,55,37,38,12,5,38,56,67.9,18,62,16,46,50,105,108,0
2756,Manuel Ugarte Ribeiro,Paris S-G,21.5,98,57,39,43,16,43,89,48.3,46,27,6,21,40,138,25,2
2757,Lesley Ugochukwu,Chelsea,3.3,14,10,4,8,2,4,10,40.0,6,6,2,4,1,15,5,0
2758,Lukas Ullrich,Gladbach,0.5,1,0,1,0,0,1,4,25.0,3,0,0,0,0,1,1,0
2759,Sven Ulreich,Bayern Munich,11.0,1,0,1,0,0,1,1,100.0,0,0,0,0,0,1,3,2
2760,Samuel Umtiti,Lille,2.1,1,1,0,1,0,1,4,25.0,3,0,0,0,2,3,4,0
2761,Enes Unal,Bournemouth,3.6,6,4,2,3,1,2,5,40.0,3,4,2,2,1,7,6,0
2762,Enes Unal,Getafe,1.6,0,0,0,0,0,0,0,0.0,0,1,0,1,0,0,2,0
2763,Deniz Undav,Stuttgart,23.2,28,13,6,8,14,4,15,26.7,11,17,0,17,6,34,5,0
2764,Dayot Upamecano,Bayern Munich,19.6,34,21,21,11,2,15,29,51.7,14,19,7,12,19,53,56,3
2765,Kacper Urbanski,Bologna,10.3,16,10,5,10,1,6,13,46.2,7,15,1,14,4,20,14,0
2766,Mark Uth,Köln,4.1,8,4,2,3,3,4,12,33.3,8,6,0,6,1,9,2,0
2767,Myrto Uzuni,Granada,27.2,18,14,8,7,3,6,27,22.2,21,19,3,16,4,22,7,0
2768,Josha Vagnoman,Stuttgart,13.1,28,18,15,11,2,15,30,50.0,15,11,5,6,2,30,16,1
2769,Oscar Valentin,Rayo Vallecano,29.9,107,66,39,62,6,46,101,45.5,55,62,10,52,35,142,52,1
2770,Emanuele Valeri,Frosinone,13.1,19,16,10,5,4,10,21,47.6,11,14,3,11,9,28,22,0
2771,Martin Valjent,Mallorca,26.1,34,18,19,13,2,18,30,60.0,12,26,11,15,29,63,112,1
2772,Jesus Vallejo,Granada,1.2,3,1,1,2,0,2,2,100.0,0,3,2,1,0,3,1,1
2773,Alvaro Valles,Las Palmas,36.3,3,2,3,0,0,3,8,37.5,5,0,0,0,0,3,40,1
2774,Federico Valverde,Real Madrid,32.3,47,34,22,13,12,24,42,57.1,18,39,2,37,43,90,40,0
2775,Kevin Van Den Kerkhof,Metz,21.3,31,24,11,13,7,13,32,40.6,19,15,2,13,11,42,32,1
2776,Siebe Van Der Heyden,Mallorca,3.2,9,2,7,2,0,4,6,66.7,2,1,1,0,7,16,12,0
2777,Virgil van Dijk,Liverpool,35.3,40,23,24,13,3,12,14,85.7,2,47,34,13,39,79,144,0
2778,Vanderson,Monaco,18.2,60,41,20,30,10,32,70,45.7,38,29,2,27,35,95,37,1
2779,Raphael Varane,Manchester Utd,15.3,18,11,10,7,1,10,14,71.4,4,23,18,5,15,33,88,0
2780,Ruben Vargas,Augsburg,21.8,23,10,6,10,7,10,25,40.0,15,19,4,15,7,30,17,0
2782,Johan Vasquez,Genoa,31.7,51,33,38,11,2,32,50,64.0,18,50,26,24,45,96,113,0
2783,Jose Luis Garcia Vaya,Valencia,36.7,78,53,36,36,6,37,71,52.1,34,41,10,31,49,127,71,0
2784,Borja Vazquez,Cádiz,0.0,1,0,1,0,0,1,1,100.0,0,0,0,0,0,1,1,0
2785,Jesus Vazquez,Valencia,8.0,24,12,13,8,3,10,16,62.5,6,17,4,13,3,27,24,0
2786,Kevin Vazquez,Celta Vigo,7.8,15,13,7,7,1,12,21,57.1,9,11,3,8,5,20,25,0
2787,Lucas Vazquez,Real Madrid,15.8,37,25,22,14,1,18,25,72.0,7,27,5,22,12,49,36,0
2788,Matias Vecino,Lazio,12.8,32,17,12,20,0,20,31,64.5,11,17,5,12,12,44,21,0
2789,Gabriel Veiga,Celta Vigo,0.2,0,0,0,0,0,0,0,0.0,0,0,0,0,0,0,0,0
2790,Alejo Veliz,Tottenham,0.6,1,0,1,0,0,0,0,0.0,0,0,0,0,0,1,0,0
2791,Alejo Veliz,Sevilla,0.4,1,0,0,1,0,1,2,50.0,1,0,0,0,0,1,1,0
2792,Milos Veljkovic,Werder Bremen,21.3,31,15,17,13,1,16,31,51.6,15,31,20,11,17,48,57,0
2793,Joel Veltman,Brighton,17.6,54,41,32,17,5,39,58,67.2,19,17,7,10,18,72,57,1
2794,Micky van de Ven,Tottenham,26.0,49,35,34,12,3,24,33,72.7,9,25,15,10,18,67,78,1
2795,Lorenzo Venuti,Lecce,4.0,6,4,5,1,0,6,10,60.0,4,4,3,1,5,11,14,0
2796,Bart Verbruggen,Brighton,21.0,1,1,1,0,0,1,2,50.0,1,0,0,0,0,1,11,3
2797,Simone Verdi,Torino,0.0,0,0,0,0,0,0,0,0.0,0,0,0,0,0,0,0,0
2798,Jordan Veretout,Marseille,24.3,38,22,19,13,6,18,39,46.2,21,20,4,16,13,51,25,0
2799,Arthur Vermeeren,Atlético Madrid,1.8,1,0,0,1,0,0,1,0.0,1,5,0,5,6,7,2,0
2800,Yorbe Vertessen,Union Berlin,6.6,3,2,0,3,0,1,4,25.0,3,8,0,8,1,4,3,0
2801,Mikel Vesga,Athletic Club,17.0,40,20,11,23,6,19,49,38.8,30,19,7,12,32,72,35,1
2802,Guglielmo Vicario,Tottenham,38.0,0,0,0,0,0,0,1,0.0,1,0,0,0,1,1,31,2
2803,Carlos Vicente,Alavés,12.4,16,6,7,7,2,10,25,40.0,15,4,0,4,4,20,9,0
2804,Nacho Vidal,Osasuna,1.1,5,4,2,2,1,2,5,40.0,3,2,0,2,0,5,6,0
2805,Nacho Vidal,Mallorca,4.6,12,5,4,5,3,6,13,46.2,7,5,2,3,3,15,9,0
2806,Fabio Vieira,Arsenal,3.3,3,2,2,0,1,3,3,100.0,0,0,0,0,2,5,2,0
2808,Fran Vieites,Betis,3.5,1,0,1,0,0,1,1,100.0,0,0,0,0,0,1,2,1
2809,Jonathan Viera,Las Palmas,6.9,6,3,1,2,3,1,9,11.1,8,0,0,0,0,6,1,0
2810,Jonathan Viera,Almería,10.1,19,9,6,9,4,10,19,52.6,9,4,0,4,4,23,1,0
2811,Emanuel Vignato,Salernitana,3.5,10,7,4,5,1,5,6,83.3,1,1,0,1,1,11,7,0
2812,Samuele Vignato,Monza,3.8,6,4,2,3,1,2,3,66.7,1,2,0,2,1,7,1,0
2813,Oscar Vilhelmsson,Darmstadt 98,15.3,13,6,3,7,3,7,10,70.0,3,15,5,10,3,16,19,0
2814,Toni Villa,Girona,0.1,0,0,0,0,0,0,0,0.0,0,0,0,0,0,0,0,0
2815,Asier Villalibre,Athletic Club,5.7,2,1,0,0,2,2,2,100.0,0,2,1,1,0,2,6,0
2816,Gonzalo Villar,Granada,20.0,51,33,26,20,5,26,41,63.4,15,32,10,22,6,57,26,1
2817,Ivan Villar,Celta Vigo,11.3,0,0,0,0,0,0,1,0.0,1,0,0,0,0,0,6,0
2818,Matias Vina,Sassuolo,11.3,34,21,22,7,5,20,36,55.6,16,12,2,10,9,43,34,0
2819,Ruben Vinagre,Hellas Verona,3.1,4,2,1,1,2,3,4,75.0,1,6,3,3,1,5,4,0
2820,Carlos Vinicius,Fulham,3.5,3,2,0,1,2,0,4,0.0,4,4,0,4,0,3,1,0
2821,Nicolas Viola,Cagliari,13.4,13,9,2,8,3,7,17,41.2,10,9,0,9,2,15,6,0
2822,Alan Virginius,Lille,0.8,1,1,1,0,0,0,1,0.0,1,0,0,0,0,1,0,0
2823,Alan Virginius,Clermont Foot,10.4,9,5,4,4,1,4,11,36.4,7,7,0,7,3,12,7,0
2824,Ricardo Visus,Betis,1.8,2,2,1,1,0,2,2,100.0,0,2,2,0,2,4,9,1
2825,Mattia Viti,Sassuolo,10.9,24,15,14,7,3,10,22,45.5,12,20,10,10,10,34,44,0
2826,Vitinha,Genoa,3.2,2,2,1,0,1,1,2,50.0,1,2,0,2,0,2,2,0
2827,Vitinha,Marseille,10.3,14,8,3,5,6,3,12,25.0,9,11,2,9,5,19,8,0
2828,Vitinha,Paris S-G,23.6,39,24,12,16,11,16,48,33.3,32,29,11,18,23,62,30,2
2829,Vitinho,Burnley,25.7,64,34,36,22,6,43,86,50.0,43,44,6,38,12,76,47,4
2830,Daniel Vivian,Athletic Club,32.0,42,28,29,11,2,28,45,62.2,17,49,25,24,31,73,104,0
2831,Odisseas Vlachodimos,Nott'ham Forest,5.0,0,0,0,0,0,0,1,0.0,1,0,0,0,0,0,1,0
2832,Dusan Vlahovic,Juventus,25.6,9,5,0,6,3,4,11,36.4,7,4,2,2,1,10,11,0
2834,Nikola Vlasic,Torino,29.0,28,16,6,14,8,4,30,13.3,26,26,7,19,11,39,16,0
2835,Alessandro Vogliacco,Genoa,13.0,23,15,14,8,1,12,15,80.0,3,16,10,6,30,53,40,1
2836,Kevin Vogt,Hoffenheim,14.7,14,10,7,7,0,8,13,61.5,5,16,13,3,9,23,54,0
2837,Kevin Vogt,Union Berlin,14.7,10,9,6,4,0,6,12,50.0,6,22,15,7,7,17,72,2
2838,Mergim Vojvoda,Torino,15.3,17,8,7,6,4,11,16,68.8,5,12,2,10,13,30,28,0
2839,Kevin Volland,Union Berlin,14.9,22,9,8,8,6,8,20,40.0,12,8,0,8,6,28,12,0
2840,Cristian Volpato,Sassuolo,7.2,16,8,9,6,1,9,25,36.0,16,7,0,7,1,17,5,0
2841,Aster Vranckx,Wolfsburg,12.8,32,15,11,11,10,15,28,53.6,13,17,6,11,14,46,29,0
2842,Stefan de Vrij,Inter,17.6,18,13,13,4,1,8,15,53.3,7,22,10,12,24,42,51,0
2843,Elye Wahi,Montpellier,0.2,0,0,0,0,0,0,0,0.0,0,0,0,0,0,0,0,0
2844,Elye Wahi,Lens,18.8,6,4,1,3,2,2,10,20.0,8,5,1,4,3,9,3,0
2845,Walace,Udinese,36.0,66,43,40,26,0,36,77,46.8,41,43,6,37,43,109,66,1
2846,Luca Waldschmidt,Köln,12.7,19,12,4,12,3,5,16,31.3,11,18,3,15,6,25,8,1
2847,Kyle Walker,Manchester City,30.7,38,24,19,17,2,19,39,48.7,20,19,6,13,27,65,40,1
2848,Sebastian Walukiewicz,Empoli,22.8,39,28,33,6,0,28,41,68.3,13,50,31,19,15,54,121,0
2849,Aaron Wan-Bissaka,Manchester Utd,19.8,42,25,18,20,4,19,26,73.1,7,29,15,14,41,83,68,1
2850,Joel Ward,Crystal Palace,22.0,45,28,26,18,1,30,47,63.8,17,17,10,7,14,59,94,1
2851,James Ward-Prowse,West Ham,33.3,45,29,14,23,8,18,44,40.9,26,31,9,22,38,83,49,0
2852,Lewis Warrington,Everton,0.0,0,0,0,0,0,0,0,0.0,0,0,0,0,0,0,0,0
2853,Deivid Washington,Chelsea,0.1,1,1,1,0,0,0,1,0.0,1,0,0,0,0,1,0,0
2854,Kjell-Arik Watjen,Dortmund,1.2,3,2,2,1,0,2,5,40.0,3,1,1,0,0,3,3,0
2855,Ollie Watkins,Aston Villa,35.7,12,7,0,5,7,5,11,45.5,6,26,4,22,4,16,20,0
2856,Timothy Weah,Juventus,14.0,27,20,16,8,3,15,20,75.0,5,12,1,11,5,32,15,0
2857,Adam Webster,Brighton,12.7,14,12,8,5,1,6,18,33.3,12,16,12,4,16,30,43,1
2858,Wout Weghorst,Hoffenheim,22.0,13,6,4,7,2,9,15,60.0,6,25,8,17,6,19,24,0
2860,Julian Weigl,Gladbach,30.7,66,40,28,32,6,41,67,61.2,26,47,14,33,48,114,61,1
2861,Nelson Weiper,Mainz 05,1.4,2,1,2,0,0,2,3,66.7,1,1,0,1,1,3,0,0
2862,Mitchell Weiser,Werder Bremen,29.3,64,38,29,25,10,31,53,58.5,22,36,6,30,20,84,43,0
2863,Noah Weisshaupt,Freiburg,8.4,9,4,6,0,3,5,11,45.5,6,8,1,7,8,17,12,0
2864,Shon Weissman,Salernitana,5.5,4,3,2,0,2,0,4,0.0,4,2,1,1,3,7,4,0
2865,Shon Weissman,Granada,0.9,1,1,0,0,1,1,4,25.0,3,3,0,3,0,1,1,0
2866,Danny Welbeck,Brighton,18.8,35,17,9,17,9,10,17,58.8,7,12,0,12,9,44,17,1
2867,Timo Werner,Tottenham,9.0,7,4,3,4,0,5,18,27.8,13,12,0,12,3,10,2,0
2868,Timo Werner,RB Leipzig,2.3,2,1,0,1,1,0,0,0.0,0,1,0,1,1,3,0,0
2869,Adam Wharton,Crystal Palace,14.4,48,32,18,22,8,23,46,50.0,23,17,3,14,20,68,24,1
2870,Ethan Wheatley,Manchester Utd,0.2,1,1,0,1,0,1,1,100.0,0,2,0,2,2,3,0,0
2871,Ben White,Arsenal,33.2,48,28,20,22,6,26,58,44.8,32,48,22,26,32,80,77,1
2872,Joe White,Newcastle Utd,0.1,1,1,1,0,0,0,0,0.0,0,0,0,0,0,1,0,0
2873,Silvan Widmer,Mainz 05,13.8,23,10,12,8,3,17,28,60.7,11,18,5,13,16,39,37,0
2874,Mateusz Wieteska,Cagliari,10.7,14,11,9,3,2,3,10,30.0,7,10,5,5,14,28,48,0
2875,Mateusz Wieteska,Clermont Foot,1.9,4,1,3,1,0,3,5,60.0,2,4,2,2,5,9,8,0
2876,Inaki Williams,Athletic Club,31.6,24,17,6,8,10,13,34,38.2,21,42,8,34,14,38,29,0
2877,Neco Williams,Nott'ham Forest,18.2,69,40,42,18,9,35,56,62.5,21,44,13,31,22,91,53,0
2878,Nico Williams,Athletic Club,25.1,31,12,9,15,7,13,36,36.1,23,18,2,16,3,34,4,1
2879,Willian,Fulham,22.8,18,11,6,7,5,3,21,14.3,18,13,0,13,9,27,12,1
2880,Joe Willock,Newcastle Utd,4.7,13,7,7,6,0,4,11,36.4,7,7,0,7,1,14,1,0
2881,Callum Wilson,Newcastle Utd,11.0,5,3,0,2,3,0,4,0.0,4,6,0,6,2,7,4,0
2882,Harry Wilson,Fulham,18.0,21,14,9,8,4,11,28,39.3,17,27,3,24,10,31,12,0
2883,Josh Wilson-Esbrand,Reims,5.1,5,4,2,3,0,2,8,25.0,6,5,2,3,6,11,7,0
2884,Patrick Wimmer,Wolfsburg,6.5,14,5,5,5,4,8,18,44.4,10,14,0,14,3,17,7,0
2886,Jonas Wind,Wolfsburg,29.5,13,10,4,6,3,7,17,41.2,10,13,4,9,3,16,21,0
2887,Florian Wirtz,Leverkusen,26.4,27,18,7,14,6,9,29,31.0,20,36,2,34,9,36,3,0
2888,Yoane Wissa,Brentford,27.7,28,16,13,10,5,5,20,25.0,15,24,3,21,9,37,15,0
2889,Axel Witsel,Atlético Madrid,30.9,35,21,23,12,0,17,24,70.8,7,40,21,19,16,51,119,0
2890,Maximilian Wittek,Bochum,11.9,23,17,9,11,3,13,21,61.9,8,12,1,11,18,41,23,0
2891,Maximilian Wober,Gladbach,23.0,66,31,40,25,1,31,53,58.5,22,47,26,21,38,104,111,0
2892,Marius Wolf,Dortmund,13.0,20,12,8,11,1,11,23,47.8,12,12,2,10,8,28,20,0
2893,Nick Woltemade,Werder Bremen,13.2,34,23,7,20,7,15,21,71.4,6,12,0,12,5,39,17,0
2894,Jeong Woo-yeong,Stuttgart,7.0,15,9,6,8,1,6,8,75.0,2,5,0,5,7,22,5,0
2895,Chris Wood,Nott'ham Forest,20.1,7,4,1,4,2,3,9,33.3,6,11,3,8,1,8,26,0
2896,Cauley Woodrow,Luton Town,4.7,16,10,8,4,4,9,16,56.3,7,7,1,6,1,17,14,0
2897,Christopher Wooh,Rennes,15.4,18,12,12,6,0,8,15,53.3,7,19,9,10,18,36,51,0
2898,Joe Worrall,Nott'ham Forest,4.9,7,5,6,1,0,3,6,50.0,3,5,4,1,3,10,32,1
2899,Xeber,Alavés,3.4,5,5,3,2,0,3,7,42.9,4,2,1,1,1,6,2,0
2900,Granit Xhaka,Leverkusen,31.3,29,21,11,14,4,9,30,30.0,21,29,8,21,19,48,42,0
2901,Antal Yaakobishvili,Girona,0.7,2,1,1,1,0,1,1,100.0,0,0,0,0,3,5,3,0
2902,Lamine Yamal,Barcelona,24.5,61,37,32,15,14,18,48,37.5,30,32,0,32,19,80,11,0
2903,Roman Yaremchuk,Valencia,10.3,5,2,1,2,2,3,6,50.0,3,4,0,4,1,6,9,0
2904,Yehor Yarmoliuk,Brentford,7.6,17,11,6,8,3,7,17,41.2,10,17,4,13,6,23,5,0
2905,Ryan Yates,Nott'ham Forest,22.1,66,39,39,21,6,19,34,55.9,15,42,15,27,21,87,44,1
2906,Yusuf Yazici,Lille,14.6,19,11,6,9,4,4,15,26.7,11,10,1,9,5,24,5,0
2907,Kelvin Yeboah,Montpellier,3.1,4,2,2,2,0,1,3,33.3,2,3,2,1,1,5,3,0
2908,Bertug Yildirim,Rennes,5.2,7,5,2,3,2,3,8,37.5,5,8,0,8,0,7,4,0
2909,Kenan Yildiz,Juventus,10.6,13,9,5,6,2,4,8,50.0,4,6,0,6,1,14,4,0
2910,Darlin Yongwa,Lorient,12.9,30,23,17,11,2,14,25,56.0,11,14,2,12,15,45,36,0
2912,Leny Yoro,Lille,29.7,36,25,27,7,2,17,31,54.8,14,20,14,6,36,72,97,1
2913,Ashley Young,Everton,25.3,53,38,28,19,6,30,54,55.6,24,24,6,18,22,75,50,3
2914,Etienne Youte Kinkoue,Le Havre,21.6,15,9,13,2,0,7,11,63.6,4,21,16,5,44,59,104,0
2915,Illia Zabarnyi,Bournemouth,37.0,59,32,29,29,1,23,50,46.0,27,53,34,19,33,92,143,4
2916,Mattia Zaccagni,Lazio,21.7,27,16,11,15,1,9,21,42.9,12,26,2,24,21,48,15,0
2917,Dan-Axel Zagadou,Stuttgart,16.1,21,14,16,5,0,4,8,50.0,4,23,18,5,20,41,78,1
2918,Yoram Zague,Paris S-G,4.1,18,8,11,4,3,11,24,45.8,13,3,0,3,4,22,9,1
2919,Warren Zaire-Emery,Paris S-G,21.8,51,28,18,24,9,28,51,54.9,23,32,8,24,15,66,22,2
2920,Denis Zakaria,Monaco,23.7,38,27,11,20,7,12,30,40.0,18,39,13,26,47,85,41,0
2921,Arsen Zakharyan,Real Sociedad,13.6,22,15,8,11,3,9,22,40.9,13,16,0,16,4,26,10,0
2922,Joseba Zaldua,Cádiz,7.8,20,12,17,2,1,13,21,61.9,8,6,4,2,2,22,20,0
2923,Nicola Zalewski,Roma,10.8,20,14,10,9,1,8,22,36.4,14,12,4,8,9,29,17,0
2924,Andre-Frank Zambo Anguissa,Napoli,31.0,61,33,21,29,11,34,69,49.3,35,40,5,35,28,89,19,1
2925,Nicolo Zaniolo,Aston Villa,9.3,19,9,10,7,2,9,17,52.9,8,13,0,13,1,20,11,0
2926,Alessandro Zanoli,Salernitana,10.2,16,13,9,7,0,7,12,58.3,5,10,2,8,1,17,17,0
2927,Alessandro Zanoli,Napoli,0.6,1,1,1,0,0,0,0,0.0,0,0,0,0,1,2,1,0
2928,Duvan Zapata,Torino,32.0,18,7,9,2,7,3,12,25.0,9,20,6,14,7,25,26,0
2929,Duvan Zapata,Atalanta,1.2,0,0,0,0,0,0,1,0.0,1,0,0,0,0,0,1,0
2930,Gabriele Zappa,Cagliari,28.5,54,31,29,16,9,29,41,70.7,12,29,5,24,20,74,75,2
2931,Davide Zappacosta,Atalanta,20.7,30,20,15,10,5,16,34,47.1,18,29,4,25,5,35,19,0
2932,Bryan Zaragoza,Granada,18.2,18,9,8,6,4,8,23,34.8,15,9,0,9,3,21,3,0
2933,Bryan Zaragoza,Bayern Munich,2.0,4,4,2,1,1,3,3,100.0,0,0,0,0,2,6,0,0
2934,Anass Zaroury,Burnley,1.7,1,0,1,0,0,0,4,0.0,4,2,0,2,0,1,1,1
2935,Oier Zarraga,Udinese,4.5,3,3,2,1,0,1,5,20.0,4,5,2,3,5,8,16,1
2936,Mehdi Zeffane,Clermont Foot,13.7,31,20,17,11,3,17,34,50.0,17,14,3,11,16,47,34,0
2938,Jordan Zemura,Udinese,11.5,24,16,13,7,4,11,19,57.9,8,5,1,4,13,37,21,0
2939,Robin Zentner,Mainz 05,30.0,2,2,2,0,0,2,5,40.0,3,1,0,1,1,3,19,1
2940,Alessio Zerbin,Monza,7.6,18,10,13,2,3,4,13,30.8,9,16,3,13,3,21,5,0
2941,Alessio Zerbin,Napoli,1.7,5,2,1,3,1,2,7,28.6,5,1,0,1,0,5,0,0
2942,Kevin Zeroli,Milan,0.3,1,1,1,0,0,0,0,0.0,0,1,0,1,0,1,1,0
2943,Cedric Zesiger,Wolfsburg,18.2,19,9,13,4,2,10,22,45.5,12,32,21,11,15,34,88,1
2944,Michael Zetterer,Werder Bremen,27.0,3,1,3,0,0,3,3,100.0,0,0,0,0,0,3,7,3
2945,Nathan Zeze,Nantes,11.4,11,6,9,2,0,7,14,50.0,7,12,3,9,12,23,47,1
2946,Edon Zhegrova,Lille,25.4,32,18,9,15,8,14,36,38.9,22,17,1,16,8,40,8,0
2947,Piotr Zielinski,Napoli,21.4,23,15,6,13,4,12,24,50.0,12,12,1,11,9,32,15,0
2948,David Zima,Torino,1.0,1,1,1,0,0,0,0,0.0,0,0,0,0,3,4,7,0
2949,Christoph Zimmermann,Darmstadt 98,13.6,33,21,26,7,0,19,39,48.7,20,21,14,7,21,54,66,1
2950,Oleksandr Zinchenko,Arsenal,19.1,50,30,19,24,7,35,52,67.3,17,18,3,15,20,70,26,2
2951,Joshua Zirkzee,Bologna,30.7,32,20,8,15,9,13,24,54.2,11,25,2,23,3,35,36,0
2952,Luc Zogbe,Brest,0.1,0,0,0,0,0,0,1,0.0,1,1,1,0,1,1,0,0
2953,Simon Zoller,Bochum,0.5,0,0,0,0,0,0,0,0.0,0,1,0,1,0,0,0,0
2954,Nadir Zortea,Frosinone,14.0,21,14,8,13,0,10,22,45.5,12,13,5,8,4,25,29,1
2955,Nadir Zortea,Atalanta,1.7,5,4,3,1,1,1,4,25.0,3,2,0,2,1,6,3,0
2956,Kurt Zouma,West Ham,31.5,23,17,14,9,0,10,16,62.5,6,38,28,10,29,52,160,0
2957,Igor Zubeldia,Real Sociedad,28.0,32,25,20,10,2,19,26,73.1,7,28,19,9,32,64,97,3
2958,Martin Zubimendi,Real Sociedad,29.5,49,27,18,29,2,23,42,54.8,19,33,9,24,37,86,54,0
2959,Szymon Zurkowski,Empoli,9.6,15,6,5,8,2,5,15,33.3,10,5,1,4,6,21,11,0
2960,Lovro Zvonarek,Bayern Munich,1.8,0,0,0,0,0,0,5,0.0,5,3,0,3,0,0,2,0
2961,Martin Odegaard,Arsenal,34.3,49,17,18,21,10,17,58,29.3,41,23,1,22,15,64,5,0
2962,Milan Duric,Hellas Verona,13.4,1,0,0,0,1,0,3,0.0,3,0,0,0,1,2,13,0
2964,Milan Duric,Monza,14.0,5,5,0,5,0,2,4,50.0,2,6,2,4,0,5,27,0
2965,Mateusz Legowski,Salernitana,12.7,23,12,8,12,3,11,26,42.3,15,13,2,11,7,30,16,0
