,Player,Squad,90s,Tackles - Tkl,Tackles - TklW,Tackles - Def 3rd,Tackles - Mid 3rd,Tackles - Att 3rd,Challenges - Tkl,Challenges - Att,Challenges - Tkl%,Challenges - Lost,Blocks - Blocks,Blocks - Sh,Blocks - Pass,Int,Tkl+Int,Clr,Err
0,Max Aarons,Bournemouth,10.6,24,15,17,6,1,16,27,59.3,11,9,5,4,5,29,21,0
1,Brenden Aaronson,Union Berlin,3.4,8,6,3,4,1,5,7,71.4,2,9,0,9,0,8,1,0
2,Paxten Aaronson,Eint Frankfurt,1.1,2,2,1,1,0,1,1,100.0,0,2,0,2,0,2,0,0
3,Yunis Abdelhamid,Reims,15.0,33,20,17,14,2,13,25,52.0,12,25,16,9,17,50,46,0
4,Salis Abdul Samed,Lens,11.9,15,11,6,7,2,5,10,50.0,5,9,0,9,7,22,9,0
5,Laurent Abergel,Lorient,15.0,48,25,23,21,4,21,54,38.9,33,18,4,14,34,82,23,1
6,Matthis Abline,Nantes,4.0,0,0,0,0,0,0,1,0.0,1,1,0,1,0,0,2,0
7,Abner,Betis,7.8,10,9,7,3,0,8,15,53.3,7,17,4,13,8,18,27,0
8,Zakaria Aboukhlal,Toulouse,4.2,1,1,0,0,1,1,3,33.3,2,3,0,3,1,2,1,0
9,Abdel Abqar,Alavés,12.9,14,7,11,1,2,8,16,50.0,8,14,10,4,11,25,68,0
10,Francesco Acerbi,Inter,12.0,13,7,10,3,0,7,8,87.5,1,8,6,2,18,31,25,0
11,Marcos Acuna,Sevilla,5.1,12,8,8,4,0,5,6,83.3,1,4,1,3,4,16,6,0
12,Benie Adama Traore,Sheffield Utd,4.3,4,2,1,2,1,0,4,0.0,4,4,1,3,1,5,1,0
13,Akor Adams,Montpellier,13.5,8,3,2,2,4,2,6,33.3,4,1,0,1,2,10,4,0
14,Junior Adamu,Freiburg,1.0,5,1,1,2,2,1,2,50.0,1,1,0,1,0,5,1,0
15,Sargis Adamyan,Köln,1.6,3,2,0,2,1,1,2,50.0,1,2,0,2,0,3,2,0
16,Tosin Adarabioyo,Fulham,2.0,1,1,0,1,0,1,1,100.0,0,1,1,0,3,4,11,0
17,Elijah Adebayo,Luton Town,6.5,1,0,1,0,0,0,3,0.0,3,6,0,6,4,5,10,0
18,Karim Adeyemi,Dortmund,4.1,7,7,3,2,2,3,10,30.0,7,6,0,6,2,9,1,0
19,Simon Adingra,Brighton,11.3,18,11,9,5,4,10,22,45.5,12,9,0,9,12,30,9,0
20,Amine Adli,Leverkusen,2.9,6,1,1,2,3,4,6,66.7,2,5,1,4,3,9,1,0
21,Yacine Adli,Milan,3.6,14,7,6,7,1,6,15,40.0,9,4,4,0,6,20,4,0
22,Adson,Nantes,2.6,7,6,1,6,0,2,2,100.0,0,5,0,5,2,9,2,0
23,Michel Aebischer,Bologna,12.0,17,13,4,12,1,7,15,46.7,8,16,3,13,9,26,11,0
24,Emmanuel Agbadou,Reims,10.7,25,16,12,12,1,17,26,65.4,9,15,7,8,23,48,51,1
26,Lucien Agoume,Inter,0.1,0,0,0,0,0,0,0,0.0,0,0,0,0,0,0,0,0
27,Felix Agu,Werder Bremen,1.2,1,1,1,0,0,1,2,50.0,1,0,0,0,1,2,4,0
28,Nayef Aguerd,West Ham,14.7,18,8,12,6,0,10,12,83.3,2,22,16,6,16,34,65,2
29,Ruben Aguilar,Lens,9.5,18,10,10,6,2,10,19,52.6,9,12,0,12,10,28,12,0
30,Naouirou Ahamada,Crystal Palace,1.4,2,2,1,1,0,2,6,33.3,4,0,0,0,1,3,0,0
31,Anel Ahmedhodzic,Sheffield Utd,11.5,24,18,19,3,2,13,22,59.1,9,22,12,10,13,37,50,0
32,Joseph Aidoo,Celta Vigo,4.5,8,3,6,2,0,4,8,50.0,4,3,1,2,4,12,28,0
33,Ola Aina,Nott'ham Forest,9.0,19,13,15,3,1,13,18,72.2,5,8,3,5,6,25,31,1
34,Rayan Ait Nouri,Wolves,9.9,30,19,19,9,2,10,15,66.7,5,13,5,8,11,41,20,0
35,Tosin Aiyegun,Lorient,5.3,5,4,1,3,1,2,4,50.0,2,2,1,1,1,6,5,0
36,Kristoffer Ajer,Brentford,8.1,17,9,12,4,1,13,19,68.4,6,5,1,4,5,22,25,0
37,Ludovic Ajorque,Mainz 05,8.8,2,2,1,1,0,1,6,16.7,5,5,1,4,0,2,4,0
38,Manuel Akanji,Manchester City,12.0,19,10,8,8,3,9,18,50.0,9,13,6,7,9,28,31,1
39,Marley Ake,Udinese,0.1,0,0,0,0,0,0,0,0.0,0,0,0,0,0,0,0,0
40,Nathan Ake,Manchester City,8.2,14,8,11,3,0,8,11,72.7,3,7,0,7,6,20,21,0
41,Ilias Akhomach,Villarreal,4.4,10,10,3,5,2,3,6,50.0,3,5,1,4,5,15,3,0
42,Sergio Akieme,Almería,13.0,18,11,15,1,2,8,10,80.0,2,8,3,5,7,25,18,0
43,Maghnes Akliouche,Monaco,5.0,8,5,3,4,1,3,10,30.0,7,5,0,5,3,11,0,0
44,Paul Akouokou,Betis,0.3,5,3,0,2,3,3,3,100.0,0,3,1,2,1,6,1,0
45,Paul Akouokou,Lyon,3.3,14,9,2,10,2,6,7,85.7,1,5,1,4,6,20,9,0
46,Jean-Daniel Akpa-Akpro,Monza,0.4,2,0,2,0,0,0,0,0.0,0,0,0,0,1,3,1,0
47,Kevin Akpoguma,Hoffenheim,6.3,21,10,15,5,1,15,19,78.9,4,14,5,9,9,30,16,0
48,David Alaba,Real Madrid,12.4,12,9,7,4,1,4,7,57.1,3,9,6,3,15,27,34,0
49,Luis Alberto,Lazio,12.8,21,12,11,6,4,9,29,31.0,20,24,2,22,3,24,4,0
50,Raul Albiol,Villarreal,12.8,14,9,6,7,1,10,17,58.8,7,17,14,3,10,24,67,0
52,Ruben Alcaraz,Cádiz,14.0,42,23,16,23,3,16,47,34.0,31,26,7,19,12,54,28,0
53,Omar Alderete,Getafe,6.8,7,6,5,2,0,4,10,40.0,6,14,8,6,3,10,42,0
54,Ivan Alejo,Cádiz,10.8,20,9,12,5,3,6,28,21.4,22,6,0,6,2,22,15,0
55,Carles Alena,Getafe,6.5,13,5,4,7,2,4,11,36.4,7,10,2,8,3,16,7,0
56,Trent Alexander-Arnold,Liverpool,12.6,17,12,11,5,1,12,42,28.6,30,8,1,7,15,32,29,3
57,Mohamed Ali Cho,Real Sociedad,2.8,4,3,3,1,0,2,7,28.6,5,6,0,6,1,5,1,0
58,Yanis Ali Issoufou,Montpellier,0.1,0.0,0,0.0,0.0,0.0,0.0,0.0,0.0,0.0,0.0,0.0,0.0,0,0.0,0.0,0.0
59,Faride Alidou,Köln,3.0,5,1,2,2,1,2,7,28.6,5,7,1,6,3,8,1,1
60,Nabil Alioui,Le Havre,10.4,3,2,2,1,0,2,4,50.0,2,6,1,5,3,6,4,0
61,Alisson,Liverpool,14.0,0,0,0,0,0,0,1,0.0,1,0,0,0,0,0,6,2
62,Jim Allevinah,Clermont Foot,11.3,19,10,6,9,4,9,23,39.1,14,14,3,11,9,28,13,0
63,Domingos Andre Ribeiro Almeida,Valencia,5.3,11,6,3,6,2,5,10,50.0,5,4,0,4,2,13,2,0
64,Miguel Almiron,Newcastle Utd,12.0,18,14,7,8,3,8,16,50.0,8,18,1,17,7,25,8,0
65,Pontus Almqvist,Lecce,10.3,18,12,6,10,2,9,24,37.5,15,12,0,12,6,24,5,0
66,Marcos Alonso,Barcelona,1.8,5,3,2,3,0,3,4,75.0,1,2,0,2,4,9,3,0
67,Adria Altimira,Villarreal,5.1,7,3,4,3,0,5,12,41.7,7,8,1,7,3,10,11,0
68,Sergi Altimira,Betis,1.8,7,4,5,2,0,6,10,60.0,4,3,0,3,2,9,3,0
69,Edson Alvarez,West Ham,11.1,27,14,16,9,2,9,22,40.9,13,21,7,14,16,43,40,0
70,Gaston Alvarez,Getafe,13.0,32,19,21,9,2,16,25,64.0,9,19,7,12,23,55,44,0
71,Julian Alvarez,Manchester City,14.6,11,5,2,3,6,4,15,26.7,11,16,0,16,1,12,8,0
72,Yeray Alvarez,Athletic Club,2.1,5,5,4,1,0,1,2,50.0,1,2,2,0,3,8,11,0
73,Skelly Alvero,Lyon,4.7,8,7,5,2,1,2,9,22.2,7,5,1,4,2,10,5,0
74,Papa Amadou Diallo,Metz,2.2,1,1,0,1,0,0,1,0.0,1,1,0,1,3,4,1,0
75,Selim Amallah,Valencia,4.2,14,9,6,5,3,3,7,42.9,4,10,0,10,9,23,4,0
76,Amath,Mallorca,4.1,9,6,7,2,0,2,10,20.0,8,1,0,1,3,12,5,0
78,Lorenzo Amatucci,Fiorentina,0.2,0,0,0,0,0,0,0,0.0,0,0,0,0,0,0,0,0
79,Zeki Amdouni,Burnley,11.7,17,10,1,7,9,6,15,40.0,9,13,5,8,3,20,6,0
80,Bruno Amione,Hellas Verona,5.9,11,3,9,2,0,4,5,80.0,1,3,2,1,8,19,17,2
81,Michael Amir Murillo,Marseille,4.1,8,3,5,2,1,5,7,71.4,2,3,0,3,4,12,10,0
82,Nadiem Amiri,Leverkusen,0.1,2,0,0,2,0,0,2,0.0,2,0,0,0,0,2,0,0
83,Sofyan Amrabat,Manchester Utd,5.8,21,13,12,7,2,14,20,70.0,6,10,2,8,4,25,6,1
84,Joachim Andersen,Crystal Palace,16.0,25,16,20,4,1,14,20,70.0,6,19,12,7,15,40,85,1
85,Elliot Anderson,Newcastle Utd,4.6,8,6,3,4,1,3,9,33.3,6,6,3,3,2,10,6,0
86,Felipe Anderson,Lazio,11.8,21,15,7,8,6,10,32,31.3,22,15,0,15,15,36,12,0
87,Benjamin Andre,Lille,13.3,45,26,18,23,4,20,39,51.3,19,12,1,11,17,62,27,0
88,Komnen Andric,Clermont Foot,1.4,2,1,0,1,1,0,1,0.0,1,2,0,2,0,2,1,0
89,Robert Andrich,Leverkusen,2.7,0,0,0,0,0,0,2,0.0,2,4,1,3,5,5,6,0
90,Miguel Angel Rubio,Granada,6.2,8,4,5,3,0,7,8,87.5,1,13,7,6,12,20,23,1
91,Fabrizio Angileri,Getafe,0.9,0,0,0,0,0,0,2,0.0,2,0,0,0,2,2,4,0
92,Jaidon Anthony,Bournemouth,1.7,3,1,1,0,2,1,7,14.3,6,3,0,3,1,4,3,0
93,Waldemar Anton,Stuttgart,14.0,17,12,8,8,1,11,18,61.1,7,14,9,5,19,36,67,1
94,Michail Antonio,West Ham,9.0,8,4,3,3,2,3,4,75.0,1,9,3,6,1,9,1,0
95,Antony,Manchester Utd,7.6,12,5,3,7,2,6,16,37.5,10,16,1,15,6,18,2,0
96,Christopher Antwi-Adjei,Bochum,5.6,7,4,4,2,1,4,12,33.3,8,6,2,4,0,7,5,1
97,Houssem Aouar,Roma,4.7,12,9,3,8,1,2,8,25.0,6,4,0,4,4,16,1,0
98,Stredair Appuah,Nantes,0.3,0,0,0,0,0,0,1,0.0,1,0,0,0,0,0,0,0
99,Mauro Arambarri,Getafe,3.8,6,2,3,2,1,1,6,16.7,5,1,0,1,2,8,7,0
100,Julian Araujo,Las Palmas,9.1,21,12,14,4,3,15,23,65.2,8,13,8,5,7,28,31,0
101,Ronald Araujo,Barcelona,8.4,10,7,4,5,1,2,4,50.0,2,9,4,5,4,14,19,0
102,Cameron Archer,Sheffield Utd,11.4,7,4,3,1,3,2,9,22.2,7,12,1,11,1,8,6,0
104,Cameron Archer,Aston Villa,0.1,0,0,0,0,0,0,0,0.0,0,0,0,0,0,0,0,0
105,Alphonse Areola,West Ham,14.0,0,0,0,0,0,0,2,0.0,2,0,0,0,0,0,5,0
106,Adu Ares,Athletic Club,0.3,3,2,2,0,1,1,2,50.0,1,0,0,0,0,3,0,0
107,Jesus Areso,Osasuna,11.1,19,11,11,7,1,14,16,87.5,2,14,5,9,8,27,28,0
108,Yoel Armougom,Clermont Foot,0.2,0,0,0,0,0,0,0,0.0,0,0,0,0,0,0,0,0
109,Jose Arnaiz,Osasuna,3.2,2,0,0,1,1,0,11,0.0,11,4,0,4,1,3,0,0
110,Hakon Arnar Haraldsson,Lille,4.2,3,3,1,2,0,1,9,11.1,8,0,0,0,1,4,3,0
111,Marko Arnautovic,Inter,1.9,2,1,1,1,0,1,1,100.0,0,1,0,1,2,4,1,0
112,Maximilian Arnold,Wolfsburg,9.9,15,10,2,9,4,8,16,50.0,8,7,1,6,11,26,20,0
113,Mohamed El Arouch,Lyon,0.0,0,0,0,0,0,0,0,0.0,0,0,0,0,0,0,0,0
114,Sergio Arribas,Almería,11.4,17,9,7,10,0,6,12,50.0,6,8,0,8,8,25,3,0
115,Kepa Arrizabalaga,Real Madrid,10.0,0,0,0,0,0,0,1,0.0,1,0,0,0,0,0,4,0
116,Arthur,Leverkusen,0.4,2,2,1,0,1,2,2,100.0,0,0,0,0,0,2,1,0
117,Takuma Asano,Bochum,11.6,10,2,2,4,4,4,13,30.8,9,6,1,5,2,12,8,0
118,Marco Asensio,Paris S-G,2.7,1,1,0,1,0,1,2,50.0,1,3,0,3,0,1,1,0
119,Kristjan Asllani,Inter,1.3,0,0,0,0,0,0,2,0.0,2,2,0,2,4,4,2,0
120,Joel Asoro,Metz,6.1,10,7,5,5,0,2,8,25.0,6,4,0,4,2,12,7,0
121,Iago Aspas,Celta Vigo,13.2,2,1,0,2,0,0,5,0.0,5,8,2,6,5,7,5,0
122,Lorenz Assignon,Rennes,10.9,24,12,12,8,4,9,23,39.1,14,9,4,5,8,32,27,1
123,Youcef Atal,Nice,4.0,9,3,6,2,1,6,8,75.0,2,7,1,6,4,13,1,0
124,Valentin Atangana Edoa,Reims,1.7,7,5,1,3,3,2,4,50.0,2,2,0,2,2,9,1,0
125,Arthur Atta,Metz,1.3,3,2,0,1,2,1,4,25.0,3,2,0,2,1,4,4,0
126,Noah Atubolu,Freiburg,14.0,0,0,0,0,0,0,0,0.0,0,0,0,0,0,0,3,0
127,Pierre-Emerick Aubameyang,Marseille,11.6,8,4,2,5,1,2,9,22.2,7,9,2,7,4,12,12,0
128,Tommaso Augello,Cagliari,10.7,10,8,7,2,1,9,14,64.3,5,7,3,4,4,14,24,0
130,Yann Aurel Bisseck,Inter,1.2,3,1,2,0,1,2,4,50.0,2,1,1,0,0,3,0,0
131,Serge Aurier,Nott'ham Forest,9.3,20,14,9,11,0,5,11,45.5,6,10,3,7,9,29,36,1
132,Ezequiel Avila,Osasuna,8.3,2,1,0,1,1,2,10,20.0,8,13,0,13,4,6,6,0
133,Taiwo Awoniyi,Nott'ham Forest,7.4,5,3,1,3,1,0,1,0.0,1,3,0,3,0,5,8,0
134,Andre Ayew,Le Havre,0.2,0,0,0,0,0,0,0,0.0,0,0,0,0,0,0,0,0
135,Jordan Ayew,Crystal Palace,14.6,34,19,14,14,6,8,21,38.1,13,19,1,18,10,44,8,0
136,Neil El Aynaoui,Lens,4.3,6,3,1,4,1,1,9,11.1,8,6,2,4,7,13,2,0
137,Sardar Azmoun,Roma,2.1,5,4,1,3,1,2,5,40.0,3,0,0,0,1,6,3,0
138,Cesar Azpilicueta,Atlético Madrid,8.7,16,10,7,8,1,8,13,61.5,5,13,3,10,10,26,27,0
139,Paulo Azzi,Cagliari,5.2,7,5,4,3,0,3,9,33.3,6,6,1,5,8,15,8,0
140,Oussama El Azzouzi,Bologna,2.2,5,3,1,3,1,3,6,50.0,3,3,2,1,4,9,6,0
141,Abdellah Baallal,Clermont Foot,0.0,0,0,0,0,0,0,0,0.0,0,1,0,1,0,0,0,0
142,Iddrisu Baba,Almería,9.3,27,17,15,12,0,9,22,40.9,13,7,1,6,10,37,11,1
143,Srdan Babic,Almería,1.0,2,2,0,2,0,1,1,100.0,0,1,1,0,0,2,2,0
144,Aliou Badara Balde,Nice,0.4,0,0,0,0,0,0,0,0.0,0,0,0,0,1,1,0,0
145,Loic Bade,Sevilla,9.8,23,14,19,4,0,10,17,58.8,7,12,8,4,16,39,51,0
146,Milan Badelj,Genoa,9.7,18,7,9,9,0,9,26,34.6,17,19,2,17,19,37,13,0
147,Matthias Bader,Darmstadt 98,8.7,19,9,12,3,4,11,20,55.0,9,10,2,8,14,33,9,0
148,Benoit Badiashile,Chelsea,3.0,6,4,4,2,0,2,2,100.0,0,5,2,3,3,9,15,0
149,Alex Baena,Villarreal,11.8,11,8,3,2,6,4,14,28.6,10,7,0,7,5,16,3,1
150,Jaime Baez,Frosinone,5.0,4,1,0,2,2,0,7,0.0,7,5,0,5,4,8,1,0
151,Leon Bailey,Aston Villa,6.6,2,2,0,0,2,0,4,0.0,4,5,0,5,5,7,3,0
152,Nedim Bajrami,Sassuolo,6.5,6,2,2,3,1,1,4,25.0,3,2,1,1,4,10,4,0
153,Tiemoue Bakayoko,Lorient,4.6,11,9,4,6,1,1,4,25.0,3,4,2,2,8,19,2,0
154,Mitchel Bakker,Atalanta,2.5,5,2,5,0,0,1,8,12.5,7,4,0,4,1,6,4,0
156,Ridle Baku,Wolfsburg,8.1,10,6,6,2,2,5,13,38.5,8,12,0,12,10,20,22,1
157,Dilane Bakwa,Strasbourg,8.2,12,10,5,5,2,5,18,27.8,13,5,0,5,7,19,2,0
158,Tommaso Baldanzi,Empoli,6.8,3,2,1,1,1,3,7,42.9,4,6,0,6,2,5,0,0
159,Alejandro Balde,Barcelona,11.3,15,7,11,2,2,5,7,71.4,2,11,1,10,5,20,20,1
160,George Baldock,Sheffield Utd,6.3,12,7,4,7,1,5,10,50.0,5,7,3,4,7,19,13,0
161,Carlos Baleba,Brighton,5.3,21,9,11,8,2,10,19,52.6,9,13,3,10,7,28,12,1
162,Carlos Baleba,Lille,0.7,6,2,1,4,1,3,4,75.0,1,0,0,0,2,8,0,0
163,Leonardo Balerdi,Marseille,8.4,22,14,15,7,0,14,17,82.4,3,16,6,10,20,42,42,0
164,Ivan Balliu,Rayo Vallecano,13.9,15,9,7,8,0,7,14,50.0,7,17,6,11,16,31,33,0
165,Fode Ballo-Toure,Fulham,0.4,2,1,1,1,0,1,1,100.0,0,1,0,1,3,5,1,0
166,Folarin Balogun,Monaco,8.4,5,1,1,4,0,2,8,25.0,6,3,0,3,2,7,2,0
167,Jonathan Bamba,Celta Vigo,14.7,10,6,3,5,2,0,9,0.0,9,15,0,15,9,19,9,0
168,Lameck Banda,Lecce,8.8,16,12,7,6,3,3,14,21.4,11,10,0,10,2,18,4,0
169,Mamady Bangre,Toulouse,1.1,4,2,2,2,0,3,4,75.0,1,0,0,0,4,8,3,0
170,Mattia Bani,Genoa,10.0,9,3,7,2,0,2,4,50.0,2,22,13,9,7,16,49,0
171,Leo Baptistao,Almería,7.6,13,7,5,4,4,5,13,38.5,8,6,1,5,2,15,11,0
172,Shandon Baptiste,Brentford,2.1,4,4,2,2,0,1,5,20.0,4,4,1,3,3,7,5,0
173,Antonin Barak,Fiorentina,1.2,1,1,0,0,1,1,1,100.0,0,2,0,2,0,1,1,0
174,Francisco Barbosa,Betis,2.5,0,0,0,0,0,0,0,0.0,0,0,0,0,0,0,2,0
175,Bradley Barcola,Lyon,3.0,5,2,0,2,3,1,7,14.3,6,4,0,4,2,7,0,0
176,Bradley Barcola,Paris S-G,5.0,17,6,9,4,4,3,12,25.0,9,8,0,8,4,21,4,1
177,Melvin Bard,Nice,14.1,32,19,10,15,7,14,27,51.9,13,26,5,21,20,52,21,0
178,Nicolo Barella,Inter,12.9,23,12,8,11,4,12,30,40.0,18,9,0,9,4,27,7,0
179,Kike Barja,Osasuna,2.7,4,2,2,1,1,2,5,40.0,3,1,1,0,1,5,2,0
180,Ross Barkley,Luton Town,8.9,12,5,2,7,3,3,14,21.4,11,9,5,4,8,20,18,1
182,Aymen Barkok,Mainz 05,3.5,9,5,2,6,1,3,5,60.0,2,7,0,7,2,11,1,0
183,Harvey Barnes,Newcastle Utd,2.1,1,0,0,1,0,0,1,0.0,1,0,0,0,1,2,0,0
184,Leandro Barreiro Martins,Mainz 05,13.9,29,21,8,17,4,10,22,45.5,12,25,10,15,25,54,21,0
185,Enzo Barrenechea,Frosinone,12.1,31,19,12,16,3,17,34,50.0,17,18,5,13,10,41,25,2
186,Ander Barrenetxea,Real Sociedad,9.1,12,4,3,6,3,3,16,18.8,13,7,0,7,5,17,3,0
187,Pablo Barrios,Atlético Madrid,6.3,15,8,6,8,1,6,15,40.0,9,8,0,8,14,29,7,1
188,Davide Bartesaghi,Milan,0.3,0,0,0,0,0,0,0,0.0,0,0,0,0,0,0,2,0
189,Marc Bartra,Betis,2.5,4,3,3,1,0,4,5,80.0,1,3,1,2,3,7,10,0
190,Federico Baschirotto,Lecce,13.6,8,5,6,2,0,3,5,60.0,2,18,11,7,8,16,52,0
191,Chris Basham,Sheffield Utd,3.6,7,2,4,3,0,2,9,22.2,7,9,4,5,5,12,17,0
192,Calvin Bassey,Fulham,9.4,17,11,10,6,1,5,6,83.3,1,12,5,7,18,35,24,3
193,Alessandro Bastoni,Inter,8.9,15,12,13,0,2,8,14,57.1,6,6,4,2,7,22,9,0
194,Simone Bastoni,Empoli,2.8,11,7,7,3,1,5,9,55.6,4,4,0,4,7,18,9,0
195,Daniel Batz,Mainz 05,2.0,0,0,0,0,0,0,0,0.0,0,0,0,0,0,0,3,0
196,Maximilian Bauer,Augsburg,5.5,9,5,5,4,0,3,9,33.3,6,8,7,1,8,17,24,1
197,Elias Baum,Eint Frankfurt,0.0,0,0,0,0,0,0,0,0.0,0,0,0,0,0,0,0,0
198,Oliver Baumann,Hoffenheim,14.0,1,1,1,0,0,1,1,100.0,0,0,0,0,0,1,5,0
199,Christoph Baumgartner,RB Leipzig,5.9,8,6,2,4,2,5,12,41.7,7,9,0,9,3,11,5,0
200,Bebe,Rayo Vallecano,1.0,2,2,1,1,0,1,3,33.3,2,0,0,0,0,2,0,0
201,Ihlas Bebou,Hoffenheim,6.3,10,6,5,3,2,4,10,40.0,6,6,0,6,7,17,7,0
202,Adrian Beck,Heidenheim,5.6,8,5,2,5,1,6,12,50.0,6,5,0,5,2,10,8,0
203,Sheraldo Becker,Union Berlin,6.5,3,3,0,2,1,0,2,0.0,2,2,0,2,0,3,2,0
204,Donny van de Beek,Manchester Utd,0.0,0,0,0,0,0,0,0,0.0,0,1,0,1,0,0,0,0
205,Yanis Begraoui,Toulouse,3.2,5,3,1,3,1,3,9,33.3,6,4,0,4,5,10,3,0
206,Kevin Behrens,Union Berlin,10.6,12,10,3,6,3,1,4,25.0,3,5,1,4,2,14,13,0
208,Maximilian Beier,Hoffenheim,10.1,5,2,1,2,2,2,6,33.3,4,6,0,6,0,5,6,0
209,Jeremie Bela,Clermont Foot,0.5,0,0,0,0,0,0,0,0.0,0,0,0,0,0,0,0,0
210,Amari'i Bell,Luton Town,10.2,28,18,17,11,0,14,23,60.9,9,19,7,12,11,39,34,0
211,Stefan Bell,Mainz 05,6.4,8,8,7,1,0,4,8,50.0,4,5,4,1,5,13,26,0
212,Raoul Bellanova,Torino,13.1,10,7,4,6,0,4,10,40.0,6,8,2,6,9,19,10,0
213,Jean-Ricner Bellegarde,Wolves,4.1,7,3,4,3,0,3,8,37.5,5,8,1,7,2,9,3,0
214,Jean-Ricner Bellegarde,Strasbourg,3.0,5,3,3,2,0,3,6,50.0,3,4,0,4,4,9,0,0
215,Hector Bellerin,Betis,10.2,12,8,7,4,1,8,23,34.8,15,8,3,5,14,26,19,0
216,Jude Bellingham,Real Madrid,13.3,22,18,7,11,4,6,16,37.5,10,33,3,30,10,32,8,0
217,Jeanoel Belocian,Rennes,9.2,17,11,10,7,0,12,15,80.0,3,7,4,3,11,28,28,0
218,Andrea Belotti,Roma,5.3,7,4,1,3,3,3,5,60.0,2,4,0,4,0,7,3,0
219,Fran Beltran,Celta Vigo,11.3,16,10,7,6,3,6,25,24.0,19,8,0,8,9,25,12,0
220,Lucas Beltran,Fiorentina,5.6,11,7,1,7,3,4,6,66.7,2,12,1,11,0,11,3,0
221,Eliesse Ben Seghir,Monaco,0.4,0,0,0,0,0,0,0,0.0,0,1,0,1,0,0,0,0
222,Anis Ben Slimane,Sheffield Utd,1.7,3,2,2,0,1,0,3,0.0,3,1,0,1,1,4,1,0
223,Wissam Ben Yedder,Monaco,10.2,3,3,0,2,1,0,2,0.0,2,7,0,7,3,6,0,0
224,Carlos Benavidez,Alavés,4.0,21,11,8,10,3,7,11,63.6,4,6,4,2,7,28,10,0
225,Ismael Bennacer,Milan,0.5,0,0,0,0,0,0,1,0.0,1,1,0,1,0,0,0,0
226,Said Benrahma,West Ham,5.4,4,1,1,3,0,2,12,16.7,10,7,0,7,3,7,2,0
227,Ramy Bensebaini,Dortmund,9.1,23,16,14,7,2,17,25,68.0,8,17,7,10,12,35,27,0
228,Nabil Bentaleb,Lille,6.4,16,11,5,9,2,6,15,40.0,9,9,1,8,11,27,8,0
229,Rodrigo Bentancur,Tottenham,1.0,4,3,3,1,0,2,3,66.7,1,3,0,3,1,5,0,0
230,Daniel Bentley,Wolves,1.8,0,0,0,0,0,0,0,0.0,0,0,0,0,0,0,0,0
231,Domenico Berardi,Sassuolo,11.8,14,7,5,8,1,2,15,13.3,13,11,0,11,9,23,9,0
232,Yuri Berchiche,Athletic Club,6.9,10,7,5,4,1,6,11,54.5,5,8,4,4,7,17,17,0
234,Alex Berenguer,Athletic Club,5.0,6,4,3,2,1,1,4,25.0,3,5,0,5,1,7,7,0
235,Bartosz Bereszynski,Empoli,6.4,17,10,11,4,2,10,16,62.5,6,3,2,1,6,23,17,0
236,Johann Berg Gudmundsson,Burnley,7.2,8,2,4,3,1,5,8,62.5,3,5,0,5,10,18,7,0
237,Sander Berge,Burnley,12.8,24,13,16,6,2,14,24,58.3,10,22,9,13,8,32,23,1
238,Etrit Berisha,Empoli,13.0,0,0,0,0,0,0,1,0.0,1,0,0,0,0,0,7,1
239,Mergim Berisha,Hoffenheim,1.6,0,0,0,0,0,0,0,0.0,0,2,1,1,0,0,0,0
240,Mergim Berisha,Augsburg,1.4,0,0,0,0,0,0,0,0.0,0,1,0,1,0,0,3,0
241,Bernardo,Bochum,14.0,40,25,28,9,3,19,31,61.3,12,33,12,21,27,67,53,1
242,Victor Bernth Kristiansen,Bologna,8.3,15,11,10,4,1,5,10,50.0,5,13,2,11,3,18,16,0
243,Matus Bero,Bochum,5.2,11,7,5,4,2,5,10,50.0,5,6,0,6,1,12,5,0
244,Luke Berry,Luton Town,0.3,0,0,0,0,0,0,0,0.0,0,0,0,0,0,0,0,0
245,Jan-Niklas Beste,Heidenheim,12.2,24,13,9,6,9,7,19,36.8,12,22,0,22,8,32,10,0
246,Beto,Everton,4.6,10,5,1,5,4,3,9,33.3,6,6,0,6,0,10,7,0
247,Beto,Udinese,0.8,1,0,0,0,1,0,0,0.0,0,0,0,0,0,1,0,0
248,Sam Beukema,Bologna,13.0,17,9,11,6,0,13,17,76.5,4,14,7,7,7,24,49,0
249,Jordan Beyer,Burnley,10.5,27,16,18,8,1,11,19,57.9,8,13,9,4,13,40,51,1
250,Jaka Bijol,Udinese,13.0,26,16,22,4,0,13,23,56.5,10,17,11,6,14,40,68,1
251,Philip Billing,Bournemouth,11.5,27,13,4,19,4,8,20,40.0,12,25,5,20,13,40,23,1
252,Cristiano Biraghi,Fiorentina,9.5,17,12,6,9,2,10,21,47.6,11,16,4,12,7,24,14,0
253,Davide Biraschi,Genoa,1.0,3,3,1,2,0,1,3,33.3,2,0,0,0,2,5,5,0
254,Samuele Birindelli,Monza,6.3,10,6,6,3,1,5,8,62.5,3,11,4,7,6,16,14,0
255,Tom Bischof,Hoffenheim,1.4,7,4,5,1,1,1,6,16.7,5,1,0,1,1,8,1,0
256,Yves Bissouma,Tottenham,12.6,47,29,20,19,8,26,37,70.3,11,16,4,12,20,67,26,2
257,Leonardo Bittencourt,Werder Bremen,6.7,21,12,13,7,1,6,20,30.0,14,10,0,10,7,28,4,0
258,Marco Bizot,Brest,15.0,0,0,0,0,0,0,0,0.0,0,0,0,0,0,0,11,1
260,Antonio Blanco,Alavés,10.4,27,19,12,14,1,13,31,41.9,18,9,0,9,16,43,14,0
261,Ruben Blanco,Marseille,0.3,0,0,0,0,0,0,0,0.0,0,0,0,0,0,0,0,0
262,Ludovic Blas,Rennes,9.8,12,5,4,8,0,6,16,37.5,10,11,1,10,3,15,2,0
263,Janis Blaswich,RB Leipzig,14.0,1,1,1,0,0,0,0,0.0,0,0,0,0,0,1,4,2
264,Alexis Blin,Lecce,4.5,9,4,2,7,0,4,12,33.3,8,5,0,5,6,15,9,0
265,Daley Blind,Girona,15.0,21,8,13,7,1,11,21,52.4,10,21,8,13,12,33,49,0
266,Myron Boadu,Monaco,0.7,2,2,0,1,1,1,1,100.0,0,1,0,1,0,2,0,0
267,Benicio Boaitey,Brighton,0.2,0,0,0,0,0,0,0,0.0,0,0,0,0,0,0,2,0
268,Oscar Bobb,Manchester City,0.8,1,0,1,0,0,1,1,100.0,0,1,0,1,0,1,1,0
269,Jeremie Boga,Nice,9.3,6,4,1,5,0,3,10,30.0,7,10,1,9,2,8,1,0
270,Jayden Bogle,Sheffield Utd,10.5,17,10,9,6,2,11,29,37.9,18,16,2,14,15,32,34,0
271,Emil Bohinen,Salernitana,5.9,8,6,5,3,0,2,10,20.0,8,8,2,6,14,22,6,1
272,Adama Bojang,Reims,0.0,0,0,0,0,0,0,0,0.0,0,0,0,0,0,0,0,0
273,Daniel Boloca,Sassuolo,12.1,28,18,10,15,3,14,20,70.0,6,15,8,7,11,39,11,2
274,Willy Boly,Nott'ham Forest,10.0,25,16,21,4,0,9,19,47.4,10,17,13,4,19,44,64,0
275,Giacomo Bonaventura,Fiorentina,12.8,12,5,1,4,7,2,9,22.2,7,12,0,12,4,16,4,0
276,Federico Bonazzoli,Hellas Verona,6.0,1,0,0,1,0,0,3,0.0,3,4,0,4,2,3,1,0
277,Warren Bondo,Monza,1.7,5,3,2,2,1,1,1,100.0,0,2,0,2,2,7,0,0
278,Giovanni Bonfanti,Atalanta,0.2,0,0,0,0,0,0,0,0.0,0,0,0,0,0,0,1,0
279,Victor Boniface,Leverkusen,13.1,6,4,0,1,5,1,4,25.0,3,3,0,3,0,6,9,0
280,Kevin Bonifazi,Bologna,1.0,4,0,0,4,0,1,2,50.0,1,0,0,0,0,4,7,1
281,Leonardo Bonucci,Union Berlin,4.9,6,5,2,4,0,4,4,100.0,0,5,3,2,7,13,14,0
282,Angelo Borges,Strasbourg,7.9,18,7,6,6,6,9,21,42.9,12,9,0,9,5,23,1,0
283,Neto Borges,Clermont Foot,11.0,19,11,10,8,1,10,24,41.7,14,12,3,9,24,43,18,0
284,Yvandro Borges Sanches,M'Gladbach,0.2,0,0,0,0,0,0,0,0.0,0,0,0,0,0,0,0,0
286,Sebastiaan Bornauw,Wolfsburg,3.4,7,2,6,1,0,5,7,71.4,2,7,4,3,3,10,12,0
287,Rafael Borre,Werder Bremen,7.6,7,5,2,3,2,4,12,33.3,8,2,0,2,1,8,4,0
288,Gennaro Borrelli,Frosinone,0.3,0,0,0,0,0,0,0,0.0,0,0,0,0,0,0,0,0
289,Adri Bosch,Granada,0.3,1,1,1,0,0,0,0,0.0,0,0,0,0,0,1,1,0
290,Erik Botheim,Salernitana,3.5,2,0,2,0,0,0,1,0.0,1,3,0,3,0,2,2,0
291,Sven Botman,Newcastle Utd,5.0,6,5,4,2,0,3,4,75.0,1,4,3,1,4,10,16,1
292,Ayyoub Bouaddi,Lille,0.4,1,1,1,0,0,0,2,0.0,2,1,0,1,1,2,1,0
293,Badredine Bouanani,Nice,1.6,3,2,1,1,1,3,4,75.0,1,4,0,4,3,6,0,0
294,Hicham Boudaoui,Nice,7.1,18,9,6,10,2,10,14,71.4,4,5,0,5,4,22,3,0
295,Yassine Bounou,Sevilla,1.0,0,0,0,0,0,0,0,0.0,0,0,0,0,0,0,0,0
296,Mehdi Bourabia,Frosinone,1.5,0,0,0,0,0,0,1,0.0,1,2,0,2,0,0,3,0
297,Benjamin Bourigeaud,Rennes,13.6,19,10,11,6,2,8,23,34.8,15,16,2,14,13,32,21,0
298,Bilal Boutobba,Clermont Foot,3.1,8,4,2,3,3,3,7,42.9,4,3,0,3,2,10,0,0
299,Edoardo Bove,Roma,8.2,27,12,6,17,4,13,21,61.9,8,11,1,10,5,32,3,1
300,Jarrod Bowen,West Ham,15.0,19,11,9,5,5,8,16,50.0,8,23,4,19,11,30,8,0
301,Lucas Boye,Granada,10.8,20,11,5,12,3,6,16,37.5,10,14,1,13,3,23,19,0
302,Domagoj Bradaric,Salernitana,12.5,19,12,6,8,5,9,14,64.3,5,9,4,5,15,34,22,1
303,Bilal Brahimi,Nice,0.1,0,0,0,0,0,0,1,0.0,1,0,0,0,0,0,0,0
304,Bilal Brahimi,Brest,1.8,0,0,0,0,0,0,3,0.0,3,2,0,2,0,0,0,0
305,Juan Brandariz,Almería,12.6,17,11,11,6,0,8,12,66.7,4,21,15,6,7,24,40,0
306,Julian Brandt,Dortmund,11.5,5,4,1,4,0,3,12,25.0,9,9,1,8,5,10,7,0
307,Jarrad Branthwaite,Everton,14.0,30,17,22,7,1,20,24,83.3,4,19,10,9,25,55,71,1
308,Lilian Brassier,Brest,12.7,15,8,9,6,0,6,10,60.0,4,13,10,3,26,41,30,0
309,Claudio Bravo,Betis,7.0,0,0,0,0,0,0,1,0.0,1,0,0,0,0,0,2,0
310,Tim Breithaupt,Augsburg,2.9,5,3,4,1,0,4,6,66.7,2,4,2,2,1,6,5,0
312,Josip Brekalo,Fiorentina,5.6,7,6,6,1,0,2,7,28.6,5,7,0,7,1,8,0,0
313,Gleison Bremer,Juventus,14.9,18,16,12,4,2,8,12,66.7,4,13,9,4,20,38,70,0
314,Ben Brereton,Villarreal,2.6,2,2,1,0,1,0,2,0.0,2,0,0,0,0,2,0,0
315,Marco Brescianini,Frosinone,6.4,9,4,4,5,0,1,8,12.5,7,7,3,4,3,12,11,0
316,Maximilian Breunig,Freiburg,0.1,0,0,0,0,0,0,0,0.0,0,1,0,1,0,0,0,0
317,Rhian Brewster,Sheffield Utd,1.8,4,1,1,1,2,0,0,0.0,0,1,0,1,0,4,1,0
318,Armando Broja,Chelsea,2.6,2,0,0,1,1,0,0,0.0,0,2,0,2,0,2,1,0
319,Dylan Bronn,Salernitana,0.0,0,0,0,0,0,0,0,0.0,0,0,0,0,0,0,2,0
320,Andre Brooks,Sheffield Utd,1.8,2,2,1,1,0,1,4,25.0,3,1,0,1,5,7,2,0
321,David Brooks,Bournemouth,2.6,4,4,2,1,1,2,3,66.7,1,2,0,2,2,6,2,0
322,John Brooks,Hoffenheim,10.0,14,6,7,6,1,5,15,33.3,10,13,6,7,17,31,68,1
323,Moritz Broschinski,Bochum,2.9,2,2,0,2,0,0,2,0.0,2,1,1,0,0,2,1,0
324,Jacob Brown,Luton Town,8.7,15,10,6,6,3,5,13,38.5,8,15,1,14,7,22,11,0
325,Josh Brownhill,Burnley,12.7,25,20,7,13,5,14,19,73.7,5,12,2,10,22,47,18,0
326,Alexander Brunst,Darmstadt 98,1.0,0,0,0,0,0,0,0,0.0,0,0,0,0,0,0,0,0
327,Jacob Bruun Larsen,Burnley,3.6,3,2,1,0,2,3,5,60.0,2,0,0,0,1,4,3,0
328,Ante Budimir,Osasuna,12.5,13,8,2,10,1,2,5,40.0,3,7,3,4,3,16,8,0
329,Hugo Bueno,Wolves,4.0,12,7,7,3,2,6,9,66.7,3,9,1,8,2,14,10,0
330,Santiago Bueno,Wolves,1.0,2,1,0,2,0,0,1,0.0,1,5,2,3,0,2,7,0
331,Marius Bulter,Hoffenheim,7.2,7,3,5,1,1,3,9,33.3,6,4,0,4,4,11,9,0
332,Facundo Buonanotte,Brighton,3.3,9,4,1,6,2,3,7,42.9,4,4,0,4,2,11,1,0
333,Alessandro Buongiorno,Torino,11.3,29,18,17,10,2,11,17,64.7,6,12,7,5,26,55,46,0
334,Jonathan Burkardt,Mainz 05,1.1,0,0,0,0,0,0,0,0.0,0,2,1,1,1,1,0,0
335,Oliver Burke,Werder Bremen,0.4,0,0,0,0,0,0,2,0.0,2,0,0,0,0,0,0,0
336,Reece Burke,Luton Town,6.6,12,7,8,2,2,5,10,50.0,5,9,6,3,7,19,26,0
338,Dan Burn,Newcastle Utd,10.5,17,9,10,7,0,4,20,20.0,16,21,8,13,10,27,29,1
339,Rares-Catalin Burnete,Lecce,0.1,0,0,0,0,0,0,0,0.0,0,0,0,0,0,0,0,0
340,Mason Burstow,Chelsea,0.1,0,0,0,0,0,0,0,0.0,0,0,0,0,0,0,0,0
341,Marnon Busch,Heidenheim,1.3,3,1,3,0,0,1,4,25.0,3,3,0,3,2,5,1,0
342,Maxime Busi,Reims,1.3,1,0,0,1,0,0,2,0.0,2,4,0,4,2,3,1,0
343,Aurelio Buta,Eint Frankfurt,9.4,20,13,10,7,3,10,19,52.6,9,12,3,9,6,26,19,0
344,Marcin Bulka,Nice,15.0,0,0,0,0,0,0,0,0.0,0,0,0,0,0,0,5,2
345,Jamie Bynoe-Gittens,Dortmund,2.9,2,1,1,1,0,0,3,0.0,3,2,1,1,2,4,3,0
346,Juan Cabal,Hellas Verona,0.3,1,0,0,1,0,0,1,0.0,1,0,0,0,0,1,0,0
347,Remy Cabella,Lille,9.5,31,22,12,10,9,11,29,37.9,18,16,0,16,3,34,2,0
348,Jovane Cabral,Salernitana,7.3,12,8,4,6,2,3,8,37.5,5,3,0,3,1,13,3,0
349,Liberato Cacace,Empoli,9.1,19,10,12,5,2,12,18,66.7,6,9,2,7,10,29,19,0
350,Anthony Caci,Mainz 05,12.8,21,8,14,7,0,15,22,68.2,7,17,3,14,15,36,21,0
351,Moises Caicedo,Chelsea,12.2,25,14,13,9,3,11,21,52.4,10,13,7,6,11,36,19,1
352,Tom Cairney,Fulham,5.4,7,6,2,4,1,4,8,50.0,4,7,1,6,2,9,1,0
353,Jens Cajuste,Napoli,3.1,13,10,7,5,1,9,14,64.3,5,6,0,6,1,14,5,0
354,Davide Calabria,Milan,11.0,31,13,18,11,2,22,34,64.7,12,11,3,8,19,50,27,0
355,Riccardo Calafiori,Bologna,10.3,15,11,11,4,0,5,11,45.5,6,21,10,11,20,35,30,2
356,Luca Caldirola,Monza,12.9,12,7,9,1,2,7,11,63.6,4,16,11,5,18,30,25,0
357,Duje Caleta-Car,Lyon,5.2,5,2,3,2,0,3,4,75.0,1,9,4,5,4,9,21,0
358,Hakan Calhanoglu,Inter,13.5,35,20,17,14,4,20,31,64.5,11,14,8,6,8,43,11,0
359,Jose Callejon,Granada,5.6,8,4,5,3,0,5,13,38.5,8,3,1,2,1,9,7,0
360,Dominic Calvert-Lewin,Everton,9.0,4,2,0,3,1,0,4,0.0,4,4,1,3,1,5,10,0
361,Lamine Camara,Metz,12.5,34,23,15,15,4,13,27,48.1,14,16,1,15,15,49,13,0
362,Mahdi Camara,Brest,10.0,25,16,3,19,3,12,22,54.5,10,15,0,15,15,40,10,0
364,Mohamed Camara,Monaco,7.3,21,12,7,10,4,8,17,47.1,9,7,2,5,8,29,4,0
365,Francesco Camarda,Milan,0.2,0,0,0,0,0,0,2,0.0,2,0,0,0,0,0,0,0
366,Eduardo Camavinga,Real Madrid,8.3,32,19,15,14,3,11,19,57.9,8,14,2,12,14,46,10,0
367,Nicolo Cambiaghi,Empoli,9.6,18,13,6,6,6,6,16,37.5,10,9,0,9,6,24,4,0
368,Andrea Cambiaso,Juventus,8.7,16,11,8,5,3,11,18,61.1,7,10,0,10,2,18,13,0
369,Axel Camblan,Brest,0.8,1,1,0,0,1,0,2,0.0,2,2,0,2,0,1,0,0
370,Sergio Camello,Rayo Vallecano,6.4,6,1,0,5,1,0,0,0.0,0,2,0,2,1,7,5,0
371,Emre Can,Dortmund,8.6,28,20,15,10,3,13,18,72.2,5,13,1,12,9,37,13,1
372,Matteo Cancellieri,Empoli,10.0,24,16,9,10,5,11,23,47.8,12,15,0,15,3,27,8,0
373,Joao Cancelo,Barcelona,12.0,37,25,18,13,6,25,37,67.6,12,20,3,17,6,43,19,0
374,Fali Cande,Metz,11.4,22,13,17,5,0,11,18,61.1,7,22,16,6,12,34,63,0
375,Antonio Candreva,Salernitana,11.8,7,5,3,3,1,5,12,41.7,7,2,0,2,5,12,6,0
376,Thomas Cannon,Everton,0.0,0,0,0,0,0,0,0,0.0,0,0,0,0,0,0,0,0
377,Sergi Canos,Valencia,3.5,7,3,3,2,2,1,6,16.7,5,5,1,4,5,12,2,0
378,Luigi Canotto,Frosinone,0.2,0,0,0,0,0,0,0,0.0,0,0,0,0,0,0,0,0
379,Etienne Capoue,Villarreal,11.0,20,14,10,8,2,11,18,61.1,7,11,2,9,14,34,17,0
380,Gianluca Caprari,Monza,2.8,2,1,1,1,0,0,1,0.0,1,0,0,0,2,4,0,0
381,Elia Caprile,Empoli,1.0,0,0,0,0,0,0,0,0.0,0,0,0,0,0,0,2,1
382,Francesco Caputo,Empoli,10.6,2,0,0,0,2,0,1,0.0,1,4,0,4,0,2,2,0
383,Maxence Caqueret,Lyon,14.7,35,24,13,14,8,15,48,31.3,33,13,2,11,27,62,12,1
384,Andrea Carboni,Monza,7.8,23,10,15,8,0,8,11,72.7,3,12,8,4,5,28,31,1
385,Valentin Carboni,Monza,1.6,3,2,1,2,0,1,6,16.7,5,3,0,3,1,4,1,0
386,Isaac Carcelen,Cádiz,13.6,25,13,18,7,0,12,20,60.0,8,13,3,10,10,35,54,2
387,Irvin Cardona,Augsburg,0.6,1,1,0,0,1,1,3,33.3,2,1,0,1,0,1,1,0
388,Marc Cardona,Las Palmas,4.1,4,3,1,1,2,0,5,0.0,5,4,0,4,1,5,2,0
390,Sergi Cardona,Las Palmas,14.3,50,28,26,19,5,34,56,60.7,22,21,4,17,27,77,49,0
391,Igor Carioca,Lorient,0.9,4,3,3,1,0,2,4,50.0,2,0,0,0,2,6,1,0
392,Carlos,Inter,5.0,10,8,7,3,0,3,6,50.0,3,8,2,6,5,15,15,0
393,Diego Carlos,Aston Villa,7.1,13,8,11,2,0,7,11,63.6,4,5,4,1,5,18,28,1
394,Carmona,Getafe,5.3,9,7,2,7,0,2,10,20.0,8,8,0,8,4,13,5,0
395,Marco Carnesecchi,Atalanta,5.0,0,0,0,0,0,0,0,0.0,0,0,0,0,0,0,1,1
396,Yannick Carrasco,Atlético Madrid,2.5,4,4,3,1,0,2,7,28.6,5,2,0,2,1,5,6,0
397,Rasmus Carstensen,Köln,10.5,25,12,10,12,3,16,30,53.3,14,20,5,15,12,37,28,1
398,Dani Carvajal,Real Madrid,12.1,27,16,13,11,3,15,24,62.5,9,11,3,8,14,41,23,1
399,Fabio Carvalho,RB Leipzig,1.7,3,1,0,2,1,1,2,50.0,1,8,0,8,0,3,1,0
400,William Carvalho,Betis,2.2,6,4,1,4,1,3,4,75.0,1,2,0,2,2,8,1,0
401,Nicolo Casale,Lazio,7.0,7,3,7,0,0,5,11,45.5,6,4,4,0,3,10,25,0
402,Casemiro,Manchester Utd,7.2,21,12,5,13,3,12,27,44.4,15,21,5,16,5,26,16,0
403,Matty Cash,Aston Villa,12.3,31,18,15,15,1,16,32,50.0,16,14,5,9,13,44,29,0
404,Josue Casimir,Le Havre,10.1,19,8,9,9,1,5,7,71.4,2,14,2,12,5,24,15,0
405,Giuseppe Caso,Frosinone,3.7,4,3,2,0,2,2,3,66.7,1,0,0,0,0,4,0,0
406,Cristian Casseres Jr.,Toulouse,9.9,29,16,15,13,1,12,25,48.0,13,18,2,16,14,43,13,1
407,Timothy Castagne,Fulham,11.4,23,9,11,7,5,12,21,57.1,9,14,3,11,20,43,24,1
408,Koen Casteels,Wolfsburg,11.0,2,1,2,0,0,2,3,66.7,1,0,0,0,0,2,7,2
409,Valentin Castellanos,Lazio,5.5,11,7,0,3,8,1,5,20.0,4,7,0,7,1,12,6,0
410,Jean-Charles Castelletto,Nantes,13.0,16,11,8,6,2,10,15,66.7,5,9,7,2,16,32,45,0
411,Samu Castillejo,Sassuolo,3.9,9,8,3,4,2,5,13,38.5,8,10,1,9,0,9,3,0
412,Jonny Castro,Wolves,0.1,0,0,0,0,0,0,1,0.0,1,1,1,0,0,0,0,0
413,Danilo Cataldi,Lazio,7.2,9,1,4,4,1,2,6,33.3,4,9,5,4,10,19,12,1
414,Catena,Osasuna,13.9,15,9,13,1,1,8,17,47.1,9,14,9,5,9,24,63,2
416,Maximiliano Caufriez,Clermont Foot,8.9,20,15,16,3,1,12,18,66.7,6,8,4,4,8,28,46,2
417,Ivan Cavaleiro,Lille,8.1,9,5,2,4,3,6,18,33.3,12,8,2,6,5,14,5,0
418,Dani Ceballos,Real Madrid,1.5,3,2,0,3,0,0,2,0.0,2,2,1,1,0,3,2,0
419,Emil Ceide,Sassuolo,1.1,0,0,0,0,0,0,0,0.0,0,3,0,3,0,0,0,0
420,Zeki Celik,Roma,1.2,7,5,3,3,1,3,4,75.0,1,0,0,0,1,8,4,0
421,Alex Centelles,Almería,2.5,3,1,3,0,0,2,6,33.3,4,2,1,1,4,7,6,0
422,Vaclav Cerny,Wolfsburg,6.0,5,2,2,3,0,1,9,11.1,8,8,0,8,6,11,4,0
423,Michele Cerofolini,Frosinone,1.0,0,0,0,0,0,0,0,0.0,0,0,0,0,0,0,0,0
424,Franco Cervi,Celta Vigo,2.2,4,3,3,1,0,1,4,25.0,3,8,0,8,2,6,3,0
425,Julio Cesar Enciso,Brighton,0.8,0,0,0,0,0,0,1,0.0,1,0,0,0,0,0,0,0
426,Julian Chabot,Köln,12.7,28,19,17,11,0,15,22,68.2,7,29,17,12,23,51,58,0
427,Fares Chaibi,Toulouse,0.6,0,0,0,0,0,0,0,0.0,0,0,0,0,0,0,2,0
428,Fares Chaibi,Eint Frankfurt,8.5,12,8,4,5,3,3,5,60.0,2,18,0,18,2,14,4,0
429,Muhammed Cham,Clermont Foot,13.7,16,9,6,8,2,7,17,41.2,10,9,1,8,1,17,2,1
430,Brendan Chardonnet,Brest,14.0,23,14,16,5,2,14,23,60.9,9,25,14,11,15,38,55,1
431,Pep Chavarria,Rayo Vallecano,1.2,3,2,1,2,0,2,2,100.0,0,1,0,1,1,4,3,0
432,Walid Cheddira,Frosinone,8.3,3,1,1,0,2,1,2,50.0,1,3,1,2,0,3,7,0
433,Rayan Cherki,Lyon,10.2,11,3,1,6,4,6,20,30.0,14,11,3,8,3,14,0,0
434,Youssef Chermiti,Everton,0.6,0,0,0,0,0,0,1,0.0,1,1,0,1,0,0,0,0
435,Lucas Chevalier,Lille,15.0,1,0,1,0,0,1,2,50.0,1,1,0,1,0,1,6,2
436,Fabio Chiarodia,M'Gladbach,0.7,4,2,4,0,0,2,2,100.0,0,1,1,0,1,5,3,0
437,Federico Chiesa,Juventus,11.2,8,3,2,3,3,2,4,50.0,2,8,1,7,4,12,4,0
438,Ben Chilwell,Chelsea,3.7,5,4,0,4,1,1,3,33.3,2,1,0,1,3,8,4,0
439,Pedro Chirivella,Nantes,13.9,18,11,6,12,0,10,32,31.3,22,13,1,12,15,33,13,0
440,Tahith Chong,Luton Town,7.6,17,8,11,4,2,7,11,63.6,4,8,1,7,3,20,2,0
442,Joris Chotard,Montpellier,13.6,49,33,28,14,7,28,54,51.9,26,25,10,15,22,71,26,0
443,Andreas Christensen,Barcelona,10.7,7,6,4,3,0,6,11,54.5,5,8,4,4,10,17,23,0
444,Oliver Christensen,Fiorentina,2.0,0,0,0,0,0,0,0,0.0,0,0,0,0,0,0,0,0
445,Ryan Christie,Bournemouth,13.7,39,19,16,13,10,18,38,47.4,20,21,3,18,17,56,15,0
446,Carney Chukwuemeka,Chelsea,1.4,1,1,1,0,0,1,2,50.0,1,0,0,0,0,1,0,0
447,Samuel Chukwueze,Milan,5.6,14,4,7,5,2,7,13,53.8,6,2,1,1,4,18,0,0
448,Victor Chust,Cádiz,2.1,4,3,3,1,0,3,6,50.0,3,1,1,0,2,6,5,0
449,Pathe Ciss,Rayo Vallecano,9.1,22,10,7,15,0,10,17,58.8,7,14,6,8,17,39,27,0
450,Ibrahim Cissoko,Toulouse,1.4,2,1,2,0,0,1,1,100.0,0,1,0,1,1,3,0,0
451,Patrick Ciurria,Monza,11.9,13,9,5,6,2,6,12,50.0,6,10,5,5,6,19,15,0
452,Jordan Clark,Luton Town,0.9,3,0,2,1,0,0,2,0.0,2,2,1,1,0,3,3,0
453,Alexis Claude-Maurice,Nice,0.9,7,3,3,3,1,1,2,50.0,1,0,0,0,0,7,3,0
454,Jonathan Clauss,Marseille,12.9,28,15,14,11,3,17,31,54.8,14,13,2,11,18,46,33,0
455,Silvi Clua,Girona,0.0,2,0,2,0,0,2,2,100.0,0,1,0,1,0,2,0,0
456,Nathaniel Clyne,Crystal Palace,3.2,3,2,2,1,0,3,4,75.0,1,4,1,3,0,3,9,0
457,Marcus Coco,Nantes,8.2,18,13,14,3,1,9,26,34.6,17,11,1,10,10,28,14,0
458,Saul Coco,Las Palmas,10.4,16,8,13,3,0,5,10,50.0,5,12,10,2,10,26,53,1
459,Seamus Coleman,Everton,0.7,2,2,1,0,1,1,1,100.0,0,0,0,0,1,3,3,0
460,Maxime Colin,Metz,7.1,13,7,8,2,3,6,11,54.5,5,7,4,3,7,20,26,0
461,Nathan Collins,Brentford,11.1,14,7,10,4,0,6,9,66.7,3,12,4,8,18,32,60,1
462,Lorenzo Colombo,Monza,10.1,13,10,3,7,3,7,10,70.0,3,9,2,7,0,13,9,0
463,Andrea Colpani,Monza,12.4,8,3,0,5,3,2,4,50.0,2,1,1,0,4,12,7,0
464,Levi Colwill,Chelsea,13.3,25,18,8,14,3,12,16,75.0,4,18,6,12,17,42,39,0
465,Kingsley Coman,Bayern Munich,9.3,11,6,5,3,3,8,13,61.5,5,12,1,11,2,13,5,0
466,Eray Comert,Nantes,11.3,18,12,13,5,0,12,15,80.0,3,14,8,6,21,39,49,0
468,Santi Comesana,Villarreal,4.3,15,8,3,9,3,8,15,53.3,7,3,0,3,5,20,7,1
469,Pietro Comuzzo,Fiorentina,0.1,0,0,0,0,0,0,0,0.0,0,0,0,0,0,0,1,0
470,Andrea Consigli,Sassuolo,13.0,0,0,0,0,0,0,0,0.0,0,1,0,1,0,0,9,0
471,Bambase Conte,Hoffenheim,0.0,1,1,1,0,0,0,0,0.0,0,0,0,0,0,1,0,0
472,Lewis Cook,Bournemouth,10.8,21,16,11,10,0,11,21,52.4,10,9,5,4,31,52,14,0
473,Copete,Mallorca,5.9,16,8,13,3,0,11,15,73.3,4,5,3,2,7,23,21,1
474,Diego Coppola,Hellas Verona,5.1,12,7,7,4,1,7,12,58.3,5,9,3,6,8,20,35,1
475,Francis Coquelin,Villarreal,0.1,0,0,0,0,0,0,0,0.0,0,1,0,1,1,1,1,0
476,Tommaso Corazza,Bologna,1.6,8,3,7,1,0,3,7,42.9,4,2,0,2,4,12,2,0
477,Jeppe Corfitzen,Lecce,0.1,1,0,0,1,0,1,1,100.0,0,0,0,0,0,1,0,0
478,Jack Cork,Burnley,0.2,1,0,0,1,0,1,3,33.3,2,0,0,0,0,1,0,0
479,Maxwel Cornet,West Ham,0.0,1,0,1,0,0,0,1,0.0,1,0,0,0,0,1,0,0
480,Jesus Corona,Sevilla,0.2,0,0,0,0,0,0,0,0.0,0,0,0,0,1,1,0,0
481,Angel Correa,Atlético Madrid,5.2,6,4,2,3,1,1,8,12.5,7,6,0,6,1,7,0,0
482,Joaquin Correa,Marseille,3.8,4,3,2,1,1,0,7,0.0,7,2,0,2,1,5,1,0
483,Thierry Correia,Valencia,13.3,42,27,26,13,3,23,39,59.0,16,16,5,11,27,69,34,0
484,Oscar Cortes,Lens,0.1,0,0,0,0,0,0,0,0.0,0,0,0,0,0,0,0,0
485,Danny da Costa,Mainz 05,7.2,13,7,6,6,1,4,13,30.8,9,13,2,11,12,25,20,0
486,David Pereira da Costa,Lens,2.0,4,2,0,4,0,1,3,33.3,2,4,1,3,2,6,3,0
487,Jaume Costa,Mallorca,8.7,20,11,11,5,4,10,16,62.5,6,6,1,5,9,29,12,0
488,Logan Costa,Toulouse,14.1,23,15,17,6,0,8,14,57.1,6,25,14,11,8,31,65,0
489,Samu Costa,Mallorca,13.6,45,26,15,28,2,25,53,47.2,28,19,10,9,23,68,29,3
490,Benoit Costil,Salernitana,4.0,0,0,0,0,0,0,1,0.0,1,0,0,0,0,0,3,0
491,Vladimir Coufal,West Ham,16.0,37,26,28,7,2,23,41,56.1,18,20,7,13,23,60,42,0
492,Lassana Coulibaly,Salernitana,9.2,21,16,11,8,2,14,24,58.3,10,12,1,11,8,29,14,0
494,Mamadou Coulibaly,Salernitana,0.0,0,0,0,0,0,0,0,0.0,0,0,0,0,0,0,0,0
495,Philippe Coutinho,Aston Villa,0.3,0,0,0,0,0,0,1,0.0,1,0,0,0,0,0,0,0
496,Yan Couto,Girona,9.5,20,13,10,7,3,10,18,55.6,8,9,1,8,3,23,17,0
497,Nicolas Cozza,Wolfsburg,2.4,7,5,3,4,0,2,7,28.6,5,2,0,2,4,11,3,0
498,Alessio Cragno,Sassuolo,2.0,0,0,0,0,0,0,0,0.0,0,0,0,0,0,0,3,0
499,Aaron Cresswell,West Ham,1.4,1,0,1,0,0,1,1,100.0,0,2,1,1,0,1,3,0
500,Bryan Cristante,Roma,15.0,29,16,16,11,2,13,20,65.0,7,14,4,10,14,43,30,0
501,Juan Cruz Armada,Osasuna,9.1,13,6,7,5,1,6,7,85.7,1,6,3,3,4,17,15,0
502,Juan Cruz,Hellas Verona,0.9,1,1,0,0,1,0,0,0.0,0,0,0,0,1,2,0,0
503,Juan Cruz,Betis,0.8,0,0,0,0,0,0,1,0.0,1,0,0,0,0,0,0,0
504,Juan Cuadrado,Inter,1.7,3,3,1,2,0,2,3,66.7,1,5,1,4,0,3,1,0
505,Marc Cucurella,Chelsea,7.8,27,17,15,10,2,16,27,59.3,11,17,5,12,12,39,22,0
506,Jorge Cuenca,Villarreal,9.1,13,11,9,2,2,6,6,100.0,0,16,9,7,11,24,48,0
507,Josh Cullen,Burnley,9.4,16,11,8,7,1,9,16,56.3,7,14,7,7,7,23,11,0
508,Matheus Cunha,Wolves,14.8,20,9,5,12,3,7,17,41.2,10,16,5,11,8,28,11,0
509,Marvin Cuni,Frosinone,5.1,5,3,1,2,2,3,4,75.0,1,9,1,8,1,6,0,0
510,Eric Curbelo,Las Palmas,1.0,2,1,1,1,0,1,2,50.0,1,3,1,2,2,4,5,1
511,Tomas Cvancara,M'Gladbach,7.0,2,2,0,2,0,0,0,0.0,0,3,1,2,0,2,8,0
512,Danilo D'Ambrosio,Monza,8.1,28,17,16,10,2,15,20,75.0,5,13,7,6,8,36,16,0
513,Finn Dahmen,Augsburg,14.0,0,0,0,0,0,0,0,0.0,0,0,0,0,0,0,10,1
514,Mahmoud Dahoud,Brighton,5.0,9,4,2,4,3,3,9,33.3,6,4,1,3,1,10,5,0
515,Ameen Al-Dakhil,Burnley,9.5,9,4,3,5,1,1,9,11.1,8,6,4,2,8,17,30,2
516,Thijs Dallinga,Toulouse,10.0,13,5,3,5,5,4,7,57.1,3,7,2,5,2,15,15,0
517,Diogo Dalot,Manchester Utd,14.3,30,16,21,5,4,20,26,76.9,6,10,3,7,14,44,42,0
518,Mikkel Damsgaard,Brentford,1.1,4,0,2,1,1,2,5,40.0,3,4,1,3,1,5,1,1
520,Flavius Daniliuc,Salernitana,5.4,14,9,8,4,2,8,14,57.1,6,12,4,8,6,20,6,0
521,Danilo,Nott'ham Forest,5.1,5,1,2,3,0,3,10,30.0,7,3,1,2,8,13,5,0
522,Danilo,Juventus,9.2,17,11,11,6,0,7,12,58.3,5,11,6,5,19,36,34,0
523,Arnaut Danjuma,Everton,4.3,2,1,2,0,0,1,2,50.0,1,3,0,3,2,4,0,0
524,Kevin Danso,Lens,14.0,12,8,5,7,0,10,16,62.5,6,21,14,7,11,23,54,1
525,Dante,Nice,15.0,24,11,18,6,0,13,17,76.5,4,21,9,12,15,39,42,0
526,Mohammed Daramy,Reims,9.7,2,2,1,1,0,2,9,22.2,7,4,1,3,4,6,3,0
527,Sergi Darder,Mallorca,11.4,25,18,6,15,4,6,17,35.3,11,10,1,9,10,35,3,0
528,Achraf Dari,Brest,1.3,1,1,1,0,0,0,2,0.0,2,2,0,2,5,6,9,1
529,Matteo Darmian,Inter,12.1,25,12,13,9,3,10,23,43.5,13,15,6,9,9,34,26,0
530,Lukas Daschner,Bochum,3.4,5,3,2,2,1,3,7,42.9,4,5,0,5,2,7,1,0
531,Josh Dasilva,Brentford,0.1,0,0,0,0,0,0,0,0.0,0,0,0,0,0,0,0,0
532,David Datro Fofana,Union Berlin,7.1,9,6,3,4,2,4,9,44.4,5,4,0,4,0,9,5,0
533,Jonathan David,Lille,12.7,9,7,1,6,2,3,13,23.1,10,6,0,6,3,12,0,0
534,Alphonso Davies,Bayern Munich,10.1,15,7,7,8,0,9,18,50.0,9,12,1,11,9,24,19,1
535,Ben Davies,Tottenham,6.0,14,12,7,5,2,9,11,81.8,2,8,8,0,7,21,21,0
536,Tom Davies,Sheffield Utd,0.7,4,2,2,2,0,1,3,33.3,2,0,0,0,2,6,2,1
537,Pawel Dawidowicz,Hellas Verona,8.8,17,12,9,8,0,6,11,54.5,5,7,4,3,10,27,43,0
538,Craig Dawson,Wolves,14.8,22,13,18,3,1,16,21,76.2,5,25,19,6,8,30,71,1
539,Kevin De Bruyne,Manchester City,0.2,0,0,0,0,0,0,0,0.0,0,0,0,0,0,0,0,0
540,Charles De Ketelaere,Atalanta,8.8,11,6,2,2,7,1,7,14.3,6,9,1,8,1,12,2,0
541,Rodrigo De Paul,Atlético Madrid,8.1,18,12,5,11,2,7,13,53.8,6,6,0,6,2,20,4,0
542,Lorenzo De Silvestri,Bologna,4.9,3,3,3,0,0,1,2,50.0,1,6,3,3,5,8,14,0
543,Thibault De Smet,Reims,10.6,32,19,19,12,1,19,34,55.9,15,11,2,9,11,43,29,0
544,Koni De Winter,Genoa,9.0,13,11,9,4,0,6,9,66.7,3,9,2,7,10,23,20,0
546,Gregoire Defrel,Sassuolo,2.7,4,1,0,3,1,1,2,50.0,1,1,0,1,1,5,3,0
547,Alessandro Deiola,Cagliari,4.0,7,5,4,3,0,5,18,27.8,13,4,1,3,1,8,2,0
548,Romain Del Castillo,Brest,13.4,16,13,5,6,5,5,26,19.2,21,14,0,14,5,21,2,0
549,Thomas Delaine,Strasbourg,11.7,19,7,14,4,1,15,26,57.7,11,5,2,3,15,34,30,0
550,Sacha Delaye,Montpellier,1.1,5,2,1,1,3,1,5,20.0,4,1,0,1,0,5,0,0
551,Hannes Delcroix,Burnley,2.7,3,2,2,1,0,2,2,100.0,0,3,1,2,6,9,6,0
552,Olivier Deman,Werder Bremen,8.1,20,11,16,3,1,14,24,58.3,10,18,6,12,7,27,15,0
553,Karamoko Dembele,Brest,0.2,0,0,0,0,0,0,0,0.0,0,0,0,0,0,0,0,0
554,Ousmane Dembele,Paris S-G,9.7,13,10,2,5,6,3,7,42.9,4,5,0,5,4,17,1,1
555,Jessy Deminguet,Strasbourg,6.3,10,6,5,5,0,5,13,38.5,8,7,0,7,5,15,4,0
556,Ermedin Demirovic,Augsburg,13.5,14,8,4,9,1,7,21,33.3,14,14,1,13,4,18,13,0
557,Sepp van den Berg,Mainz 05,11.5,22,13,12,8,2,7,12,58.3,5,23,11,12,19,41,37,1
558,Leander Dendoncker,Aston Villa,0.4,2,1,0,2,0,1,1,100.0,0,2,2,0,0,2,2,1
559,Remy Descamps,Nantes,5.0,0,0,0,0,0,0,0,0.0,0,0,0,0,0,0,6,0
560,Mikkel Desler,Toulouse,11.0,12,8,6,5,1,6,11,54.5,5,21,9,12,10,22,27,0
561,Arthur Desmas,Le Havre,15.0,0,0,0,0,0,0,1,0.0,1,0,0,0,0,0,5,0
562,Mattia Destro,Empoli,1.6,0,0,0,0,0,0,0,0.0,0,0,0,0,2,2,2,0
563,Federico Di Francesco,Lecce,0.2,1,0,0,1,0,0,0,0.0,0,0,0,0,0,1,0,0
564,Michele Di Gregorio,Monza,14.0,1,0,1,0,0,1,1,100.0,0,0,0,0,1,2,8,0
565,Giovanni Di Lorenzo,Napoli,15.0,30,20,17,11,2,17,35,48.6,18,17,4,13,9,39,25,0
566,Alessandro Di Pardo,Cagliari,1.9,3,1,2,0,1,0,1,0.0,1,3,2,1,2,5,2,0
567,Boulaye Dia,Salernitana,9.0,4,2,2,2,0,1,2,50.0,1,5,0,5,3,7,5,0
568,Moussa Diaby,Aston Villa,11.7,5,1,1,3,1,2,8,25.0,6,2,0,2,4,9,3,0
569,Lamine Diack,Nantes,0.0,0,0,0,0,0,0,0,0.0,0,0,0,0,0,0,0,0
570,Mouctar Diakhaby,Valencia,7.9,15,10,7,8,0,10,12,83.3,2,12,4,8,5,20,45,0
572,Mamadou Diakhon,Reims,0.6,1,1,1,0,0,1,2,50.0,1,0,0,0,1,2,0,0
573,Bafode Diakite,Lille,7.9,17,12,5,12,0,12,15,80.0,3,9,5,4,9,26,19,0
574,Ibrahim Diakite,Reims,1.1,0,0,0,0,0,0,1,0.0,1,2,0,2,2,2,5,0
575,Moussa Diakite,Cádiz,0.0,0,0,0,0,0,0,0,0.0,0,0,0,0,0,0,0,0
576,Oumar Diakite,Reims,6.3,9,5,6,2,1,3,9,33.3,6,6,0,6,3,12,4,0
577,Amadou Diallo,Newcastle Utd,0.0,0,0,0,0,0,0,0,0.0,0,0,0,0,0,0,0,0
578,Assane Diao,Betis,6.8,12,7,4,4,4,4,9,44.4,5,13,3,10,6,18,3,0
579,Mouhamadou Diarra,Strasbourg,9.5,9,6,3,6,0,1,14,7.1,13,11,3,8,10,19,4,0
580,Moussa Diarra,Toulouse,7.4,17,6,9,7,1,7,15,46.7,8,16,9,7,10,27,25,0
581,Ruben Dias,Manchester City,13.2,16,8,6,9,1,7,13,53.8,6,14,7,7,14,30,45,0
582,Krepin Diatta,Monaco,5.8,13,8,5,7,1,10,21,47.6,11,6,1,5,7,20,8,0
583,Mory Diaw,Clermont Foot,15.0,0,0,0,0,0,0,0,0.0,0,0,0,0,1,1,5,2
584,Mahamadou Diawara,Lyon,3.1,6,3,3,3,0,1,7,14.3,6,2,0,2,3,9,3,0
585,Brahim Diaz,Real Madrid,3.9,6,5,0,6,0,3,6,50.0,3,4,0,4,2,8,0,0
586,Luis Diaz,Liverpool,10.3,12,9,1,6,5,4,18,22.2,14,4,0,4,1,13,1,0
587,Victor Diaz,Granada,1.8,5,3,2,3,0,1,3,33.3,2,1,0,1,1,6,8,0
588,Famara Diedhiou,Granada,0.9,1,1,0,1,0,0,1,0.0,1,0,0,0,0,1,2,0
589,Bamba Dieng,Lorient,3.0,2,2,0,2,0,1,1,100.0,0,0,0,0,0,2,5,0
590,Eric Dier,Tottenham,1.6,2,1,2,0,0,2,2,100.0,0,1,1,0,1,3,8,0
591,Guillaume Dietsch,Metz,0.8,0,0,0,0,0,0,0,0.0,0,0,0,0,0,0,0,0
592,Florian Dietz,Köln,0.3,0,0,0,0,0,0,0,0.0,0,1,0,1,0,0,0,0
593,Lucas Digne,Aston Villa,15.5,30,13,23,6,1,17,29,58.6,12,10,0,10,19,49,34,0
594,Federico Dimarco,Inter,10.9,23,15,9,10,4,12,23,52.2,11,8,1,7,6,29,15,1
595,Stole Dimitrievski,Rayo Vallecano,16.0,0,0,0,0,0,0,0,0.0,0,0,0,0,0,0,5,1
596,Junior Dina Ebimbe,Eint Frankfurt,9.2,17,10,3,8,6,8,17,47.1,9,14,3,11,3,20,16,0
598,Eren Dinkci,Heidenheim,11.5,13,8,8,5,0,7,14,50.0,7,12,0,12,3,16,10,0
599,Sinaly Diomande,Lyon,9.9,10,4,5,3,2,9,16,56.3,7,12,9,3,15,25,26,1
600,Edan Diop,Monaco,0.7,2,2,1,0,1,1,2,50.0,1,1,0,1,0,2,2,0
601,Issa Diop,Fulham,7.8,11,6,8,2,1,6,8,75.0,2,8,4,4,7,18,36,1
602,Sofiane Diop,Nice,5.3,8,6,3,4,1,4,10,40.0,6,4,0,4,3,11,3,0
603,Andy Diouf,Lens,7.9,15,11,6,7,2,9,14,64.3,5,8,1,7,3,18,3,0
604,Yehvann Diouf,Reims,15.0,0,0,0,0,0,0,0,0.0,0,0,0,0,0,0,9,1
605,Axel Disasi,Chelsea,13.7,11,5,7,3,1,7,11,63.6,4,12,9,3,6,17,43,1
606,Djene,Getafe,10.8,10,3,3,6,1,2,6,33.3,4,15,4,11,11,21,25,0
607,Koffi Djidji,Torino,0.3,1,0,0,1,0,0,0,0.0,0,3,2,1,1,2,2,0
608,Berat Djimsiti,Atalanta,13.0,13,8,6,7,0,3,7,42.9,4,29,18,11,25,38,33,0
609,Marko Dmitrovic,Sevilla,7.0,1,1,1,0,0,1,2,50.0,1,0,0,0,1,2,5,0
610,Ben Doak,Liverpool,0.2,0,0,0,0,0,0,0,0.0,0,0,0,0,0,0,0,0
611,Ritsu Doan,Freiburg,9.8,15,9,8,5,2,4,10,40.0,6,10,1,9,2,17,9,0
612,Lewis Dobbin,Everton,1.4,2,2,1,0,1,2,6,33.3,4,4,1,3,1,3,0,0
613,Dodo,Fiorentina,3.0,3,2,1,2,0,1,4,25.0,3,2,0,2,3,6,6,0
614,Danilho Doekhi,Union Berlin,8.0,14,10,9,5,0,5,9,55.6,4,13,3,10,15,29,25,0
615,Matt Doherty,Wolves,4.2,5,1,2,2,1,2,4,50.0,2,5,1,4,2,7,14,0
616,Josh Doig,Hellas Verona,6.0,9,6,5,4,0,7,11,63.6,4,9,2,7,1,10,13,1
617,Jeremy Doku,Manchester City,7.7,20,14,7,7,6,6,13,46.2,7,5,0,5,5,25,3,0
618,Jeremy Doku,Rennes,1.2,2,2,1,0,1,1,1,100.0,0,0,0,0,0,2,0,0
619,Carlos Dominguez,Celta Vigo,3.0,3,3,0,2,1,2,4,50.0,2,1,1,0,5,8,12,0
620,Mario Dominguez,Valencia,0.3,0,0,0,0,0,0,0,0.0,0,0,0,0,0,0,0,0
621,Nicolas Dominguez,Nott'ham Forest,7.2,28,17,16,11,1,13,21,61.9,8,5,0,5,6,34,12,0
622,Nicolas Dominguez,Bologna,1.1,1,0,1,0,0,0,2,0.0,2,3,0,3,0,1,2,0
624,Giulio Donati,Monza,0.1,0,0,0,0,0,0,0,0.0,0,0,0,0,0,0,0,0
625,Jamie Donley,Tottenham,0.0,0,0,0,0,0,0,0,0.0,0,0,0,0,0,0,2,0
626,Gianluigi Donnarumma,Paris S-G,13.1,0,0,0,0,0,0,0,0.0,0,0,0,0,1,1,3,4
627,Patrick Dorgu,Lecce,7.6,23,13,16,6,1,13,18,72.2,5,9,3,6,6,29,22,2
628,Niklas Dorsch,Augsburg,9.7,21,14,8,13,0,8,20,40.0,12,9,7,2,9,30,13,0
629,Gabriel Dos Santos,Arsenal,12.3,16,7,10,5,1,7,9,77.8,2,18,15,3,12,28,24,0
630,Alberto Dossena,Cagliari,14.1,28,21,22,6,0,17,24,70.8,7,24,15,9,24,52,83,2
631,Carlos Dotor,Celta Vigo,3.7,5,4,1,3,1,2,6,33.3,4,6,2,4,2,7,3,0
632,Abdoulaye Doucoure,Everton,15.5,24,14,10,10,4,10,23,43.5,13,14,1,13,11,35,8,0
633,Cheick Doucoure,Crystal Palace,10.2,34,17,15,13,6,18,30,60.0,12,13,2,11,20,54,12,0
634,Ckene Doucoure,Lorient,4.5,8,6,0,4,4,3,3,100.0,0,4,0,4,1,9,6,0
635,Desire Doue,Rennes,4.9,14,6,4,5,5,3,11,27.3,8,5,0,5,3,17,3,0
636,Guela Doue,Rennes,0.5,0,0,0,0,0,0,3,0.0,3,1,0,1,1,1,5,0
637,Alfie Doughty,Luton Town,11.8,25,15,12,9,4,14,30,46.7,16,20,1,19,12,37,19,0
638,Douglas,Nantes,9.0,31,20,12,16,3,9,20,45.0,11,15,6,9,14,45,16,0
639,Ismael Doukoure,Strasbourg,12.8,18,13,4,13,1,12,16,75.0,4,12,5,7,17,35,12,2
640,Kamory Doumbia,Brest,3.0,9,7,0,3,6,4,11,36.4,7,9,0,9,3,12,2,0
641,Anastasios Douvikas,Celta Vigo,3.2,6,3,0,3,3,0,2,0.0,2,1,0,1,1,7,5,0
642,Artem Dovbyk,Girona,9.9,2,1,1,0,1,0,1,0.0,1,4,1,3,0,2,8,0
643,Nikola Dovedan,Heidenheim,2.5,5,3,0,5,0,2,7,28.6,5,4,0,4,0,5,1,0
644,Damion Downs,Köln,0.3,0,0,0,0,0,0,0,0.0,0,0,0,0,0,0,0,0
645,Tommy Doyle,Wolves,3.0,5,2,3,1,1,2,4,50.0,2,4,3,1,4,9,7,0
646,Radu Dragusin,Genoa,15.0,12,8,7,5,0,5,6,83.3,1,11,6,5,17,29,67,3
647,Dion Drena Beljo,Augsburg,3.9,0,0,0,0,0,0,1,0.0,1,5,0,5,1,1,2,0
648,Domingos Duarte,Getafe,7.4,7,4,6,0,1,5,7,71.4,2,3,3,0,6,13,24,0
650,Ruben Duarte,Alavés,9.2,21,13,13,6,2,8,14,57.1,6,8,1,7,10,31,27,0
651,Martin Dubravka,Newcastle Utd,2.1,0,0,0,0,0,0,0,0.0,0,0,0,0,0,0,0,0
652,Marvin Ducksch,Werder Bremen,12.1,4,1,4,0,0,2,5,40.0,3,0,0,0,0,4,13,0
653,Ondrej Duda,Hellas Verona,11.7,19,13,5,11,3,8,18,44.4,10,11,2,9,11,30,9,0
654,Denzel Dumfries,Inter,10.3,12,9,4,8,0,4,12,33.3,8,12,4,8,6,18,15,0
655,Paul Dummett,Newcastle Utd,0.1,1,0,1,0,0,1,1,100.0,0,0,0,0,0,1,0,0
656,Alfred Duncan,Fiorentina,9.9,17,9,6,7,4,7,17,41.2,10,14,4,10,5,22,5,0
657,Lewis Dunk,Brighton,12.7,13,6,8,5,0,6,14,42.9,8,17,14,3,11,24,29,0
658,Jhon Duran,Aston Villa,1.1,2,2,1,1,0,0,3,0.0,3,3,0,3,0,2,2,0
659,Hugo Duro,Valencia,14.5,8,5,2,4,2,4,16,25.0,12,11,3,8,0,8,11,0
660,Jean-Kevin Duverne,Nantes,9.1,24,15,12,10,2,11,27,40.7,16,9,5,4,11,35,22,0
661,Paulo Dybala,Roma,8.9,12,7,1,5,6,1,6,16.7,5,6,0,6,2,14,2,0
662,Aron Donnum,Toulouse,8.2,6,4,2,2,2,3,12,25.0,9,8,0,8,5,11,8,0
663,Festy Ebosele,Udinese,10.8,22,13,16,5,1,15,25,60.0,10,21,1,20,5,27,13,0
664,Enzo Ebosse,Udinese,0.1,1,1,1,0,0,0,1,0.0,1,0,0,0,1,2,0,0
665,Tyronne Ebuehi,Empoli,8.6,12,7,8,4,0,5,8,62.5,3,8,3,5,5,17,18,0
666,Ederson,Manchester City,15.0,0,0,0,0,0,0,1,0.0,1,0,0,0,0,0,2,0
667,Ederson,Atalanta,14.2,43,26,17,22,4,27,36,75.0,9,20,3,17,20,63,12,1
668,Odsonne Edouard,Crystal Palace,13.8,17,10,5,5,7,3,12,25.0,9,13,1,12,5,22,15,0
669,John Egan,Sheffield Utd,5.4,6,4,4,2,0,4,11,36.4,7,10,4,6,13,19,39,1
670,Maximilian Eggestein,Freiburg,13.5,19,8,10,6,3,3,13,23.1,10,23,10,13,16,35,21,0
671,Lilian Egloff,Stuttgart,1.2,4,1,3,1,0,2,4,50.0,2,3,1,2,1,5,0,0
672,Kingsley Ehizibue,Udinese,0.1,0,0,0,0,0,0,0,0.0,0,1,0,1,1,1,0,0
673,Hjalmar Ekdal,Burnley,1.2,0,0,0,0,0,0,0,0.0,0,1,0,1,2,2,6,0
674,Hugo Ekitike,Paris S-G,0.1,0,0,0,0,0,0,0,0.0,0,0,0,0,0,0,0,0
676,Emmanuel Ekong,Empoli,0.1,0,0,0,0,0,0,0,0.0,0,0,0,0,0,0,0,0
677,Caleb Ekuban,Genoa,3.4,4,2,1,1,2,2,2,100.0,0,5,1,4,0,4,0,0
678,Anthony Elanga,Nott'ham Forest,11.2,10,6,7,2,1,3,8,37.5,5,12,2,10,3,13,6,0
679,Simon Elisor,Metz,7.3,9,2,3,2,4,2,6,33.3,4,5,0,5,0,9,9,0
680,Harvey Elliott,Liverpool,3.4,2,1,1,1,0,0,6,0.0,6,3,0,3,2,4,3,0
681,Elif Elmas,Napoli,3.8,4,3,1,3,0,2,2,100.0,0,2,0,2,2,6,8,0
682,Mohamed Elneny,Arsenal,0.0,0,0,0,0,0,0,0,0.0,0,0,0,0,1,1,0,0
683,Aritz Elustondo,Real Sociedad,4.0,3,3,1,2,0,2,2,100.0,0,4,4,0,2,5,12,0
684,Nico Elvedi,M'Gladbach,9.9,15,6,11,3,1,9,11,81.8,2,8,5,3,13,28,46,1
685,Adri Embarba,Almería,11.6,24,14,15,5,4,13,22,59.1,9,14,0,14,9,33,3,0
686,Emanuel Emegha,Strasbourg,9.8,3,2,2,0,1,3,5,60.0,2,6,2,4,2,5,10,0
687,Emerson,Tottenham,5.7,12,10,9,3,0,6,19,31.6,13,9,4,5,5,17,31,1
688,Youssef En-Nesyri,Sevilla,10.9,5,3,0,3,2,0,2,0.0,2,2,0,2,2,7,7,0
689,Wataru Endo,Liverpool,4.0,7,6,3,4,0,4,11,36.4,7,3,0,3,2,9,11,0
690,Arne Engels,Augsburg,5.9,9,5,0,7,2,4,8,50.0,4,9,0,9,4,13,6,0
691,Christian Eriksen,Manchester Utd,6.7,10,8,2,6,2,5,17,29.4,12,11,5,6,3,13,5,0
692,Martin Erlic,Sassuolo,14.3,25,14,21,3,1,14,18,77.8,4,16,9,7,17,42,66,1
693,Gonzalo Escalante,Cádiz,7.7,20,11,9,5,6,12,26,46.2,14,6,3,3,12,32,14,1
694,Alfonso Espino,Rayo Vallecano,14.5,41,26,28,12,1,17,48,35.4,31,8,1,7,15,56,35,0
695,Bernardo Espinosa,Girona,0.0,1,1,1,0,0,1,1,100.0,0,0,0,0,0,1,2,0
696,Maxime Esteve,Montpellier,7.1,12,8,9,3,0,7,10,70.0,3,10,6,4,16,28,34,0
697,Oscar Estupinan,Metz,2.8,5,4,0,3,2,1,2,50.0,1,2,0,2,0,5,0,0
698,Pervis Estupinan,Brighton,5.5,7,3,5,2,0,4,9,44.4,5,7,1,6,8,15,7,0
699,Jonny Evans,Manchester Utd,5.1,4,2,4,0,0,4,9,44.4,5,2,2,0,3,7,25,0
700,Eberechi Eze,Crystal Palace,8.9,20,7,1,9,10,9,19,47.4,10,6,1,5,2,22,2,0
702,Abdessamad Ezzalzouli,Barcelona,0.8,1,1,0,0,1,0,1,0.0,1,1,0,1,0,1,0,0
703,Abdessamad Ezzalzouli,Betis,4.6,4,3,1,2,1,1,2,50.0,1,5,0,5,3,7,0,0
704,Giovanni Fabbian,Bologna,1.8,3,1,2,1,0,2,2,100.0,0,0,0,0,2,5,2,0
705,Lukasz Fabianski,West Ham,2.0,1,0,1,0,0,1,1,100.0,0,0,0,0,1,2,0,0
706,Nicolo Fagioli,Juventus,3.8,4,2,1,2,1,2,5,40.0,3,3,0,3,3,7,0,0
707,Romain Faivre,Lorient,14.1,10,4,4,3,3,3,10,30.0,7,6,1,5,6,16,3,1
708,Radamel Falcao,Rayo Vallecano,1.6,4,3,0,4,0,0,1,0.0,1,1,0,1,0,4,3,0
709,Wladimiro Falcone,Lecce,15.0,0,0,0,0,0,0,0,0.0,0,0,0,0,0,0,8,0
710,Fali,Cádiz,13.9,19,12,12,7,0,9,16,56.3,7,22,15,7,13,32,59,0
711,Davide Faraoni,Hellas Verona,6.7,13,10,5,6,2,7,10,70.0,3,9,5,4,6,19,21,0
712,Ansu Fati,Brighton,3.2,2,1,1,1,0,0,6,0.0,6,3,0,3,1,3,2,0
713,Ansu Fati,Barcelona,0.6,0,0,0,0,0,0,1,0.0,1,0,0,0,0,0,0,0
714,Khalil Fayad,Montpellier,6.8,17,10,12,3,2,6,15,40.0,9,8,0,8,8,25,1,0
715,Federico Fazio,Salernitana,5.3,8,5,7,1,0,3,5,60.0,2,10,8,2,5,13,26,0
716,Jacopo Fazzini,Empoli,6.7,25,11,14,7,4,18,35,51.4,17,15,1,14,6,31,9,0
717,Nabil Fekir,Betis,0.2,0,0,0,0,0,0,0,0.0,0,0,0,0,0,0,0,0
718,Felipe,Nott'ham Forest,1.5,5,4,3,2,0,4,5,80.0,1,2,1,1,1,6,5,0
719,Luiz Felipe,Betis,4.0,7,3,5,2,0,4,5,80.0,1,10,4,6,4,11,16,0
720,Joao Felix,Barcelona,9.6,12,10,5,3,4,4,10,40.0,6,9,1,8,7,19,4,0
721,Ohis Felix Uduokhai,Augsburg,12.5,14,7,10,3,1,7,10,70.0,3,11,9,2,17,31,73,1
722,Kiko Femenia,Villarreal,2.2,2,2,0,2,0,0,2,0.0,2,3,2,1,3,5,3,0
723,Evan Ferguson,Brighton,9.5,9,6,2,4,3,2,7,28.6,5,7,2,5,1,10,4,0
724,Lewis Ferguson,Bologna,15.0,21,13,9,11,1,9,20,45.0,11,9,5,4,8,29,12,0
725,Bruno Fernandes,Manchester Utd,16.0,35,19,14,15,6,19,47,40.4,28,19,1,18,11,46,17,1
726,Edimilson Fernandes,Mainz 05,9.7,17,11,12,5,0,11,16,68.8,5,8,2,6,21,38,36,0
728,Aitor Fernandez,Osasuna,3.1,0,0,0,0,0,0,1,0.0,1,0,0,0,0,0,2,1
729,Alex Fernandez,Cádiz,6.4,6,2,5,1,0,6,9,66.7,3,8,3,5,8,14,17,0
730,Alvaro Fernandez,Granada,3.9,11,6,7,4,0,4,7,57.1,3,2,0,2,6,17,7,1
731,Carlos Fernandez,Real Sociedad,4.3,11,7,3,6,2,0,2,0.0,2,4,0,4,0,11,4,0
732,Enzo Fernandez,Chelsea,13.7,25,13,9,11,5,13,36,36.1,23,22,5,17,9,34,13,0
733,Raul Fernandez,Granada,3.1,0,0,0,0,0,0,1,0.0,1,0,0,0,0,0,1,2
734,Valery Fernandez,Girona,2.3,1,1,0,1,0,1,1,100.0,0,2,1,1,0,1,0,0
735,Fernando,Almería,2.0,0,0,0,0,0,0,0,0.0,0,1,0,1,0,0,1,0
736,Fernando,Sevilla,5.1,9,8,2,4,3,5,9,55.6,4,2,0,2,7,16,9,0
737,Ichem Ferrah,Lille,0.0,0,0,0,0,0,0,0,0.0,0,0,0,0,0,0,0,0
738,Andre Ferreira,Granada,12.9,0,0,0,0,0,0,1,0.0,1,0,0,0,0,0,8,1
739,Joao Ferreira,Udinese,7.5,19,15,11,6,2,11,18,61.1,7,16,3,13,7,26,29,0
740,Jordan Ferri,Montpellier,11.1,15,8,8,7,0,11,39,28.2,28,11,0,11,10,25,11,0
741,Nacho Ferri,Eint Frankfurt,0.6,3,3,1,2,0,2,2,100.0,0,0,0,0,0,3,2,0
742,Rachad Fettal,Almería,0.2,0.0,0,0.0,0.0,0.0,0.0,0.0,0.0,0.0,0.0,0.0,0.0,0,0.0,0.0,0.0
743,Seydou Fini,Genoa,0.4,0,0,0,0,0,0,0,0.0,0,0,0,0,0,0,0,0
744,Max Finkgrafe,Köln,1.4,2,2,1,1,0,2,9,22.2,7,2,0,2,1,3,2,0
745,John Fleck,Sheffield Utd,1.0,1,0,0,1,0,0,1,0.0,1,0,0,0,0,1,1,0
746,Mark Flekken,Brentford,14.5,0,0,0,0,0,0,1,0.0,1,0,0,0,0,0,4,0
747,Alessandro Florenzi,Milan,7.2,19,9,12,5,2,11,23,47.8,12,8,5,3,8,27,12,1
748,Phil Foden,Manchester City,13.8,15,11,9,3,3,9,19,47.4,10,12,0,12,10,25,8,1
749,Wes Foderingham,Sheffield Utd,16.0,1,1,1,0,0,1,2,50.0,1,0,0,0,0,1,7,3
750,Youssouf Fofana,Monaco,12.7,25,14,6,14,5,13,25,52.0,12,15,2,13,19,44,12,0
751,Jonas Fohrenbach,Heidenheim,12.1,16,11,9,5,2,8,16,50.0,8,13,7,6,8,24,22,0
752,Thomas Foket,Reims,11.6,20,7,13,5,2,12,29,41.4,17,23,7,16,15,35,17,0
754,Michael Folorunsho,Hellas Verona,14.0,26,17,12,10,4,11,34,32.4,23,24,5,19,7,33,19,2
755,Pablo Fornals,West Ham,2.5,6,4,3,1,2,2,9,22.2,7,5,1,4,2,8,3,0
756,Emil Forsberg,RB Leipzig,4.2,6,3,2,4,0,4,10,40.0,6,6,0,6,0,6,5,0
757,Philipp Forster,Bochum,2.0,4,3,2,0,2,2,4,50.0,2,2,0,2,4,8,1,0
758,Lyle Foster,Burnley,6.7,7,1,2,2,3,1,5,20.0,4,7,1,6,1,8,11,0
759,Dimitri Foulquier,Valencia,4.9,6,3,4,1,1,2,4,50.0,2,3,0,3,3,9,14,1
760,Juan Foyth,Villarreal,11.8,26,15,18,8,0,12,27,44.4,15,17,4,13,12,38,44,0
761,Matheus Franca,Crystal Palace,0.4,0,0,0,0,0,0,0,0.0,0,0,0,0,0,0,0,0
762,Bartol Franjic,Darmstadt 98,4.1,1,1,1,0,0,1,10,10.0,9,6,0,6,10,11,15,0
763,Przemyslaw Frankowski,Lens,9.0,20,14,6,9,5,7,21,33.3,14,12,1,11,5,25,15,0
764,Davide Frattesi,Inter,3.4,2,0,1,1,0,0,2,0.0,2,3,0,3,1,3,5,0
765,Jean Frederic N'Guessan,Metz,0.1,1,0,0,1,0,0,2,0.0,2,1,0,1,0,1,0,0
766,Morten Frendrup,Genoa,15.0,62,33,21,33,8,27,39,69.2,12,26,7,19,20,82,16,1
767,Remo Freuler,Bologna,9.0,22,13,10,11,1,9,17,52.9,8,13,4,9,12,34,14,1
768,Marco Friedl,Werder Bremen,10.4,22,14,16,6,0,18,26,69.2,8,24,15,9,11,33,47,0
769,Marvin Friedrich,M'Gladbach,5.4,10,6,8,1,1,7,8,87.5,1,12,9,3,3,13,29,0
770,Jeremie Frimpong,Leverkusen,12.7,12,8,8,1,3,5,11,45.5,6,18,0,18,5,17,6,0
771,Jorge de Frutos,Rayo Vallecano,4.8,1,0,1,0,0,1,6,16.7,5,4,0,4,2,3,3,0
772,Chris Fuhrich,Stuttgart,12.3,8,5,1,4,3,5,20,25.0,15,15,0,15,4,12,2,0
773,Angelo Fulgini,Lens,8.1,10,3,2,6,2,4,9,44.4,5,11,0,11,3,13,4,0
774,Niclas Fullkrug,Werder Bremen,2.0,1,1,0,1,0,1,1,100.0,0,2,1,1,0,1,1,0
775,Niclas Fullkrug,Dortmund,9.5,3,2,0,3,0,1,2,50.0,1,3,1,2,0,3,11,0
776,Matteo Gabbia,Villarreal,5.3,10,6,4,6,0,5,8,62.5,3,5,2,3,8,18,36,1
777,Gianluca Gaetano,Napoli,0.3,0,0,0,0,0,0,1,0.0,1,1,0,1,0,0,1,0
778,Roberto Gagliardini,Monza,14.2,37,20,14,18,5,18,27,66.7,9,17,5,12,13,50,20,0
780,Cody Gakpo,Liverpool,6.9,8,4,3,5,0,3,10,30.0,7,12,2,10,4,12,5,0
781,Javi Galan,Atlético Madrid,1.0,5,4,2,2,1,4,5,80.0,1,1,0,1,1,6,3,0
782,Inigo Ruiz de Galarreta,Athletic Club,11.9,25,16,6,18,1,12,26,46.2,14,8,1,7,6,31,8,0
783,Pablo Galdames Millan,Genoa,0.1,0,0,0,0,0,0,0,0.0,0,1,0,1,0,0,0,0
784,Conor Gallagher,Chelsea,13.7,44,26,16,20,8,20,39,51.3,19,20,2,18,19,63,10,0
785,Antonino Gallo,Lecce,7.4,14,10,7,7,0,10,15,66.7,5,12,4,8,5,19,19,0
786,Cristian Gamboa,Bochum,8.5,13,9,6,6,1,7,20,35.0,13,7,1,6,7,20,21,0
787,Kevin Gameiro,Strasbourg,6.6,7,7,4,2,1,1,10,10.0,9,6,0,6,1,8,2,0
788,Idrissa Gana Gueye,Everton,11.0,31,19,9,16,6,12,23,52.2,11,13,3,10,11,42,10,0
789,Ignatius Ganago,Nantes,2.0,0,0,0,0,0,0,1,0.0,1,1,0,1,1,1,1,0
790,Aleix Garcia,Girona,16.0,23,15,10,10,3,14,28,50.0,14,24,9,15,19,42,30,0
791,Alvaro Garcia,Rayo Vallecano,14.3,17,13,7,7,3,2,20,10.0,18,17,0,17,18,35,16,0
792,Dani Garcia,Athletic Club,4.5,6,2,1,2,3,4,14,28.6,10,7,1,6,3,9,5,0
793,David Garcia,Osasuna,15.0,19,12,14,5,0,12,17,70.6,5,19,10,9,11,30,72,1
794,Eric Garcia,Barcelona,0.6,0,0,0,0,0,0,0,0.0,0,1,1,0,0,0,0,0
795,Eric Garcia,Girona,10.6,15,12,6,6,3,10,14,71.4,4,12,8,4,12,27,26,1
796,Fran Garcia,Real Madrid,6.0,9,6,4,4,1,5,13,38.5,8,5,0,5,10,19,12,1
797,Francisco Jesus Crespo Garcia,Las Palmas,3.8,10,6,3,5,2,6,18,33.3,12,3,0,3,2,12,4,0
798,Gonzalo Garcia,Real Madrid,0.2,0,0,0,0,0,0,1,0.0,1,1,1,0,0,0,1,0
799,Raul Garcia,Athletic Club,1.0,1,1,1,0,0,1,4,25.0,3,2,0,2,1,2,1,0
800,Ruben Garcia,Osasuna,6.3,10,7,1,7,2,4,10,40.0,6,13,2,11,4,14,7,0
801,Santiago Garcia,Getafe,0.3,1,0,0,0,1,1,1,100.0,0,0,0,0,0,1,0,0
802,Unai Garcia,Osasuna,1.0,2,2,1,0,1,0,0,0.0,0,1,0,1,1,3,7,0
803,Alejandro Garnacho,Manchester Utd,8.1,8,5,2,3,3,3,13,23.1,10,7,0,7,5,13,6,0
804,James Garner,Everton,13.9,38,21,18,14,6,15,34,44.1,19,16,4,12,14,52,21,0
806,Luca Garritano,Frosinone,3.7,5,2,4,1,0,2,8,25.0,6,10,0,10,3,8,4,0
807,Johan Gastien,Clermont Foot,10.0,15,8,5,8,2,12,31,38.7,19,9,2,7,13,28,10,2
808,Federico Gatti,Juventus,12.1,14,10,8,5,1,9,12,75.0,3,8,7,1,10,24,47,0
809,Federico Gattoni,Sevilla,0.1,1,0,1,0,0,1,1,100.0,0,0,0,0,0,1,1,0
810,Gavi,Barcelona,10.5,39,21,20,14,5,18,36,50.0,18,19,3,16,8,47,16,1
811,Paulo Gazzaniga,Girona,16.0,1,1,1,0,0,1,1,100.0,0,0,0,0,0,1,3,0
812,Gelabert,Toulouse,5.3,7,5,2,4,1,3,10,30.0,7,5,1,4,4,11,5,0
813,Francesco Gelli,Frosinone,5.2,5,3,2,2,1,3,4,75.0,1,6,2,4,6,11,3,0
814,Luca Gemello,Torino,1.0,0,0,0,0,0,0,1,0.0,1,0,0,0,0,0,1,0
815,Valentin Gendrey,Lecce,14.0,19,13,12,6,1,13,21,61.9,8,16,4,12,18,37,35,0
816,Denis Genreau,Toulouse,4.8,11,8,5,6,0,8,13,61.5,5,8,1,7,4,15,8,0
817,Yannick Gerhardt,Wolfsburg,6.8,4,3,2,1,1,1,8,12.5,7,7,1,6,3,7,9,0
818,Anwar El Ghazi,Mainz 05,0.6,0,0,0,0,0,0,1,0.0,1,0,0,0,0,0,0,0
819,Saman Ghoddos,Brentford,4.8,14,12,10,3,1,11,13,84.6,2,5,1,4,2,16,7,0
820,Morgan Gibbs-White,Nott'ham Forest,14.8,16,12,2,9,5,9,19,47.4,10,10,2,8,8,24,12,0
821,Samuel Gigot,Marseille,9.7,23,16,10,11,2,9,14,64.3,5,16,10,6,12,35,62,0
822,Bryan Gil,Tottenham,1.6,1,0,0,0,1,1,2,50.0,1,1,0,1,1,2,1,0
823,David Gil,Cádiz,2.1,0,0,0,0,0,0,0,0.0,0,0,0,0,0,0,3,0
824,Mario Gila,Lazio,3.0,3,0,3,0,0,1,1,100.0,0,1,0,1,1,4,8,0
825,Billy Gilmour,Brighton,10.2,12,8,6,4,2,6,21,28.6,15,9,3,6,4,16,7,0
826,Benedikt Gimber,Heidenheim,4.9,14,9,8,5,1,8,10,80.0,2,5,4,1,4,18,20,0
827,Gvidas Gineitis,Torino,2.1,4,3,0,4,0,2,3,66.7,1,4,2,2,3,7,6,1
828,Matthias Ginter,Freiburg,12.3,15,8,9,6,0,8,18,44.4,10,23,15,8,11,26,49,0
829,Olivier Giroud,Milan,9.4,6,5,2,3,1,1,4,25.0,3,5,1,4,3,9,5,0
830,Klaus Gjasula,Darmstadt 98,5.5,19,11,9,10,0,5,9,55.6,4,6,3,3,9,28,20,0
832,Serge Gnabry,Bayern Munich,2.5,3,2,0,3,0,2,9,22.2,7,3,0,3,0,3,2,0
833,Ben Godfrey,Everton,0.0,0,0,0,0,0,0,0,0.0,0,1,0,1,0,0,0,0
834,Edoardo Goldaniga,Cagliari,7.2,9,5,6,3,0,3,7,42.9,4,7,5,2,11,20,22,1
835,Pierluigi Gollini,Napoli,2.0,1,1,1,0,0,1,1,100.0,0,0,0,0,0,1,1,0
836,Aleksandr Golovin,Monaco,13.6,21,14,9,9,3,7,19,36.8,12,19,0,19,7,28,5,0
837,Angel Gomes,Lille,12.6,11,5,1,7,3,5,12,41.7,7,9,1,8,12,23,15,1
838,Joao Gomes,Wolves,11.5,33,21,13,15,5,11,31,35.5,20,17,1,16,9,42,7,1
839,Toti Gomes,Wolves,10.5,18,14,13,4,1,10,11,90.9,1,7,6,1,10,28,24,0
840,Joe Gomez,Liverpool,7.4,19,9,10,6,3,12,23,52.2,11,8,1,7,9,28,22,2
841,Maxi Gomez,Cádiz,5.5,1,1,1,0,0,1,1,100.0,0,3,3,0,1,2,1,0
842,Moi Gomez,Osasuna,9.7,18,12,3,11,4,5,10,50.0,5,6,1,5,6,24,7,0
843,Papu Gomez,Monza,0.5,0,0,0,0,0,0,2,0.0,2,0,0,0,1,1,0,0
844,Sergio Gomez,Manchester City,0.2,0,0,0,0,0,0,0,0.0,0,0,0,0,1,1,0,0
845,Unai Gomez,Athletic Club,1.4,2,2,0,1,1,0,1,0.0,1,1,0,1,0,2,3,0
846,Maxime Gonalons,Clermont Foot,10.3,28,18,10,16,2,14,37,37.8,23,14,2,12,17,45,6,0
847,Edgar Gonzalez,Almería,10.9,19,11,10,7,2,10,18,55.6,8,21,12,9,11,30,54,0
848,Giovanni Gonzalez,Mallorca,10.7,24,17,10,13,1,10,26,38.5,16,9,2,7,6,30,17,0
849,Hugo Gonzalez,Valencia,0.5,1,0,0,1,0,0,0,0.0,0,0,0,0,0,1,0,0
850,Joan Gonzalez,Lecce,6.7,5,4,0,3,2,3,7,42.9,4,10,1,9,2,7,2,0
851,Nicolas Gonzalez,Fiorentina,10.2,15,10,8,5,2,4,14,28.6,10,14,1,13,4,19,2,0
852,Urko Gonzalez,Real Sociedad,1.1,3,0,0,2,1,1,1,100.0,0,0,0,0,0,3,3,0
853,Anthony Gordon,Newcastle Utd,13.6,27,15,9,14,4,13,35,37.1,22,20,0,20,2,29,2,0
854,Leon Goretzka,Bayern Munich,9.2,11,7,5,3,3,5,16,31.3,11,12,0,12,11,22,13,0
855,Andoni Gorosabel,Alavés,15.2,22,15,14,7,1,15,35,42.9,20,12,3,9,12,34,25,0
856,Robin Gosens,Union Berlin,10.6,31,20,9,19,3,16,21,76.2,5,24,2,22,18,49,27,0
858,Mario Gotze,Eint Frankfurt,7.1,16,9,8,5,3,11,21,52.4,10,11,0,11,1,17,4,0
859,Amine Gouiri,Rennes,12.3,13,9,3,6,4,6,12,50.0,6,9,0,9,6,19,6,0
860,Jeffrey Gouweleeuw,Augsburg,10.5,12,9,5,6,1,5,7,71.4,2,16,6,10,13,25,52,0
861,Pablo Gozalbez,Valencia,1.1,1,0,0,0,1,1,6,16.7,5,0,0,0,1,2,2,0
862,Jonathan Gradit,Lens,13.5,21,11,10,9,2,11,20,55.0,9,14,6,8,21,42,30,0
863,Jens Grahl,Eint Frankfurt,1.0,0,0,0,0,0,0,0,0.0,0,0,0,0,0,0,1,0
864,Samuel Grandsir,Le Havre,4.3,10,8,2,6,2,4,13,30.8,9,1,0,1,3,13,3,1
865,Alberto Grassi,Empoli,9.0,11,6,5,6,0,2,8,25.0,6,13,7,6,19,30,12,0
866,Ryan Gravenberch,Liverpool,5.0,7,3,1,3,3,2,8,25.0,6,7,1,6,8,15,6,0
867,Ryan Gravenberch,Bayern Munich,0.1,0,0,0,0,0,0,0,0.0,0,0,0,0,0,0,0,0
868,Adrian Grbic,Lorient,0.3,0,0,0,0,0,0,0,0.0,0,0,0,0,0,0,0,0
869,Jack Grealish,Manchester City,5.1,8,5,5,3,0,4,6,66.7,2,7,2,5,4,12,3,0
870,Mason Greenwood,Getafe,9.3,2,0,1,0,1,0,4,0.0,4,2,0,2,1,3,1,0
871,Michael Gregoritsch,Freiburg,5.8,2,1,1,0,1,0,4,0.0,4,7,1,6,4,6,9,0
872,Antoine Griezmann,Atlético Madrid,13.8,16,7,4,9,3,6,20,30.0,14,16,2,14,6,22,9,0
873,Vincenzo Grifo,Freiburg,11.4,14,11,5,6,3,6,14,42.9,8,9,0,9,2,16,8,0
874,Florian Grillitsch,Hoffenheim,7.6,15,12,9,5,1,6,17,35.3,11,10,1,9,12,27,7,1
875,Alex Grimaldo,Leverkusen,13.9,25,12,14,4,7,19,31,61.3,12,17,4,13,9,34,22,0
876,Christian Gross,Werder Bremen,4.2,10,6,6,4,0,4,14,28.6,10,7,2,5,5,15,7,0
877,Pascal Gross,Brighton,13.2,18,10,6,6,6,9,24,37.5,15,14,1,13,8,26,8,2
878,Brajan Gruda,Mainz 05,7.1,5,3,0,3,2,4,9,44.4,5,9,0,9,2,7,2,0
879,Ilia Gruev,Werder Bremen,0.0,0,0,0,0,0,0,0,0.0,0,0,0,0,0,0,0,0
880,Vicente Guaita,Celta Vigo,6.7,0,0,0,0,0,0,0,0.0,0,0,0,0,0,0,1,0
881,Andres Guardado,Betis,3.5,11,8,3,8,0,5,11,45.5,6,2,1,1,4,15,3,0
882,Sergi Guardiola,Cádiz,1.0,2,1,1,0,1,1,2,50.0,1,1,0,1,0,2,1,0
884,Nemanja Gudelj,Sevilla,11.8,13,9,8,4,1,8,16,50.0,8,8,3,5,15,28,39,0
885,Gabriel Gudmundsson,Lille,4.0,5,3,0,5,0,5,7,71.4,2,3,1,2,6,11,9,0
886,Marc Guehi,Crystal Palace,15.0,19,12,16,3,0,9,17,52.9,8,14,12,2,14,33,68,1
887,Matteo Guendouzi,Lazio,8.9,10,4,3,3,4,5,18,27.8,13,5,0,5,7,17,7,1
888,Matteo Guendouzi,Marseille,0.2,0,0,0,0,0,0,0,0.0,0,1,1,0,0,0,0,0
889,Javier Guerra,Valencia,14.4,23,12,11,9,3,9,25,36.0,16,17,2,15,9,32,23,0
890,Raphael Guerreiro,Bayern Munich,1.3,2,1,2,0,0,0,0,0.0,0,0,0,0,1,3,2,0
891,Axel Guessand,Udinese,0.5,1,1,0,1,0,1,1,100.0,0,1,0,1,0,1,0,0
892,Evann Guessand,Nice,4.8,7,3,0,3,4,1,1,100.0,0,6,1,5,1,8,1,0
893,Ander Guevara,Alavés,14.4,31,18,15,13,3,17,35,48.6,18,13,3,10,6,37,24,1
894,Pape Gueye,Marseille,0.3,3,1,0,3,0,1,2,50.0,1,1,0,1,1,4,1,0
895,Josuha Guilavogui,Mainz 05,0.3,2,1,2,0,0,1,1,100.0,0,3,1,2,1,3,2,0
896,Morgan Guilavogui,Lens,5.0,12,7,1,9,2,2,7,28.6,5,5,1,4,3,15,2,0
897,Frederic Guilbert,Strasbourg,9.9,33,17,19,10,4,16,28,57.1,12,14,1,13,31,64,29,1
898,Hugo Guillamon,Valencia,1.9,6,3,2,3,1,4,5,80.0,1,0,0,0,0,6,6,1
899,Bruno Guimaraes,Newcastle Utd,14.6,35,21,21,9,5,16,30,53.3,14,18,5,13,14,49,9,0
900,Serhou Guirassy,Stuttgart,9.7,2,2,0,2,0,1,3,33.3,2,3,1,2,2,4,11,0
901,Marc Guiu,Barcelona,0.1,1,0,0,1,0,0,0,0.0,0,0,0,0,0,1,0,0
902,Manuel Gulde,Freiburg,6.0,11,9,7,4,0,4,4,100.0,0,4,2,2,10,21,12,0
903,Gerard Gumbau,Granada,13.8,19,12,5,13,1,4,17,23.5,13,13,3,10,10,29,14,1
904,Robert Gumny,Augsburg,4.5,5,4,1,2,2,1,4,25.0,3,12,4,8,7,12,9,0
905,Ilkay Gundogan,Barcelona,14.5,14,8,6,7,1,5,14,35.7,9,7,0,7,12,26,5,0
906,Christian Gunter,Freiburg,1.0,1,0,1,0,0,0,0,0.0,0,2,1,1,0,1,2,0
907,Jon Guridi,Alavés,13.0,19,11,4,13,2,4,25,16.0,21,15,2,13,8,27,5,0
908,Gorka Guruzeta,Athletic Club,12.1,15,12,3,12,0,3,11,27.3,8,14,0,14,12,27,11,0
910,Malo Gusto,Chelsea,6.0,17,7,14,3,0,8,13,61.5,5,7,1,6,3,20,10,0
911,Miguel Gutierrez,Girona,14.7,15,10,5,7,3,6,18,33.3,12,8,2,6,6,21,34,0
912,Albert Gudmundsson,Genoa,12.9,11,5,6,3,2,6,14,42.9,8,7,0,7,10,21,2,0
913,Josko Gvardiol,Manchester City,10.8,21,13,5,13,3,9,14,64.3,5,13,7,6,15,36,20,2
914,Emmanuel Gyasi,Empoli,3.6,4,1,1,2,1,0,1,0.0,1,4,1,3,1,5,2,0
915,Norbert Gyomber,Salernitana,11.0,25,11,21,4,0,14,16,87.5,2,24,18,6,20,45,43,1
916,Erling Haaland,Manchester City,14.4,3,1,0,3,0,2,2,100.0,0,8,1,7,1,4,9,0
917,Nicolas Haas,Empoli,1.0,5,3,1,2,2,3,3,100.0,0,1,0,1,1,6,1,0
918,Janik Haberer,Union Berlin,7.2,19,14,7,9,3,13,25,52.0,12,11,1,10,6,25,4,0
919,Robin Hack,M'Gladbach,2.1,3,1,1,2,0,0,3,0.0,3,1,0,1,2,5,4,0
920,Antwoine Hackford,Sheffield Utd,0.1,0,0,0,0,0,0,0,0.0,0,0,0,0,0,0,0,0
921,Munir El Haddadi,Las Palmas,13.0,21,13,10,8,3,11,22,50.0,11,10,0,10,5,26,8,0
922,Jaouen Hadjam,Nantes,1.2,6,4,5,1,0,1,2,50.0,1,0,0,0,3,9,1,0
923,Ianis Hagi,Alavés,5.5,10,8,2,7,1,3,10,30.0,7,5,0,5,1,11,4,0
924,Amadou Haidara,RB Leipzig,5.5,9,7,4,3,2,3,11,27.3,8,11,1,10,8,17,7,0
925,Massadio Haidara,Lens,4.0,4,3,1,2,1,0,2,0.0,2,4,1,3,6,10,11,1
926,Oualid El Hajjam,Le Havre,1.2,3,3,2,1,0,0,2,0.0,2,2,1,1,2,5,4,0
927,Achraf Hakimi,Paris S-G,12.8,18,11,7,7,4,11,23,47.8,12,19,2,17,10,28,14,1
928,Lewis Hall,Newcastle Utd,0.8,6,4,3,3,0,2,5,40.0,3,2,0,2,1,7,0,0
929,Sebastien Haller,Dortmund,3.7,1,0,0,1,0,1,1,100.0,0,4,1,3,0,1,7,0
930,Gustavo Hamer,Sheffield Utd,13.9,26,14,12,10,4,9,36,25.0,27,19,2,17,9,35,19,0
931,Andreas Hanche-Olsen,Mainz 05,0.7,3,0,2,1,0,1,1,100.0,0,0,0,0,0,3,2,0
932,Ridgeciano Haps,Genoa,6.1,4,4,2,0,2,3,4,75.0,1,3,0,3,5,9,4,1
933,Genki Haraguchi,Stuttgart,0.2,1,1,1,0,0,0,0,0.0,0,0,0,0,0,1,1,0
934,Amine Harit,Marseille,9.4,14,9,3,9,2,7,19,36.8,12,14,3,11,6,20,1,0
936,Luke Harris,Fulham,0.8,1,1,1,0,0,0,1,0.0,1,0,0,0,0,1,0,0
937,Jack Harrison,Everton,8.8,13,4,2,6,5,6,15,40.0,9,7,0,7,3,16,9,0
938,Abdou Harroui,Frosinone,2.8,6,5,1,5,0,2,5,40.0,3,4,0,4,2,8,0,0
939,Makoto Hasebe,Eint Frankfurt,0.4,2,2,2,0,0,2,2,100.0,0,0,0,0,0,2,1,0
940,Hans Hateboer,Atalanta,3.6,4,1,3,1,0,1,2,50.0,1,5,0,5,2,6,5,0
941,Pantelis Hatzidiakos,Cagliari,5.7,14,5,8,6,0,8,12,66.7,4,8,3,5,6,20,13,1
942,Kai Havertz,Arsenal,10.2,21,10,1,15,5,10,19,52.6,9,12,1,11,7,28,4,0
943,Thorgan Hazard,Dortmund,0.1,0,0,0,0,0,0,0,0.0,0,0,0,0,0,0,0,0
944,Jan Paul van Hecke,Brighton,9.3,14,5,11,2,1,8,17,47.1,9,20,13,7,10,24,26,1
945,Hwang Hee-chan,Wolves,12.6,12,6,8,4,0,7,17,41.2,10,15,1,14,6,18,6,0
946,Silvan Hefti,Genoa,1.3,6,1,2,3,1,4,7,57.1,3,2,0,2,0,6,1,0
947,Dominique Heintz,Köln,3.6,6,3,4,2,0,4,7,57.1,3,5,0,5,1,7,13,0
948,Liam Henderson,Empoli,0.1,0,0,0,0,0,0,0,0.0,0,0,0,0,0,0,0,0
949,Benjamin Henrichs,RB Leipzig,11.9,24,14,12,10,2,6,22,27.3,16,19,1,18,13,37,9,0
950,Henrique,Lyon,3.1,4,2,1,3,0,1,2,50.0,1,3,1,2,6,10,1,0
951,Luiz Henrique,Betis,3.6,6,5,2,4,0,4,8,50.0,4,6,0,6,3,9,4,0
952,Matheus Henrique,Sassuolo,9.9,14,10,6,8,0,8,17,47.1,9,5,2,3,8,22,12,2
953,Rico Henry,Brentford,4.5,7,5,3,3,1,6,7,85.7,1,8,3,5,5,12,5,1
954,Thomas Henry,Hellas Verona,0.8,0,0,0,0,0,0,0,0.0,0,0,0,0,0,0,2,0
955,Christophe Herelle,Metz,7.2,9,4,6,3,0,3,7,42.9,4,7,3,4,6,15,27,0
956,Mario Hermoso,Atlético Madrid,13.6,20,11,10,9,1,9,18,50.0,9,17,7,10,15,35,46,0
957,Javi Hernandez,Cádiz,15.5,14,9,9,2,3,10,21,47.6,11,20,7,13,8,22,45,0
958,Aridane Hernandez,Rayo Vallecano,8.8,7,5,3,3,1,4,7,57.1,3,6,4,2,3,10,49,1
959,Lucas Hernandez,Paris S-G,10.7,28,17,14,9,5,16,27,59.3,11,9,2,7,18,46,17,0
960,Luis Hernandez,Cádiz,6.0,4,3,2,2,0,2,6,33.3,4,2,1,1,5,9,21,0
962,Theo Hernandez,Milan,11.9,12,5,10,2,0,6,10,60.0,4,10,5,5,12,24,17,0
963,Yarek Hernandis,Valencia,2.9,0.0,6,0.0,0.0,0.0,0.0,0.0,0.0,0.0,0.0,0.0,0.0,7,0.0,0.0,0.0
964,Jorge Herrando,Osasuna,2.4,2,1,2,0,0,0,0,0.0,0,2,1,1,2,4,12,0
965,Ander Herrera,Athletic Club,4.5,20,15,4,15,1,10,19,52.6,9,6,1,5,8,28,5,0
966,Cristian Herrera,Las Palmas,1.3,1,1,0,1,0,1,2,50.0,1,1,0,1,0,1,2,0
967,Sergio Herrera,Osasuna,12.9,0,0,0,0,0,0,1,0.0,1,0,0,0,0,0,8,1
968,Yangel Herrera,Girona,12.1,28,13,9,14,5,13,28,46.4,15,16,6,10,11,39,27,0
969,Patrick Herrmann,M'Gladbach,0.5,2,2,1,0,1,1,1,100.0,0,0,0,0,1,3,1,0
970,Son Heung-min,Tottenham,14.8,10,7,4,3,3,4,11,36.4,7,1,0,1,5,15,4,0
971,Aaron Hickey,Brentford,7.9,16,9,9,3,4,7,7,100.0,0,7,3,4,3,19,10,0
972,Isak Hien,Hellas Verona,6.6,11,7,6,5,0,6,10,60.0,4,8,2,6,4,15,24,0
973,James Hill,Bournemouth,0.2,0,0,0,0,0,0,0,0.0,0,0,0,0,0,0,0,0
974,Piero Hincapie,Leverkusen,2.4,2,1,2,0,0,2,2,100.0,0,0,0,0,3,5,5,0
975,Jack Hinshelwood,Brighton,3.3,2,1,2,0,0,2,6,33.3,4,4,2,2,8,10,9,0
976,Adam Hlozek,Leverkusen,0.8,2,1,1,1,0,1,1,100.0,0,0,0,0,2,4,0,0
977,Nicolas Hofler,Freiburg,9.9,17,12,13,3,1,6,18,33.3,12,12,6,6,15,32,20,0
978,Jonas Hofmann,Leverkusen,12.4,12,9,3,6,3,5,13,38.5,8,8,0,8,4,16,5,0
979,Philipp Hofmann,Bochum,8.7,8,3,2,5,1,4,6,66.7,2,3,0,3,1,9,12,0
980,Lucas Holer,Freiburg,11.3,17,11,9,5,3,2,8,25.0,6,8,1,7,5,22,15,0
981,Fabian Holland,Darmstadt 98,11.0,23,13,12,9,2,13,23,56.5,10,12,6,6,15,38,21,0
982,Benedict Hollerbach,Union Berlin,2.4,4,2,1,2,1,3,9,33.3,6,8,0,8,1,5,0,0
983,Emil Holm,Atalanta,2.0,6,5,2,3,1,2,6,33.3,4,5,0,5,4,10,3,0
984,Martin Hongla,Hellas Verona,9.0,18,9,7,9,2,5,8,62.5,3,8,3,5,5,23,15,0
985,Franck Honorat,M'Gladbach,12.0,10,7,5,5,0,5,9,55.6,4,11,1,10,3,13,7,0
986,Mathias Honsak,Darmstadt 98,5.7,6,4,3,2,1,4,9,44.4,5,7,1,6,3,9,11,0
988,Sydney van Hooijdonk,Bologna,1.3,3,0,0,2,1,1,1,100.0,0,1,1,0,1,4,3,0
989,Fraser Hornby,Darmstadt 98,2.4,0,0,0,0,0,0,1,0.0,1,2,1,1,0,0,4,0
990,Lukas Hradecky,Leverkusen,14.0,0,0,0,0,0,0,0,0.0,0,1,0,1,0,0,4,2
991,Timo Hubers,Köln,13.9,33,26,25,6,2,23,43,53.5,20,26,15,11,33,66,79,0
992,Callum Hudson-Odoi,Nott'ham Forest,3.8,2,1,0,1,1,0,3,0.0,3,4,0,4,1,3,2,0
993,Will Hughes,Crystal Palace,10.1,25,12,11,9,5,9,21,42.9,12,20,8,12,6,31,17,0
994,Dean Huijsen,Juventus,0.1,0,0,0,0,0,0,0,0.0,0,0,0,0,0,0,1,0
995,Mats Hummels,Dortmund,10.5,28,19,14,8,6,16,31,51.6,15,16,5,11,24,52,51,0
996,Denis Huseinbasic,Köln,3.8,7,3,3,2,2,3,6,50.0,3,7,0,7,4,11,3,0
997,Elseid Hysaj,Lazio,5.1,13,7,5,7,1,9,14,64.3,5,8,2,6,5,18,20,0
998,Pierre Hojbjerg,Tottenham,6.3,9,4,4,4,1,3,13,23.1,10,14,6,8,6,15,13,1
999,Rasmus Hojlund,Manchester Utd,8.8,4,3,0,1,3,3,6,50.0,3,0,0,0,0,4,9,0
1000,Iago,Augsburg,5.7,14,7,8,5,1,8,16,50.0,8,8,1,7,4,18,11,0
1001,Pablo Ibanez,Osasuna,3.6,3,0,0,2,1,0,4,0.0,4,6,1,5,2,5,4,0
1002,Arijon Ibrahimovic,Frosinone,3.7,7,6,4,2,1,1,8,12.5,7,4,0,4,0,7,1,0
1003,Iglesias,Getafe,7.4,18,12,10,6,2,8,10,80.0,2,5,3,2,8,26,24,0
1004,Borja Iglesias,Betis,3.1,0,0,0,0,0,0,2,0.0,2,0,0,0,2,2,2,0
1005,Igor,Brighton,6.0,9,6,1,7,1,3,5,60.0,2,7,3,4,6,15,13,0
1006,Jonathan Ikone,Fiorentina,4.9,10,4,4,2,4,2,6,33.3,4,3,0,3,1,11,3,0
1007,Chukwubuikem Ikwuemesi,Salernitana,5.5,2,0,0,1,1,1,3,33.3,2,1,1,0,1,3,4,0
1008,Ivan Ilic,Torino,9.7,12,6,3,7,2,6,12,50.0,6,10,5,5,9,21,11,0
1009,Samuel Iling-Junior,Juventus,1.3,5,4,4,1,0,3,6,50.0,3,4,1,3,1,6,1,0
1010,Imanol,Athletic Club,2.9,3,3,0,3,0,2,7,28.6,5,4,0,4,5,8,6,0
1011,Ciro Immobile,Lazio,9.7,6,5,1,3,2,1,7,14.3,6,3,1,2,3,9,3,0
1012,Gino Infantino,Fiorentina,0.9,1,1,0,1,0,0,1,0.0,1,3,0,3,1,2,1,0
1014,Danny Ings,West Ham,1.5,0,0,0,0,0,0,1,0.0,1,2,1,1,0,0,4,0
1015,Bonke Innocent,Lorient,1.1,2,2,1,1,0,2,4,50.0,2,0,0,0,3,5,1,0
1016,Alexander Isak,Newcastle Utd,9.1,1,0,0,1,0,1,4,25.0,3,2,0,2,2,3,3,0
1017,Gustav Isaksen,Lazio,3.2,3,2,1,1,1,0,0,0.0,0,3,1,2,1,4,2,0
1018,Isco,Betis,14.6,18,12,3,12,3,7,23,30.4,16,12,0,12,6,24,3,0
1019,Thomas Isherwood,Darmstadt 98,1.9,4,1,2,1,1,2,2,100.0,0,2,2,0,3,7,10,0
1020,Ismaily,Lille,11.2,24,17,11,9,4,10,18,55.6,8,12,3,9,13,37,30,0
1021,Ardian Ismajli,Empoli,9.2,6,4,4,2,0,3,3,100.0,0,16,11,5,9,15,45,1
1022,Ko Itakura,M'Gladbach,6.8,12,7,6,6,0,6,11,54.5,5,15,7,8,12,24,22,0
1023,Hiroki Ito,Stuttgart,10.9,4,4,3,1,0,3,8,37.5,5,11,5,6,16,20,30,0
1024,Junya Ito,Reims,14.8,17,9,6,7,4,6,21,28.6,15,11,1,10,7,24,5,0
1025,Alex Iwobi,Everton,1.6,2,0,1,0,1,2,3,66.7,1,2,0,2,1,3,0,0
1026,Alex Iwobi,Fulham,8.7,11,6,5,5,1,4,9,44.4,5,4,0,4,9,20,2,0
1027,Armando Izzo,Monza,4.5,11,7,6,5,0,4,10,40.0,6,5,3,2,5,16,7,1
1028,Nicolas Jackson,Chelsea,12.2,7,6,0,3,4,0,8,0.0,8,7,2,5,3,10,8,0
1029,Lee Jae-sung,Mainz 05,10.9,10,6,3,6,1,5,21,23.8,16,11,0,11,11,21,10,0
1030,Paul Jaeckel,Union Berlin,2.4,7,2,4,3,0,5,8,62.5,3,2,1,1,4,11,5,0
1031,Filip Jagiello,Genoa,0.4,0,0,0,0,0,0,1,0.0,1,1,1,0,1,1,0,0
1032,Kristijan Jakic,Eint Frankfurt,2.0,1,1,0,1,0,0,2,0.0,2,1,0,1,1,2,2,0
1033,Ismail Jakobs,Monaco,8.9,31,23,12,14,5,16,24,66.7,8,10,1,9,8,39,26,0
1034,Ablie Jallow,Metz,7.3,4,3,0,2,2,1,3,33.3,2,2,0,2,4,8,2,0
1035,Reece James,Chelsea,4.3,13,8,10,2,1,8,10,80.0,2,4,4,0,3,16,7,1
1036,Vitaly Janelt,Brentford,14.3,27,17,10,10,7,15,33,45.5,18,14,2,12,9,36,28,0
1037,Jakub Jankto,Cagliari,4.7,6,4,5,1,0,4,8,50.0,4,2,0,2,4,10,14,0
1038,Tony Jantschke,M'Gladbach,0.2,1,1,1,0,0,1,1,100.0,0,2,2,0,0,1,2,0
1040,Adnan Januzaj,Sevilla,1.1,2,2,2,0,0,0,1,0.0,1,1,0,1,0,2,0,0
1041,Luis Javier Suarez,Almería,7.7,5,4,2,3,0,1,4,25.0,3,9,0,9,0,5,8,0
1042,Danley Jean-Jacques,Metz,13.2,26,17,14,10,2,12,27,44.4,15,24,3,21,23,49,15,0
1043,Jefferson,Lyon,3.3,11,4,3,5,3,4,11,36.4,7,1,0,1,0,11,0,0
1044,Fredrik Jensen,Augsburg,5.9,9,2,2,2,5,4,12,33.3,8,10,1,9,3,12,8,0
1045,Mathias Jensen,Brentford,10.1,24,13,13,10,1,12,36,33.3,24,17,2,15,8,32,11,1
1046,Moritz Jenz,Wolfsburg,6.5,10,7,4,5,1,4,6,66.7,2,8,4,4,9,19,34,0
1047,Gabriel Jesus,Arsenal,7.4,15,10,8,3,4,3,13,23.1,10,11,0,11,5,20,4,0
1048,Juan Jesus,Napoli,5.6,10,5,8,1,1,6,7,85.7,1,5,4,1,5,15,18,0
1049,Raul Jimenez,Fulham,11.0,12,9,2,7,3,5,14,35.7,9,8,2,6,2,14,11,0
1050,Joao Pedro,Brighton,9.4,14,7,6,5,3,5,11,45.5,6,2,0,2,4,18,15,0
1051,Joelinton,Newcastle Utd,11.1,26,19,12,12,2,9,26,34.6,17,16,4,12,13,39,9,0
1052,Ryan John Giles,Luton Town,4.3,6,4,2,3,1,2,6,33.3,4,2,0,2,1,7,13,0
1053,Brennan Johnson,Tottenham,6.3,5,4,3,2,0,3,9,33.3,6,6,0,6,3,8,6,1
1054,Brennan Johnson,Nott'ham Forest,2.6,4,1,1,1,2,2,4,50.0,2,4,1,3,0,4,0,0
1055,Sam Johnstone,Crystal Palace,16.0,1,0,1,0,0,1,1,100.0,0,0,0,0,0,1,3,0
1056,Curtis Jones,Liverpool,4.3,9,5,4,3,2,4,9,44.4,5,7,0,7,2,11,6,0
1057,Frenkie de Jong,Barcelona,8.4,11,6,3,6,2,3,10,30.0,7,7,4,3,5,16,9,1
1058,Joan Jordan,Sevilla,2.8,5,4,2,3,0,5,11,45.5,6,2,2,0,3,8,2,0
1059,Jordi,Getafe,0.9,3,3,0,3,0,0,1,0.0,1,2,0,2,2,5,0,0
1060,Kaio Jorge,Frosinone,1.6,1,1,0,0,1,1,2,50.0,1,1,0,1,0,1,0,0
1061,Jorginho,Arsenal,4.3,11,3,4,3,4,6,12,50.0,6,8,1,7,2,13,2,1
1062,Willian Jose,Betis,8.6,5,2,1,2,2,0,2,0.0,2,4,1,3,0,5,8,0
1063,Joselu,Real Madrid,9.2,5,3,1,3,1,0,1,0.0,1,4,0,4,3,8,5,0
1064,Diogo Jota,Liverpool,7.0,10,6,3,6,1,4,12,33.3,8,3,1,2,3,13,4,0
1066,Antoine Joujou,Le Havre,3.8,9,7,3,4,2,5,10,50.0,5,4,1,3,1,10,4,0
1067,Luka Jovic,Milan,4.6,3,2,0,3,0,1,3,33.3,2,1,0,1,0,3,6,0
1068,Juanpe,Girona,1.3,1,1,1,0,0,1,1,100.0,0,3,3,0,0,1,15,0
1069,Mads Juel Andersen,Luton Town,4.1,5,5,3,2,0,4,4,100.0,0,7,5,2,8,13,24,0
1070,Christopher Jullien,Montpellier,4.0,4,3,3,1,0,3,7,42.9,4,3,1,2,4,8,24,0
1071,Anthony Jung,Werder Bremen,11.4,16,9,11,4,1,8,14,57.1,6,14,5,9,8,24,41,0
1072,Eli Junior Kroupi,Lorient,7.6,3,2,1,1,1,0,7,0.0,7,2,0,2,7,10,4,0
1073,Hamed Junior Traore,Bournemouth,0.5,1,0,1,0,0,1,3,33.3,2,3,0,3,0,1,0,0
1074,Vinicius Junior,Real Madrid,7.8,6,4,3,0,3,0,5,0.0,5,2,0,2,0,6,2,1
1075,Josip Juranovic,Union Berlin,4.6,5,3,3,2,0,1,4,25.0,3,3,0,3,0,5,12,0
1076,Julian Justvan,Hoffenheim,0.5,1,0,1,0,0,1,2,50.0,1,1,0,1,0,1,0,0
1077,Filip Jorgensen,Villarreal,16.0,3,1,3,0,0,3,4,75.0,1,0,0,0,1,4,4,2
1078,Mathias Jorgensen,Brentford,0.1,0,0,0,0,0,0,0,0.0,0,1,1,0,0,0,0,0
1079,Mohamed Kaba,Lecce,7.2,15,8,5,6,4,8,18,44.4,10,12,1,11,6,21,8,0
1080,Sory Kaba,Las Palmas,5.8,1,0,0,1,0,0,3,0.0,3,3,0,3,0,1,8,0
1081,Ozan Kabak,Hoffenheim,8.8,17,13,10,5,2,9,13,69.2,4,12,4,8,13,30,37,0
1082,Christian Kabasele,Udinese,8.5,8,6,4,3,1,1,10,10.0,9,13,7,6,9,17,47,0
1083,Issa Kabore,Luton Town,10.6,28,14,16,8,4,14,23,60.9,9,10,4,6,12,40,30,1
1084,Abdoul Kader Bamba,Nantes,3.2,9,6,2,4,3,4,5,80.0,1,3,0,3,2,11,2,0
1085,Pavel Kaderabek,Hoffenheim,9.0,13,8,4,8,1,9,17,52.9,8,10,4,6,9,22,20,0
1086,Tino Kadewere,Lyon,3.1,1,1,0,1,0,1,5,20.0,4,3,1,2,5,6,7,0
1087,Kaiky,Almería,4.7,6,4,5,0,1,3,6,50.0,3,6,5,1,3,9,21,1
1088,Florian Kainz,Köln,11.5,18,14,6,6,6,12,22,54.5,10,11,5,6,6,24,9,0
1089,Sasa Kalajdzic,Wolves,1.8,6,2,3,2,1,1,2,50.0,1,3,0,3,1,7,6,0
1090,Arnaud Kalimuendo,Rennes,9.0,3,2,1,1,1,2,4,50.0,2,2,1,1,3,6,1,0
1092,Gedeon Kalulu,Lorient,8.2,18,13,11,6,1,8,16,50.0,8,12,2,10,3,21,25,0
1093,Pierre Kalulu,Milan,1.2,4,0,2,2,0,0,1,0.0,1,3,2,1,1,5,6,1
1094,Daichi Kamada,Lazio,5.4,20,12,10,7,3,11,20,55.0,9,7,2,5,4,24,3,0
1095,Waren Kamanzi,Toulouse,3.4,12,10,7,3,2,5,10,50.0,5,2,1,1,2,14,10,0
1096,Boubacar Kamara,Aston Villa,14.0,32,21,14,16,2,18,36,50.0,18,15,5,10,16,48,11,0
1097,Hassane Kamara,Udinese,7.7,16,11,9,4,3,8,12,66.7,4,6,1,5,9,25,19,0
1098,Jakub Kaminski,Wolfsburg,1.8,3,2,3,0,0,1,3,33.3,2,2,0,2,0,3,2,0
1099,Thomas Kaminski,Luton Town,16.0,0,0,0,0,0,0,0,0.0,0,0,0,0,0,0,9,1
1100,Kevin Kampl,RB Leipzig,8.3,13,7,5,6,2,6,12,50.0,6,12,5,7,7,20,6,1
1101,Harry Kane,Bayern Munich,12.6,5,3,3,1,1,3,9,33.3,6,3,1,2,4,9,8,0
1102,Lee Kang-in,Paris S-G,6.8,15,8,4,4,7,10,19,52.6,9,4,0,4,4,19,1,0
1103,Yann Karamoh,Torino,1.7,1,0,0,0,1,0,0,0.0,0,0,0,0,0,1,1,0
1104,Atakan Karazor,Stuttgart,13.2,37,23,13,20,4,17,26,65.4,9,13,4,9,16,53,21,0
1105,Ayman Kari,Lorient,0.2,1,1,1,0,0,1,2,50.0,1,0,0,0,0,1,0,0
1106,Emir Karic,Darmstadt 98,5.3,19,14,9,5,5,12,15,80.0,3,10,0,10,4,23,13,0
1107,Jesper Karlsson,Bologna,3.5,3,3,2,1,0,2,8,25.0,6,4,0,4,3,6,1,0
1108,Jon Karrikaburu,Alavés,0.2,0,0,0,0,0,0,0,0.0,0,0,0,0,0,0,0,0
1109,Rick Karsdorp,Roma,6.2,12,10,5,3,4,7,13,53.8,6,5,2,3,3,15,5,0
1110,Grigoris Kastanos,Salernitana,8.8,13,7,6,3,4,6,11,54.5,5,5,2,3,7,20,4,0
1111,Silas Katompa,Stuttgart,7.6,3,2,2,1,0,2,6,33.3,4,7,0,7,0,3,2,0
1112,Mikkel Kaufmann,Union Berlin,0.9,0,0,0,0,0,0,1,0.0,1,0,0,0,0,0,0,0
1113,Michael Kayode,Fiorentina,7.1,20,12,11,4,5,11,14,78.6,3,9,4,5,8,28,18,1
1114,Moise Kean,Juventus,5.2,7,4,3,2,2,1,2,50.0,1,2,1,1,1,8,4,0
1115,Michael Keane,Everton,2.5,4,2,3,0,1,0,2,0.0,2,2,2,0,4,8,7,1
1116,Ibrahima Kebe,Girona,0.1,1,1,0,1,0,0,0,0.0,0,1,0,1,1,2,0,0
1118,Kevin Keben Biakolo,Toulouse,1.4,1,1,1,0,0,1,2,50.0,1,2,0,2,2,3,7,0
1119,Yassine Kechta,Le Havre,7.0,21,8,9,11,1,11,26,42.3,15,8,2,6,11,32,1,0
1120,Thilo Kehrer,West Ham,0.2,0,0,0,0,0,0,0,0.0,0,2,2,0,0,0,0,0
1121,Habib Keita,Clermont Foot,4.6,12,9,3,7,2,6,9,66.7,3,15,7,8,15,27,7,0
1122,Naby Keita,Werder Bremen,0.9,0,0,0,0,0,0,1,0.0,1,1,0,1,1,1,0,0
1123,Yannik Keitel,Freiburg,1.4,7,5,3,3,1,3,4,75.0,1,3,0,3,4,11,4,1
1124,Caoimhin Kelleher,Liverpool,2.0,0,0,0,0,0,0,0,0.0,0,0,0,0,0,0,2,1
1125,Thomas Keller,Heidenheim,0.0,0,0,0,0,0,0,0,0.0,0,0,0,0,0,0,0,0
1126,Lloyd Kelly,Bournemouth,7.6,10,8,4,4,2,7,14,50.0,7,10,7,3,6,16,22,0
1127,Aljoscha Kemlein,Union Berlin,0.3,0,0,0,0,0,0,3,0.0,3,1,0,1,0,0,0,0
1128,Tobias Kempe,Darmstadt 98,7.2,7,7,4,3,0,4,9,44.4,5,5,1,4,6,13,5,0
1129,Milos Kerkez,Bournemouth,12.9,33,18,21,10,2,20,28,71.4,8,19,6,13,10,43,38,1
1130,Reda Khadra,Reims,1.9,1,0,0,0,1,1,3,33.3,2,1,0,1,2,3,2,0
1131,Wahbi Khazri,Montpellier,7.3,11,8,5,6,0,9,20,45.0,11,7,0,7,1,12,4,0
1132,Rani Khedira,Union Berlin,2.3,6,4,2,4,0,2,3,66.7,1,2,0,2,2,8,6,0
1133,Kike,Alavés,7.9,1,1,0,1,0,1,5,20.0,4,10,4,6,0,1,8,0
1134,Luca Kilian,Köln,2.8,9,4,8,1,0,4,6,66.7,2,5,2,3,1,10,7,0
1135,Max Kilman,Wolves,16.0,20,10,16,3,1,11,15,73.3,4,26,11,15,17,37,72,2
1136,Joshua Kimmich,Bayern Munich,9.5,22,16,8,10,4,12,18,66.7,6,11,2,9,9,31,5,1
1137,Jakub Kiwior,Arsenal,2.8,4,3,2,2,0,3,3,100.0,0,3,1,2,0,4,11,0
1138,Simon Kjaer,Milan,3.3,10,5,4,4,2,7,8,87.5,1,5,2,3,3,13,14,0
1139,Davy Klaassen,Inter,0.8,2,1,0,2,0,0,0,0.0,0,0,0,0,0,2,0,0
1140,Christoph Klarer,Darmstadt 98,11.2,20,12,15,2,3,11,20,55.0,9,13,5,8,9,29,33,1
1141,Tim Kleindienst,Heidenheim,13.5,6,5,1,3,2,3,11,27.3,8,11,4,7,5,11,20,0
1142,Lukas Klostermann,RB Leipzig,6.7,8,6,5,3,0,4,8,50.0,4,10,4,6,3,11,29,0
1144,Justin Kluivert,Bournemouth,7.5,13,7,2,7,4,3,13,23.1,10,5,0,5,4,17,3,0
1145,Ansgar Knauff,Eint Frankfurt,7.0,14,9,6,7,1,4,11,36.4,7,12,2,10,6,20,6,0
1146,Robin Knoche,Union Berlin,9.6,21,12,16,5,0,12,20,60.0,8,11,7,4,7,28,26,0
1147,Gregor Kobel,Dortmund,13.3,0,0,0,0,0,0,0,0.0,0,0,0,0,0,0,9,0
1148,Robin Koch,Eint Frankfurt,12.0,14,9,10,4,0,9,11,81.8,2,14,11,3,12,26,61,0
1149,Philipp Kohn,Monaco,15.0,1,1,1,0,0,1,1,100.0,0,0,0,0,1,2,4,2
1150,Dominik Kohr,Mainz 05,9.4,27,18,15,10,2,12,23,52.2,11,9,1,8,19,46,22,0
1151,Koke,Atlético Madrid,9.3,20,16,10,9,1,12,27,44.4,15,10,5,5,7,27,8,0
1152,Sead Kolasinac,Atalanta,10.7,17,11,11,6,0,12,21,57.1,9,7,2,5,15,32,20,0
1153,Luca Koleosho,Burnley,10.8,7,4,2,5,0,2,10,20.0,8,13,0,13,2,9,0,0
1154,Randal Kolo Muani,Paris S-G,4.5,4,3,3,1,0,2,4,50.0,2,3,0,3,1,5,6,0
1155,Randal Kolo Muani,Eint Frankfurt,1.7,0,0,0,0,0,0,0,0.0,0,0,0,0,0,0,1,0
1156,Cheick Konate,Clermont Foot,8.7,22,12,16,6,0,18,31,58.1,13,12,2,10,9,31,14,0
1157,Ibrahima Konate,Liverpool,6.8,13,8,9,4,0,7,11,63.6,4,10,6,4,9,22,24,0
1158,Geoffrey Kondogbia,Marseille,6.2,17,10,10,6,1,6,13,46.2,7,11,1,10,14,31,14,0
1159,Amadou Kone,Reims,0.2,1,1,1,0,0,0,0,0.0,0,0,0,0,0,1,2,0
1160,Ibrahima Kone,Almería,2.9,1,0,1,0,0,1,1,100.0,0,1,0,1,0,1,4,0
1161,Ibrahima Kone,Lorient,0.4,0,0,0,0,0,0,1,0.0,1,0,0,0,0,0,0,0
1162,Kouadio Kone,M'Gladbach,4.8,13,7,5,6,2,4,8,50.0,4,4,0,4,2,15,3,1
1163,Ezri Konsa,Aston Villa,15.5,29,18,15,12,2,12,14,85.7,2,20,11,9,17,46,39,1
1164,Teun Koopmeiners,Atalanta,12.9,17,11,6,9,2,9,29,31.0,20,9,2,7,5,22,15,0
1165,Odilon Kossonou,Leverkusen,12.4,18,15,7,7,4,5,10,50.0,5,20,1,19,21,39,27,0
1166,Filip Kostic,Juventus,9.4,20,15,12,5,3,12,21,57.1,9,14,5,9,5,25,20,0
1167,Christian Kouame,Fiorentina,5.1,6,2,3,3,0,2,3,66.7,1,9,0,9,0,6,4,0
1168,Rominigue Kouame,Cádiz,4.0,4,2,3,1,0,2,5,40.0,3,4,2,2,7,11,1,0
1170,Koffi Kouao,Metz,7.5,15,10,8,6,1,8,14,57.1,6,6,3,3,13,28,25,1
1171,Therence Koudou,Reims,0.1,0,0,0,0,0,0,0,0.0,0,0,0,0,0,0,1,0
1172,Jules Kounde,Barcelona,11.4,14,8,10,2,2,10,15,66.7,5,7,4,3,5,19,41,3
1173,Boubakar Kouyate,Montpellier,12.8,26,18,18,6,2,14,32,43.8,18,17,7,10,17,43,62,1
1174,Cheikhou Kouyate,Nott'ham Forest,1.5,5,4,2,2,1,1,2,50.0,1,3,1,2,2,7,10,0
1175,Mateo Kovacic,Manchester City,7.5,17,13,10,5,2,10,14,71.4,4,8,0,8,2,19,6,0
1176,Viktor Kovalenko,Empoli,2.3,3,1,1,1,1,1,2,50.0,1,4,1,3,0,3,4,0
1177,Dawid Kownacki,Werder Bremen,2.3,0,0,0,0,0,0,2,0.0,2,1,1,0,0,0,1,0
1178,Emil Krafth,Newcastle Utd,0.1,0,0,0,0,0,0,0,0.0,0,0,0,0,0,0,0,0
1179,Alex Kral,Union Berlin,7.8,11,7,2,7,2,4,11,36.4,7,8,2,6,2,13,13,0
1180,Andrej Kramaric,Hoffenheim,8.5,2,0,1,0,1,1,3,33.3,2,3,0,3,1,3,4,0
1181,Christoph Kramer,M'Gladbach,1.8,5,3,2,3,0,0,9,0.0,9,5,1,4,3,8,4,0
1182,Frans Kratzig,Bayern Munich,0.6,2,0,2,0,0,1,2,50.0,1,0,0,0,0,2,0,0
1183,Tom Krauss,Mainz 05,7.4,28,17,11,14,3,9,22,40.9,13,18,4,14,9,37,13,0
1184,Thomas Kristensen,Udinese,4.4,6,5,5,1,0,2,5,40.0,3,3,2,1,5,11,18,0
1185,Toni Kroos,Real Madrid,10.8,27,14,10,11,6,19,34,55.9,15,12,2,10,10,37,4,1
1186,Nikola Krstovic,Lecce,10.5,7,2,3,4,0,3,4,75.0,1,4,2,2,1,8,10,0
1187,Rade Krunic,Milan,7.6,10,8,3,6,1,4,9,44.4,5,7,3,4,11,21,14,0
1188,Lukas Kubler,Freiburg,8.4,19,9,14,4,1,10,16,62.5,6,14,8,6,12,31,17,0
1189,Takefusa Kubo,Real Sociedad,12.7,13,9,6,4,3,5,12,41.7,7,11,1,10,7,20,3,1
1190,Dejan Kulusevski,Tottenham,15.6,25,13,10,10,5,6,31,19.4,25,12,1,11,9,34,1,0
1191,Sael Kumbedi,Lyon,9.6,27,18,14,10,3,9,22,40.9,13,11,2,9,13,40,17,1
1192,Layvin Kurzawa,Paris S-G,0.1,0,0,0,0,0,0,0,0.0,0,0,0,0,0,0,0,0
1193,Berkan Kutlu,Genoa,2.2,6,4,5,1,0,3,6,50.0,3,3,0,3,4,10,5,0
1194,Daler Kuzyaev,Le Havre,13.7,24,12,8,11,5,12,31,38.7,19,10,3,7,13,37,9,0
1196,Khvicha Kvaratskhelia,Napoli,11.4,12,7,3,6,3,6,23,26.1,17,5,1,4,10,22,7,0
1197,Giorgi Kvernadze,Frosinone,0.4,1,0,0,0,1,1,1,100.0,0,1,0,1,1,2,0,0
1198,Moritz-Broni Kwarteng,Bochum,1.8,1,0,0,1,0,0,3,0.0,3,0,0,0,1,2,0,0
1199,Grejohn Kyei,Clermont Foot,5.6,5,3,1,2,2,2,3,66.7,1,0,0,0,0,5,4,0
1200,Giorgos Kyriakopoulos,Monza,10.9,10,6,7,3,0,3,11,27.3,8,6,0,6,7,17,15,0
1201,Luca de la Torre,Celta Vigo,11.6,19,8,5,11,3,9,18,50.0,9,12,3,9,5,24,10,0
1202,Gaetan Laborde,Nice,11.4,10,9,6,2,2,7,17,41.2,10,11,1,10,4,14,3,1
1203,Alexandre Lacazette,Lyon,10.7,10,6,4,4,2,2,6,33.3,4,8,2,6,1,11,5,0
1204,Maxence Lacroix,Wolfsburg,13.0,23,13,15,8,0,15,21,71.4,6,20,8,12,16,39,67,0
1205,Alban Lafont,Nantes,9.7,0,0,0,0,0,0,1,0.0,1,0,0,0,0,0,1,0
1206,Aissa Laidouni,Union Berlin,7.7,15,8,4,8,3,3,7,42.9,4,16,2,14,10,25,5,0
1207,Konrad Laimer,Bayern Munich,9.3,21,13,9,7,5,10,19,52.6,9,21,4,17,11,32,8,1
1208,Kenny Lala,Brest,15.0,43,26,16,18,9,15,32,46.9,17,6,2,4,18,61,33,1
1209,Adam Lallana,Brighton,4.5,4,1,2,2,0,0,3,0.0,3,0,0,0,2,6,1,0
1210,Mathis Lambourde,Rennes,0.1,0,0,0,0,0,0,1,0.0,1,1,0,1,0,0,1,0
1211,Erik Lamela,Sevilla,3.8,14,8,2,7,5,6,10,60.0,4,9,0,9,0,14,4,0
1212,Mohamed Lamine Bayo,Le Havre,8.1,6,2,1,2,3,0,6,0.0,6,4,1,3,1,7,7,0
1213,Tariq Lamptey,Brighton,1.9,3,3,1,2,0,0,4,0.0,4,0,0,0,2,5,0,0
1214,Gianluca Lapadula,Cagliari,2.0,1,1,0,0,1,1,2,50.0,1,0,0,0,1,2,0,0
1215,Aymeric Laporte,Manchester City,0.1,0,0,0,0,0,0,0,0.0,0,1,1,0,0,0,1,0
1216,Julien Laporte,Lorient,10.0,10,7,9,1,0,9,20,45.0,11,15,12,3,7,17,53,1
1217,Cyle Larin,Mallorca,7.1,6,2,2,0,4,1,1,100.0,0,6,1,5,1,7,6,0
1218,Yasser Larouci,Sheffield Utd,2.5,4,1,2,1,1,2,3,66.7,1,4,1,3,5,9,10,0
1219,Hugo Larsson,Eint Frankfurt,11.7,16,8,10,4,2,6,12,50.0,6,12,2,10,15,31,11,1
1220,Jamaal Lascelles,Newcastle Utd,10.1,13,8,6,7,0,5,9,55.6,4,16,11,5,3,16,35,0
1222,Juanmi Latasa,Getafe,9.0,2,2,0,1,1,0,6,0.0,6,2,0,2,2,4,14,0
1223,Toni Lato,Mallorca,6.8,17,11,9,7,1,6,9,66.7,3,9,1,8,7,24,8,0
1224,Armand Lauriente,Sassuolo,12.3,7,4,2,4,1,5,16,31.3,11,11,2,9,6,13,3,0
1225,Lazaro,Almería,2.3,2,1,1,0,1,1,4,25.0,3,1,0,1,0,2,1,0
1226,Valentino Lazaro,Torino,9.3,9,6,1,7,1,5,7,71.4,2,4,0,4,4,13,16,0
1227,Darko Lazovic,Hellas Verona,6.8,9,5,4,0,5,4,6,66.7,2,3,1,2,1,10,5,0
1228,Manuel Lazzari,Lazio,9.3,14,10,8,5,1,13,17,76.5,4,14,4,10,10,24,18,1
1229,Theo Le Bris,Lorient,7.1,16,8,13,2,1,7,16,43.8,9,9,2,7,3,19,8,0
1230,Julien Le Cardinal,Brest,2.0,4,4,2,1,1,1,2,50.0,1,2,2,0,7,11,10,0
1231,Julien Le Cardinal,Lens,0.6,6,2,4,2,0,4,9,44.4,5,2,1,1,0,6,0,0
1232,Jeremy Le Douaron,Brest,11.2,13,8,5,3,5,7,18,38.9,11,6,1,5,2,15,6,0
1233,Enzo Le Fee,Rennes,9.5,26,18,11,11,4,16,27,59.3,11,7,0,7,12,38,9,0
1234,Vincent Le Goff,Lorient,6.0,5,0,4,0,1,4,8,50.0,4,11,3,8,3,8,10,0
1235,Robin Le Normand,Real Sociedad,11.6,14,13,6,8,0,7,16,43.8,9,11,6,5,14,28,34,1
1236,Nicola Leali,Genoa,1.0,0,0,0,0,0,0,0,0.0,0,0,0,0,0,0,0,0
1237,Rafael Leao,Milan,9.2,6,5,1,3,2,1,3,33.3,2,7,0,7,3,9,3,0
1238,Adrien Lebeau,Brest,0.3,0,0,0,0,0,0,1,0.0,1,0,0,0,0,0,1,0
1239,Benjamin Lecomte,Montpellier,15.0,0,0,0,0,0,0,0,0.0,0,0,0,0,0,0,9,1
1240,Jeremias Ledesma,Cádiz,13.9,0,0,0,0,0,0,1,0.0,1,0,0,0,0,0,7,1
1241,Pierre Lees-Melou,Brest,14.0,45,31,24,20,1,19,59,32.2,40,31,7,24,21,66,37,3
1242,Diogo Leite,Union Berlin,12.6,20,16,10,7,3,13,26,50.0,13,20,8,12,20,40,58,0
1243,Maxim Leitsch,Mainz 05,4.1,5,2,4,1,0,2,5,40.0,3,2,0,2,4,9,12,0
1244,Florian Lejeune,Rayo Vallecano,16.0,15,8,9,5,1,6,11,54.5,5,18,9,9,8,23,64,0
1245,Inigo Lekue,Athletic Club,8.9,20,8,12,5,3,14,25,56.0,11,4,1,3,4,24,19,0
1246,Thomas Lemar,Atlético Madrid,1.8,3,1,2,1,0,1,2,50.0,1,0,0,0,0,3,0,0
1248,Mario Lemina,Wolves,13.5,31,23,18,11,2,6,17,35.3,11,9,4,5,21,52,25,0
1249,Alvaro Lemos,Las Palmas,2.2,4,1,1,3,0,0,1,0.0,1,3,1,2,2,6,4,0
1250,Bernd Leno,Fulham,16.0,0,0,0,0,0,0,0,0.0,0,0,0,0,0,0,7,0
1251,Christopher Lenz,RB Leipzig,0.4,1,1,1,0,0,1,1,100.0,0,0,0,0,1,2,2,0
1252,Christopher Lenz,Eint Frankfurt,0.1,1,1,0,1,0,1,1,100.0,0,0,0,0,0,1,1,0
1253,Johann Lepenant,Lyon,2.8,4,3,2,2,0,1,8,12.5,7,5,0,5,4,8,0,0
1254,Jefferson Lerma,Crystal Palace,11.5,14,9,5,9,0,4,15,26.7,11,8,2,6,17,31,22,0
1255,Leo Leroy,Montpellier,1.7,9,2,3,4,2,2,5,40.0,3,2,0,2,0,9,4,0
1256,Robert Lewandowski,Barcelona,12.3,3,2,0,2,1,2,6,33.3,4,4,1,3,2,5,7,0
1257,Jamie Leweling,Stuttgart,4.9,7,4,3,2,2,2,5,40.0,3,7,0,7,1,8,5,0
1258,Rico Lewis,Manchester City,2.8,3,1,2,1,0,0,1,0.0,1,2,0,2,3,6,1,0
1259,Keane Lewis-Potter,Brentford,3.8,2,0,1,1,0,1,2,50.0,1,1,1,0,2,4,3,0
1260,Philipp Lienhart,Freiburg,13.7,18,12,12,5,1,11,20,55.0,9,17,10,7,13,31,50,0
1261,Matthijs de Ligt,Bayern Munich,2.8,3,3,0,2,1,2,2,100.0,0,2,1,1,3,6,13,0
1262,Victor Lindelof,Manchester Utd,10.0,11,6,4,7,0,4,9,44.4,5,13,8,5,8,19,23,1
1263,Jesper Lindstrom,Napoli,2.0,6,2,2,1,3,4,7,57.1,3,1,0,1,2,8,1,0
1264,Jesper Lindstrom,Eint Frankfurt,0.9,1,1,1,0,0,0,0,0.0,0,0,0,0,0,1,0,0
1265,Karol Linetty,Torino,7.1,13,11,4,9,0,4,11,36.4,7,12,5,7,9,22,11,0
1266,Samuel Lino,Atlético Madrid,6.6,22,13,17,1,4,16,22,72.7,6,10,0,10,3,25,12,0
1267,Pol Lirola,Frosinone,2.8,4,1,3,1,0,2,5,40.0,3,2,0,2,5,9,4,0
1268,Valentino Livramento,Newcastle Utd,5.4,11,5,9,2,0,6,11,54.5,5,6,4,2,7,18,11,0
1269,Dejan Ljubicic,Köln,11.3,24,14,11,10,3,12,22,54.5,10,13,2,11,10,34,4,0
1270,Javier Llabres,Mallorca,1.3,2,0,1,1,0,1,1,100.0,0,1,0,1,1,3,1,0
1271,Diego Llorente,Roma,11.0,20,13,14,6,0,8,14,57.1,6,15,9,6,8,28,36,0
1272,Marcos Llorente,Atlético Madrid,10.8,14,10,8,5,1,5,16,31.3,11,11,3,8,6,20,14,0
1274,Gautier Lloris,Le Havre,13.9,21,10,18,3,0,13,24,54.2,11,28,18,10,18,39,64,1
1275,Abou Lo,Metz,0.8,1,0,1,0,0,1,2,50.0,1,1,1,0,0,1,2,0
1276,Giovani Lo Celso,Tottenham,3.2,8,5,1,4,3,2,5,40.0,3,3,1,2,2,10,0,0
1277,Stanislav Lobotka,Napoli,14.1,28,18,7,16,5,11,31,35.5,20,10,2,8,6,34,10,0
1278,Manuel Locatelli,Juventus,13.2,25,12,7,15,3,13,28,46.4,15,15,4,11,7,32,36,0
1279,Bradley Locko,Brest,15.0,48,28,26,18,4,24,38,63.2,14,13,0,13,18,66,28,0
1280,Tom Lockyer,Luton Town,13.0,25,16,17,6,2,15,22,68.2,7,23,13,10,23,48,68,0
1281,Renan Lodi,Marseille,12.7,20,14,7,11,2,11,19,57.9,8,7,2,5,13,33,34,0
1282,Ruben Loftus-Cheek,Milan,7.0,5,4,2,1,2,2,7,28.6,5,12,7,5,3,8,5,0
1283,Andy Logbo,Le Havre,2.8,0,0,0,0,0,0,3,0.0,3,7,3,4,0,0,2,0
1284,Enzo Loiodice,Las Palmas,10.9,30,17,8,15,7,9,23,39.1,14,8,0,8,8,38,11,1
1285,Sean Longstaff,Newcastle Utd,9.3,15,9,3,9,3,9,24,37.5,15,15,4,11,4,19,8,0
1286,Ademola Lookman,Atalanta,9.6,2,2,0,1,1,1,6,16.7,5,9,0,9,2,4,0,0
1287,Noah Loosli,Bochum,1.3,4,3,2,2,0,4,5,80.0,1,2,0,2,2,6,10,0
1288,Anthony Lopes,Lyon,12.0,0,0,0,0,0,0,0,0.0,0,0,0,0,0,0,5,0
1289,David Lopez,Girona,12.0,23,16,13,10,0,9,12,75.0,3,16,12,4,13,36,34,1
1290,Diego Lopez,Valencia,13.1,20,13,5,9,6,6,22,27.3,16,9,0,9,9,29,0,0
1291,Fermin Lopez,Barcelona,4.9,11,5,2,7,2,4,14,28.6,10,6,0,6,2,13,2,0
1292,Javi Lopez,Alavés,8.7,7,4,1,5,1,6,9,66.7,3,5,1,4,3,10,29,0
1293,Maxime Lopez,Fiorentina,2.1,4,3,1,1,2,2,4,50.0,2,1,0,1,2,6,2,0
1294,Maxime Lopez,Sassuolo,1.6,2,1,1,1,0,1,2,50.0,1,1,1,0,2,4,0,0
1295,Pau Lopez,Marseille,14.7,0,0,0,0,0,0,0,0.0,0,0,0,0,0,0,4,1
1296,Unai Lopez,Rayo Vallecano,9.5,16,9,5,7,4,7,23,30.4,16,14,1,13,6,22,6,1
1297,Dion Lopy,Almería,10.6,33,22,21,11,1,8,22,36.4,14,11,2,9,6,39,10,0
1298,Anthony Losilla,Bochum,11.6,29,14,6,21,2,13,21,61.9,8,18,4,14,15,44,19,0
1300,Jordan Lotomba,Nice,6.4,10,8,8,1,1,8,11,72.7,3,8,2,6,5,15,8,0
1301,Tom Louchet,Nice,0.2,1,0,1,0,0,1,2,50.0,1,0,0,0,0,1,3,0
1302,Matteo Lovato,Salernitana,8.5,19,10,13,4,2,13,19,68.4,6,12,6,6,13,32,31,1
1303,Dejan Lovren,Lyon,5.1,6,5,5,1,0,1,3,33.3,2,4,4,0,7,13,21,0
1304,Sandi Lovric,Udinese,7.4,9,3,3,2,4,4,6,66.7,2,8,0,8,3,12,9,0
1305,Max Lowe,Sheffield Utd,1.6,10,6,7,2,1,2,5,40.0,3,2,2,0,1,11,5,0
1306,Anthony Lozano,Getafe,1.0,0,0,0,0,0,0,1,0.0,1,0,0,0,0,0,1,0
1307,Lucas,Cádiz,5.5,16,9,11,3,2,11,19,57.9,8,11,1,10,2,18,12,0
1308,Lorenzo Lucca,Udinese,9.1,5,2,2,2,1,3,9,33.3,6,7,0,7,2,7,12,0
1309,Jhon Lucumi,Bologna,6.3,18,10,12,6,0,12,14,85.7,2,8,3,5,1,19,23,0
1310,Jose Luis Gaya,Valencia,10.4,43,23,27,13,3,25,38,65.8,13,6,1,5,4,47,21,0
1311,Jose Luis Morales,Villarreal,6.1,4,3,1,3,0,2,6,33.3,4,4,0,4,2,6,2,0
1312,Jose Luis Palomino,Atalanta,0.0,1,0,0,1,0,0,0,0.0,0,0,0,0,0,1,2,0
1313,Douglas Luiz,Aston Villa,15.4,36,24,14,15,7,16,30,53.3,14,18,5,13,10,46,13,0
1314,Romelu Lukaku,Roma,12.1,2,1,0,1,1,1,3,33.3,2,4,0,4,0,2,7,0
1315,Castello Lukeba,RB Leipzig,10.4,10,6,5,5,0,6,7,85.7,1,19,6,13,4,14,39,0
1316,Dodi Lukebakio,Sevilla,8.2,4,2,2,1,1,1,5,20.0,4,7,2,5,2,6,1,0
1317,Sasa Lukic,Fulham,4.1,8,5,1,5,2,3,9,33.3,6,5,2,3,4,12,5,1
1318,Karlo Lulic,Frosinone,0.2,0,0,0,0,0,0,0,0.0,0,1,0,1,1,1,0,0
1319,Andriy Lunin,Real Madrid,6.0,0,0,0,0,0,0,0,0.0,0,0,0,0,0,0,1,0
1320,Sebastiano Luperto,Empoli,15.0,18,12,11,6,1,11,15,73.3,4,23,19,4,10,28,59,1
1321,Charalambos Lykogiannis,Bologna,6.3,7,4,4,2,1,5,9,55.6,4,10,5,5,5,12,21,0
1322,Senne Lynen,Werder Bremen,4.6,10,6,3,6,1,4,14,28.6,10,14,1,13,12,22,9,0
1323,Ian Maatsen,Chelsea,1.5,3,2,1,1,1,0,3,0.0,3,2,0,2,3,6,4,0
1324,Alexis Mac Allister,Liverpool,12.0,31,18,12,15,4,20,45,44.4,25,29,4,25,17,48,8,0
1326,Deiver Machado,Lens,7.0,8,5,2,5,1,6,10,60.0,4,9,1,8,4,12,5,0
1327,Darwin Machis,Cádiz,7.4,17,11,5,8,4,10,18,55.6,8,6,1,5,3,20,2,0
1328,James Maddison,Tottenham,9.8,15,6,1,9,5,8,15,53.3,7,6,0,6,5,20,4,1
1329,Noni Madueke,Chelsea,1.4,0,0,0,0,0,0,1,0.0,1,0,0,0,0,0,1,0
1330,Pablo Maffeo,Mallorca,8.6,19,11,9,7,3,14,25,56.0,11,5,1,4,6,25,15,0
1331,Soungoutou Magassa,Monaco,10.4,40,19,18,22,0,17,29,58.6,12,13,2,11,17,57,29,1
1332,Giulio Maggiore,Salernitana,6.8,13,5,8,4,1,6,11,54.5,5,7,1,6,9,22,15,0
1333,Matej Maglica,Darmstadt 98,8.0,16,9,11,5,0,11,17,64.7,6,15,5,10,12,28,41,1
1334,Giangiacomo Magnani,Hellas Verona,12.0,13,7,8,5,0,7,13,53.8,6,17,9,8,20,33,46,0
1335,Hugo Magnetti,Brest,11.3,23,15,8,14,1,9,25,36.0,16,7,1,6,7,30,6,0
1336,Yohann Magnin,Clermont Foot,7.9,15,8,4,10,1,4,13,30.8,9,15,4,11,7,22,10,0
1337,Frank Magri,Toulouse,9.4,8,4,1,5,2,4,8,50.0,4,4,1,3,1,9,7,0
1338,Harry Maguire,Manchester Utd,9.3,10,6,7,3,0,6,11,54.5,5,19,13,6,13,23,38,0
1339,Arne Maier,Augsburg,0.6,2,2,0,1,1,1,1,100.0,0,1,0,1,0,2,0,0
1340,Habib Maiga,Metz,1.0,2,2,1,0,1,1,2,50.0,1,1,0,1,4,6,2,0
1341,Mike Maignan,Milan,12.0,1,0,1,0,0,1,1,100.0,0,1,0,1,0,1,0,2
1342,Linton Maina,Köln,9.7,9,8,6,1,2,5,15,33.3,10,6,1,5,3,12,2,0
1343,Patrick Mainka,Heidenheim,14.0,29,15,20,8,1,13,29,44.8,16,27,11,16,20,49,57,0
1344,Kobbie Mainoo,Manchester Utd,1.7,1,1,0,1,0,0,0,0.0,0,1,1,0,2,3,7,0
1345,Ainsley Maitland-Niles,Lyon,3.0,8,3,1,5,2,5,9,55.6,4,4,0,4,4,12,6,0
1346,Lovro Majer,Rennes,0.2,0,0,0,0,0,0,0,0.0,0,0,0,0,0,0,1,0
1347,Lovro Majer,Wolfsburg,10.9,12,8,5,7,0,4,13,30.8,9,9,1,8,3,15,5,0
1348,Jean-Victor Makengo,Lorient,5.2,3,2,2,1,0,1,5,20.0,4,12,1,11,8,11,5,0
1349,Jordy Makengo,Freiburg,2.6,4,2,2,1,1,2,4,50.0,2,5,0,5,5,9,13,0
1350,Antoine Makoumbou,Cagliari,13.2,19,12,5,10,4,4,9,44.4,5,15,3,12,9,28,11,0
1352,Nemanja Maksimovic,Getafe,15.9,28,17,13,11,4,10,18,55.6,8,20,12,8,28,56,33,0
1353,Daniel Maldini,Empoli,1.2,0,0,0,0,0,0,0,0.0,0,3,0,3,2,2,1,0
1354,Youssef Maleh,Empoli,11.2,32,24,10,16,6,9,22,40.9,13,26,5,21,11,43,6,0
1355,Donyell Malen,Dortmund,8.6,4,4,2,0,2,0,2,0.0,2,5,1,4,2,6,2,0
1356,Ruslan Malinovskyi,Genoa,7.3,14,8,9,3,2,8,19,42.1,11,7,2,5,0,14,4,0
1357,Lennard Maloney,Heidenheim,13.0,19,12,9,7,3,12,30,40.0,18,14,2,12,17,36,52,0
1358,Aaron Malouda,Lille,0.0,0,0,0,0,0,0,0,0.0,0,0,0,0,0,0,0,0
1359,Giorgi Mamardashvili,Valencia,16.0,2,2,2,0,0,2,2,100.0,0,0,0,0,0,2,10,1
1360,Wilson Manafa,Granada,2.7,6,4,3,2,1,4,7,57.1,3,1,0,1,1,7,4,1
1361,Hianga Mananga Mbock,Brest,0.1,1,0,0,0,1,1,2,50.0,1,0,0,0,1,2,0,0
1362,Gianluca Mancini,Roma,14.0,16,9,10,5,1,4,13,30.8,9,11,9,2,15,31,30,0
1363,Marco Mancosu,Cagliari,1.7,2,0,0,2,0,0,1,0.0,1,0,0,0,0,2,0,0
1364,Steve Mandanda,Rennes,15.0,0,0,0,0,0,0,1,0.0,1,0,0,0,0,0,3,0
1365,Aissa Mandi,Villarreal,5.2,8,4,6,2,0,6,10,60.0,4,3,2,1,3,11,16,0
1366,Rolando Mandragora,Fiorentina,5.7,6,3,2,3,1,2,7,28.6,5,6,1,5,2,8,4,0
1367,Orel Mangala,Nott'ham Forest,14.1,21,9,13,7,1,12,24,50.0,12,10,5,5,22,43,23,0
1368,Braydon Manu,Darmstadt 98,0.9,1,0,0,1,0,0,0,0.0,0,1,0,1,0,1,0,0
1369,Benson Manuel,Burnley,0.7,2,2,1,1,0,0,0,0.0,0,0,0,0,0,2,0,0
1370,Faitout Maouassa,Lens,0.3,1,1,1,0,0,1,1,100.0,0,0,0,0,0,1,0,0
1371,Solly March,Brighton,6.2,19,14,9,7,3,8,14,57.1,6,5,0,5,11,30,8,0
1372,Riccardo Marchizza,Frosinone,12.8,7,6,4,3,0,3,13,23.1,10,10,2,8,7,14,33,0
1373,Gian Marco Ferrari,Sassuolo,5.7,7,3,4,3,0,4,5,80.0,1,6,3,3,7,14,12,0
1374,Oscar de Marcos,Athletic Club,12.9,28,20,16,9,3,21,37,56.8,16,16,4,12,7,35,13,0
1375,Jose Mari,Cádiz,0.2,2,1,0,2,0,1,2,50.0,1,0,0,0,0,2,0,0
1376,Pablo Mari,Monza,10.0,20,12,16,4,0,10,14,71.4,4,12,7,5,11,31,37,1
1378,Jose Maria Gimenez,Atlético Madrid,4.8,5,2,1,4,0,2,2,100.0,0,4,4,0,3,8,27,0
1379,Mariano,Sevilla,1.9,1,1,0,1,0,0,0,0.0,0,1,0,1,0,1,2,0
1380,Mirko Maric,Monza,2.3,3,0,2,0,1,0,0,0.0,0,4,0,4,2,5,3,0
1381,Rafa Marin,Alavés,9.1,8,6,5,3,0,2,6,33.3,4,10,5,5,11,19,35,0
1382,Razvan Marin,Empoli,8.2,17,7,5,8,4,10,16,62.5,6,7,0,7,1,18,16,0
1383,Diego Marino,Almería,1.0,0,0,0,0,0,0,0,0.0,0,0,0,0,0,0,1,0
1384,Guillermo Maripan,Monaco,9.0,10,4,6,4,0,6,10,60.0,4,12,7,5,14,24,53,2
1385,Mika Marmol,Las Palmas,13.5,30,20,17,13,0,13,17,76.5,4,16,7,9,15,45,56,1
1386,Omar Marmoush,Eint Frankfurt,11.0,10,4,5,3,2,5,8,62.5,3,3,0,3,6,16,6,0
1387,Marquinhos,Nantes,1.3,2,2,2,0,0,1,2,50.0,1,6,2,4,4,6,1,0
1388,Marquinhos,Paris S-G,9.5,9,6,3,5,1,5,8,62.5,3,15,9,6,11,20,36,0
1389,Agustin Martegani,Salernitana,4.4,4,2,1,1,2,3,9,33.3,6,1,0,1,3,7,2,1
1390,Eric Martel,Köln,10.6,24,13,12,11,1,14,25,56.0,11,23,6,17,15,39,31,0
1391,Roger Marti,Cádiz,11.3,9,5,1,8,0,1,4,25.0,3,13,1,12,6,15,3,0
1392,Anthony Martial,Manchester Utd,5.0,4,1,1,1,2,1,1,100.0,0,4,0,4,0,4,3,0
1393,Aaron Martin,Genoa,3.9,4,2,1,3,0,2,5,40.0,3,4,1,3,4,8,3,0
1394,Ivan Martin,Girona,12.5,23,14,10,10,3,14,32,43.8,18,10,1,9,5,28,7,0
1395,Jonas Martin,Brest,5.0,17,11,6,10,1,10,15,66.7,5,3,0,3,1,18,5,0
1396,Gabriel Martinelli,Arsenal,11.2,8,6,2,4,2,2,6,33.3,4,9,0,9,3,11,2,0
1397,Arnau Martinez,Girona,7.8,17,12,10,6,1,8,17,47.1,9,8,3,5,5,22,22,1
1398,Emiliano Martinez,Aston Villa,15.0,0,0,0,0,0,0,0,0.0,0,0,0,0,0,0,5,1
1399,Inigo Martinez,Barcelona,6.0,6,4,6,0,0,3,3,100.0,0,10,9,1,6,12,24,0
1400,Josep Martinez,Genoa,14.0,0,0,0,0,0,0,0,0.0,0,0,0,0,0,0,8,1
1401,Lautaro Martinez,Inter,13.9,13,8,3,8,2,3,10,30.0,7,13,1,12,13,26,5,0
1402,Lisandro Martinez,Manchester Utd,4.2,7,6,6,1,0,4,11,36.4,7,4,2,2,2,9,11,0
1404,Lucas Martinez Quarta,Fiorentina,12.3,38,23,23,13,2,18,25,72.0,7,17,6,11,17,55,32,1
1405,Adam Marusic,Lazio,13.5,20,14,11,9,0,11,21,52.4,10,11,4,7,15,35,19,1
1406,Marvin,Las Palmas,5.9,13,7,5,7,1,6,10,60.0,4,7,2,5,5,18,3,0
1407,Omar Mascarell,Mallorca,6.5,12,6,7,5,0,6,13,46.2,7,9,2,7,12,24,15,0
1408,Erhan Masovic,Bochum,11.7,36,22,23,11,2,22,38,57.9,16,17,8,9,6,42,29,1
1409,Roberto Massimo,Stuttgart,0.7,1,0,1,0,0,1,2,50.0,1,0,0,0,0,1,1,0
1410,Clinton Mata,Lyon,9.7,13,10,8,3,2,6,11,54.5,5,9,5,4,18,31,14,0
1411,Jaime Mata,Getafe,6.3,10,8,7,1,2,6,12,50.0,6,8,0,8,4,14,9,0
1412,Pape Matar Sarr,Tottenham,10.1,20,16,7,9,4,10,19,52.6,9,10,4,6,9,29,12,0
1413,Eliot Matazo,Monaco,1.1,3,1,0,3,0,2,4,50.0,2,1,1,0,3,6,0,0
1414,Jean-Philippe Mateta,Crystal Palace,5.0,5,3,3,2,0,1,1,100.0,0,2,0,2,1,6,3,0
1415,Nemanja Matic,Rennes,11.0,18,10,7,9,2,8,11,72.7,3,14,7,7,26,44,19,0
1416,Joel Matip,Liverpool,8.7,12,6,7,4,1,8,12,66.7,4,16,12,4,9,21,43,0
1417,Alex Matos,Chelsea,0.0,0,0,0,0,0,0,0,0.0,0,0,0,0,0,0,0,0
1418,Chrislain Matsima,Monaco,3.3,9,7,5,3,1,2,7,28.6,5,4,1,3,4,13,4,0
1419,Remi Matthews,Crystal Palace,0.0,0,0,0,0,0,0,0,0.0,0,0,0,0,0,0,1,0
1420,Alan Matturro,Genoa,0.9,1,1,1,0,0,1,1,100.0,0,3,1,2,2,3,3,0
1421,Azor Matusiwa,Reims,12.5,30,19,16,13,1,17,26,65.4,9,17,3,14,26,56,26,1
1422,Neal Maupay,Brentford,6.2,5,4,1,3,1,2,5,40.0,3,6,0,6,1,6,3,0
1423,Neal Maupay,Everton,1.2,0,0,0,0,0,0,1,0.0,1,2,0,2,0,0,1,0
1424,Aiman Maurer,Clermont Foot,0.4,1,1,1,0,0,1,1,100.0,0,0,0,0,0,1,0,0
1425,Konstantinos Mavropanos,West Ham,2.5,4,2,3,1,0,2,2,100.0,0,3,1,2,3,7,13,1
1426,Christian Mawissa,Toulouse,0.2,0,0,0,0,0,0,0,0.0,0,0,0,0,0,0,1,0
1427,Philipp Max,Eint Frankfurt,8.5,15,9,4,9,2,13,19,68.4,6,11,1,10,3,18,9,0
1428,Eric Maxim Choupo-Moting,Bayern Munich,3.6,8,6,3,4,1,2,3,66.7,1,1,0,1,2,10,3,0
1430,Luis Maximiano,Almería,13.0,0,0,0,0,0,0,1,0.0,1,0,0,0,0,0,8,1
1431,Borja Mayoral,Getafe,13.9,4,2,2,1,1,2,10,20.0,8,3,0,3,2,6,10,0
1432,Youssef Maziz,Metz,1.4,0,0,0,0,0,0,2,0.0,2,1,0,1,1,1,2,0
1433,Noussair Mazraoui,Bayern Munich,9.1,12,8,5,5,2,5,10,50.0,5,9,1,8,13,25,16,1
1434,Luca Mazzitelli,Frosinone,10.1,17,12,5,8,4,10,23,43.5,13,12,1,11,5,22,24,0
1435,Pasquale Mazzocchi,Salernitana,11.3,20,16,12,7,1,12,24,50.0,12,10,5,5,3,23,19,0
1436,Kevin Mbabu,Augsburg,6.3,15,12,9,3,3,6,8,75.0,2,7,3,4,9,24,11,0
1437,Noah Mbamba,Leverkusen,0.2,0,0,0,0,0,0,0,0.0,0,0,0,0,1,1,0,0
1438,Kylian Mbappe,Paris S-G,12.8,2,1,0,1,1,2,4,50.0,2,2,0,2,1,3,0,0
1439,Malick Mbaye,Metz,1.6,5,1,0,1,4,1,2,50.0,1,1,0,1,0,5,2,0
1440,Mamadou Mbaye,Cádiz,3.2,6,3,3,3,0,2,5,40.0,3,10,7,3,5,11,26,0
1441,Chancel Mbemba,Marseille,14.0,20,14,17,2,1,12,15,80.0,3,13,9,4,10,30,60,0
1442,Nolan Mbemba,Le Havre,0.2,0,0,0,0,0,0,1,0.0,1,0,0,0,0,0,0,0
1443,Bryan Mbeumo,Brentford,14.3,12,8,6,4,2,4,13,30.8,9,14,0,14,5,17,9,0
1444,Jordi Mboula,Hellas Verona,2.1,2,2,0,2,0,2,3,66.7,1,1,1,0,1,3,0,0
1445,Nathanael Mbuku,Augsburg,0.1,0,0,0,0,0,0,0,0.0,0,1,0,1,0,0,0,0
1446,James Mcatee,Sheffield Utd,9.0,20,13,4,8,8,9,17,52.9,8,14,0,14,3,23,3,0
1447,James Mcatee,Manchester City,0.0,0,0,0,0,0,0,0,0.0,0,1,0,1,0,0,0,0
1448,Oliver McBurnie,Sheffield Utd,5.8,9,2,1,4,4,1,4,25.0,3,9,1,8,2,11,12,0
1449,James McConnell,Liverpool,0.0,0,0,0,0,0,0,0,0.0,0,1,0,1,1,1,0,0
1450,John McGinn,Aston Villa,15.0,25,13,5,17,3,11,33,33.3,22,11,0,11,11,36,5,0
1451,Scott McKenna,Nott'ham Forest,4.6,4,0,3,1,0,2,3,66.7,1,6,4,2,5,9,27,0
1452,Weston McKennie,Juventus,12.8,28,17,18,7,3,13,18,72.2,5,13,4,9,13,41,34,0
1453,Dwight McNeil,Everton,11.4,22,10,10,7,5,11,24,45.8,13,24,2,22,8,30,16,0
1454,Scott McTominay,Manchester Utd,9.8,20,10,10,9,1,8,15,53.3,7,13,5,8,8,28,13,0
1456,Facundo Medina,Lens,13.2,33,21,10,20,3,23,34,67.6,11,23,7,16,12,45,24,0
1457,Ben Mee,Brentford,6.7,11,9,4,5,2,5,8,62.5,3,7,4,3,7,18,25,1
1458,Marvin Mehlem,Darmstadt 98,10.8,18,13,6,8,4,8,20,40.0,12,16,2,14,24,42,13,0
1459,Bamo Meite,Marseille,1.0,0,0,0,0,0,0,1,0.0,1,1,0,1,1,1,1,0
1460,Bamo Meite,Lorient,1.6,2,1,2,0,0,0,1,0.0,1,3,2,1,3,5,9,0
1461,Hannibal Mejbri,Manchester Utd,1.4,3,3,1,2,0,1,3,33.3,2,1,1,0,0,3,0,0
1462,Oscar Melendo,Granada,8.4,12,5,4,8,0,3,10,30.0,7,10,0,10,3,15,2,1
1463,Gonzalo Melero,Almería,7.6,8,5,4,4,0,3,8,37.5,5,6,1,5,1,9,5,0
1464,Birger Meling,Rennes,0.2,1,1,1,0,0,1,1,100.0,0,1,0,1,0,1,0,0
1465,Arthur Melo,Fiorentina,11.7,30,19,11,15,4,16,25,64.0,9,17,2,15,7,37,5,0
1466,Memphis,Atlético Madrid,2.3,3,1,0,1,2,2,2,100.0,0,0,0,0,0,3,0,0
1467,Houboulang Mendes,Almería,4.1,15,12,10,5,0,7,14,50.0,7,3,1,2,1,16,15,1
1468,Tomas Mendes,Alavés,0.1,0,0,0,0,0,0,0,0.0,0,0,0,0,0,0,0,0
1469,Brais Mendez,Real Sociedad,13.4,21,14,8,9,4,9,26,34.6,17,11,2,9,5,26,6,0
1470,Diego Mendez,Rayo Vallecano,0.1,1,1,1,0,0,1,1,100.0,0,0,0,0,1,2,0,0
1471,Antoine Mendy,Nice,0.1,1,0,1,0,0,1,2,50.0,1,1,0,1,0,1,1,0
1472,Benjamin Mendy,Lorient,2.4,1,0,1,0,0,0,1,0.0,1,3,1,2,3,4,5,0
1473,Ferland Mendy,Real Madrid,7.5,3,2,1,1,1,2,5,40.0,3,6,2,4,8,11,14,0
1474,Formose Mendy,Lorient,7.5,16,9,13,3,0,13,22,59.1,9,12,4,8,14,30,36,0
1475,Nampalys Mendy,Lens,2.7,8,3,4,2,2,4,5,80.0,1,5,2,3,4,12,3,0
1476,Teden Mengi,Luton Town,9.6,17,7,12,4,1,5,10,50.0,5,14,8,6,19,36,47,0
1477,Chris Mepham,Bournemouth,2.0,2,2,1,1,0,1,2,50.0,1,3,2,1,3,5,8,1
1478,Jorge Mere,Cádiz,3.6,3,3,2,1,0,1,3,33.3,2,4,3,1,4,7,22,0
1479,Alex Meret,Napoli,13.0,0,0,0,0,0,0,0,0.0,0,0,0,0,0,0,4,0
1480,Mikel Merino,Real Sociedad,11.2,24,15,7,11,6,7,18,38.9,11,11,4,7,7,31,23,2
1482,Quentin Merlin,Nantes,11.3,17,14,8,8,1,11,15,73.3,4,13,1,12,13,30,14,0
1483,Junior Messias,Genoa,2.0,8,7,5,3,0,4,7,57.1,3,1,0,1,1,9,4,0
1484,Thomas Meunier,Dortmund,1.0,1,1,0,1,0,0,1,0.0,1,1,0,1,0,1,3,0
1485,Bastien Meupiyou,Nantes,0.1,0,0,0,0,0,0,0,0.0,0,0,0,0,0,0,1,0
1486,Alexander Meyer,Dortmund,0.7,1,1,1,0,0,1,1,100.0,0,0,0,0,0,1,1,0
1487,Omenuke Mfulu,Las Palmas,0.8,4,3,3,1,0,0,1,0.0,1,1,1,0,2,6,5,0
1488,Sven Michel,Augsburg,4.8,5,3,1,1,3,2,5,40.0,3,1,0,1,0,5,4,0
1489,Miguel,Alavés,0.7,0,0,0,0,0,0,0,0.0,0,2,0,2,0,0,0,0
1490,Georges Mikautadze,Metz,2.9,1,1,0,1,0,0,1,0.0,1,1,0,1,1,2,0,0
1491,Nikola Milenkovic,Fiorentina,12.3,23,12,12,10,1,14,23,60.9,9,13,8,5,9,32,40,1
1492,Lewis Miley,Newcastle Utd,4.7,9,7,2,5,2,4,6,66.7,2,8,1,7,4,13,5,0
1493,Arkadiusz Milik,Juventus,4.0,2,2,1,1,0,1,2,50.0,1,3,1,2,2,4,2,0
1494,Vanja Milinkovic-Savic,Torino,14.0,0,0,0,0,0,0,0,0.0,0,0,0,0,0,0,5,3
1495,Eder Militao,Real Madrid,0.5,0,0,0,0,0,0,0,0.0,0,1,0,1,0,0,1,0
1496,Luis Milla,Getafe,4.2,9,7,4,4,1,3,9,33.3,6,3,0,3,4,13,1,0
1497,Enzo Millot,Stuttgart,10.6,16,9,3,9,4,8,14,57.1,6,9,1,8,6,22,4,1
1498,James Milner,Brighton,5.2,12,9,6,5,1,6,8,75.0,2,5,0,5,6,18,13,0
1499,Jovan Milosevic,Stuttgart,0.3,0,0,0,0,0,0,0,0.0,0,0,0,0,0,0,0,0
1500,Marko Milovanovic,Almería,0.3,0,0,0,0,0,0,0,0.0,0,0,0,0,0,0,3,0
1501,Kim Min-jae,Bayern Munich,12.6,14,7,8,4,2,6,14,42.9,8,18,8,10,21,35,39,1
1502,Yerry Mina,Fiorentina,0.0,0,0,0,0,0,0,0,0.0,0,0,0,0,0,0,0,0
1503,Takumi Minamino,Monaco,10.4,17,11,3,7,7,8,27,29.6,19,9,0,9,6,23,4,0
1504,Lucas Mincarelli,Montpellier,1.9,5,3,3,1,1,4,5,80.0,1,3,1,2,1,6,4,0
1505,Tyrone Mings,Aston Villa,0.3,0,0,0,0,0,0,0,0.0,0,0,0,0,1,1,1,0
1506,Oscar Mingueza,Celta Vigo,14.8,30,19,22,5,3,22,49,44.9,27,19,3,16,7,37,21,1
1508,Ignasi Miquel,Granada,15.5,24,15,21,3,0,12,22,54.5,10,10,6,4,16,40,60,2
1509,Rafa Mir,Sevilla,2.1,2,2,1,1,0,1,1,100.0,0,1,0,1,0,2,0,0
1510,Ignacio Miramon,Lille,0.4,1,0,0,1,0,0,1,0.0,1,1,0,1,0,1,0,0
1511,Aleksei Miranchuk,Atalanta,2.9,3,2,1,2,0,1,3,33.3,2,2,1,1,0,3,1,0
1512,Juan Miranda,Betis,8.2,8,6,3,3,2,3,5,60.0,2,11,2,9,8,16,30,0
1513,Kevin Miranda,Sassuolo,0.2,0,0,0,0,0,0,0,0.0,0,0,0,0,0,0,1,0
1514,Antonio Mirante,Milan,1.0,0,0,0,0,0,0,0,0.0,0,0,0,0,0,0,0,0
1515,Fabio Miretti,Juventus,5.1,4,4,2,2,0,3,9,33.3,6,5,1,4,2,6,2,0
1516,Filippo Missori,Sassuolo,0.5,1,1,0,1,0,1,2,50.0,1,1,0,1,2,3,0,0
1517,Tyrick Mitchell,Crystal Palace,14.1,34,19,27,4,3,9,18,50.0,9,18,5,13,13,47,57,0
1518,Kaoru Mitoma,Brighton,12.8,9,3,2,5,2,4,15,26.7,11,11,1,10,4,13,5,0
1519,Aleksandar Mitrovic,Fulham,0.4,0,0,0,0,0,0,0,0.0,0,0,0,0,0,0,0,0
1520,Stefan Mitrovic,Getafe,7.6,8,2,7,1,0,4,8,50.0,4,3,2,1,6,14,26,0
1521,Maximilian Mittelstadt,Stuttgart,5.8,31,17,19,9,3,21,30,70.0,9,9,1,8,18,49,12,0
1522,Henrikh Mkhitaryan,Inter,13.0,36,20,8,24,4,12,22,54.5,10,6,1,5,20,56,14,0
1523,Jakub Moder,Brighton,0.2,2,2,1,1,0,2,3,66.7,1,1,0,1,0,2,4,0
1524,Luka Modric,Real Madrid,6.4,8,4,5,2,1,3,5,60.0,2,4,3,1,6,14,4,0
1525,Terem Moffi,Nice,12.0,2,2,0,1,1,0,5,0.0,5,5,0,5,1,3,7,0
1526,Mostafa Mohamed,Nantes,10.0,8,6,2,5,1,2,12,16.7,10,11,2,9,6,14,9,0
1527,Kudus Mohammed,West Ham,7.8,22,17,6,12,4,7,9,77.8,2,10,0,10,2,24,2,0
1528,Dion Moise Sahi,Strasbourg,3.8,3,3,0,2,1,0,2,0.0,2,6,1,5,1,4,3,0
1529,Johan Mojica,Osasuna,8.0,14,11,3,8,3,6,8,75.0,2,7,0,7,14,28,10,0
1530,Alberto Moleiro,Las Palmas,4.5,4,2,3,1,0,2,10,20.0,8,5,0,5,3,7,3,0
1531,Nahuel Molina,Atlético Madrid,8.5,15,9,6,7,2,9,18,50.0,9,8,1,7,3,18,16,1
1532,Florent Mollet,Nantes,10.6,6,2,2,1,3,3,15,20.0,12,7,0,7,3,9,6,0
1534,Jon Moncayola,Osasuna,7.2,9,5,7,2,0,5,13,38.5,8,10,3,7,7,16,10,0
1535,Ilario Monterisi,Frosinone,10.7,14,9,10,4,0,7,11,63.6,4,18,15,3,5,19,43,0
1536,Cesar Montes,Almería,6.7,4,4,2,2,0,2,5,40.0,3,10,2,8,4,8,28,0
1537,Gonzalo Montiel,Nott'ham Forest,1.9,4,2,2,1,1,4,6,66.7,2,2,0,2,2,6,6,0
1538,Lorenzo Montipo,Hellas Verona,15.0,0,0,0,0,0,0,1,0.0,1,0,0,0,0,0,10,0
1539,Kieffer Moore,Bournemouth,1.0,0,0,0,0,0,0,0,0.0,0,0,0,0,0,0,0,0
1540,Alvaro Morata,Atlético Madrid,11.4,6,2,1,2,3,1,1,100.0,0,9,0,9,0,6,15,0
1541,Diego Moreira,Lyon,2.7,0,0,0,0,0,0,3,0.0,3,2,0,2,2,2,5,0
1542,Alberto Moreno,Villarreal,5.1,7,4,5,1,1,2,6,33.3,4,2,0,2,3,10,13,0
1543,Alex Moreno,Aston Villa,0.3,2,1,2,0,0,1,1,100.0,0,1,1,0,0,2,1,0
1544,Gerard Moreno,Villarreal,11.9,14,5,6,3,5,7,14,50.0,7,12,5,7,4,18,12,0
1545,Manu Morlanes,Mallorca,4.4,15,11,6,8,1,7,14,50.0,7,3,0,3,4,19,4,0
1546,Nikola Moro,Bologna,4.6,10,7,3,7,0,4,8,50.0,4,9,1,8,4,14,4,0
1547,Carlton Morris,Luton Town,13.2,7,4,2,2,3,3,7,42.9,4,10,1,9,1,8,17,0
1548,Cristhian Mosquera,Valencia,12.2,23,15,11,10,2,9,14,64.3,5,13,6,7,19,42,48,2
1549,Dany Mota,Monza,7.4,1,0,0,0,1,0,3,0.0,3,2,0,2,0,1,5,0
1550,Lebo Mothiba,Strasbourg,6.7,5,2,1,4,0,3,4,75.0,1,6,1,5,0,5,11,0
1551,Youssoufa Moukoko,Dortmund,1.7,2,0,2,0,0,1,2,50.0,1,2,1,1,1,3,0,0
1552,Steve Mounie,Brest,7.9,5,4,0,1,4,2,6,33.3,4,6,2,4,0,5,7,0
1553,Mason Mount,Manchester Utd,4.4,16,10,4,7,5,3,12,25.0,9,5,1,4,3,19,1,0
1554,Samuel Moutoussamy,Nantes,7.5,17,10,6,7,4,10,17,58.8,7,13,3,10,8,25,8,0
1555,Divin Mubama,West Ham,0.6,0,0,0,0,0,0,0,0.0,0,0,0,0,0,0,0,0
1556,Mykhailo Mudryk,Chelsea,7.1,11,6,5,3,3,4,15,26.7,11,8,0,8,4,15,4,0
1557,Francois Mughe,Marseille,2.0,0,0,0,0,0,0,3,0.0,3,2,0,2,1,1,1,0
1558,Joel Mugisha,Lorient,2.0,5,3,3,1,1,3,7,42.9,4,1,0,1,2,7,1,0
1560,Nordi Mukiele,Paris S-G,4.1,8,5,4,4,0,6,10,60.0,4,6,2,4,7,15,19,0
1561,Samuele Mulattieri,Sassuolo,1.3,0,0,0,0,0,0,0,0.0,0,3,1,2,0,0,1,0
1562,Andreas Muller,Darmstadt 98,0.4,5,5,2,3,0,2,2,100.0,0,1,1,0,1,6,2,0
1563,Jannik Muller,Darmstadt 98,6.7,11,4,9,2,0,6,9,66.7,3,9,6,3,9,20,25,0
1564,Kevin Muller,Heidenheim,14.0,1,0,1,0,0,1,1,100.0,0,0,0,0,0,1,4,1
1565,Thomas Muller,Bayern Munich,4.0,8,7,0,3,5,6,12,50.0,6,8,0,8,0,8,2,0
1566,Abdul Mumin,Rayo Vallecano,6.8,6,2,6,0,0,3,5,60.0,2,13,10,3,8,14,41,0
1567,Marshall Munetsi,Reims,10.2,25,15,6,16,3,15,28,53.6,13,10,3,7,3,28,11,0
1568,Iker Muniain,Athletic Club,3.6,3,0,1,2,0,1,1,100.0,0,3,0,3,0,3,0,0
1569,Rodrigo Muniz,Fulham,1.5,0,0,0,0,0,0,2,0.0,2,1,0,1,1,1,2,0
1570,Aihen Munoz,Real Sociedad,11.8,32,19,18,10,4,20,31,64.5,11,16,8,8,8,40,29,0
1571,Iker Munoz,Osasuna,5.4,10,9,4,6,0,6,12,50.0,6,2,1,1,3,13,14,0
1572,Javier Munoz,Las Palmas,12.0,17,7,6,7,4,8,20,40.0,12,18,3,15,9,26,11,0
1573,Luis Muriel,Atalanta,2.8,2,2,0,2,0,1,1,100.0,0,1,0,1,1,3,0,0
1574,Murillo,Nott'ham Forest,9.7,17,9,13,4,0,3,8,37.5,5,13,6,7,11,28,55,0
1575,Vedat Muriqi,Mallorca,11.7,4,3,3,0,1,1,7,14.3,6,2,1,1,0,4,14,0
1576,Alex Murphy,Newcastle Utd,0.0,0,0,0,0,0,0,1,0.0,1,0,0,0,1,1,0,0
1577,Jacob Murphy,Newcastle Utd,1.3,2,2,0,1,1,0,0,0.0,0,2,0,2,0,2,4,0
1578,Yunus Musah,Milan,9.7,14,7,8,3,3,3,8,37.5,5,10,3,7,7,21,9,1
1579,Jamal Musiala,Bayern Munich,5.3,10,8,2,8,0,6,11,54.5,5,7,1,6,2,12,2,0
1580,Juan Musso,Atalanta,10.0,1,0,1,0,0,1,1,100.0,0,0,0,0,0,1,6,0
1581,Yvon Mvogo,Lorient,15.0,0,0,0,0,0,0,0,0.0,0,0,0,0,0,0,7,0
1582,Junior Mwanga,Strasbourg,6.6,21,10,13,5,3,7,12,58.3,5,8,2,6,10,31,8,0
1583,Phillipp Mwene,Mainz 05,6.4,9,2,3,5,1,4,9,44.4,5,9,0,9,5,14,10,0
1584,Vitaliy Mykolenko,Everton,12.0,43,25,28,14,1,24,38,63.2,14,18,6,12,18,61,39,0
1586,Joakim Maehle,Wolfsburg,12.0,23,11,14,6,3,15,26,57.7,11,19,2,17,14,37,30,0
1587,Obite N'Dicka,Roma,11.8,19,10,6,12,1,7,11,63.6,4,12,5,7,7,26,35,0
1588,Kevin N'Doram,Metz,6.9,5,2,2,2,1,4,8,50.0,4,6,3,3,12,17,23,0
1589,Joseph N'Duquidi,Metz,5.2,7,2,4,3,0,1,7,14.3,6,8,2,6,9,16,9,0
1590,Nathan N'Goumou,M'Gladbach,7.0,16,12,9,6,1,8,18,44.4,10,11,0,11,2,18,9,0
1591,Stanley N'Soki,Hoffenheim,0.3,1,0,0,1,0,1,2,50.0,1,0,0,0,0,1,5,0
1592,Nacho,Real Madrid,5.3,7,5,2,5,0,3,7,42.9,4,8,6,2,4,11,12,0
1593,Bilal Nadir,Marseille,0.3,1,1,0,1,0,0,0,0.0,0,0,0,0,0,1,0,0
1594,Mahamadou Nagida,Rennes,0.3,1,1,0,0,1,0,0,0.0,0,0,0,0,2,3,0,0
1595,Marvelous Nakamba,Luton Town,12.6,40,24,24,14,2,24,42,57.1,18,23,6,17,11,51,11,1
1596,Keito Nakamura,Reims,5.7,15,7,7,4,4,11,24,45.8,13,11,2,9,1,16,3,0
1597,Nahitan Nandez,Cagliari,8.1,8,5,5,2,1,4,15,26.7,11,5,1,4,4,12,8,0
1598,Matija Nastasic,Mallorca,10.1,10,4,6,4,0,6,8,75.0,2,17,10,7,11,21,44,0
1599,Natan,Napoli,8.6,11,9,7,3,1,5,9,55.6,4,10,9,1,6,17,29,0
1600,Roberto Navarro,Cádiz,2.8,9,3,1,7,1,2,5,40.0,3,1,0,1,2,11,1,0
1601,Jesus Navas,Sevilla,9.0,24,17,12,10,2,17,27,63.0,10,6,3,3,14,38,15,0
1602,Michel Ndary Adopo,Atalanta,0.4,0,0,0,0,0,0,0,0.0,0,0,0,0,0,0,0,1
1603,Youssouf Ndayishimiye,Nice,12.7,15,9,7,8,0,6,13,46.2,7,15,8,7,9,24,33,1
1604,Bassirou Ndiaye,Lorient,1.7,0.0,2,0.0,0.0,0.0,0.0,0.0,0.0,0.0,0.0,0.0,0.0,1,0.0,0.0,0.0
1605,Iliman Ndiaye,Marseille,8.3,7,7,0,4,3,2,8,25.0,6,7,1,6,3,10,3,0
1606,Rassoul Ndiaye,Le Havre,4.3,21,13,8,12,1,9,17,52.9,8,1,1,0,3,24,5,0
1607,Michael Ndiweni,Newcastle Utd,0.0,0,0,0,0,0,0,0,0.0,0,0,0,0,0,0,0,0
1608,Cher Ndour,Paris S-G,0.3,2,2,0,2,0,1,2,50.0,1,0,0,0,0,2,0,0
1609,Dan Ndoye,Bologna,9.9,20,9,14,6,0,11,24,45.8,13,9,1,8,4,24,10,0
1610,Loic Nego,Le Havre,8.4,16,10,8,7,1,6,13,46.2,7,8,1,7,11,27,6,0
1612,Alvaro Negredo,Cádiz,0.4,0,0,0,0,0,0,0,0.0,0,1,0,1,1,1,0,0
1613,Reiss Nelson,Arsenal,0.7,3,2,1,0,2,3,4,75.0,1,1,1,0,0,3,2,0
1614,Neto,Bournemouth,14.0,0,0,0,0,0,0,0,0.0,0,1,0,1,1,1,6,1
1615,Pedro Neto,Wolves,9.8,4,2,1,1,2,4,11,36.4,7,4,1,3,3,7,2,0
1616,Luca Netz,M'Gladbach,10.5,19,12,9,8,2,8,16,50.0,8,19,6,13,11,30,39,1
1617,Manuel Neuer,Bayern Munich,5.0,0,0,0,0,0,0,0,0.0,0,0,0,0,0,0,1,0
1618,Florian Neuhaus,M'Gladbach,6.7,5,5,2,3,0,3,14,21.4,11,5,4,1,7,12,6,0
1619,Carlos Neva,Granada,15.4,18,11,13,4,1,11,22,50.0,11,20,8,12,5,23,43,1
1620,Jessic Ngankam,Eint Frankfurt,2.5,2,1,0,1,1,0,0,0.0,0,0,0,0,0,2,1,0
1621,Cyril Ngonge,Hellas Verona,11.1,10,8,4,1,5,4,11,36.4,7,4,1,3,2,12,3,0
1622,Moussa Niakhate,Nott'ham Forest,7.2,18,13,16,2,0,6,8,75.0,2,9,4,5,6,24,20,0
1623,Tanguy Nianzou,Sevilla,1.0,7,6,5,1,1,6,6,100.0,0,0,0,0,1,8,3,0
1624,Shamar Nicholson,Clermont Foot,8.1,2,1,0,2,0,0,2,0.0,2,4,1,3,0,2,7,0
1625,Rasmus Nicolaisen,Toulouse,15.0,22,14,19,3,0,11,17,64.7,6,22,17,5,14,36,89,0
1626,Moritz Nicolas,M'Gladbach,12.0,0,0,0,0,0,0,1,0.0,1,0,0,0,0,0,5,1
1627,Hans Nicolussi Caviglia,Juventus,1.5,2,0,1,1,0,2,3,66.7,1,2,0,2,0,2,1,0
1628,Saul Niguez,Atlético Madrid,7.9,36,21,18,14,4,19,31,61.3,12,20,6,14,6,42,24,0
1629,Rasmus Nissen,Roma,7.6,18,9,11,5,2,14,22,63.6,8,13,2,11,1,19,19,0
1630,Justin Njinmah,Werder Bremen,2.8,2,0,0,2,0,1,2,50.0,1,2,0,2,2,4,3,0
1631,Eddie Nketiah,Arsenal,9.2,6,3,1,3,2,1,4,25.0,3,11,0,11,3,9,3,0
1632,Niels Nkounkou,Eint Frankfurt,3.5,9,6,4,5,0,6,12,50.0,6,8,0,8,5,14,4,0
1633,Felix Nmecha,Dortmund,6.7,13,9,3,6,4,8,13,61.5,5,9,0,9,8,21,11,0
1634,Peru Nolaskoain,Athletic Club,0.1,1,1,1,0,0,1,1,100.0,0,0,0,0,0,1,1,0
1635,Arnaud Nordin,Montpellier,3.4,2,0,1,1,0,1,3,33.3,2,3,0,3,1,3,2,0
1636,Oliver Norwood,Sheffield Utd,11.8,33,20,14,16,3,16,37,43.2,21,14,4,10,13,46,33,0
1638,Randy Ntekja,Rayo Vallecano,3.3,4,1,1,2,1,2,4,50.0,2,4,1,3,1,5,3,0
1639,Ernest Nuamah,Lyon,8.6,13,5,5,4,4,3,12,25.0,9,3,1,2,4,17,4,0
1640,Alexander Nubel,Stuttgart,14.0,1,1,1,0,0,1,1,100.0,0,0,0,0,0,1,6,1
1641,Matheus Nunes,Wolves,2.0,3,1,3,0,0,2,6,33.3,4,0,0,0,6,9,1,0
1642,Matheus Nunes,Manchester City,2.6,6,2,1,4,1,3,7,42.9,4,2,1,1,0,6,5,0
1643,Darwin Nunez,Liverpool,9.7,10,8,1,4,5,5,11,45.5,6,12,3,9,1,11,4,0
1644,Unai Nunez,Celta Vigo,16.0,19,12,7,11,1,6,15,40.0,9,18,11,7,28,47,90,0
1645,Fabian Nurnberger,Darmstadt 98,10.6,19,14,16,3,0,17,33,51.5,16,5,1,4,11,30,19,0
1646,Simeon Nwankwo,Salernitana,0.7,0,0,0,0,0,0,1,0.0,1,0,0,0,0,0,0,0
1647,Gerzino Nyamsi,Strasbourg,12.1,18,14,13,5,0,12,18,66.7,6,19,11,8,10,28,43,0
1648,Orjan Nyland,Sevilla,7.0,0,0,0,0,0,0,0,0.0,0,0,0,0,0,0,2,0
1649,M'Bala Nzola,Fiorentina,9.2,7,5,0,2,5,3,4,75.0,1,5,0,5,0,7,13,0
1650,Christian Norgaard,Brentford,14.4,42,27,21,16,5,18,45,40.0,27,23,2,21,17,59,36,0
1651,Jake O'Brien,Lyon,9.0,4,4,4,0,0,2,2,100.0,0,5,4,1,3,7,28,1
1652,Dara O'Shea,Burnley,11.4,11,7,6,3,2,5,10,50.0,5,18,15,3,16,27,53,1
1653,Michael Obafemi,Burnley,0.2,0,0,0,0,0,0,0,0.0,0,1,0,1,0,0,0,0
1654,Adam Obert,Cagliari,4.2,9,4,4,4,1,4,7,57.1,3,9,4,5,9,18,17,0
1655,Pedro Obiang,Sassuolo,0.1,0,0,0,0,0,0,0,0.0,0,0,0,0,0,0,0,0
1656,Jan Oblak,Atlético Madrid,15.0,0,0,0,0,0,0,0,0.0,0,0,0,0,0,0,3,0
1657,Brian Ocampo,Cádiz,0.5,0,0,0,0,0,0,0,0.0,0,0,0,0,0,0,0,0
1658,Lucas Ocampos,Sevilla,12.7,23,16,6,9,8,6,14,42.9,8,14,0,14,7,30,5,0
1659,Guillermo Ochoa,Salernitana,11.0,0,0,0,0,0,0,0,0.0,0,0,0,0,0,0,7,0
1660,Wilson Odobert,Burnley,2.7,4,3,1,1,2,3,6,50.0,3,2,0,2,1,5,3,0
1661,Alvaro Odriozola,Real Sociedad,0.5,0,0,0,0,0,0,0,0.0,0,1,1,0,1,1,0,0
1662,Tim Oermann,Bochum,0.3,0,0,0,0,0,0,0,0.0,0,1,0,1,0,0,0,0
1664,Chiedozie Ogbene,Luton Town,10.4,13,8,7,6,0,8,11,72.7,3,7,1,6,3,16,17,1
1665,Angelo Ogbonna,West Ham,1.6,1,0,1,0,0,1,1,100.0,0,5,3,2,2,3,8,0
1666,Florent Ogier,Clermont Foot,5.4,9,3,7,2,0,4,7,57.1,3,14,11,3,5,14,20,2
1667,Noah Okafor,Milan,4.2,1,0,0,1,0,0,0,0.0,0,1,0,1,0,1,5,0
1668,Caleb Okoli,Frosinone,10.6,17,9,6,11,0,8,15,53.3,7,15,15,0,5,22,47,3
1669,Masaya Okugawa,Augsburg,0.4,0,0,0,0,0,0,0,0.0,0,0,0,0,0,0,2,0
1670,Joseph Okumu,Reims,10.3,23,15,14,8,1,10,22,45.5,12,8,4,4,19,42,63,1
1671,Michael Olakigbe,Brentford,0.5,1,0,1,0,0,1,3,33.3,2,7,0,7,0,1,0,1
1672,Olasagasti,Real Sociedad,0.4,2,1,1,1,0,1,2,50.0,1,0,0,0,2,4,1,0
1673,Finn Ole Becker,Hoffenheim,3.8,6,6,4,2,0,2,8,25.0,6,8,1,7,0,6,3,0
1674,Mathias Olesen,Köln,1.2,0,0,0,0,0,0,0,0.0,0,0,0,0,2,2,2,0
1675,Michael Olise,Crystal Palace,3.5,8,6,4,3,1,6,11,54.5,5,4,0,4,3,11,1,0
1676,Mathias Olivera,Napoli,8.3,28,16,19,7,2,13,22,59.1,9,13,1,12,8,36,14,0
1677,Dani Olmo,RB Leipzig,3.1,2,0,1,1,0,1,2,50.0,1,1,0,1,3,5,2,0
1678,Robin Olsen,Aston Villa,1.0,0,0,0,0,0,0,0,0.0,0,0,0,0,0,0,0,0
1679,Warmed Omari,Rennes,11.0,18,12,11,5,2,9,17,52.9,8,18,12,6,20,38,34,2
1680,Becir Omeragic,Montpellier,9.4,17,8,11,4,2,9,17,52.9,8,16,12,4,11,28,27,0
1681,Jonas Omlin,M'Gladbach,2.0,0,0,0,0,0,0,0,0.0,0,0,0,0,0,0,1,0
1682,Samuel Omorodion,Alavés,8.0,3,1,0,3,0,0,2,0.0,2,4,1,3,1,4,5,0
1683,Samuel Omorodion,Granada,0.9,1,1,0,1,0,1,1,100.0,0,0,0,0,0,1,0,0
1684,Amadou Onana,Everton,10.7,30,17,12,12,6,10,19,52.6,9,9,0,9,6,36,10,0
1685,Andre Onana,Manchester Utd,16.0,1,0,1,0,0,1,1,100.0,0,0,0,0,0,1,2,0
1686,Ryan One,Sheffield Utd,0.1,0,0,0,0,0,0,0,0.0,0,0,0,0,0,0,0,0
1687,Karim Onisiwo,Mainz 05,7.6,8,3,1,3,4,3,6,50.0,3,10,2,8,1,9,1,0
1688,Tyler Onyango,Everton,0.0,0,0,0,0,0,0,0,0.0,0,0,0,0,0,0,0,0
1690,Frank Onyeka,Brentford,7.7,22,14,5,13,4,9,16,56.3,7,8,4,4,12,34,10,0
1691,Lois Openda,RB Leipzig,12.0,1,1,0,0,1,0,2,0.0,2,5,0,5,2,3,4,0
1692,Christopher Operi,Le Havre,10.2,23,16,10,10,3,13,23,56.5,10,15,1,14,13,36,21,0
1693,Leon Opitz,Werder Bremen,0.2,2,2,1,1,0,2,3,66.7,1,0,0,0,0,2,0,0
1694,Willi Orban,RB Leipzig,3.0,7,4,2,5,0,4,5,80.0,1,4,1,3,2,9,14,0
1695,Ivan Ordets,Bochum,8.4,4,2,0,3,1,1,2,50.0,1,14,8,6,19,23,42,0
1696,Divock Origi,Nott'ham Forest,1.7,0,0,0,0,0,0,0,0.0,0,0,0,0,0,0,0,0
1697,Gaetano Oristanio,Cagliari,6.9,9,6,3,5,1,2,5,40.0,3,4,0,4,7,16,3,0
1698,Aimar Oroz,Osasuna,14.4,18,10,5,11,2,5,19,26.3,14,18,1,17,7,25,4,0
1699,Riccardo Orsolini,Bologna,8.0,7,3,6,0,1,3,15,20.0,12,10,2,8,4,11,10,0
1700,Stefan Ortega,Manchester City,1.0,0,0,0,0,0,0,0,0.0,0,0,0,0,0,0,0,0
1701,Ben Osborn,Sheffield Utd,3.4,5,1,0,3,2,4,6,66.7,2,7,0,7,0,5,10,0
1702,Gabriel Osho,Luton Town,5.6,8,5,5,3,0,5,6,83.3,1,14,9,5,8,16,38,0
1703,Victor Osimhen,Napoli,9.2,5,2,0,2,3,1,2,50.0,1,4,1,3,1,6,8,0
1704,Milutin Osmajic,Cádiz,0.1,0,0,0,0,0,0,0,0.0,0,0,0,0,0,0,0,0
1705,Patrick Osterhage,Bochum,6.6,11,8,1,9,1,2,9,22.2,7,10,0,10,6,17,13,0
1706,William Osula,Sheffield Utd,4.6,1,1,1,0,0,1,2,50.0,1,2,1,1,0,1,3,0
1707,Dango Ouattara,Bournemouth,2.7,9,4,6,1,2,3,6,50.0,3,4,0,4,2,11,5,0
1708,Kassoum Ouattara,Monaco,0.1,1,1,0,0,1,1,1,100.0,0,0,0,0,0,1,0,0
1709,Remi Oudin,Lecce,5.1,8,5,2,6,0,3,4,75.0,1,5,0,5,10,18,3,0
1710,Alexandre Oukidja,Metz,14.2,0,0,0,0,0,0,0,0.0,0,0,0,0,1,1,13,0
1711,Azzedine Ounahi,Marseille,6.8,14,6,6,7,1,5,19,26.3,14,3,0,3,5,19,3,0
1712,Adam Ounas,Lille,1.4,2,1,1,1,0,2,5,40.0,3,1,0,1,4,6,1,0
1713,Mikel Oyarzabal,Real Sociedad,10.0,8,7,2,4,2,3,11,27.3,8,11,1,10,2,10,6,0
1714,Anthony Oyono,Frosinone,13.2,37,26,21,14,2,23,34,67.6,11,17,3,14,9,46,32,0
1716,Salih Ozcan,Dortmund,6.1,11,5,7,4,0,5,8,62.5,3,12,1,11,6,17,4,0
1717,Bertug Ozgur Yildirim,Rennes,3.0,3,2,1,1,1,1,2,50.0,1,3,0,3,0,3,4,0
1718,Cenk Ozkacar,Valencia,6.5,12,7,9,3,0,8,14,57.1,6,7,2,5,5,17,25,1
1719,David Ozoh,Crystal Palace,0.1,1,0,0,1,0,1,1,100.0,0,0,0,0,0,1,0,0
1720,Jon Pacheco,Real Sociedad,3.9,4,4,4,0,0,1,3,33.3,2,7,4,3,2,6,18,0
1721,Willian Pacho,Eint Frankfurt,14.0,34,22,21,12,1,16,22,72.7,6,19,6,13,21,55,67,0
1722,Goncalo Paciencia,Bochum,3.1,3,1,1,0,2,2,4,50.0,2,0,0,0,0,3,3,0
1723,Simone Pafundi,Udinese,0.1,0,0,0,0,0,0,0,0.0,0,0,0,0,0,0,0,0
1724,Riccardo Pagano,Roma,0.6,2,2,1,1,0,0,6,0.0,6,3,2,1,0,2,2,0
1725,Pablo Pagis,Lorient,1.8,10,6,5,4,1,6,10,60.0,4,2,0,2,3,13,1,0
1726,Exequiel Palacios,Leverkusen,12.5,33,17,13,15,5,14,31,45.2,17,18,0,18,23,56,10,2
1727,Isaac Palazon Camacho,Rayo Vallecano,13.4,16,6,4,7,5,5,20,25.0,15,13,0,13,8,24,24,0
1728,Joao Palhinha,Fulham,11.9,72,35,42,23,7,50,75,66.7,25,25,2,23,22,94,22,0
1729,Nicolas Pallois,Nantes,4.9,8,2,3,3,2,3,5,60.0,2,8,6,2,7,15,33,0
1730,Cole Palmer,Manchester City,0.1,0,0,0,0,0,0,0,0.0,0,0,0,0,0,0,0,0
1731,Cole Palmer,Chelsea,9.7,9,6,4,1,4,5,10,50.0,5,7,1,6,9,18,4,1
1732,Emerson Palmieri,West Ham,14.5,39,26,19,14,6,19,29,65.5,10,20,3,17,17,56,36,0
1733,Milos Pantovic,Union Berlin,0.2,0,0,0,0,0,0,0,0.0,0,0,0,0,0,0,0,0
1734,Antonios Papadopoulos,Dortmund,0.3,3,1,3,0,0,3,3,100.0,0,1,0,1,0,3,4,0
1735,Sokratis Papastathopoulos,Betis,0.1,0,0,0,0,0,0,0,0.0,0,0,0,0,0,0,2,0
1736,Matondo-Merveille Papela,Mainz 05,0.5,0,0,0,0,0,0,1,0.0,1,0,0,0,2,2,0,0
1737,Leart Paqarada,Köln,9.6,17,9,8,8,1,8,19,42.1,11,15,5,10,9,26,20,1
1738,Lucas Paqueta,West Ham,14.5,38,28,19,15,4,14,32,43.8,18,16,0,16,13,51,14,1
1739,Aitor Paredes,Athletic Club,13.8,4,2,3,1,0,3,8,37.5,5,13,7,6,12,16,42,0
1740,Kevin Paredes,Wolfsburg,3.6,10,4,7,3,0,5,8,62.5,3,10,0,10,11,21,4,0
1742,Leandro Paredes,Roma,11.9,25,18,13,11,1,15,35,42.9,20,10,0,10,15,40,14,0
1743,Daniel Parejo,Villarreal,14.5,20,15,9,11,0,9,19,47.4,10,10,4,6,6,26,13,3
1744,Fabiano Parisi,Fiorentina,9.5,20,9,8,6,6,10,16,62.5,6,18,4,14,12,32,16,0
1745,Ben Parkinson,Newcastle Utd,0.3,0,0,0,0,0,0,0,0.0,0,1,0,1,0,0,1,0
1746,Thomas Partey,Arsenal,2.8,6,5,5,1,0,4,6,66.7,2,2,1,1,4,10,2,0
1747,Mario Pasalic,Atalanta,6.2,6,2,3,3,0,4,6,66.7,2,9,2,7,1,7,13,0
1748,Pascu,Villarreal,0.2,0,0,0,0,0,0,0,0.0,0,0,0,0,0,0,0,0
1749,Felix Passlack,Bochum,4.8,10,7,4,5,1,7,13,53.8,6,6,1,5,5,15,10,0
1750,Patric,Lazio,8.0,7,5,6,1,0,3,8,37.5,5,5,2,3,3,10,17,0
1751,Rui Patricio,Roma,15.0,0,0,0,0,0,0,1,0.0,1,0,0,0,0,0,1,1
1752,Nathan Patterson,Everton,6.9,21,15,15,6,0,9,22,40.9,13,11,3,8,7,28,22,0
1753,Gabriel Paulista,Valencia,11.8,9,6,8,1,0,6,11,54.5,5,13,6,7,21,30,58,0
1754,Benjamin Pavard,Inter,4.5,10,6,3,7,0,4,5,80.0,1,9,5,4,9,19,10,0
1755,Jiri Pavlenka,Werder Bremen,7.0,0,0,0,0,0,0,0,0.0,0,0,0,0,0,0,2,0
1756,Aleksandar Pavlovic,Bayern Munich,1.3,6,5,4,2,0,4,6,66.7,2,4,0,4,1,7,2,0
1757,Leonardo Pavoletti,Cagliari,2.8,1,1,0,0,1,0,0,0.0,0,1,1,0,0,1,3,0
1758,Martin Payero,Udinese,7.7,17,11,6,7,4,8,19,42.1,11,6,1,5,7,24,11,0
1759,Nicolas Paz,Real Madrid,0.3,0,0,0,0,0,0,0,0.0,0,2,0,2,1,1,0,0
1760,Myles Peart-Harris,Brentford,0.1,0,0,0,0,0,0,0,0.0,0,0,0,0,0,0,1,0
1761,Sydie Peck,Sheffield Utd,0.1,0,0,0,0,0,0,0,0.0,0,0,0,0,0,0,0,0
1762,Mads Pedersen,Augsburg,10.5,23,14,9,11,3,8,15,53.3,7,11,2,9,8,31,25,0
1763,Marcus Pedersen,Sassuolo,3.8,8,5,7,1,0,5,7,71.4,2,4,1,3,3,11,11,0
1764,Alfonso Pedraza,Villarreal,8.7,17,7,14,2,1,7,12,58.3,5,10,4,6,7,24,16,0
1765,Pedri,Barcelona,5.8,8,5,1,6,1,2,8,25.0,6,7,0,7,3,11,2,0
1766,Pedro,Lazio,4.6,11,8,3,5,3,3,5,60.0,2,9,0,9,1,12,1,0
1768,Adria Pedrosa,Sevilla,9.0,25,12,16,7,2,8,13,61.5,5,12,3,9,8,33,24,0
1769,Jordan Pefok,M'Gladbach,5.5,2,1,0,2,0,0,2,0.0,2,6,2,4,1,3,9,0
1770,Jordan Pefok,Union Berlin,0.3,0,0,0,0,0,0,0,0.0,0,1,1,0,0,0,0,0
1771,Pietro Pellegri,Torino,3.4,3,1,1,2,0,1,4,25.0,3,0,0,0,0,3,3,0
1772,Lorenzo Pellegrini,Roma,5.3,11,5,3,6,2,7,12,58.3,5,6,0,6,4,15,6,0
1773,Luca Pellegrini,Lazio,2.1,3,3,2,1,0,2,5,40.0,3,3,2,1,1,4,3,0
1774,Marco Pellegrino,Milan,0.8,1,1,0,0,1,0,2,0.0,2,1,1,0,1,2,2,0
1775,Facundo Pellistri,Manchester Utd,1.6,4,3,3,1,0,1,3,33.3,2,6,0,6,1,5,4,0
1776,Andy Pelmard,Clermont Foot,14.2,28,21,22,6,0,19,22,86.4,3,20,9,11,8,36,27,1
1777,Inaki Pena,Barcelona,3.0,0,0,0,0,0,0,0,0.0,0,0,0,0,0,0,1,0
1778,Ruben Pena,Osasuna,10.1,24,16,11,9,4,10,27,37.0,17,15,2,13,12,36,20,1
1779,Pepin,Monza,2.5,5,0,1,4,0,2,3,66.7,1,5,2,3,0,5,3,0
1780,Alberto Perea,Granada,0.0,0,0,0,0,0,0,2,0.0,2,0,0,0,0,0,0,0
1781,Andreas Pereira,Fulham,12.2,13,5,2,4,7,4,14,28.6,10,6,1,5,3,16,7,0
1782,Danilo Pereira,Paris S-G,7.5,9,5,6,2,1,1,4,25.0,3,16,16,0,12,21,42,0
1783,Mathias Pereira Lage,Brest,3.5,4,1,2,2,0,3,12,25.0,9,6,2,4,4,8,2,0
1784,Pedro Pereira,Monza,2.7,4,2,3,1,0,3,7,42.9,4,5,1,4,1,5,9,0
1785,Roberto Pereyra,Udinese,7.5,7,2,4,3,0,4,11,36.4,7,6,1,5,2,9,2,0
1786,Ayoze Perez,Betis,13.0,29,20,7,19,3,9,23,39.1,14,23,2,21,15,44,11,0
1787,Carles Perez,Celta Vigo,3.1,5,2,1,3,1,3,6,50.0,3,5,0,5,3,8,1,0
1788,Francisco Perez,Valencia,12.0,13,6,5,6,2,5,19,26.3,14,12,0,12,7,20,1,0
1789,Kike Perez,Rayo Vallecano,4.7,17,7,8,8,1,8,15,53.3,7,5,0,5,4,21,5,0
1790,Nehuen Perez,Udinese,15.0,38,24,21,16,1,20,25,80.0,5,22,9,13,14,52,55,0
1791,Mattia Perin,Juventus,2.0,0,0,0,0,0,0,0,0.0,0,0,0,0,0,0,1,0
1792,Samuele Perisan,Empoli,1.0,0,0,0,0,0,0,0,0.0,0,0,0,0,0,0,0,0
1794,Ivan Perisic,Tottenham,1.1,3,2,1,1,1,3,5,60.0,2,1,0,1,2,5,1,0
1795,Romain Perraud,Nice,1.3,6,5,4,1,1,3,6,50.0,3,3,0,3,2,8,6,0
1796,Lucas Perrin,Strasbourg,13.0,28,20,21,7,0,18,31,58.1,13,18,11,7,13,41,46,0
1797,Maximo Perrone,Las Palmas,5.3,17,11,6,9,2,7,12,58.3,5,4,1,3,10,27,6,0
1798,Pavao Pervan,Wolfsburg,3.0,0,0,0,0,0,0,0,0.0,0,0,0,0,0,0,1,0
1799,Matteo Pessina,Monza,14.5,19,9,7,10,2,9,24,37.5,15,17,7,10,12,31,20,0
1800,Andrea Petagna,Cagliari,5.6,0,0,0,0,0,0,1,0.0,1,2,1,1,0,0,3,0
1801,Denis Petric,Nantes,0.3,0,0,0,0,0,0,0,0.0,0,0,0,0,0,0,0,0
1802,Njegos Petrovic,Granada,1.4,5,2,4,1,0,2,3,66.7,1,2,0,2,0,5,3,0
1803,Dorde Petrovic,Chelsea,0.1,0,0,0,0,0,0,0,0.0,0,0,0,0,0,0,0,0
1804,Jens Petter Hauge,Eint Frankfurt,1.2,2,1,1,0,1,2,6,33.3,4,4,1,3,0,2,0,0
1805,German Pezzella,Betis,14.6,18,14,13,5,0,11,19,57.9,8,18,11,7,19,37,77,0
1806,Giuseppe Pezzella,Empoli,3.7,11,8,7,3,1,9,13,69.2,4,12,4,8,0,11,9,0
1807,Luca Pfeiffer,Darmstadt 98,9.2,5,1,0,3,2,2,6,33.3,4,3,1,2,1,6,11,0
1808,Patric Pfeiffer,Augsburg,3.6,9,5,5,3,1,5,5,100.0,0,6,3,3,5,14,13,0
1809,Maximilian Philipp,Freiburg,2.5,7,5,4,3,0,1,5,20.0,4,5,0,5,0,7,0,0
1810,Kalvin Phillips,Manchester City,1.0,3,3,1,1,1,0,0,0.0,0,0,0,0,2,5,2,0
1811,Jaden Philogene Bidace,Aston Villa,0.0,0,0,0,0,0,0,0,0.0,0,0,0,0,0,0,0,0
1812,Roberto Piccoli,Empoli,0.4,1,1,0,0,1,1,1,100.0,0,0,0,0,0,1,0,0
1813,Roberto Piccoli,Lecce,3.1,7,4,1,4,2,1,2,50.0,1,6,0,6,1,8,4,0
1814,Florian Pick,Heidenheim,2.2,3,3,2,0,1,2,3,66.7,1,2,0,2,2,5,0,0
1815,Jordan Pickford,Everton,16.0,0,0,0,0,0,0,0,0.0,0,1,0,1,0,0,8,0
1816,Amos Pieper,Werder Bremen,6.0,13,10,8,5,0,7,12,58.3,5,12,7,5,8,21,34,1
1817,Marvin Pieringer,Heidenheim,6.7,8,6,2,4,2,3,8,37.5,5,13,2,11,7,15,7,0
1818,Ronael Pierre-Gabriel,Nantes,6.6,15,9,12,2,1,5,7,71.4,2,13,4,9,8,23,25,0
1820,Andrea Pinamonti,Sassuolo,12.9,3,3,0,1,2,1,6,16.7,5,7,1,6,0,3,12,0
1821,Ethan Pinnock,Brentford,16.0,25,16,16,9,0,5,12,41.7,7,22,13,9,28,53,106,2
1822,Yeremi Pino,Villarreal,5.3,25,18,12,10,3,9,18,50.0,9,11,1,10,5,30,5,0
1823,Lorenzo Pirola,Salernitana,11.3,20,10,12,8,0,6,14,42.9,8,17,12,5,8,28,48,0
1824,Alassane Plea,M'Gladbach,11.2,10,6,4,4,2,4,11,36.4,7,6,0,6,0,10,3,0
1825,Tommaso Pobega,Milan,3.1,14,8,11,3,0,5,10,50.0,5,8,2,6,6,20,6,0
1826,Paul Pogba,Juventus,0.6,1,1,0,1,0,1,1,100.0,0,0,0,0,1,2,1,0
1827,Matteo Politano,Napoli,10.5,10,6,2,6,2,8,21,38.1,13,3,0,3,8,18,4,0
1828,Julien Ponceau,Lorient,8.5,11,5,6,3,2,2,9,22.2,7,9,0,9,13,24,9,0
1829,Marin Pongracic,Lecce,15.0,18,13,9,8,1,12,17,70.6,5,14,10,4,20,38,56,0
1830,Nick Pope,Newcastle Utd,13.9,0,0,0,0,0,0,1,0.0,1,0,0,0,0,0,7,2
1831,Pedro Porro,Tottenham,15.0,46,32,25,15,6,32,63,50.8,31,35,8,27,10,56,40,1
1832,Portu,Getafe,1.1,5,3,4,0,1,5,6,83.3,1,0,0,0,0,5,0,0
1833,Portu,Girona,2.6,4,4,0,3,1,1,7,14.3,6,3,0,3,1,5,1,0
1834,Stefan Posch,Bologna,8.7,30,16,14,14,2,22,34,64.7,12,7,4,3,7,37,22,0
1835,Yussuf Poulsen,RB Leipzig,7.6,7,5,0,4,3,2,6,33.3,4,7,1,6,2,9,11,0
1836,Jose Pozo,Rayo Vallecano,0.1,0,0,0,0,0,0,0,0.0,0,0,0,0,0,0,0,0
1837,Alejandro Pozo Pozo,Almería,6.4,10,8,4,4,2,4,10,40.0,6,6,1,5,4,14,10,0
1838,Benat Prados,Athletic Club,2.5,8,4,4,3,1,6,10,60.0,4,6,1,5,4,12,6,0
1839,Matteo Prati,Cagliari,9.3,23,13,4,16,3,13,19,68.4,6,11,1,10,10,33,7,1
1840,Abdon Prats,Mallorca,6.9,2,2,0,1,1,0,2,0.0,2,0,0,0,2,4,4,0
1841,Sanjin Prcic,Strasbourg,1.0,0,0,0,0,0,0,1,0.0,1,2,1,1,3,3,1,0
1842,Grischa Promel,Hoffenheim,11.6,20,14,6,8,6,10,22,45.5,12,11,2,9,6,26,19,0
1843,Ivan Provedel,Lazio,15.0,0,0,0,0,0,0,1,0.0,1,0,0,0,0,0,9,0
1844,Pubill,Almería,3.0,14,7,9,4,1,8,13,61.5,5,4,3,1,4,18,9,0
1846,Gustavo Puerta,Leverkusen,0.1,3,2,2,0,1,1,1,100.0,0,0,0,0,0,3,0,0
1847,Antonio Puertas,Granada,5.9,10,7,4,5,1,5,12,41.7,7,3,0,3,4,14,4,0
1848,Arnau Puigmal,Almería,2.7,2,1,1,1,0,1,3,33.3,2,3,0,3,3,5,2,0
1849,Christian Pulisic,Milan,9.8,10,9,4,3,3,5,8,62.5,3,7,0,7,4,14,3,0
1850,George Puscas,Genoa,2.1,0,0,0,0,0,0,3,0.0,3,1,0,1,0,0,1,0
1851,Jarrell Quansah,Liverpool,1.9,4,3,3,1,0,2,3,66.7,1,1,0,1,3,7,9,0
1852,Domingos Quina,Udinese,0.1,1,1,1,0,0,0,0,0.0,0,0,0,0,0,1,0,0
1853,Adrien Rabiot,Juventus,14.0,34,20,13,19,2,21,30,70.0,9,18,5,13,15,49,16,0
1854,Uros Racic,Sassuolo,3.8,5,2,2,3,0,0,4,0.0,4,7,2,5,3,8,12,0
1855,Nemanja Radonjic,Torino,4.0,1,1,0,0,1,1,3,33.3,2,3,0,3,0,1,0,0
1856,Ionut Radu,Bournemouth,2.0,0,0,0,0,0,0,0,0.0,0,0,0,0,0,0,0,0
1857,Boris Radunovic,Cagliari,7.0,0,0,0,0,0,0,0,0.0,0,0,0,0,1,1,1,2
1858,Hamza Rafia,Lecce,7.5,23,17,7,15,1,4,12,33.3,8,16,1,15,7,30,5,0
1859,Antonio Raillo,Mallorca,4.9,4,2,2,2,0,2,2,100.0,0,9,4,5,8,12,18,1
1860,Luca Raimund,Stuttgart,0.2,3,1,2,1,0,0,0,0.0,0,1,0,1,0,3,0,0
1861,Predrag Rajkovic,Mallorca,16.0,1,1,1,0,0,1,1,100.0,0,0,0,0,0,1,6,0
1862,Jesuran Rak Sakyi,Crystal Palace,1.5,4,1,3,1,0,2,3,66.7,1,2,0,2,3,7,1,0
1863,Ivan Rakitic,Sevilla,13.1,26,14,8,10,8,9,13,69.2,4,10,3,7,9,35,10,0
1864,Ylber Ramadani,Lecce,13.5,24,15,12,9,3,13,36,36.1,23,20,6,14,21,45,18,0
1865,Largie Ramazani,Almería,9.8,11,7,4,6,1,6,25,24.0,19,6,2,4,20,31,4,0
1866,Benito Ramirez,Las Palmas,1.1,3,1,1,2,0,2,2,100.0,0,2,1,1,0,3,0,0
1867,Sandro Ramirez,Las Palmas,5.1,5,5,1,3,1,2,4,50.0,2,4,0,4,0,5,4,0
1868,Chris Ramos,Cádiz,12.8,14,9,5,8,1,5,17,29.4,12,9,4,5,6,20,27,0
1869,Goncalo Ramos,Paris S-G,7.5,13,7,4,4,5,5,13,38.5,8,5,1,4,0,13,8,0
1870,Sergio Ramos,Sevilla,6.0,7,5,4,2,1,4,7,57.1,3,6,6,0,12,19,30,0
1872,Aaron Ramsdale,Arsenal,5.0,0,0,0,0,0,0,0,0.0,0,0,0,0,0,0,3,1
1873,Aaron Ramsey,Burnley,2.9,7,6,4,1,2,3,8,37.5,5,7,0,7,0,7,4,0
1874,Jacob Ramsey,Aston Villa,1.5,7,3,4,2,1,1,5,20.0,4,2,0,2,1,8,1,0
1875,Luca Ranieri,Fiorentina,6.4,2,2,2,0,0,2,3,66.7,1,9,7,2,9,11,13,0
1876,Filippo Ranocchia,Empoli,4.1,8,7,3,5,0,5,13,38.5,8,8,1,7,1,9,13,0
1877,Grant Ranos,M'Gladbach,0.4,0,0,0,0,0,0,0,0.0,0,0,0,0,0,0,0,0
1878,Raphinha,Barcelona,4.8,5,2,1,3,1,2,8,25.0,6,5,0,5,2,7,2,0
1879,Nicolai Rapp,Werder Bremen,0.8,3,2,2,1,0,2,2,100.0,0,2,0,2,2,5,8,0
1880,Elba Rashani,Clermont Foot,5.1,10,8,1,8,1,3,10,30.0,7,11,1,10,3,13,5,0
1881,Marcus Rashford,Manchester Utd,12.2,7,4,2,1,4,4,12,33.3,8,6,1,5,1,8,8,0
1882,Giacomo Raspadori,Napoli,9.0,15,7,4,6,5,4,8,50.0,4,7,0,7,3,18,3,0
1883,Andrei Ratiu,Rayo Vallecano,2.0,5,2,2,2,1,4,7,57.1,3,1,0,1,0,5,2,0
1884,Raul,Osasuna,4.1,6,2,3,1,2,1,4,25.0,3,1,1,0,2,8,4,0
1885,David Raum,RB Leipzig,13.7,25,14,11,11,3,16,28,57.1,12,23,4,19,7,32,29,2
1886,David Raya,Arsenal,11.0,0,0,0,0,0,0,0,0.0,0,0,0,0,0,0,2,3
1887,Tim Ream,Fulham,12.7,17,9,11,4,2,7,13,53.8,6,13,7,6,20,37,40,2
1888,Abderrahman Rebbach,Alavés,4.7,5,2,1,2,2,4,10,40.0,6,6,0,6,2,7,2,0
1889,Nathan Redmond,Burnley,1.3,2,1,0,0,2,1,3,33.3,2,0,0,0,0,2,3,0
1890,Harrison Reed,Fulham,8.5,13,8,4,6,3,6,16,37.5,10,9,4,5,7,20,12,0
1891,Sergio Reguilon,Manchester Utd,4.5,13,8,6,2,5,8,17,47.1,9,8,0,8,5,18,7,0
1892,Bobby Reid,Fulham,7.2,13,9,3,9,1,3,7,42.9,4,12,1,11,0,13,8,0
1893,Tijjani Reijnders,Milan,13.9,20,9,6,12,2,7,16,43.8,9,11,3,8,7,27,14,0
1894,Reinier,Frosinone,5.8,11,5,2,7,2,3,8,37.5,5,10,2,8,4,15,3,0
1895,Rocco Reitz,M'Gladbach,10.5,24,16,9,14,1,12,22,54.5,10,18,8,10,10,34,21,0
1896,Alex Remiro,Real Sociedad,16.0,0,0,0,0,0,0,0,0.0,0,0,0,0,0,0,12,2
1898,Guillaume Restes,Toulouse,15.0,0,0,0,0,0,0,1,0.0,1,0,0,0,0,0,9,1
1899,Mateo Retegui,Genoa,8.8,6,4,3,2,1,1,4,25.0,3,3,0,3,0,6,4,0
1900,Marco Reus,Dortmund,9.3,19,16,8,9,2,5,11,45.5,6,9,0,9,4,23,8,0
1901,Elvis Rexhbecaj,Augsburg,13.3,19,13,6,11,2,12,20,60.0,8,23,4,19,10,29,11,0
1902,Gio Reyna,Dortmund,2.0,7,5,2,3,2,2,5,40.0,3,4,0,4,1,8,4,0
1903,Chadi Riad,Betis,10.3,16,9,8,8,0,8,13,61.5,5,7,4,3,9,25,51,0
1904,Alexsandro Ribeiro,Lille,12.4,20,14,17,3,0,11,18,61.1,7,12,5,7,21,41,61,0
1905,Samuele Ricci,Torino,9.5,16,8,8,7,1,8,12,66.7,4,6,1,5,8,24,10,0
1906,Declan Rice,Arsenal,15.4,33,19,16,15,2,15,28,53.6,13,19,5,14,24,57,25,0
1907,Chris Richards,Crystal Palace,4.3,13,9,8,5,0,6,6,100.0,0,8,4,4,5,18,20,0
1908,Amir Richardson,Reims,8.5,17,10,7,8,2,5,13,38.5,8,17,4,13,10,27,19,0
1909,Richarlison,Tottenham,7.1,7,5,3,2,2,2,5,40.0,3,16,3,13,6,13,7,0
1910,Marco Richter,Mainz 05,4.1,4,1,1,2,1,1,2,50.0,1,3,0,3,0,4,1,0
1911,Diego Rico,Getafe,10.8,29,20,14,13,2,19,34,55.9,15,4,2,2,18,47,27,0
1912,Clemens Riedel,Darmstadt 98,2.2,7,3,6,1,0,4,8,50.0,4,3,0,3,4,11,12,0
1913,Fabian Rieder,Rennes,2.6,5,4,1,3,1,2,5,40.0,3,1,1,0,2,7,1,0
1914,Jairo Riedewald,Crystal Palace,1.1,3,1,0,1,2,1,2,50.0,1,0,0,0,2,5,0,0
1915,Manuel Riemann,Bochum,14.0,1,0,1,0,0,1,1,100.0,0,0,0,0,1,2,9,0
1916,Luis Rioja,Alavés,14.0,15,12,5,9,1,6,16,37.5,10,11,0,11,8,23,14,0
1917,Remy Riou,Lyon,3.0,0,0,0,0,0,0,1,0.0,1,0,0,0,0,0,1,1
1918,Rodrigo Riquelme,Atlético Madrid,6.0,8,4,6,2,0,6,12,50.0,6,7,0,7,1,9,7,0
1919,Mihailo Ristic,Celta Vigo,4.1,3,2,2,1,0,2,2,100.0,0,6,1,5,2,5,9,0
1920,Matt Ritchie,Newcastle Utd,1.1,3,2,1,2,0,2,3,66.7,1,0,0,0,1,4,5,0
1921,Gorka Rivera Alonso,Getafe,0.0,0,0,0,0,0,0,0,0.0,0,0,0,0,0,0,0,0
1922,Sergi Roberto,Barcelona,2.1,2,2,1,1,0,1,2,50.0,1,1,1,0,2,4,0,0
1924,Lucas Robertone,Almería,10.2,23,13,6,13,4,11,20,55.0,9,12,4,8,25,48,15,0
1925,Connor Roberts,Burnley,8.3,11,5,6,3,2,7,14,50.0,7,8,6,2,4,15,22,2
1926,Andrew Robertson,Liverpool,8.0,15,11,11,3,1,10,17,58.8,7,6,3,3,8,23,21,0
1927,Antonee Robinson,Fulham,14.6,39,24,23,11,5,19,41,46.3,22,20,1,19,40,79,41,1
1928,Jack Robinson,Sheffield Utd,15.5,18,12,11,7,0,12,20,60.0,8,25,15,10,16,34,65,2
1929,Marc Roca,Betis,13.1,26,18,7,15,4,15,27,55.6,12,16,1,15,12,38,9,1
1930,Sebastian Rode,Eint Frankfurt,0.3,3,2,0,2,1,2,3,66.7,1,0,0,0,1,4,0,0
1931,Rodri,Manchester City,12.1,27,18,12,11,4,13,23,56.5,10,10,3,7,12,39,12,2
1932,Rodri,Betis,5.8,8,3,3,4,1,5,13,38.5,8,5,0,5,4,12,1,0
1933,Oscar Rodriguez Arnaiz,Getafe,3.3,8,5,1,6,1,2,5,40.0,3,1,0,1,2,10,1,0
1934,Dani Rodriguez,Mallorca,13.0,24,13,9,11,4,13,21,61.9,8,12,3,9,5,29,9,0
1935,Guido Rodriguez,Betis,11.9,22,12,12,7,3,16,31,51.6,15,16,3,13,15,37,30,0
1936,Jay Rodriguez,Burnley,7.0,11,7,4,4,3,5,9,55.6,4,7,1,6,1,12,7,0
1937,Kirian Rodriguez,Las Palmas,14.7,25,18,12,11,2,14,36,38.9,22,17,3,14,12,37,9,0
1938,Miguel Rodriguez,Celta Vigo,0.8,1,0,0,0,1,1,1,100.0,0,0,0,0,1,2,0,0
1939,Ricardo Rodriguez,Torino,13.9,26,17,9,17,0,15,26,57.7,11,10,4,6,11,37,30,1
1940,Rodrygo,Real Madrid,12.7,6,6,1,4,1,2,6,33.3,4,3,0,3,4,10,1,0
1941,Mads Roerslev,Brentford,5.8,12,6,10,2,0,6,17,35.3,11,2,0,2,4,16,24,0
1942,Rogerio,Wolfsburg,5.3,4,2,4,0,0,2,3,66.7,1,9,3,6,3,7,9,1
1943,Merlin Rohl,Freiburg,6.8,10,5,6,3,1,3,12,25.0,9,12,1,11,1,11,15,0
1944,Alessio Romagnoli,Lazio,12.0,8,5,2,6,0,4,6,66.7,2,14,9,5,14,22,47,0
1945,Simone Romagnoli,Frosinone,11.4,14,5,8,5,1,7,8,87.5,1,17,11,6,11,25,67,0
1946,Carlos Romero,Villarreal,1.9,5,2,3,0,2,4,7,57.1,3,2,0,2,1,6,5,0
1947,Cristian Romero,Tottenham,11.5,29,20,18,10,1,15,19,78.9,4,16,7,9,17,46,47,0
1948,Luka Romero,Milan,1.0,0,0,0,0,0,0,3,0.0,3,2,0,2,0,0,0,0
1950,Oriol Romeu,Barcelona,7.0,20,12,12,7,1,9,14,64.3,5,8,2,6,6,26,12,0
1951,Valentin Rongier,Marseille,9.5,23,12,9,12,2,14,26,53.8,12,16,4,12,15,38,18,0
1952,Frank Ronstadt,Darmstadt 98,0.2,0,0,0,0,0,0,1,0.0,1,1,0,1,1,1,1,0
1953,Marten de Roon,Atalanta,14.0,38,18,18,17,3,19,46,41.3,27,13,2,11,20,58,24,0
1954,Unai Ropero,Alavés,0.1,0,0,0,0,0,0,0,0.0,0,0,0,0,0,0,0,0
1955,Pablo Rosario,Nice,8.3,15,10,8,6,1,8,12,66.7,4,4,2,2,9,24,10,0
1956,Joe Rothwell,Bournemouth,4.1,7,2,4,2,1,2,8,25.0,6,4,2,2,2,9,1,0
1957,Anthony Rouault,Stuttgart,4.5,10,7,8,2,0,7,9,77.8,2,7,4,3,3,13,9,0
1958,Jerome Roussillon,Union Berlin,3.6,7,4,3,2,2,3,5,60.0,2,6,2,4,3,10,7,0
1959,Nicolo Rovella,Lazio,7.2,15,11,10,4,1,7,19,36.8,12,13,1,12,12,27,10,0
1960,Amir Rrahmani,Napoli,9.5,9,8,3,6,0,8,14,57.1,6,12,6,6,9,18,25,0
1961,Ruan,Sassuolo,7.9,9,5,4,3,2,3,6,50.0,3,6,4,2,11,20,34,1
1962,Pelly Ruddock Mpanzu,Luton Town,8.0,8,1,2,6,0,4,8,50.0,4,8,3,5,6,14,12,1
1963,Antonio Rudiger,Real Madrid,14.5,14,9,10,1,3,10,13,76.9,3,16,14,2,5,19,47,0
1964,Fabian Rudlin,Freiburg,0.1,1,0,0,0,1,0,0,0.0,0,0,0,0,0,1,0,0
1965,Daniele Rugani,Juventus,5.8,1,0,0,1,0,0,1,0.0,1,7,2,5,6,7,24,0
1966,Matteo Ruggeri,Atalanta,12.7,14,6,8,3,3,9,15,60.0,6,21,2,19,12,26,17,0
1967,Mario Rui,Napoli,3.9,11,5,6,1,4,6,9,66.7,3,6,2,4,5,16,8,0
1968,Aitor Ruibal,Betis,4.4,14,7,7,6,1,11,27,40.7,16,3,0,3,7,21,10,0
1969,Fabian Ruiz Pena,Paris S-G,6.7,22,13,11,8,3,15,22,68.2,7,7,2,5,3,25,8,0
1970,Sergio Ruiz,Granada,9.0,27,13,13,10,4,14,30,46.7,16,9,1,8,9,36,10,1
1971,Julian Ryerson,Dortmund,9.9,22,15,15,5,2,17,24,70.8,7,16,2,14,6,28,20,2
1972,Frederik Ronnow,Union Berlin,13.0,0,0,0,0,0,0,0,0.0,0,0,0,0,1,1,9,1
1973,Jose Sa,Wolves,14.2,0,0,0,0,0,0,0,0.0,0,3,0,3,0,0,6,3
1974,Youssouf Sabaly,Betis,3.0,6,3,5,0,1,2,3,66.7,1,3,1,2,3,9,10,0
1976,Emmanuel Sabbi,Le Havre,3.4,6,1,3,2,1,4,10,40.0,6,9,0,9,1,7,1,0
1977,Stefano Sabelli,Genoa,11.7,22,10,12,10,0,6,13,46.2,7,12,1,11,10,32,15,0
1978,Marcel Sabitzer,Dortmund,8.3,14,9,8,6,0,9,18,50.0,9,15,6,9,6,20,18,0
1979,Falaye Sacko,Montpellier,13.6,27,15,12,10,5,21,32,65.6,11,18,7,11,20,47,31,0
1980,Umar Sadiq,Real Sociedad,5.7,4,2,0,2,2,1,3,33.3,2,5,0,5,0,4,4,0
1981,Alexis Saelemaekers,Bologna,6.8,10,6,4,5,1,5,13,38.5,8,6,1,5,3,13,3,1
1982,Wesley Said,Lens,4.0,0,0,0,0,0,0,2,0.0,2,2,0,2,3,3,1,0
1983,Theo Sainte-Luce,Montpellier,3.5,14,5,9,4,1,9,15,60.0,6,9,4,5,3,17,14,0
1984,Bukayo Saka,Arsenal,14.5,33,19,12,9,12,12,25,48.0,13,26,2,24,6,39,7,1
1985,Mamadou Sakho,Montpellier,0.1,1,1,1,0,0,1,1,100.0,0,0,0,0,0,1,1,0
1986,Ibrahim Salah,Rennes,2.8,6,5,1,2,3,4,4,100.0,0,2,0,2,4,10,3,0
1987,Mohamed Salah,Liverpool,15.3,11,8,0,4,7,5,15,33.3,10,10,1,9,2,13,0,0
1988,Amine Salama,Reims,2.2,0,0,0,0,0,0,0,0.0,0,1,0,1,0,0,1,0
1989,Kike Salas,Sevilla,2.2,6,5,4,1,1,4,6,66.7,2,1,1,0,5,11,11,0
1990,William Saliba,Arsenal,16.0,17,9,11,6,0,11,12,91.7,1,12,6,6,9,26,33,1
1991,Mohammed Salisu,Monaco,1.0,2,2,0,2,0,2,3,66.7,1,0,0,0,2,4,4,0
1992,Roland Sallai,Freiburg,7.2,6,2,4,0,2,3,9,33.3,6,11,1,10,3,9,14,0
1993,Yoann Salmier,Le Havre,11.1,15,8,8,5,2,8,11,72.7,3,16,11,5,15,30,41,0
1994,Salvi,Rayo Vallecano,0.3,0,0,0,0,0,0,4,0.0,4,0,0,0,1,1,0,0
1995,Lazar Samardzic,Udinese,11.8,11,6,6,4,1,4,15,26.7,11,9,3,6,5,16,9,0
1996,Diadie Samassekou,Hoffenheim,0.0,0,0,0,0,0,0,0,0.0,0,0,0,0,1,1,0,0
1997,Mama Samba Balde,Lyon,4.4,5,3,0,1,4,2,6,33.3,4,0,0,0,1,6,1,1
1998,Brice Samba,Lens,15.0,0,0,0,0,0,0,0,0.0,0,0,0,0,0,0,4,1
1999,Albert Sambi Lokonga,Luton Town,1.6,3,0,1,1,1,2,3,66.7,1,0,0,0,1,4,0,0
2000,Junior Sambia,Salernitana,0.6,1,1,1,0,0,1,2,50.0,1,0,0,0,0,1,2,0
2002,Fede San Emeterio,Cádiz,1.5,3,2,2,1,0,1,4,25.0,3,3,2,1,1,4,1,0
2003,Antonio Sanabria,Torino,8.3,8,7,3,4,1,2,3,66.7,1,3,0,3,5,13,4,0
2004,Marciano Sanca,Almería,0.5,0,0,0,0,0,0,0,0.0,0,0,0,0,0,0,0,0
2005,Oihan Sancet,Athletic Club,11.6,10,7,1,5,4,4,12,33.3,8,3,1,2,3,13,1,0
2006,Renato Sanches,Roma,1.1,2,1,1,1,0,2,3,66.7,1,1,0,1,0,2,1,0
2007,Ricard Sanchez,Granada,12.2,13,7,5,4,4,4,8,50.0,4,11,0,11,9,22,31,0
2008,Alexis Sanchez,Inter,1.4,1,1,0,1,0,0,0,0.0,0,1,0,1,1,2,1,0
2009,Antonio Sanchez,Mallorca,5.8,15,4,10,4,1,10,20,50.0,10,13,5,8,2,17,4,0
2010,Davinson Sanchez,Tottenham,0.9,0,0,0,0,0,0,0,0.0,0,3,2,1,1,1,2,0
2011,Juanlu Sanchez,Sevilla,6.0,25,15,14,10,1,18,29,62.1,11,11,4,7,4,29,15,0
2012,Manu Sanchez,Celta Vigo,10.5,28,18,13,13,2,15,27,55.6,12,8,1,7,12,40,35,0
2013,Robert Sanchez,Chelsea,15.9,0,0,0,0,0,0,0,0.0,0,0,0,0,0,0,11,3
2014,Jadon Sancho,Manchester Utd,0.9,1,0,1,0,0,1,3,33.3,2,1,0,1,1,2,0,0
2015,Alex Sandro,Juventus,3.1,4,2,1,3,0,2,3,66.7,1,4,3,1,6,10,10,0
2016,Ibou Sane,Metz,0.3,2,1,1,0,1,0,0,0.0,0,2,0,2,0,2,1,0
2017,Leroy Sane,Bayern Munich,12.6,9,5,3,4,2,4,8,50.0,4,7,0,7,3,12,2,0
2018,Sadibou Sane,Metz,0.5,1,0,1,0,0,0,0,0.0,0,0,0,0,1,2,0,0
2019,Arouna Sangante,Le Havre,13.0,22,15,12,9,1,7,15,46.7,8,16,12,4,32,54,42,0
2020,Ibrahim Sangare,Nott'ham Forest,8.3,29,15,16,9,4,9,19,47.4,10,19,5,14,9,38,17,0
2021,Morgan Sanson,Nice,12.1,18,12,6,7,5,9,19,47.4,10,15,5,10,13,31,7,0
2022,Nicola Sansone,Lecce,3.3,6,4,4,1,1,3,8,37.5,5,3,1,2,2,8,1,0
2023,Baptiste Santamaria,Rennes,6.3,15,7,7,5,3,6,12,50.0,6,4,1,3,7,22,7,0
2024,Andrey Santos,Nott'ham Forest,0.1,0,0,0,0,0,0,0,0.0,0,1,0,1,0,0,0,0
2025,Tiago santos,Lille,10.2,21,17,9,8,4,12,26,46.2,14,11,1,10,8,29,13,0
2026,Riccardo Saponara,Hellas Verona,1.8,2,0,1,0,1,0,2,0.0,2,3,0,3,0,2,0,0
2028,Pablo Sarabia,Wolves,4.1,6,4,3,3,0,4,8,50.0,4,6,1,5,2,8,2,0
2029,Amin Sarr,Lyon,1.1,1,0,0,1,0,0,0,0.0,0,1,0,1,0,1,1,0
2030,Amin Sarr,Wolfsburg,1.1,0,0,0,0,0,0,0,0.0,0,1,1,0,0,0,0,0
2031,Bouna Sarr,Bayern Munich,1.2,2,0,1,1,0,2,2,100.0,0,3,0,3,0,2,1,0
2032,Ismaila Sarr,Marseille,8.8,9,5,1,7,1,2,11,18.2,9,10,3,7,9,18,2,0
2033,Mamadou Sarr,Lyon,0.1,0,0,0,0,0,0,0,0.0,0,0,0,0,0,0,0,0
2034,Martin Satriano,Brest,7.4,8,6,3,5,0,3,7,42.9,4,9,3,6,3,11,16,0
2035,Teji Savanier,Montpellier,14.4,14,10,4,6,4,5,27,18.5,22,18,2,16,10,24,8,1
2036,Stefan Savic,Atlético Madrid,7.6,12,9,8,3,1,6,15,40.0,9,18,9,9,17,29,22,0
2037,Savio,Girona,14.5,19,13,6,10,3,7,13,53.8,6,20,0,20,5,24,5,1
2038,Saba Sazonov,Torino,1.4,3,3,2,1,0,1,1,100.0,0,2,2,0,1,4,7,0
2039,Joe Scally,M'Gladbach,10.9,25,16,10,13,2,14,20,70.0,6,15,6,9,10,35,37,0
2040,Giorgio Scalvini,Atalanta,12.0,30,18,20,9,1,10,16,62.5,6,25,10,15,31,61,37,0
2041,Gianluca Scamacca,Atalanta,5.6,4,4,2,1,1,3,4,75.0,1,2,0,2,1,5,2,0
2042,Kevin Schade,Brentford,2.9,2,1,1,1,0,0,3,0.0,3,0,0,0,1,3,3,0
2043,Andras Schafer,Union Berlin,0.6,2,1,0,2,0,1,1,100.0,0,0,0,0,1,3,0,0
2044,Fabian Schar,Newcastle Utd,16.0,22,14,17,4,1,8,16,50.0,8,16,12,4,15,37,62,0
2045,Patrik Schick,Leverkusen,0.3,1,1,0,0,1,0,0,0.0,0,0,0,0,0,1,0,0
2046,Stefan Schimmer,Heidenheim,0.5,1,1,0,1,0,0,3,0.0,3,1,0,1,1,2,3,0
2047,Xaver Schlager,RB Leipzig,12.7,38,24,17,19,2,11,27,40.7,16,20,4,16,10,48,9,0
2048,Keven Schlotterbeck,Bochum,7.0,10,5,8,2,0,6,6,100.0,0,12,9,3,6,16,29,0
2049,Nico Schlotterbeck,Dortmund,12.7,24,18,12,11,1,15,26,57.7,11,20,10,10,16,40,39,2
2050,Jeffrey Schlupp,Crystal Palace,11.0,27,16,11,13,3,7,12,58.3,5,9,1,8,6,33,18,0
2051,Romano Schmid,Werder Bremen,12.5,18,11,5,11,2,10,25,40.0,15,17,1,16,3,21,9,2
2052,Kenneth Schmidt,Freiburg,0.8,2,2,2,0,0,2,4,50.0,2,1,0,1,1,3,2,0
2054,Niklas Schmidt,Toulouse,8.8,28,18,11,14,3,12,21,57.1,9,8,5,3,4,32,9,0
2055,Benno Schmitz,Köln,4.8,9,4,7,2,0,6,13,46.2,7,8,1,7,2,11,9,0
2056,Fabian Schnellhardt,Darmstadt 98,1.4,2,0,1,1,0,1,3,33.3,2,1,0,1,3,5,5,0
2057,Jan Schoppner,Heidenheim,5.0,8,2,5,3,0,6,12,50.0,6,4,2,2,7,15,15,0
2058,Marcel Schuhen,Darmstadt 98,13.0,0,0,0,0,0,0,0,0.0,0,0,0,0,0,0,5,3
2059,Perr Schuurs,Torino,8.6,20,12,11,8,1,3,9,33.3,6,10,2,8,9,29,23,0
2060,Marvin Schwabe,Köln,14.0,0,0,0,0,0,0,0,0.0,0,0,0,0,0,0,5,0
2061,Alex Scott,Bournemouth,2.1,1,1,1,0,0,1,3,33.3,2,2,1,1,2,3,1,0
2062,Simone Scuffet,Cagliari,8.0,1,0,1,0,0,1,1,100.0,0,0,0,0,0,1,1,0
2063,Jeremy Sebas,Strasbourg,0.4,1,0,1,0,0,1,1,100.0,0,0,0,0,0,1,0,0
2064,Demba Seck,Torino,4.7,5,3,1,4,0,3,4,75.0,1,1,0,1,1,6,0,0
2065,Aleksandar Sedlar,Alavés,10.5,14,10,10,4,0,10,16,62.5,6,8,4,4,13,27,43,0
2066,Alidu Seidu,Clermont Foot,10.6,25,18,12,13,0,17,24,70.8,7,10,5,5,21,46,29,0
2067,Nicolas Seiwald,RB Leipzig,1.5,10,6,6,3,1,4,6,66.7,2,4,1,3,1,11,0,0
2068,Davie Selke,Köln,9.4,2,1,1,1,0,0,1,0.0,1,3,2,1,0,2,14,0
2069,Matz Sels,Strasbourg,15.0,0,0,0,0,0,0,0,0.0,0,2,0,2,0,0,10,0
2070,Nelson Semedo,Wolves,14.7,37,22,25,6,6,17,25,68.0,8,18,6,12,17,54,39,0
2071,Vivaldo Semedo,Udinese,0.1,0,0,0,0,0,0,0,0.0,0,0,0,0,0,0,0,0
2072,Antoine Semenyo,Bournemouth,7.5,10,6,4,3,3,3,6,50.0,3,7,0,7,2,12,5,0
2073,Marvin Senaya,Strasbourg,8.8,30,20,17,10,3,19,31,61.3,12,17,7,10,18,48,23,0
2074,Marcos Senesi,Bournemouth,10.4,25,13,14,10,1,8,26,30.8,18,21,12,9,11,36,48,1
2075,Stefano Sensi,Inter,0.3,0,0,0,0,0,0,1,0.0,1,1,0,1,1,1,0,0
2076,Suat Serdar,Hellas Verona,2.6,6,4,2,3,1,0,2,0.0,2,1,0,1,2,8,4,0
2077,Benjamin Sesko,RB Leipzig,3.6,5,2,2,3,0,1,3,33.3,2,7,1,6,1,6,5,0
2078,Kevin Sessa,Heidenheim,2.0,0,0,0,0,0,0,4,0.0,4,4,0,4,1,1,3,0
2080,Aaron Seydel,Darmstadt 98,2.9,2,1,0,2,0,0,0,0.0,0,5,2,3,0,2,5,0
2081,Stephan El Shaarawy,Roma,6.3,6,3,4,2,0,0,3,0.0,3,5,2,3,2,8,6,0
2082,Luke Shaw,Manchester Utd,5.7,5,4,3,2,0,4,8,50.0,4,10,6,4,3,8,26,0
2083,Eldor Shomurodov,Cagliari,3.5,2,1,0,1,1,2,5,40.0,3,1,0,1,1,3,0,0
2084,Steven Shpendi,Empoli,2.9,0,0,0,0,0,0,1,0.0,1,2,1,1,1,1,0,0
2085,Vincent Sierro,Toulouse,10.3,11,5,2,7,2,7,27,25.9,20,10,2,8,12,23,10,0
2086,Tim Siersleben,Heidenheim,9.0,25,9,19,6,0,8,19,42.1,11,15,10,5,17,42,24,1
2087,Kiliann Sildillia,Freiburg,9.7,22,9,14,5,3,16,25,64.0,9,10,5,5,9,31,24,0
2088,Andre Silva,Real Sociedad,0.4,0,0,0,0,0,0,1,0.0,1,0,0,0,0,0,0,0
2089,Bernardo Silva,Manchester City,12.1,25,13,8,11,6,14,29,48.3,15,15,3,12,4,29,5,1
2090,Caio Henrique Oliveira Silva,Monaco,5.9,12,6,3,6,3,6,9,66.7,3,7,1,6,3,15,8,0
2091,Fabio Silva,Wolves,2.9,7,4,3,4,0,2,3,66.7,1,1,0,1,2,9,0,0
2092,Rui Silva,Betis,6.5,0,0,0,0,0,0,2,0.0,2,0,0,0,1,1,4,0
2093,Thiago Silva,Chelsea,15.0,17,9,14,2,1,13,20,65.0,7,16,13,3,13,30,62,1
2094,Marco Silvestri,Udinese,15.0,0,0,0,0,0,0,3,0.0,3,1,0,1,0,0,4,3
2095,Mohamed Simakan,RB Leipzig,13.4,24,15,16,8,0,16,23,69.6,7,19,7,12,19,43,38,0
2096,Giovanni Simeone,Napoli,2.9,4,0,1,1,2,1,7,14.3,6,4,0,4,0,4,2,0
2097,Moses Simon,Nantes,13.9,2,1,0,2,0,1,4,25.0,3,7,1,6,3,5,5,0
2098,Unai Simon,Athletic Club,16.0,0,0,0,0,0,0,1,0.0,1,0,0,0,0,0,7,0
2099,Xavi Simons,RB Leipzig,12.2,10,3,4,5,1,7,13,53.8,6,11,0,11,4,14,0,0
2100,Wilfried Singo,Monaco,14.0,18,15,10,8,0,6,11,54.5,5,15,8,7,28,46,48,1
2101,Luis Sinisterra,Bournemouth,3.0,10,5,6,2,2,4,10,40.0,6,6,0,6,3,13,1,0
2102,Daley Sinkgraven,Las Palmas,1.6,3,2,2,1,0,0,5,0.0,5,2,1,1,2,5,3,0
2103,Ayanda Sishuba,Lens,0.4,1,0,0,0,1,0,0,0.0,0,1,0,1,0,1,0,0
2104,Ibrahima Sissoko,Strasbourg,4.7,17,12,6,8,3,10,13,76.9,3,6,4,2,5,22,7,0
2106,Moussa Sissoko,Nantes,3.8,4,1,2,1,1,2,5,40.0,3,0,0,0,1,5,9,0
2107,Antonio Sivera,Alavés,16.0,0,0,0,0,0,0,1,0.0,1,0,0,0,0,0,8,0
2108,Tim Skarke,Darmstadt 98,10.0,11,9,8,2,1,7,13,53.8,6,8,1,7,4,15,8,0
2109,Ellyes Skhiri,Eint Frankfurt,12.0,23,13,7,13,3,10,21,47.6,11,19,2,17,17,40,27,1
2110,Oliver Skipp,Tottenham,2.7,8,4,5,3,0,3,5,60.0,2,5,1,4,0,8,1,0
2111,Leo Skiri Ostigard,Napoli,8.7,17,9,10,7,0,3,6,50.0,3,7,6,1,8,25,33,0
2112,Lukasz Skorupski,Bologna,15.0,1,1,1,0,0,1,1,100.0,0,0,0,0,0,1,6,0
2113,Robert Skov,Hoffenheim,8.1,14,9,8,5,1,10,22,45.5,12,12,1,11,7,21,13,1
2114,Milan Skriniar,Paris S-G,12.5,19,15,13,6,0,12,17,70.6,5,16,9,7,10,29,31,0
2115,Naatan Skytta,Toulouse,0.2,0,0,0,0,0,0,0,0.0,0,0,0,0,0,0,0,0
2116,Chris Smalling,Roma,2.7,1,1,1,0,0,1,3,33.3,2,1,0,1,4,5,3,0
2117,Adam Smith,Bournemouth,5.4,8,3,6,0,2,5,7,71.4,2,8,5,3,4,12,17,0
2118,Emile Smith Rowe,Arsenal,1.2,1,0,1,0,0,1,2,50.0,1,3,1,2,1,2,0,0
2119,Hrvoje Smolcic,Eint Frankfurt,2.5,4,0,4,0,0,3,4,75.0,1,2,0,2,3,7,16,0
2120,Danilo Soares,Bochum,3.4,10,6,5,3,2,5,6,83.3,1,6,0,6,7,17,11,0
2121,Eduard Sobol,Strasbourg,0.3,0,0,0,0,0,0,0,0.0,0,0,0,0,0,0,1,0
2122,Ruben Sobrino,Cádiz,5.7,14,8,7,5,2,7,17,41.2,10,8,1,7,5,19,9,0
2123,Emran Soglo,Marseille,0.8,2,1,0,2,0,1,1,100.0,0,4,0,4,1,3,3,0
2124,Alex Sola,Alavés,6.5,14,9,5,5,4,7,10,70.0,3,9,1,8,3,17,7,0
2125,Alex Sola,Real Sociedad,0.3,0,0,0,0,0,0,0,0.0,0,0,0,0,1,1,2,0
2126,Dominic Solanke,Bournemouth,15.8,8,4,1,5,2,4,8,50.0,4,15,2,13,3,11,21,0
2127,Ola Solbakken,Roma,0.3,0,0,0,0,0,0,0,0.0,0,0,0,0,0,0,0,0
2128,Carlos Soler,Paris S-G,5.0,7,6,2,2,3,2,11,18.2,9,6,3,3,2,9,7,0
2129,Jhon Solis,Girona,0.1,0,0,0,0,0,0,2,0.0,2,0,0,0,0,0,0,0
2130,Manor Solomon,Tottenham,2.2,3,3,1,1,1,1,2,50.0,1,4,0,4,3,6,2,0
2132,Yann Sommer,Inter,15.0,1,1,1,0,0,1,1,100.0,0,1,0,1,0,1,4,1
2133,Brandon Soppy,Torino,1.3,2,2,1,1,0,2,3,66.7,1,1,0,1,0,2,1,0
2134,David Soria,Getafe,16.0,0,0,0,0,0,0,0,0.0,0,0,0,0,0,0,6,5
2135,Alberto Soro,Granada,0.1,0,0,0,0,0,0,0,0.0,0,0,0,0,0,0,0,0
2136,Alessandro Sorrentino,Monza,1.0,0,0,0,0,0,0,0,0.0,0,0,0,0,0,0,0,0
2137,Borna Sosa,Stuttgart,0.5,0,0,0,0,0,0,1,0.0,1,0,0,0,0,0,0,0
2138,Hugo Sotelo,Celta Vigo,3.4,8,7,1,5,2,2,7,28.6,5,5,1,4,1,9,2,0
2139,Florian Sotoca,Lens,12.4,12,6,4,7,1,7,13,53.8,6,9,0,9,5,17,18,0
2140,Riccardo Sottil,Fiorentina,4.6,7,4,3,1,3,1,3,33.3,2,6,0,6,1,8,1,0
2141,Tomas Soucek,West Ham,13.0,15,11,3,11,1,7,16,43.8,9,17,9,8,17,32,41,0
2142,Matias Soule,Frosinone,12.5,22,15,9,9,4,8,19,42.1,11,21,2,19,7,29,4,0
2143,Boubakary Soumare,Sevilla,5.9,14,9,6,8,0,4,4,100.0,0,3,0,3,6,20,8,0
2144,Issa Soumare,Le Havre,2.6,2,0,2,0,0,0,4,0.0,4,0,0,0,0,2,2,0
2145,Vinicius Souza,Sheffield Utd,12.8,46,23,18,18,10,13,26,50.0,13,20,4,16,14,60,31,0
2146,Djibril Sow,Sevilla,8.9,15,12,9,5,1,6,15,40.0,9,11,0,11,9,24,5,0
2147,Caglar Soyuncu,Atlético Madrid,0.7,1,1,1,0,0,0,0,0.0,0,1,0,1,1,2,4,0
2148,Stijn Spierings,Toulouse,8.3,24,19,10,10,4,15,25,60.0,10,12,1,11,18,42,17,0
2149,Stijn Spierings,Lens,1.3,1,0,0,1,0,1,1,100.0,0,2,1,1,2,3,1,0
2150,Leonardo Spinazzola,Roma,9.5,11,4,7,4,0,6,12,50.0,6,5,1,4,3,14,7,0
2151,Marco Sportiello,Milan,2.0,0,0,0,0,0,0,0,0.0,0,0,0,0,0,0,1,0
2152,Anton Stach,Hoffenheim,9.7,29,14,18,9,2,14,25,56.0,11,11,4,7,35,64,24,0
2153,Anton Stach,Mainz 05,1.9,3,0,2,0,1,2,4,50.0,2,5,0,5,2,5,5,0
2154,Jens Stage,Werder Bremen,13.0,24,10,12,10,2,8,22,36.4,14,18,8,10,12,36,18,0
2155,Josip Stanisic,Leverkusen,1.8,3,2,2,1,0,2,3,66.7,1,1,0,1,3,6,4,0
2156,Carl Starfelt,Celta Vigo,14.6,19,16,15,3,1,9,15,60.0,6,21,17,4,20,39,101,2
2158,Niklas Stark,Werder Bremen,5.4,16,9,6,8,2,6,8,75.0,2,6,5,1,7,23,27,1
2159,Jason Steele,Brighton,9.0,0,0,0,0,0,0,1,0.0,1,0,0,0,0,0,2,0
2160,Pascal Stenzel,Stuttgart,7.6,13,7,5,7,1,9,23,39.1,14,15,6,9,12,25,19,0
2161,Leonidas Stergiou,Stuttgart,0.4,5,3,2,3,0,3,3,100.0,0,0,0,0,1,6,1,0
2162,Raheem Sterling,Chelsea,13.9,12,7,6,2,4,8,18,44.4,10,5,0,5,7,19,4,0
2163,Trivante Stewart,Salernitana,1.1,0,0,0,0,0,0,0,0.0,0,1,0,1,0,0,0,0
2164,Angelo Stiller,Hoffenheim,0.9,0,0,0,0,0,0,1,0.0,1,2,0,2,0,0,3,0
2165,Angelo Stiller,Stuttgart,11.2,23,15,8,14,1,12,23,52.2,11,16,7,9,15,38,8,1
2166,Kevin Stoger,Bochum,12.2,25,17,11,11,3,14,37,37.8,23,14,0,14,12,37,6,0
2167,Filip Stojilkovic,Darmstadt 98,1.7,1,1,0,0,1,0,0,0.0,0,0,0,0,0,1,1,0
2168,John Stones,Manchester City,4.1,2,1,1,0,1,0,2,0.0,2,7,3,4,3,5,9,0
2169,Thomas Strakosha,Brentford,1.5,0,0,0,0,0,0,0,0.0,0,0,0,0,0,0,0,0
2170,Jorgen Strand Larsen,Celta Vigo,13.9,7,4,0,7,0,4,15,26.7,11,5,1,4,2,9,7,0
2171,Gabriel Strefezza,Lecce,8.9,18,13,6,6,6,9,14,64.3,5,12,0,12,4,22,6,0
2172,Kevin Strootman,Genoa,6.0,20,9,8,10,2,8,16,50.0,8,9,3,6,3,23,9,0
2173,Cristhian Stuani,Girona,6.1,9,8,2,5,2,4,7,57.1,3,1,0,1,5,14,9,0
2174,Alex Suarez,Las Palmas,12.3,27,18,16,10,1,16,18,88.9,2,11,6,5,10,37,46,0
2175,Damian Suarez,Getafe,12.2,33,21,15,14,4,24,37,64.9,13,11,3,8,9,42,29,0
2176,Denis Suarez,Villarreal,1.5,0,0,0,0,0,0,2,0.0,2,2,2,0,0,0,4,0
2177,Gabriel Suazo,Toulouse,11.7,28,14,16,10,2,16,36,44.4,20,23,3,20,11,39,19,0
2178,Isaac Success,Udinese,7.1,4,4,0,3,1,1,2,50.0,1,3,1,2,1,5,8,0
2179,Niklas Sule,Dortmund,5.4,4,4,3,1,0,2,3,66.7,1,13,6,7,5,9,20,1
2180,Ibrahim Sulemana,Cagliari,6.1,9,2,4,4,1,5,8,62.5,3,15,2,13,3,12,7,0
2181,Tomas Suslov,Hellas Verona,6.2,11,7,1,8,2,5,14,35.7,9,6,0,6,0,11,2,0
2182,Suso,Sevilla,6.8,10,7,6,4,0,3,7,42.9,4,2,0,2,3,13,0,0
2184,Mattias Svanberg,Wolfsburg,11.6,25,9,5,13,7,6,23,26.1,17,14,4,10,11,36,18,0
2185,Williot Swedberg,Celta Vigo,0.6,2,1,1,1,0,2,2,100.0,0,0,0,0,0,2,1,0
2186,Abakar Sylla,Strasbourg,6.9,33,14,18,12,3,22,26,84.6,4,12,2,10,11,44,30,1
2187,Dembo Sylla,Lorient,0.5,1,1,0,1,0,0,0,0.0,0,0,0,0,1,2,2,0
2188,Issiaga Sylla,Montpellier,8.0,15,9,9,4,2,8,18,44.4,10,5,1,4,11,26,20,0
2189,Mamadou Sylla,Alavés,0.2,0,0,0,0,0,0,0,0.0,0,1,1,0,0,0,1,0
2190,Attila Szalai,Hoffenheim,3.2,3,1,3,0,0,1,4,25.0,3,6,2,4,1,4,7,0
2191,Wojciech Szczesny,Juventus,13.0,0,0,0,0,0,0,0,0.0,0,0,0,0,0,0,5,1
2192,Dominik Szoboszlai,Liverpool,15.0,20,12,6,8,6,11,39,28.2,28,30,1,29,8,28,15,1
2193,Przemyslaw Szyminski,Frosinone,0.1,0,0,0,0,0,0,0,0.0,0,1,1,0,0,0,0,0
2194,Alexander Sorloth,Villarreal,11.0,3,2,0,0,3,1,4,25.0,3,5,2,3,0,3,12,0
2195,Musa Al-Taamari,Montpellier,12.6,15,14,7,3,5,7,16,43.8,9,15,1,14,3,18,4,0
2196,Nicolas Tagliafico,Lyon,11.9,31,17,13,15,3,16,28,57.1,12,10,4,6,8,39,19,0
2197,Jonathan Tah,Leverkusen,12.8,13,7,7,5,1,4,10,40.0,6,17,14,3,5,18,54,1
2198,Montassar Talbi,Lorient,15.0,21,10,13,7,1,11,19,57.9,8,26,16,10,22,43,66,0
2199,Adrien Tameze,Torino,10.7,13,8,4,7,2,6,17,35.3,11,13,6,7,21,34,10,0
2200,Renato Tapia,Celta Vigo,4.2,15,9,4,11,0,3,8,37.5,5,8,2,6,2,17,8,0
2201,Edmond Tapsoba,Leverkusen,11.8,16,12,6,9,1,5,7,71.4,2,8,5,3,8,24,34,1
2202,Matt Targett,Newcastle Utd,0.9,2,0,1,1,0,1,1,100.0,0,1,0,1,0,2,2,0
2203,Oussama Targhalline,Le Havre,1.3,2,2,2,0,0,1,3,33.3,2,3,0,3,2,4,1,0
2204,James Tarkowski,Everton,16.0,21,14,15,6,0,7,15,46.7,8,32,23,9,28,49,65,2
2205,Cesar Tarrega,Valencia,0.1,0,0,0,0,0,0,0,0.0,0,0,0,0,0,0,2,0
2206,Nuno Tavares,Nott'ham Forest,1.1,2,2,2,0,0,2,2,100.0,0,1,0,1,0,2,4,0
2207,Marcus Tavernier,Bournemouth,10.0,22,12,12,7,3,9,16,56.3,7,13,1,12,2,24,9,0
2208,Charlie Taylor,Burnley,13.0,21,14,9,11,1,10,20,50.0,10,16,7,9,9,30,41,0
2210,Loum Tchaouna,Salernitana,3.5,5,1,1,4,0,2,6,33.3,4,3,0,3,2,7,3,1
2211,Jackson Tchatchoua,Hellas Verona,3.8,11,7,8,2,1,8,12,66.7,4,5,2,3,5,16,9,1
2212,Enzo Tchato,Montpellier,1.6,3,3,2,1,0,1,4,25.0,3,2,2,0,2,5,3,0
2213,Aurelien Tchouameni,Real Madrid,9.3,19,10,11,7,1,3,6,50.0,3,10,4,6,14,33,13,0
2214,Mathys Tel,Bayern Munich,2.3,2,0,0,1,1,0,0,0.0,0,4,0,4,2,4,2,0
2215,Nathan Tella,Leverkusen,0.8,0,0,0,0,0,0,0,0.0,0,2,0,2,1,1,1,0
2216,Nahuel Tenaglia,Alavés,1.2,2,2,2,0,0,2,3,66.7,1,0,0,0,1,3,9,0
2217,Arnau Tenas,Paris S-G,1.9,0,0,0,0,0,0,0,0.0,0,0,0,0,0,0,0,0
2218,Marc-Andre ter Stegen,Barcelona,13.0,0,0,0,0,0,0,0,0.0,0,0,0,0,0,0,2,1
2219,Filippo Terracciano,Hellas Verona,12.6,29,18,22,6,1,17,27,63.0,10,22,6,16,14,43,14,0
2220,Pietro Terracciano,Fiorentina,13.0,0,0,0,0,0,0,1,0.0,1,1,0,1,0,0,3,0
2221,Ramon Terrats,Villarreal,5.2,7,5,2,5,0,1,7,14.3,6,3,0,3,1,8,2,0
2222,Martin Terrier,Rennes,3.5,3,2,1,1,1,1,2,50.0,1,5,0,5,3,6,5,0
2223,Kenny Tete,Fulham,5.6,11,7,8,3,0,4,7,57.1,3,3,1,2,11,22,23,0
2224,Benjamin Tetteh,Metz,2.4,3,3,1,2,0,3,6,50.0,3,0,0,0,0,3,1,0
2225,Teddy Teuma,Reims,10.6,30,24,9,12,9,15,34,44.1,19,13,2,11,11,41,3,0
2226,Florian Thauvin,Udinese,8.6,5,2,2,2,1,4,11,36.4,7,4,0,4,0,5,1,0
2227,Arthur Theate,Rennes,11.4,7,4,6,1,0,6,10,60.0,4,17,9,8,15,22,38,1
2228,Norman Theuerkauf,Heidenheim,7.6,13,8,8,4,1,8,13,61.5,5,6,2,4,10,23,10,0
2229,Malick Thiaw,Milan,10.3,13,11,5,8,0,6,11,54.5,5,16,7,9,7,20,31,0
2230,Jan Thielmann,Köln,3.5,10,7,7,2,1,4,6,66.7,2,13,2,11,4,14,5,0
2231,Denis Thomalla,Heidenheim,3.9,6,4,2,4,0,5,9,55.6,4,2,1,1,3,9,8,0
2232,Luke Thomas,Sheffield Utd,9.2,18,9,11,6,1,8,13,61.5,5,22,5,17,10,28,25,0
2233,Adrien Thomasson,Lens,9.2,15,7,4,9,2,8,23,34.8,15,10,0,10,7,22,7,0
2234,Morten Thorsby,Genoa,6.5,8,5,3,4,1,4,8,50.0,4,10,1,9,2,10,8,0
2236,Kristian Thorstvedt,Sassuolo,7.9,8,2,2,6,0,3,7,42.9,4,9,3,6,7,15,9,0
2237,Khephren Thuram,Nice,10.1,15,12,3,9,3,8,18,44.4,10,10,4,6,6,21,13,0
2238,Marcus Thuram,Inter,12.6,9,6,5,3,1,1,7,14.3,6,7,0,7,2,11,5,0
2239,Cheikh Tidiane Sabaly,Metz,9.7,27,13,16,7,4,12,32,37.5,20,12,2,10,8,35,10,0
2240,Youri Tielemans,Aston Villa,6.3,15,6,7,8,0,7,15,46.7,8,8,0,8,7,22,4,0
2241,Kieran Tierney,Real Sociedad,4.4,9,7,5,4,0,6,9,66.7,3,6,2,4,4,13,12,0
2242,Phillip Tietz,Augsburg,10.1,6,3,4,2,0,2,7,28.6,5,7,0,7,3,9,14,0
2243,Steffen Tigges,Köln,4.1,2,1,1,0,1,0,0,0.0,0,2,1,1,1,3,4,0
2244,Jurrien Timber,Arsenal,0.5,1,1,0,1,0,0,0,0.0,0,0,0,0,0,1,1,0
2245,Jean-Clair Todibo,Nice,12.7,24,13,12,9,3,13,25,52.0,12,20,9,11,17,41,46,0
2246,Harry Toffolo,Nott'ham Forest,8.3,13,5,10,3,0,9,14,64.3,5,17,7,10,9,22,26,0
2247,Umut Tohumcu,Hoffenheim,1.7,3,3,3,0,0,3,7,42.9,4,3,1,2,1,4,2,0
2248,Corentin Tolisso,Lyon,7.8,18,13,2,8,8,9,20,45.0,11,8,3,5,4,22,9,0
2249,Jeremy Toljan,Sassuolo,14.0,8,5,4,3,1,5,10,50.0,5,13,3,10,8,16,32,1
2250,Rafael Toloi,Atalanta,4.8,6,2,3,1,2,3,6,50.0,3,1,0,1,7,13,15,0
2251,Raul de Tomas,Rayo Vallecano,6.9,6,3,2,2,2,1,4,25.0,3,1,0,1,1,7,5,0
2252,Tiago Tomas,Wolfsburg,6.0,3,1,2,0,1,1,5,20.0,4,6,0,6,1,4,5,0
2253,Takehiro Tomiyasu,Arsenal,6.5,10,4,9,1,0,6,9,66.7,3,2,0,2,9,19,17,0
2254,James Tomkins,Crystal Palace,0.0,0,0,0,0,0,0,0,0.0,0,0,0,0,0,0,0,0
2255,Fikayo Tomori,Milan,13.7,27,18,21,5,1,14,22,63.6,8,21,14,7,17,44,44,1
2256,Sandro Tonali,Newcastle Utd,4.9,7,7,4,2,1,3,9,33.3,6,3,0,3,2,9,4,0
2257,Pablo Torre,Girona,2.3,1,0,0,1,0,1,3,33.3,2,1,0,1,2,3,3,0
2258,Raul Torrente,Granada,9.5,21,13,14,7,0,14,18,77.8,4,11,7,4,8,29,41,2
2259,Ferran Torres,Barcelona,7.4,4,3,1,2,1,4,10,40.0,6,4,0,4,3,7,4,0
2260,Oliver Torres,Sevilla,6.3,14,6,6,5,3,7,20,35.0,13,13,0,13,0,14,0,0
2262,Pau Torres,Aston Villa,15.7,17,10,10,6,1,9,20,45.0,11,15,6,9,7,24,36,0
2263,Lucas Torro,Osasuna,10.9,14,9,6,5,3,5,13,38.5,8,4,1,3,19,33,18,0
2264,Fabio Torsiello,Darmstadt 98,0.0,0,0,0,0,0,0,2,0.0,2,0,0,0,0,0,0,0
2265,Ahmed Touba,Lecce,1.3,2,2,1,1,0,1,1,100.0,0,2,2,0,2,4,11,0
2266,Abdoulaye Toure,Le Havre,13.1,24,17,11,11,2,15,31,48.4,16,14,3,11,15,39,15,0
2267,Souleymane Toure,Lorient,8.0,11,5,7,4,0,4,7,57.1,3,16,11,5,19,30,40,1
2268,Lucas Tousart,Union Berlin,3.4,6,5,2,3,1,3,4,75.0,1,3,2,1,2,8,7,0
2269,Andros Townsend,Luton Town,4.4,9,8,4,1,4,6,12,50.0,6,4,0,4,4,13,2,0
2270,James Trafford,Burnley,16.0,2,1,2,0,0,2,2,100.0,0,0,0,0,1,3,9,0
2271,Adama Traore,Fulham,0.5,0,0,0,0,0,0,1,0.0,1,0,0,0,0,0,1,0
2272,Bertrand Traore,Aston Villa,0.1,1,1,1,0,0,0,0,0.0,0,0,0,0,0,1,1,0
2273,Boubacar Traore,Wolves,4.3,13,10,7,5,1,3,8,37.5,5,7,1,6,2,15,4,0
2274,Chaka Traore,Milan,0.1,1,1,1,0,0,0,1,0.0,1,0,0,0,0,1,0,0
2275,Hamari Traore,Real Sociedad,14.1,28,14,16,10,2,15,27,55.6,12,13,4,9,13,41,27,0
2276,Ismael Traore,Metz,11.0,11,8,6,5,0,6,12,50.0,6,16,8,8,16,27,44,0
2277,Omar Traore,Heidenheim,12.4,22,11,14,4,4,12,22,54.5,10,14,3,11,17,39,20,0
2278,Kevin Trapp,Eint Frankfurt,13.0,0,0,0,0,0,0,0,0.0,0,0,0,0,1,1,7,1
2279,Oscar Trejo,Rayo Vallecano,7.5,16,10,8,4,4,8,11,72.7,3,9,1,8,3,19,6,0
2280,Mike Tresor,Burnley,3.0,8,4,8,0,0,7,13,53.8,6,1,0,1,0,8,1,0
2281,Manu Trigueros,Villarreal,1.4,2,2,2,0,0,2,4,50.0,2,0,0,0,2,4,3,0
2282,Christopher Trimmel,Union Berlin,8.0,6,5,2,4,0,3,10,30.0,7,4,1,3,7,13,20,0
2283,Kieran Trippier,Newcastle Utd,15.5,27,14,13,10,4,19,44,43.2,25,24,7,17,14,41,31,3
2284,Leandro Trossard,Arsenal,5.9,8,5,4,3,1,3,8,37.5,5,14,0,14,6,14,1,0
2285,Adrien Truffert,Rennes,11.2,17,11,11,3,3,11,15,73.3,4,13,3,10,7,24,23,0
2286,Auston Trusty,Sheffield Utd,9.2,20,13,13,5,2,6,14,42.9,8,12,8,4,10,30,51,1
2288,Kostas Tsimikas,Liverpool,6.0,13,8,6,5,2,7,11,63.6,4,6,0,6,4,17,10,0
2289,Viktor Tsyhankov,Girona,10.6,10,6,5,3,2,7,13,53.8,6,9,0,9,3,13,8,0
2290,Stefano Turati,Frosinone,14.0,0,0,0,0,0,0,0,0.0,0,0,0,0,0,0,4,1
2291,Matt Turner,Nott'ham Forest,11.0,0,0,0,0,0,0,0,0.0,0,0,0,0,0,0,2,2
2292,Benat Turrientes,Real Sociedad,5.9,9,5,4,3,2,3,5,60.0,2,5,2,3,1,10,6,0
2293,Tuta,Eint Frankfurt,12.1,28,16,17,9,2,18,24,75.0,6,8,5,3,13,41,48,0
2294,Destiny Udogie,Tottenham,12.7,38,20,22,9,7,12,26,46.2,14,14,4,10,19,57,41,2
2295,Matthieu Udol,Metz,13.0,16,14,11,3,2,10,16,62.5,6,32,10,22,22,38,48,0
2296,Manuel Ugarte Ribeiro,Paris S-G,9.5,45,27,13,24,8,20,45,44.4,25,9,0,9,17,62,9,1
2297,Lesley Ugochukwu,Chelsea,2.4,10,7,1,8,1,3,7,42.9,4,4,1,3,1,11,3,0
2298,Lukas Ullrich,M'Gladbach,0.2,1,0,1,0,0,1,3,33.3,2,0,0,0,0,1,1,0
2299,Sven Ulreich,Bayern Munich,8.0,1,0,1,0,0,1,1,100.0,0,0,0,0,0,1,3,2
2300,Samuel Umtiti,Lille,2.1,1,1,0,1,0,1,4,25.0,3,0,0,0,2,3,4,0
2301,Deniz Undav,Stuttgart,7.0,6,1,2,1,3,2,7,28.6,5,3,0,3,2,8,3,0
2302,Dayot Upamecano,Bayern Munich,9.7,17,9,9,8,0,10,18,55.6,8,9,4,5,7,24,26,1
2303,Kacper Urbanski,Bologna,0.8,2,2,0,2,0,1,2,50.0,1,1,0,1,0,2,3,0
2304,Mark Uth,Köln,1.7,4,1,1,2,1,1,6,16.7,5,3,0,3,1,5,0,0
2305,Myrto Uzuni,Granada,13.1,9,7,2,5,2,4,17,23.5,13,8,0,8,1,10,4,0
2306,Josha Vagnoman,Stuttgart,1.8,4,2,2,2,0,3,5,60.0,2,3,2,1,0,4,1,0
2307,Oscar Valentin,Rayo Vallecano,13.6,48,28,20,24,4,16,41,39.0,25,29,6,23,11,59,23,1
2308,Martin Valjent,Mallorca,15.3,20,13,14,6,0,12,18,66.7,6,19,9,10,23,43,65,1
2309,Jesus Vallejo,Granada,1.1,2,1,0,2,0,1,1,100.0,0,2,1,1,0,2,0,1
2310,Alvaro Valles,Las Palmas,16.0,2,1,2,0,0,2,3,66.7,1,0,0,0,0,2,16,0
2311,Federico Valverde,Real Madrid,14.4,21,17,11,7,3,13,19,68.4,6,10,1,9,19,40,13,0
2312,Kevin Van Den Kerkhof,Metz,6.9,15,12,5,7,3,4,11,36.4,7,8,2,6,4,19,11,0
2314,Siebe Van Der Heyden,Mallorca,2.6,9,2,7,2,0,4,6,66.7,2,1,1,0,6,15,12,0
2315,Virgil van Dijk,Liverpool,13.3,19,10,13,4,2,7,7,100.0,0,20,15,5,21,40,70,0
2316,Vanderson,Monaco,9.0,26,17,7,12,7,11,30,36.7,19,15,1,14,16,42,14,1
2317,Raphael Varane,Manchester Utd,3.8,5,4,1,4,0,1,3,33.3,2,4,2,2,1,6,21,0
2318,Ruben Vargas,Augsburg,7.6,6,3,2,3,1,3,8,37.5,5,10,3,7,2,8,9,0
2319,Johan Vasquez,Genoa,11.7,24,14,19,5,0,18,23,78.3,5,24,8,16,17,41,41,0
2320,Jose Luis Garcia Vaya,Valencia,15.7,33,26,17,13,3,13,26,50.0,13,20,6,14,18,51,34,0
2321,Jesus Vazquez,Valencia,0.4,2,1,1,0,1,1,1,100.0,0,1,0,1,0,2,0,0
2322,Kevin Vazquez,Celta Vigo,5.3,11,11,7,3,1,8,14,57.1,6,8,1,7,4,15,22,0
2323,Lucas Vazquez,Real Madrid,3.4,7,5,6,1,0,2,4,50.0,2,7,1,6,4,11,7,0
2324,Matias Vecino,Lazio,3.5,6,4,1,5,0,2,5,40.0,3,6,2,4,4,10,5,0
2325,Gabriel Veiga,Celta Vigo,0.2,0,0,0,0,0,0,0,0.0,0,0,0,0,0,0,0,0
2326,Alejo Veliz,Tottenham,0.2,1,0,1,0,0,0,0,0.0,0,0,0,0,0,1,0,0
2327,Milos Veljkovic,Werder Bremen,11.2,15,7,8,6,1,10,17,58.8,7,13,9,4,4,19,28,0
2328,Joel Veltman,Brighton,9.9,26,21,13,10,3,16,27,59.3,11,12,6,6,12,38,32,1
2329,Micky van de Ven,Tottenham,10.5,18,12,12,4,2,8,10,80.0,2,7,5,2,4,22,33,0
2330,Lorenzo Venuti,Lecce,0.7,1,1,1,0,0,1,1,100.0,0,3,2,1,2,3,5,0
2331,Bart Verbruggen,Brighton,7.0,0,0,0,0,0,0,0,0.0,0,0,0,0,0,0,2,1
2332,Simone Verdi,Torino,0.0,0,0,0,0,0,0,0,0.0,0,0,0,0,0,0,0,0
2333,Jordan Veretout,Marseille,10.8,22,14,12,8,2,11,20,55.0,9,12,4,8,7,29,14,0
2334,Mikel Vesga,Athletic Club,9.3,22,11,6,14,2,10,25,40.0,15,9,2,7,14,36,19,1
2335,Guglielmo Vicario,Tottenham,16.0,0,0,0,0,0,0,1,0.0,1,0,0,0,0,0,19,2
2336,Nacho Vidal,Osasuna,0.9,5,4,2,2,1,2,5,40.0,3,2,0,2,0,5,5,0
2337,Fabio Vieira,Arsenal,2.7,3,2,2,0,1,3,3,100.0,0,0,0,0,2,5,1,0
2338,Jonathan Viera,Las Palmas,6.9,6,3,1,2,3,1,9,11.1,8,0,0,0,0,6,1,0
2340,Samuele Vignato,Monza,3.7,5,4,1,3,1,2,3,66.7,1,2,0,2,0,5,1,0
2341,Oscar Vilhelmsson,Darmstadt 98,4.9,7,3,0,4,3,3,3,100.0,0,7,2,5,1,8,4,0
2342,Asier Villalibre,Athletic Club,1.9,0,0,0,0,0,0,0,0.0,0,1,0,1,0,0,2,0
2343,Gonzalo Villar,Granada,8.1,16,13,8,7,1,9,18,50.0,9,15,4,11,2,18,13,0
2344,Ivan Villar,Celta Vigo,9.3,0,0,0,0,0,0,1,0.0,1,0,0,0,0,0,5,0
2345,Matias Vina,Sassuolo,11.3,34,21,22,7,5,20,36,55.6,16,12,2,10,9,43,34,0
2346,Carlos Vinicius,Fulham,3.1,3,2,0,1,2,0,3,0.0,3,4,0,4,0,3,1,0
2347,Nicolas Viola,Cagliari,4.9,3,3,0,2,1,2,6,33.3,4,3,0,3,1,4,3,0
2348,Alan Virginius,Lille,0.8,1,1,1,0,0,0,1,0.0,1,0,0,0,0,1,0,0
2349,Ricardo Visus,Betis,0.3,0.0,0,0.0,0.0,0.0,0.0,0.0,0.0,0.0,0.0,0.0,0.0,1,0.0,0.0,0.0
2350,Mattia Viti,Sassuolo,2.6,1,0,0,1,0,0,4,0.0,4,5,3,2,3,4,14,0
2351,Vitinha,Marseille,7.8,12,6,3,3,6,2,11,18.2,9,8,2,6,5,17,5,0
2352,Vitinha,Paris S-G,10.9,20,13,8,6,6,13,24,54.2,11,13,3,10,11,31,10,2
2353,Vitinho,Burnley,8.7,18,10,10,5,3,11,25,44.0,14,9,1,8,3,21,14,2
2354,Daniel Vivian,Athletic Club,15.7,20,12,17,3,0,15,23,65.2,8,23,11,12,12,32,55,0
2355,Odisseas Vlachodimos,Nott'ham Forest,5.0,0,0,0,0,0,0,1,0.0,1,0,0,0,0,0,1,0
2356,Dusan Vlahovic,Juventus,8.8,2,2,0,1,1,1,4,25.0,3,0,0,0,0,2,5,0
2357,Nikola Vlasic,Torino,11.0,14,9,2,6,6,2,13,15.4,11,9,2,7,3,17,7,0
2358,Alessandro Vogliacco,Genoa,2.0,2,2,0,1,1,1,1,100.0,0,0,0,0,7,9,6,0
2359,Kevin Vogt,Hoffenheim,12.7,12,8,6,6,0,7,12,58.3,5,15,12,3,8,20,48,0
2360,Mergim Vojvoda,Torino,7.2,4,3,1,2,1,3,7,42.9,4,6,0,6,7,11,7,0
2361,Kevin Volland,Union Berlin,3.7,9,4,2,3,4,2,5,40.0,3,3,0,3,1,10,2,0
2362,Cristian Volpato,Sassuolo,0.8,1,1,0,1,0,0,1,0.0,1,1,0,1,0,1,1,0
2363,Aster Vranckx,Wolfsburg,5.1,16,8,6,6,4,10,14,71.4,4,4,2,2,8,24,8,0
2364,Stefan de Vrij,Inter,8.3,10,6,6,4,0,3,8,37.5,5,12,6,6,10,20,25,0
2366,Elye Wahi,Montpellier,0.2,0,0,0,0,0,0,0,0.0,0,0,0,0,0,0,0,0
2367,Elye Wahi,Lens,6.4,1,0,0,1,0,0,2,0.0,2,1,0,1,1,2,0,0
2368,Walace,Udinese,14.2,22,14,15,7,0,12,27,44.4,15,17,2,15,17,39,19,1
2369,Luca Waldschmidt,Köln,8.6,15,8,2,11,2,5,14,35.7,9,14,3,11,5,20,8,0
2370,Kyle Walker,Manchester City,16.0,19,11,9,9,1,9,20,45.0,11,10,2,8,13,32,22,1
2371,Sebastian Walukiewicz,Empoli,5.8,8,6,8,0,0,6,10,60.0,4,14,6,8,7,15,31,0
2372,Aaron Wan-Bissaka,Manchester Utd,5.8,17,12,10,6,1,10,14,71.4,4,10,5,5,9,26,26,1
2373,Joel Ward,Crystal Palace,14.4,33,20,18,14,1,22,36,61.1,14,10,5,5,8,41,54,1
2374,James Ward-Prowse,West Ham,14.7,21,15,9,11,1,7,18,38.9,11,16,6,10,19,40,21,0
2375,Deivid Washington,Chelsea,0.1,1,1,1,0,0,0,1,0.0,1,0,0,0,0,1,0,0
2376,Ollie Watkins,Aston Villa,15.5,6,4,0,2,4,2,5,40.0,3,13,2,11,3,9,10,0
2377,Timothy Weah,Juventus,4.6,9,7,5,2,2,6,8,75.0,2,6,1,5,3,12,9,0
2378,Adam Webster,Brighton,6.0,9,9,7,2,0,5,13,38.5,8,6,3,3,5,14,23,1
2379,Wout Weghorst,Hoffenheim,10.8,8,5,3,4,1,5,7,71.4,2,14,4,10,1,9,13,0
2380,Julian Weigl,M'Gladbach,12.9,26,18,12,12,2,15,26,57.7,11,19,4,15,13,39,25,1
2381,Nelson Weiper,Mainz 05,1.2,1,0,1,0,0,1,2,50.0,1,1,0,1,1,2,0,0
2382,Mitchell Weiser,Werder Bremen,13.4,33,18,15,15,3,15,26,57.7,11,18,3,15,2,35,16,0
2383,Noah Weisshaupt,Freiburg,4.8,2,0,0,0,2,1,5,20.0,4,6,0,6,5,7,5,0
2384,Shon Weissman,Granada,0.9,1,1,0,0,1,1,4,25.0,3,3,0,3,0,1,1,0
2385,Danny Welbeck,Brighton,4.5,7,3,3,4,0,3,4,75.0,1,5,0,5,2,9,6,0
2386,Timo Werner,RB Leipzig,2.3,2,1,0,1,1,0,0,0.0,0,1,0,1,1,3,0,0
2387,Ben White,Arsenal,12.7,16,11,7,7,2,8,16,50.0,8,17,11,6,11,27,32,1
2388,Silvan Widmer,Mainz 05,2.9,9,6,6,2,1,7,8,87.5,1,2,0,2,3,12,7,0
2389,Mateusz Wieteska,Cagliari,4.5,7,7,4,1,2,1,4,25.0,3,4,2,2,5,12,15,0
2390,Mateusz Wieteska,Clermont Foot,1.9,4,1,3,1,0,3,5,60.0,2,4,2,2,5,9,8,0
2392,Inaki Williams,Athletic Club,15.4,13,9,4,4,5,8,16,50.0,8,21,3,18,8,21,15,0
2393,Neco Williams,Nott'ham Forest,2.4,14,7,8,3,3,7,13,53.8,6,9,2,7,9,23,5,0
2394,Nico Williams,Athletic Club,10.9,13,6,4,4,5,6,17,35.3,11,10,1,9,2,15,3,0
2395,Willian,Fulham,11.1,5,1,2,1,2,1,10,10.0,9,9,0,9,4,9,8,0
2396,Joe Willock,Newcastle Utd,1.5,3,2,2,1,0,2,5,40.0,3,2,0,2,0,3,1,0
2397,Callum Wilson,Newcastle Utd,5.7,2,2,0,0,2,0,1,0.0,1,3,0,3,0,2,1,0
2398,Harry Wilson,Fulham,9.3,11,7,5,4,2,6,11,54.5,5,12,1,11,5,16,2,0
2399,Josh Wilson-Esbrand,Reims,4.3,5,4,2,3,0,2,8,25.0,6,5,2,3,6,11,7,0
2400,Patrick Wimmer,Wolfsburg,3.1,7,3,5,2,0,6,7,85.7,1,8,0,8,2,9,3,0
2401,Jonas Wind,Wolfsburg,13.6,5,3,2,1,2,3,8,37.5,5,6,2,4,1,6,11,0
2402,Florian Wirtz,Leverkusen,12.1,10,7,5,3,2,4,12,33.3,8,9,0,9,4,14,1,0
2403,Yoane Wissa,Brentford,14.4,12,9,6,5,1,1,10,10.0,9,12,2,10,6,18,8,0
2404,Axel Witsel,Atlético Madrid,13.2,17,8,12,5,0,8,11,72.7,3,16,8,8,7,24,49,0
2405,Maximilian Wittek,Bochum,5.5,11,8,4,7,0,7,12,58.3,5,5,0,5,7,18,11,0
2406,Maximilian Wober,M'Gladbach,12.7,27,11,18,8,1,10,20,50.0,10,29,18,11,26,53,63,0
2407,Marius Wolf,Dortmund,6.9,12,7,4,7,1,6,13,46.2,7,4,0,4,4,16,8,0
2408,Nick Woltemade,Werder Bremen,2.8,7,6,1,5,1,5,6,83.3,1,0,0,0,0,7,6,0
2409,Jeong Woo-yeong,Stuttgart,4.0,6,4,2,4,0,3,5,60.0,2,3,0,3,5,11,1,0
2410,Chris Wood,Nott'ham Forest,4.9,1,1,0,1,0,0,2,0.0,2,4,2,2,1,2,10,0
2411,Cauley Woodrow,Luton Town,0.9,6,4,3,2,1,5,6,83.3,1,0,0,0,0,6,1,0
2412,Christopher Wooh,Rennes,4.1,4,4,3,1,0,0,1,0.0,1,5,1,4,10,14,15,0
2413,Joe Worrall,Nott'ham Forest,4.9,7,5,6,1,0,3,6,50.0,3,5,4,1,3,10,27,1
2414,Xeber,Alavés,3.0,4,4,2,2,0,2,6,33.3,4,1,0,1,1,5,2,0
2415,Granit Xhaka,Leverkusen,13.7,17,11,6,10,1,7,17,41.2,10,18,4,14,10,27,19,0
2416,Abduqodir Xusanov,Lens,2.5,3,3,2,1,0,2,4,50.0,2,2,0,2,2,5,9,2
2418,Lamine Yamal,Barcelona,8.4,21,13,9,7,5,5,16,31.3,11,8,0,8,6,27,6,0
2419,Roman Yaremchuk,Valencia,2.1,1,1,0,0,1,0,0,0.0,0,1,0,1,0,1,2,0
2420,Yehor Yarmoliuk,Brentford,3.2,0.0,7,0.0,0.0,0.0,0.0,0.0,0.0,0.0,0.0,0.0,0.0,3,0.0,0.0,0.0
2421,Ryan Yates,Nott'ham Forest,6.8,21,14,13,5,3,5,9,55.6,4,18,5,13,9,30,18,0
2422,Yusuf Yazici,Lille,7.9,13,10,6,3,4,3,11,27.3,8,6,0,6,2,15,4,0
2423,Kelvin Yeboah,Montpellier,1.9,3,1,2,1,0,1,3,33.3,2,2,2,0,1,4,1,0
2424,Kenan Yildiz,Juventus,0.5,1,1,0,1,0,0,1,0.0,1,0,0,0,0,1,0,0
2425,Darlin Yongwa,Lorient,7.4,16,13,9,6,1,8,12,66.7,4,8,1,7,11,27,20,0
2426,Leny Yoro,Lille,12.6,19,14,15,2,2,10,15,66.7,5,9,4,5,15,34,42,1
2427,Ashley Young,Everton,13.4,23,17,12,9,2,13,30,43.3,17,11,4,7,13,36,26,2
2428,Etienne Youte Kinkoue,Le Havre,6.0,3,3,3,0,0,2,4,50.0,2,2,0,2,18,21,33,0
2429,Illia Zabarnyi,Bournemouth,16.0,26,18,14,11,1,11,25,44.0,14,27,20,7,16,42,61,3
2430,Mattia Zaccagni,Lazio,10.1,16,13,7,9,0,3,9,33.3,6,11,1,10,12,28,4,0
2431,Dan-Axel Zagadou,Stuttgart,11.3,13,7,10,3,0,2,6,33.3,4,19,15,4,17,30,57,1
2432,Warren Zaire-Emery,Paris S-G,10.4,22,13,5,12,5,13,23,56.5,10,16,5,11,6,28,7,0
2433,Denis Zakaria,Monaco,12.1,22,14,8,10,4,8,17,47.1,9,24,8,16,23,45,17,0
2434,Arsen Zakharyan,Real Sociedad,4.0,7,5,3,4,0,3,8,37.5,5,8,0,8,0,7,4,0
2435,Joseba Zaldua,Cádiz,2.1,8,4,6,1,1,4,7,57.1,3,2,2,0,1,9,3,0
2436,Nicola Zalewski,Roma,4.1,12,9,5,6,1,4,13,30.8,9,4,2,2,2,14,5,0
2437,Andre-Frank Zambo Anguissa,Napoli,11.3,23,9,7,11,5,12,31,38.7,19,17,2,15,14,37,8,0
2438,Nicolo Zaniolo,Aston Villa,5.2,6,3,3,2,1,3,8,37.5,5,11,0,11,1,7,6,0
2439,Alessandro Zanoli,Napoli,0.6,0,0,0,0,0,0,0,0.0,0,0,0,0,1,1,1,0
2440,Duvan Zapata,Torino,10.4,1,1,0,1,0,0,2,0.0,2,7,2,5,2,3,5,0
2441,Duvan Zapata,Atalanta,1.2,0,0,0,0,0,0,1,0.0,1,0,0,0,0,0,1,0
2442,Gabriele Zappa,Cagliari,11.8,15,8,7,7,1,10,16,62.5,6,12,1,11,6,21,29,1
2444,Davide Zappacosta,Atalanta,8.5,7,7,3,2,2,4,11,36.4,7,10,2,8,0,7,11,0
2445,Bryan Zaragoza,Granada,12.3,12,6,7,4,1,6,15,40.0,9,4,0,4,1,13,3,0
2446,Anass Zaroury,Burnley,1.5,1,0,1,0,0,0,4,0.0,4,1,0,1,0,1,1,1
2447,Oier Zarraga,Udinese,0.7,0,0,0,0,0,0,1,0.0,1,0,0,0,0,0,2,1
2448,Mehdi Zeffane,Clermont Foot,6.5,12,10,8,3,1,4,14,28.6,10,3,1,2,9,21,15,0
2449,Jordan Zemura,Udinese,7.3,21,14,12,7,2,9,16,56.3,7,5,1,4,8,29,9,0
2450,Robin Zentner,Mainz 05,12.0,0,0,0,0,0,0,2,0.0,2,0,0,0,0,0,5,0
2451,Alessio Zerbin,Napoli,0.1,1,1,0,1,0,1,4,25.0,3,0,0,0,0,1,0,0
2452,Cedric Zesiger,Wolfsburg,9.9,6,1,4,2,0,5,9,55.6,4,18,10,8,8,14,43,1
2453,Michael Zetterer,Werder Bremen,7.0,0,0,0,0,0,0,0,0.0,0,0,0,0,0,0,2,2
2454,Nathan Zeze,Nantes,1.0,0,0,0,0,0,0,0,0.0,0,0,0,0,1,1,2,0
2455,Edon Zhegrova,Lille,10.9,8,5,2,5,1,4,8,50.0,4,8,0,8,1,9,4,0
2456,Piotr Zielinski,Napoli,12.2,18,13,4,10,4,10,19,52.6,9,9,1,8,7,25,10,0
2457,David Zima,Torino,1.0,1,1,1,0,0,0,0,0.0,0,0,0,0,3,4,7,0
2458,Christoph Zimmermann,Darmstadt 98,4.9,13,11,9,4,0,9,15,60.0,6,10,8,2,10,23,21,1
2459,Oleksandr Zinchenko,Arsenal,10.7,33,20,11,17,5,25,30,83.3,5,9,2,7,9,42,9,2
2460,Joshua Zirkzee,Bologna,13.7,12,7,3,7,2,4,11,36.4,7,7,0,7,3,15,23,0
2461,Zito,Cagliari,11.1,4,3,3,0,1,1,4,25.0,3,9,0,9,0,4,1,0
2462,Simon Zoller,Bochum,0.5,0,0,0,0,0,0,0,0.0,0,1,0,1,0,0,0,0
2463,Nadir Zortea,Atalanta,1.4,5,4,3,1,1,1,4,25.0,3,2,0,2,1,6,2,0
2464,Kurt Zouma,West Ham,13.7,8,7,4,4,0,2,4,50.0,2,16,8,8,15,23,72,0
2465,Igor Zubeldia,Real Sociedad,13.7,15,10,11,4,0,10,14,71.4,4,16,11,5,13,28,43,1
2466,Martin Zubimendi,Real Sociedad,14.9,27,13,7,18,2,9,22,40.9,13,16,4,12,19,46,29,0
2467,Martin Odegaard,Arsenal,12.7,20,6,3,14,3,7,24,29.2,17,11,0,11,4,24,1,0
2468,Milan Duric,Hellas Verona,8.8,1,0,0,0,1,0,2,0.0,2,0,0,0,1,2,8,0
2470,Mateusz Legowski,Salernitana,6.3,12,6,3,8,1,8,17,47.1,9,6,1,5,2,14,8,0
