,Player,Squad,90s,Tackles - Tkl,Tackles - TklW,Tackles - Def 3rd,Tackles - Mid 3rd,Tackles - Att 3rd,Challenges - Tkl,Challenges - Att,Challenges - Tkl%,Challenges - Lost,Blocks - Blocks,Blocks - Sh,Blocks - Pass,Int,Tkl+Int,Clr,Err
0,Rodrigo Abajas,Valencia,0.7,3,2,2,1,0,3,3,100.0,0,1,0,1,1,4,0,0
1,James Abankwah,Udinese,0.2,0,0,0,0,0,0,0,0.0,0,0,0,0,1,1,2,0
2,Keyliane Abdallah,Marseille,0.0,1,1,1,0,0,1,1,100.0,0,0,0,0,0,1,0,0
3,Yunis Abdelhamid,Saint-Étienne,6.4,11,7,9,2,0,6,11,54.5,5,11,9,2,5,16,30,1
4,Himad Abdelli,Angers,10.8,18,13,5,7,6,7,21,33.3,14,8,0,8,9,27,9,0
5,Mohamed Abdelmoneim,Nice,4.8,14,10,8,5,1,9,15,60.0,6,4,2,2,11,25,22,1
6,Ali Abdi,Nice,6.5,16,10,7,4,5,14,21,66.7,7,13,3,10,3,19,13,0
7,Abel,Osasuna,9.1,22,16,11,7,4,13,22,59.1,9,14,2,12,9,31,30,0
8,Nabil Aberdin,Getafe,2.9,6,4,3,3,0,1,1,100.0,0,3,0,3,0,6,5,0
9,Oliver Abildgaard,Como,0.1,0,0,0,0,0,0,0,0.0,0,1,0,1,0,0,0,0
10,Matthis Abline,Nantes,8.7,4,3,1,2,1,1,6,16.7,5,2,0,2,1,5,14,1
11,Abner,Lyon,6.2,13,8,5,6,2,10,14,71.4,4,9,1,8,5,18,15,0
12,Zakaria Aboukhlal,Toulouse,9.2,10,5,4,3,3,4,11,36.4,7,5,0,5,3,13,2,0
13,Abdel Abqar,Alavés,10.5,13,9,7,6,0,4,10,40.0,6,10,6,4,21,34,45,0
14,Tammy Abraham,Roma,0.0,0,0,0,0,0,0,1,0.0,1,0,0,0,0,0,0,0
15,Tammy Abraham,Milan,4.2,4,1,0,4,0,0,0,0.0,0,3,0,3,2,6,3,0
16,Federico Accornero,Genoa,0.1,0,0,0,0,0,0,0,0.0,0,0,0,0,0,0,0,0
17,Francesco Acerbi,Inter,7.3,6,4,5,1,0,2,3,66.7,1,6,6,0,15,21,28,0
18,Akor Adams,Montpellier,9.2,3,2,1,1,1,2,3,66.7,1,2,1,1,1,4,3,1
19,Che Adams,Torino,7.5,5,3,1,2,2,0,1,0.0,1,5,3,2,0,5,2,0
20,Tyler Adams,Bournemouth,1.1,5,2,1,4,0,1,1,100.0,0,4,2,2,4,9,1,0
21,Junior Adamu,Freiburg,8.6,2,0,1,0,1,0,4,0.0,4,6,0,6,5,7,9,0
22,Tosin Adarabioyo,Chelsea,1.9,2,2,2,0,0,1,1,100.0,0,2,2,0,1,3,8,0
23,Martin Adeline,Reims,0.3,1,1,0,1,0,1,2,50.0,1,0,0,0,0,1,2,0
24,Karim Adeyemi,Dortmund,3.4,7,5,3,1,3,2,2,100.0,0,6,0,6,1,8,0,0
26,Simon Adingra,Brighton,2.3,6,2,3,2,1,3,5,60.0,2,3,0,3,3,9,1,0
27,Amine Adli,Leverkusen,2.3,7,4,1,1,5,3,5,60.0,2,3,0,3,0,7,3,0
28,Yacine Adli,Fiorentina,4.5,12,6,4,5,3,5,11,45.5,6,5,0,5,2,14,9,0
29,Adryelson,Lyon,0.0,0,0,0,0,0,0,0,0.0,0,0,0,0,1,1,1,0
30,Vasilije Adzic,Juventus,0.2,2,2,0,1,1,0,1,0.0,1,0,0,0,0,2,0,0
31,Michel Aebischer,Bologna,4.2,7,4,1,4,2,4,8,50.0,4,3,1,2,5,12,2,0
32,Oladapo Afolayan,St. Pauli,6.7,9,5,2,3,4,4,8,50.0,4,5,0,5,5,14,6,0
33,Emmanuel Agbadou,Reims,11.0,22,15,17,3,2,16,20,80.0,4,19,12,7,9,31,51,1
34,Asher Agbinone,Crystal Palace,0.1,2,1,0,2,0,0,0,0.0,0,0,0,0,0,2,0,0
35,Julen Agirrezabala,Athletic Club,9.4,0,0,0,0,0,0,1,0.0,1,0,0,0,0,0,2,0
36,Lucien Agoume,Sevilla,7.6,21,6,9,10,2,10,15,66.7,5,14,6,8,11,32,9,0
37,Felix Agu,Werder Bremen,8.9,10,5,6,3,1,5,11,45.5,6,6,2,4,8,18,23,0
38,Alvaro Aguado,Espanyol,3.2,4,2,2,2,0,2,5,40.0,3,5,0,5,2,6,5,1
39,Nayef Aguerd,Real Sociedad,8.7,12,9,7,5,0,4,8,50.0,4,8,4,4,8,20,36,0
40,Ruben Aguilar,Lens,3.0,9,6,5,4,0,7,9,77.8,2,5,1,4,5,14,2,0
41,Honest Ahanor,Genoa,0.9,2,1,0,2,0,2,4,50.0,2,0,0,0,0,2,2,0
42,Jean-Eudes Aholou,Angers,8.5,21,15,11,6,4,10,20,50.0,10,16,9,7,15,36,8,0
43,Joseph Aidoo,Celta Vigo,0.0,1,0,1,0,0,0,0,0.0,0,0,0,0,0,1,0,0
44,Ayman Aiki,Saint-Étienne,1.0,3,3,1,2,0,1,1,100.0,0,1,0,1,1,4,0,0
45,Ola Aina,Nott'ham Forest,10.6,22,16,15,6,1,15,22,68.2,7,11,4,7,14,36,28,1
46,Rayan Ait-Nouri,Wolves,10.2,22,11,16,5,1,10,17,58.8,7,12,2,10,11,33,22,1
47,Kristoffer Ajer,Brentford,7.1,6,5,5,1,0,2,8,25.0,6,8,1,7,6,12,19,0
48,Ludovic Ajorque,Brest,7.8,9,6,1,4,4,4,8,50.0,4,3,1,2,2,11,5,0
49,Manuel Akanji,Manchester City,8.7,7,5,3,2,2,4,7,57.1,3,5,3,2,4,11,24,0
50,Umit Akdag,Toulouse,1.6,3,2,1,2,0,3,5,60.0,2,2,2,0,6,9,4,0
52,Nathan Ake,Manchester City,0.8,1,1,1,0,0,1,1,100.0,0,0,0,0,1,2,1,1
53,Ilias Akhomach,Villarreal,6.5,12,7,4,4,4,6,12,50.0,6,8,0,8,3,15,13,0
54,Sergio Akieme,Reims,7.9,9,8,8,1,0,5,9,55.6,4,9,4,5,5,14,31,1
55,Maghnes Akliouche,Monaco,7.4,13,8,7,3,3,4,13,30.8,9,3,0,3,3,16,2,0
56,Clement Akpa,Auxerre,8.0,14,9,7,3,4,8,14,57.1,6,15,4,11,10,24,34,1
57,David Akpan Ankeye,Genoa,0.5,0,0,0,0,0,0,1,0.0,1,0,0,0,0,0,1,0
58,Kevin Akpoguma,Hoffenheim,9.0,13,4,9,2,2,6,14,42.9,8,26,18,8,7,20,46,0
59,Andreas Albers,St. Pauli,0.4,0,0,0,0,0,0,1,0.0,1,0,0,0,0,0,1,0
60,Raul Albiol,Villarreal,8.2,3,3,2,1,0,2,4,50.0,2,8,8,0,4,7,51,1
61,Carlos Alcaraz,Southampton,0.1,0,0,0,0,0,0,0,0.0,0,0,0,0,1,1,0,0
62,Omar Alderete,Getafe,12.0,19,12,14,4,1,9,13,69.2,4,12,7,5,15,34,58,1
63,Carles Alena,Getafe,3.5,6,3,2,3,1,4,8,50.0,4,7,1,6,0,6,2,0
64,Trent Alexander-Arnold,Liverpool,9.6,31,24,19,8,4,20,32,62.5,12,8,3,5,8,39,12,0
65,Alfon,Celta Vigo,2.4,2,0,0,2,0,0,2,0.0,2,2,0,2,2,4,1,0
66,Mohamed Ali Cho,Nice,7.1,6,3,1,1,4,2,5,40.0,3,3,0,3,1,7,2,0
67,Faride Alidou,Hellas Verona,0.8,0,0,0,0,0,0,0,0.0,0,1,0,1,1,1,3,1
68,Alisson,Liverpool,5.9,0,0,0,0,0,0,0,0.0,0,0,0,0,0,0,2,0
69,Tadeo Allende,Celta Vigo,0.0,0,0,0,0,0,0,0,0.0,0,0,0,0,0,0,0,0
70,Jim Allevinah,Angers,5.8,6,4,3,1,2,1,10,10.0,9,2,0,2,3,9,7,0
71,Domingos Andre Ribeiro Almeida,Valencia,5.0,13,7,5,5,3,5,8,62.5,3,6,1,5,3,16,2,0
72,Iker Almena,Girona,0.5,0,0,0,0,0,0,1,0.0,1,1,0,1,0,0,2,0
73,Miguel Almiron,Newcastle Utd,1.2,1,1,1,0,0,1,1,100.0,0,0,0,0,0,1,0,0
74,Pontus Almqvist,Parma,3.6,7,5,4,2,1,3,5,60.0,2,3,0,3,6,13,1,0
75,Marcos Alonso,Celta Vigo,8.1,12,8,8,2,2,9,14,64.3,5,6,3,3,8,20,39,1
76,Giorgio Altare,Venezia,3.8,5,4,4,1,0,1,7,14.3,6,5,3,2,8,13,18,0
78,Adria Altimira,Leganés,5.8,14,5,7,5,2,7,13,53.8,6,6,3,3,10,24,15,1
79,Sergi Altimira,Betis,7.2,18,11,6,10,2,10,17,58.8,7,7,1,6,4,22,9,0
80,Edson Alvarez,West Ham,4.5,11,7,7,3,1,6,7,85.7,1,7,2,5,8,19,8,0
81,Hugo Alvarez,Celta Vigo,10.1,15,5,8,6,1,6,10,60.0,4,10,1,9,6,21,21,1
82,Julian Alvarez,Atlético Madrid,8.4,3,1,1,0,2,1,5,20.0,4,7,0,7,0,3,4,0
83,Yeray Alvarez,Athletic Club,6.0,7,5,4,2,1,3,5,60.0,2,4,2,2,16,23,19,1
84,Skelly Alvero,Werder Bremen,1.1,3,3,3,0,0,1,1,100.0,0,4,0,4,2,5,5,0
85,Selim Amallah,Valladolid,7.4,12,7,4,7,1,0,6,0.0,6,12,0,12,7,19,2,1
86,Amath,Valladolid,3.3,1,0,1,0,0,1,5,20.0,4,5,1,4,2,3,2,0
87,Jordan Amavi,Brest,7.3,22,16,10,9,3,14,20,70.0,6,8,2,6,7,29,13,0
88,Aurele Amenda,Eint Frankfurt,0.8,0,0,0,0,0,0,0,0.0,0,2,2,0,1,1,4,0
89,Kelvin Amian,Nantes,7.4,23,13,20,3,0,13,16,81.3,3,7,3,4,1,24,14,0
90,Michael Amir Murillo,Marseille,8.8,23,15,13,6,4,14,22,63.6,8,4,3,1,8,31,22,0
91,Nadiem Amiri,Mainz 05,8.1,9,2,4,5,0,1,16,6.3,15,8,2,6,6,15,13,0
92,Samuel Amo-Ameyaw,Southampton,0.1,0,0,0,0,0,0,0,0.0,0,0,0,0,0,0,0,0
93,Mathis Amougou,Saint-Étienne,7.0,11,6,7,4,0,4,9,44.4,5,5,0,5,11,22,2,0
94,Mohamed Amoura,Wolfsburg,7.2,5,3,1,0,4,2,4,50.0,2,8,0,8,2,7,2,0
95,Sofyan Amrabat,Fiorentina,2.0,3,2,1,2,0,2,2,100.0,0,1,1,0,0,3,2,0
96,Joachim Andersen,Crystal Palace,1.0,1,1,1,0,0,1,2,50.0,1,0,0,0,0,1,7,0
97,Joachim Andersen,Fulham,6.7,6,3,6,0,0,4,7,57.1,3,7,5,2,11,17,42,0
98,Elliot Anderson,Nott'ham Forest,7.0,19,15,9,5,5,10,18,55.6,8,18,4,14,4,23,13,1
99,Andre,Wolves,4.0,10,5,6,2,2,7,8,87.5,1,12,3,9,2,12,6,0
100,Benjamin Andre,Lille,8.9,27,11,11,14,2,17,28,60.7,11,12,2,10,13,40,19,0
101,Marcos Andre,Valladolid,3.2,0,0,0,0,0,0,3,0.0,3,3,1,2,1,1,2,0
102,Robert Andrich,Leverkusen,7.5,14,7,5,9,0,4,9,44.4,5,5,2,3,11,25,9,0
104,Angelino,Roma,11.0,18,6,6,10,2,5,9,55.6,4,12,6,6,9,27,32,0
105,Lorenzo Anghele,Juventus,0.1,0,0,0,0,0,0,0,0.0,0,0,0,0,0,0,0,0
106,Faustino Anjorin,Empoli,4.8,13,5,3,8,2,1,7,14.3,6,7,1,6,4,17,9,0
107,Waldemar Anton,Dortmund,7.5,12,9,7,4,1,4,6,66.7,2,12,8,4,7,19,26,1
108,Michail Antonio,West Ham,7.4,1,1,0,0,1,1,2,50.0,1,4,0,4,0,1,2,0
109,Antoniu,Espanyol,0.7,3,0,1,1,1,1,1,100.0,0,0,0,0,1,4,2,1
110,Antony,Manchester Utd,0.3,2,0,2,0,0,1,3,33.3,2,1,0,1,1,3,0,0
111,Anuar,Valladolid,3.5,7,5,3,2,2,1,6,16.7,5,6,2,4,4,11,3,0
112,Dennis Appiah,Saint-Étienne,7.3,19,16,11,8,0,12,25,48.0,13,10,4,6,7,26,21,0
113,Aritz Arambarri,Leganés,2.0,1,1,1,0,0,1,1,100.0,0,2,2,0,3,4,8,0
114,Mauro Arambarri,Getafe,9.2,10,4,1,6,3,4,11,36.4,7,8,1,7,3,13,13,0
115,Jon Aramburu,Real Sociedad,8.4,33,25,18,10,5,22,35,62.9,13,14,3,11,9,42,31,0
116,Julian Araujo,Bournemouth,3.9,7,3,3,4,0,4,10,40.0,6,3,0,3,4,11,13,0
117,Cameron Archer,Southampton,6.6,7,4,3,2,2,1,3,33.3,2,4,1,3,1,8,1,0
118,Carlens Arcus,Angers,9.2,23,14,14,8,1,15,27,55.6,12,12,2,10,16,39,24,1
119,Alphonse Areola,West Ham,7.5,1,1,1,0,0,1,2,50.0,1,0,0,0,0,1,5,0
120,Adu Ares,Athletic Club,0.2,0,0,0,0,0,0,1,0.0,1,0,0,0,0,0,0,0
121,Jesus Areso,Osasuna,11.8,20,16,15,3,2,16,25,64.0,9,13,3,10,4,24,33,0
122,David Arguelles,Getafe,0.1,0,0,0,0,0,0,0,0.0,0,2,0,2,0,0,0,0
123,Joe Aribo,Southampton,6.7,10,6,3,4,3,2,6,33.3,4,6,3,3,6,16,9,1
124,Adam Armstrong,Southampton,5.1,6,1,1,2,3,2,7,28.6,5,1,0,1,2,8,2,0
125,Harrison Armstrong,Everton,0.0,0,0,0,0,0,0,1,0.0,1,0,0,0,0,0,0,0
126,Jose Arnaiz,Osasuna,0.3,2,2,1,1,0,1,2,50.0,1,0,0,0,1,3,0,0
127,Hakon Arnar Haraldsson,Lille,1.9,5,2,2,2,1,3,7,42.9,4,0,0,0,1,6,0,0
128,Marko Arnautovic,Inter,0.5,2,2,1,1,0,1,1,100.0,0,0,0,0,0,2,1,0
130,Maximilian Arnold,Wolfsburg,8.4,15,10,6,7,2,8,14,57.1,6,8,6,2,6,21,22,0
131,Jann-Fiete Arp,Holstein Kiel,3.1,5,4,3,1,1,1,5,20.0,4,2,0,2,0,5,0,0
132,Kepa Arrizabalaga,Bournemouth,6.0,0,0,0,0,0,0,1,0.0,1,0,0,0,0,0,3,2
133,Arthur,Leverkusen,0.1,0,0,0,0,0,0,0,0.0,0,0,0,0,1,1,1,0
134,Takuma Asano,Mallorca,3.5,5,3,1,3,1,2,3,66.7,1,3,0,3,2,7,4,0
135,Raul Asencio,Real Madrid,0.7,1,1,1,0,0,0,0,0.0,0,0,0,0,0,1,3,0
136,Marco Asensio,Paris S-G,5.6,2,2,0,2,0,0,5,0.0,5,1,0,1,0,2,0,0
137,Kristjan Asllani,Inter,1.6,4,0,3,1,0,2,6,33.3,4,3,1,2,1,5,3,0
138,Iago Aspas,Celta Vigo,9.9,9,5,4,3,2,6,13,46.2,7,11,1,10,3,12,4,0
139,Yaser Asprilla,Girona,3.8,8,4,4,3,1,3,7,42.9,4,0,0,0,3,11,4,0
140,Lorenz Assignon,Rennes,5.9,9,4,4,4,1,4,11,36.4,7,8,3,5,8,17,24,0
141,Dehmaine Assoumani,Nantes,0.4,4,1,0,2,2,2,2,100.0,0,0,0,0,0,4,1,0
142,Valentin Atangana Edoa,Reims,10.5,22,17,11,10,1,9,12,75.0,3,7,3,4,14,36,19,0
143,Arthur Atta,Udinese,0.3,2,2,0,1,1,0,0,0.0,0,0,0,0,0,2,0,0
144,Noah Atubolu,Freiburg,8.0,0,0,0,0,0,0,0,0.0,0,0,0,0,0,0,5,2
145,Emil Audero,Como,7.0,0,0,0,0,0,0,1,0.0,1,0,0,0,0,0,3,1
146,Tommaso Augello,Cagliari,9.2,15,8,7,5,3,10,13,76.9,3,11,4,7,8,23,40,0
147,Carlos Augusto,Inter,2.1,3,2,2,1,0,2,4,50.0,2,1,1,0,1,4,6,0
148,Yann Aurel Bisseck,Inter,4.3,4,3,4,0,0,2,3,66.7,1,3,1,2,3,7,15,1
149,Ezequiel Avila,Betis,4.2,4,2,1,1,2,1,3,33.3,2,4,0,4,1,5,3,0
150,Taiwo Awoniyi,Nott'ham Forest,1.2,1,0,0,1,0,1,1,100.0,0,1,0,1,0,1,2,0
151,Yasin Ayari,Brighton,5.5,21,11,3,13,5,8,16,50.0,8,6,1,5,6,27,6,0
152,Florian Aye,Auxerre,3.3,1,1,0,0,1,0,1,0.0,1,3,0,3,3,4,5,0
153,Andre Ayew,Le Havre,3.3,2,2,0,0,2,1,2,50.0,1,2,1,1,1,3,4,0
154,Jordan Ayew,Crystal Palace,0.2,1,0,0,0,1,0,0,0.0,0,0,0,0,0,1,0,0
156,Jordan Ayew,Leicester City,5.5,11,5,3,6,2,2,5,40.0,3,5,0,5,4,15,2,0
157,Neil El Aynaoui,Lens,1.2,1,1,0,1,0,0,3,0.0,3,3,2,1,1,2,1,0
158,Ayman Azhil,Dortmund,0.3,1,1,1,0,0,0,0,0.0,0,0,0,0,0,1,0,0
159,Adam Aznou,Bayern Munich,0.1,0,0,0,0,0,0,0,0.0,0,0,0,0,0,0,0,0
160,Cesar Azpilicueta,Atlético Madrid,4.3,8,3,4,4,0,8,12,66.7,4,2,1,1,1,9,11,0
161,Paulo Azzi,Cagliari,4.7,11,9,3,6,2,5,9,55.6,4,5,2,3,5,16,11,0
162,Papa Ba,Girona,0.5,1,1,1,0,0,0,0,0.0,0,1,0,1,0,1,1,0
163,Shavy Babicka,Toulouse,4.4,8,7,3,3,2,4,6,66.7,2,8,0,8,0,8,3,1
164,Aliou Badara Balde,Bochum,1.0,1,1,1,0,0,0,0,0.0,0,2,0,2,0,1,0,0
165,Loic Bade,Sevilla,8.2,19,11,16,3,0,8,10,80.0,2,6,3,3,9,28,45,1
166,Milan Badelj,Genoa,7.5,10,4,6,4,0,5,16,31.3,11,8,3,5,8,18,15,0
167,Benoit Badiashile,Chelsea,0.4,1,1,0,1,0,0,0,0.0,0,0,0,0,1,2,2,0
168,Alex Baena,Villarreal,9.2,4,3,1,2,1,1,9,11.1,8,12,1,11,8,12,7,1
169,Leon Bailey,Aston Villa,5.6,2,0,0,1,1,0,2,0.0,2,3,0,3,1,3,6,0
170,Eric Bailly,Villarreal,5.9,9,2,5,4,0,2,3,66.7,1,11,6,5,6,15,24,0
171,Theo Bair,Auxerre,3.6,2,1,0,1,1,0,0,0.0,0,4,1,3,0,2,3,0
172,Cedric Bakambu,Betis,2.4,1,0,0,1,0,0,1,0.0,1,3,0,3,0,1,1,0
173,Mitchel Bakker,Atalanta,0.2,1,0,1,0,0,1,1,100.0,0,0,0,0,0,1,0,0
174,Mitchel Bakker,Lille,2.3,8,6,2,3,3,3,5,60.0,2,3,0,3,7,15,7,0
175,Ridle Baku,Wolfsburg,8.0,11,6,4,4,3,3,10,30.0,7,14,1,13,9,20,8,0
176,Dilane Bakwa,Strasbourg,10.6,10,6,6,1,3,4,7,57.1,3,11,0,11,4,14,11,0
177,Tommaso Baldanzi,Roma,3.8,6,1,3,1,2,1,4,25.0,3,2,0,2,4,10,2,0
178,Alejandro Balde,Barcelona,10.1,7,4,3,3,1,3,5,60.0,2,5,2,3,5,12,10,0
179,Carlos Baleba,Brighton,6.9,22,11,4,11,7,13,22,59.1,9,11,3,8,15,37,2,0
180,Leonardo Balerdi,Marseille,7.0,13,10,9,3,1,8,14,57.1,6,12,9,3,8,21,16,2
182,Ivan Balliu,Rayo Vallecano,6.6,10,8,2,5,3,3,10,30.0,7,4,1,3,6,16,18,0
183,Botond Balogh,Parma,10.7,18,7,13,5,0,10,12,83.3,2,20,15,5,11,29,62,1
184,Folarin Balogun,Monaco,4.5,0,0,0,0,0,0,2,0.0,2,0,0,0,0,0,0,0
185,Mario Balotelli,Genoa,0.3,0,0,0,0,0,0,0,0.0,0,0,0,0,0,0,1,0
186,Abdoulaye Bamba,Angers,2.8,5,2,4,1,0,2,3,66.7,1,2,2,0,5,10,12,0
187,Jonathan Bamba,Celta Vigo,6.3,9,5,2,5,2,4,9,44.4,5,6,0,6,4,13,5,0
188,Mohamed Bamba,Reims,0.0,0,0,0,0,0,0,0,0.0,0,1,0,1,0,0,0,0
189,Samuel Bamba,Bochum,0.1,0,0,0,0,0,0,0,0.0,0,0,0,0,0,0,0,0
190,Lameck Banda,Lecce,5.6,5,4,4,1,0,3,10,30.0,7,6,0,6,1,6,6,0
191,Daniel Bandeira,Hellas Verona,3.3,4,0,1,3,0,3,5,60.0,2,2,1,1,6,10,8,0
192,Mattia Bani,Genoa,4.0,2,1,2,0,0,1,1,100.0,0,3,2,1,8,10,12,0
193,Scott Banks,St. Pauli,0.6,0,0,0,0,0,0,2,0.0,2,0,0,0,1,1,2,0
194,Antonin Barak,Fiorentina,0.6,2,0,0,2,0,0,2,0.0,2,1,1,0,0,2,0,0
195,Federico Barba,Como,2.7,1,1,0,1,0,0,2,0.0,2,2,2,0,3,4,10,0
196,Valentin Barco,Sevilla,3.1,15,9,8,3,4,12,15,80.0,3,0,0,0,2,17,5,0
197,Bradley Barcola,Paris S-G,8.3,12,6,5,5,2,1,10,10.0,9,9,0,9,4,16,2,0
198,Melvin Bard,Nice,5.2,16,7,11,5,0,6,11,54.5,5,8,3,5,4,20,10,1
199,Nicolo Barella,Inter,8.2,15,8,4,8,3,5,14,35.7,9,10,0,10,3,18,2,0
200,Gabriel Bares,Montpellier,0.4,2,2,2,0,0,1,2,50.0,1,0,0,0,1,3,1,0
201,Ross Barkley,Aston Villa,3.1,6,2,3,3,0,5,7,71.4,2,4,2,2,3,9,3,0
202,Aymen Barkok,Mainz 05,0.8,2,1,1,1,0,1,1,100.0,0,1,1,0,2,4,0,0
203,Harvey Barnes,Newcastle Utd,5.5,6,4,3,2,1,2,2,100.0,0,2,0,2,4,10,5,0
204,Enzo Barrenechea,Valencia,3.8,6,1,4,2,0,3,6,50.0,3,5,1,4,4,10,7,0
205,Ander Barrenetxea,Real Sociedad,4.9,10,8,2,6,2,2,8,25.0,6,5,0,5,5,15,10,0
206,Pablo Barrios,Atlético Madrid,7.0,14,8,6,8,0,6,13,46.2,7,3,1,2,12,26,7,2
208,Thierno Barry,Villarreal,7.9,1,0,0,1,0,1,3,33.3,2,4,0,4,0,1,4,0
209,Davide Bartesaghi,Milan,0.1,0,0,0,0,0,0,0,0.0,0,0,0,0,0,0,0,0
210,Marc Bartra,Betis,5.3,5,3,5,0,0,3,4,75.0,1,8,5,3,5,10,27,0
211,Federico Baschirotto,Lecce,12.0,14,10,10,4,0,9,11,81.8,2,18,15,3,11,25,47,0
212,Daniele Baselli,Como,0.2,0,0,0,0,0,0,0,0.0,0,0,0,0,1,1,1,0
213,Calvin Bassey,Fulham,11.0,12,8,8,4,0,3,5,60.0,2,17,10,7,4,16,36,2
214,Aboubacar Bassinga,Las Palmas,0.0,0,0,0,0,0,0,0,0.0,0,0,0,0,0,0,0,0
215,Alessandro Bastoni,Inter,9.5,16,10,6,8,2,8,12,66.7,4,8,2,6,9,25,13,1
216,Augusto Batalla,Rayo Vallecano,8.0,0,0,0,0,0,0,1,0.0,1,0,0,0,0,0,3,1
217,Dylan Batubinsika,Saint-Étienne,9.6,13,7,11,2,0,5,8,62.5,3,11,5,6,23,36,45,1
218,Maximilian Bauer,Augsburg,4.9,11,6,4,6,1,7,11,63.6,4,8,2,6,5,16,26,1
219,Oliver Baumann,Hoffenheim,10.0,0,0,0,0,0,0,1,0.0,1,0,0,0,0,0,5,0
220,Christoph Baumgartner,RB Leipzig,4.1,11,7,3,6,2,4,12,33.3,8,10,2,8,3,14,3,0
221,Rafael Bauza,Espanyol,0.7,3,2,2,1,0,2,3,66.7,1,1,0,1,0,3,2,0
222,Adrian Beck,Heidenheim,3.7,13,6,9,4,0,3,12,25.0,9,13,0,13,4,17,9,0
223,Sheraldo Becker,Real Sociedad,6.7,2,2,0,2,0,0,2,0.0,2,4,0,4,1,3,8,0
224,Timo Becker,Holstein Kiel,9.5,16,9,12,4,0,11,17,64.7,6,9,6,3,6,22,26,0
225,Jan Bednarek,Southampton,10.9,8,4,6,2,0,3,9,33.3,6,16,14,2,15,23,57,1
226,Donny van de Beek,Girona,5.8,8,3,4,2,2,3,8,37.5,5,8,2,6,3,11,7,0
227,Kevin Behrens,Wolfsburg,1.0,1,1,0,1,0,0,1,0.0,1,1,0,1,0,1,1,0
228,Maximilian Beier,Dortmund,4.6,5,2,1,3,1,3,7,42.9,4,7,0,7,2,7,3,0
229,Reda Belahyane,Hellas Verona,10.0,19,14,6,9,4,8,9,88.9,1,9,4,5,5,24,9,0
230,Haris Belkebla,Angers,6.0,12,9,9,3,0,4,9,44.4,5,9,1,8,6,18,12,1
231,Yassin Belkhdim,Angers,5.2,25,12,12,9,4,10,22,45.5,12,9,2,7,8,33,10,0
232,Stefan Bell,Mainz 05,3.8,6,3,4,2,0,2,5,40.0,3,4,4,0,11,17,26,0
234,Raoul Bellanova,Torino,1.0,0,0,0,0,0,0,1,0.0,1,0,0,0,0,0,4,0
235,Raoul Bellanova,Atalanta,6.8,7,5,2,4,1,3,5,60.0,2,4,1,3,7,14,6,0
236,Jean-Ricner Bellegarde,Wolves,5.3,6,4,2,2,2,2,3,66.7,1,7,1,6,4,10,4,0
237,Hector Bellerin,Betis,5.8,12,7,6,4,2,9,16,56.3,7,4,3,1,6,18,18,0
238,Jude Bellingham,Real Madrid,7.7,20,10,10,6,4,9,13,69.2,4,14,1,13,10,30,4,0
239,Jeanuel Belocian,Leverkusen,0.5,1,1,1,0,0,1,1,100.0,0,0,0,0,0,1,2,0
240,Andrea Belotti,Como,3.3,5,4,1,3,1,0,2,0.0,2,2,0,2,1,6,4,0
241,Fran Beltran,Celta Vigo,8.4,17,9,10,6,1,7,17,41.2,10,12,4,8,5,22,10,2
242,Lucas Beltran,Fiorentina,5.2,8,4,2,4,2,2,3,66.7,1,6,1,5,1,9,1,0
243,Eliesse Ben Seghir,Monaco,7.7,17,13,5,8,4,10,15,66.7,5,10,0,10,3,20,1,0
244,Carlos Benavidez,Alavés,2.6,5,3,2,2,1,0,3,0.0,3,1,1,0,5,10,3,1
245,Adrian Benedyczak,Parma,0.6,0,0,0,0,0,0,0,0.0,0,0,0,0,0,0,0,0
246,Laszlo Benes,Union Berlin,1.8,1,1,0,1,0,0,1,0.0,1,1,1,0,0,1,1,0
247,Iker Benito,Osasuna,0.4,0,0,0,0,0,0,1,0.0,1,0,0,0,1,1,2,0
248,Ismael Bennacer,Milan,0.6,1,1,0,1,0,0,0,0.0,0,0,0,0,0,1,0,0
249,Said Benrahma,Lyon,4.9,5,3,2,2,1,2,6,33.3,4,4,0,4,1,6,0,0
250,Ramy Bensebaini,Dortmund,5.0,9,3,6,2,1,3,8,37.5,5,14,2,12,6,15,8,1
251,Rodrigo Bentancur,Tottenham,5.9,19,9,9,9,1,11,16,68.8,5,5,0,5,16,35,5,0
252,Lucas Beraldo,Paris S-G,7.4,14,12,10,4,0,9,19,47.4,10,5,1,4,7,21,11,1
253,Yuri Berchiche,Athletic Club,8.1,14,8,10,3,1,8,14,57.1,6,9,2,7,8,22,22,1
254,Alex Berenguer,Athletic Club,7.8,7,3,2,3,2,5,8,62.5,3,5,2,3,4,11,5,0
255,Sander Berge,Fulham,5.8,14,8,6,6,2,5,8,62.5,3,10,4,6,12,26,5,0
256,Lucas Bergvall,Tottenham,0.6,5,2,0,3,2,5,7,71.4,2,0,0,0,0,5,0,0
257,Medon Berisha,Lecce,0.9,2,1,1,1,0,1,1,100.0,0,0,0,0,0,2,0,0
258,Mergim Berisha,Hoffenheim,3.0,1,1,1,0,0,0,3,0.0,3,1,0,1,0,1,3,0
260,Adrian Bernabe,Parma,10.0,21,13,14,6,1,12,26,46.2,14,18,9,9,6,27,16,0
261,Marc Bernal,Barcelona,2.7,8,6,2,5,1,7,8,87.5,1,5,1,4,1,9,4,0
262,Juan Bernat,Villarreal,0.4,2,1,1,0,1,1,2,50.0,1,2,0,2,0,2,0,0
263,Alexander Bernhardsson,Holstein Kiel,2.1,1,1,0,0,1,1,2,50.0,1,2,0,2,0,1,2,0
264,Victor Bernth Kristiansen,Leicester City,9.5,31,24,22,8,1,15,26,57.7,11,17,7,10,12,43,28,0
265,Matus Bero,Bochum,7.2,14,7,7,3,4,6,19,31.6,13,15,2,13,2,16,6,1
266,Juan Berrocal,Getafe,5.3,9,3,7,2,0,7,9,77.8,2,0,0,0,7,16,29,0
267,Dimitry Bertaud,Montpellier,3.0,0,0,0,0,0,0,0,0.0,0,0,0,0,0,0,2,0
268,Beto,Everton,1.1,1,0,0,0,1,0,1,0.0,1,1,0,1,0,1,2,0
269,Sam Beukema,Bologna,10.5,12,5,5,6,1,3,9,33.3,6,11,8,3,8,20,28,0
270,Alessandro Bianco,Monza,6.4,16,11,6,9,1,10,11,90.9,1,6,0,6,5,21,8,2
271,Alessandro Bianco,Fiorentina,0.2,0,0,0,0,0,0,1,0.0,1,0,0,0,0,0,0,0
272,Jaka Bijol,Udinese,12.0,19,11,13,6,0,11,18,61.1,7,14,7,7,15,34,55,1
273,El Bilal Toure,Stuttgart,3.5,3,1,1,1,1,3,3,100.0,0,1,0,1,0,3,1,0
274,Philip Billing,Bournemouth,0.3,1,0,1,0,0,0,0,0.0,0,0,0,0,1,2,0,0
275,Cristiano Biraghi,Fiorentina,4.8,4,4,1,3,0,2,7,28.6,5,2,0,2,4,8,11,0
276,Samuele Birindelli,Monza,2.0,5,5,2,3,0,2,2,100.0,0,2,1,1,0,5,2,0
277,Tom Bischof,Hoffenheim,6.7,31,15,11,18,2,9,20,45.0,11,17,4,13,7,38,14,0
278,Yves Bissouma,Tottenham,4.5,12,9,5,6,1,8,13,61.5,5,4,1,3,5,17,13,0
279,Leonardo Bittencourt,Werder Bremen,3.5,2,0,0,2,0,1,4,25.0,3,4,0,4,4,6,4,0
280,Emmanuel Biumla,Angers,8.1,14,7,10,4,0,9,14,64.3,5,11,5,6,6,20,37,0
281,Marco Bizot,Brest,11.0,1,1,1,0,0,0,0,0.0,0,0,0,0,0,1,9,0
282,Antonio Blanco,Alavés,8.5,21,13,7,14,0,11,21,52.4,10,13,5,8,15,36,10,0
283,Ludovic Blas,Rennes,10.6,10,7,2,3,5,8,16,50.0,8,9,2,7,3,13,2,0
284,Daley Blind,Girona,9.9,17,8,8,8,1,11,14,78.6,3,13,5,8,13,30,30,1
286,Myron Boadu,Bochum,3.9,0,0,0,0,0,0,1,0.0,1,1,0,1,0,0,3,0
287,Augustine Boakye,Saint-Étienne,3.0,3,1,1,2,0,2,7,28.6,5,0,0,0,4,7,2,0
288,Sacha Boey,Bayern Munich,1.4,3,0,2,0,1,2,3,66.7,1,1,0,1,0,3,4,0
289,Jeremie Boga,Nice,6.0,6,4,1,5,0,2,3,66.7,1,6,0,6,2,8,0,0
290,Lamare Bogarde,Aston Villa,1.9,8,4,2,5,1,5,9,55.6,4,1,0,1,1,9,4,0
291,Emil Bohinen,Genoa,1.8,4,4,3,0,1,2,5,40.0,3,2,0,2,1,5,6,0
292,Adama Boiro,Athletic Club,3.7,8,4,3,4,1,3,5,60.0,2,5,3,2,4,12,11,0
293,Willy Boly,Nott'ham Forest,1.0,4,0,3,1,0,3,3,100.0,0,3,1,2,1,5,8,0
294,Moise Bombito,Nice,8.7,10,8,6,4,0,7,10,70.0,3,9,5,4,7,17,45,1
295,Warren Bondo,Monza,9.9,18,11,12,4,2,8,13,61.5,5,12,4,8,4,22,3,2
296,Victor Boniface,Leverkusen,7.3,4,3,0,3,1,2,2,100.0,0,1,0,1,0,4,4,0
297,Ange-Yoan Bonny,Parma,9.3,10,6,1,7,2,1,5,20.0,4,5,0,5,0,10,4,0
298,Sebastiaan Bornauw,Wolfsburg,7.0,7,4,2,4,1,2,6,33.3,4,13,12,1,9,16,26,0
299,Saimon Bouabre,Monaco,0.1,0,0,0,0,0,0,2,0.0,2,1,0,1,0,0,0,0
300,Ayyoub Bouaddi,Lille,3.4,14,9,9,3,2,4,8,50.0,4,3,0,3,4,18,1,0
301,Badredine Bouanani,Nice,3.1,1,0,1,0,0,0,2,0.0,2,4,0,4,3,4,0,0
302,Benjamin Bouchouari,Saint-Étienne,3.4,8,7,2,3,3,5,13,38.5,8,3,0,3,3,11,5,1
303,Hicham Boudaoui,Nice,7.0,26,13,14,8,4,11,20,55.0,9,10,3,7,7,33,10,0
304,Carlo Boukhalfa,St. Pauli,5.6,9,3,2,6,1,2,5,40.0,3,7,1,6,5,14,6,1
305,Benjamin Bourigeaud,Rennes,0.9,1,0,0,1,0,0,2,0.0,2,2,1,1,2,3,1,0
306,Edoardo Bove,Fiorentina,8.3,19,12,7,10,2,12,24,50.0,12,9,0,9,5,24,6,0
307,Jarrod Bowen,West Ham,10.7,17,8,6,4,7,5,16,31.3,11,8,1,7,5,22,13,0
308,Enzo Boyomo,Osasuna,10.0,21,15,16,4,1,9,11,81.8,2,15,10,5,11,32,44,2
309,Enzo Boyomo,Valladolid,3.0,6,2,4,2,0,3,3,100.0,0,4,3,1,1,7,7,0
310,Domagoj Bradaric,Hellas Verona,4.6,6,4,5,0,1,3,7,42.9,4,2,1,1,2,8,7,0
312,Conor Bradley,Liverpool,1.6,1,1,1,0,0,1,5,20.0,4,0,0,0,2,3,10,0
313,Bilal Brahimi,Nice,0.8,0,0,0,0,0,0,0,0.0,0,1,0,1,0,0,2,0
314,Julian Brandt,Dortmund,9.0,8,3,4,3,1,5,14,35.7,9,4,0,4,3,11,5,0
315,Jarrad Branthwaite,Everton,2.1,5,2,4,1,0,3,3,100.0,0,3,1,2,4,9,10,0
316,Darko Brasanac,Leganés,8.0,12,4,2,6,4,4,6,66.7,2,9,6,3,6,18,21,0
317,Lilian Brassier,Marseille,7.0,6,5,6,0,0,3,4,75.0,1,7,2,5,4,10,24,1
318,Matthias Braunoder,Como,2.9,10,4,6,3,1,7,11,63.6,4,2,0,2,2,12,4,1
319,Iker Bravo,Udinese,2.2,4,3,1,3,0,1,2,50.0,1,0,0,0,0,4,1,0
320,James Bree,Southampton,0.2,0,0,0,0,0,0,0,0.0,0,0,0,0,0,0,0,0
321,Tim Breithaupt,Augsburg,1.3,1,1,0,1,0,0,4,0.0,4,1,0,1,2,3,0,0
322,Gleison Bremer,Juventus,6.0,15,7,9,5,1,4,5,80.0,1,15,11,4,6,21,16,0
323,Brenner,Udinese,4.3,6,4,2,3,1,3,8,37.5,5,4,0,4,1,7,6,0
324,Ben Brereton,Southampton,4.5,3,2,0,2,1,1,8,12.5,7,2,1,1,0,3,3,0
325,Marco Brescianini,Atalanta,4.4,3,2,1,1,1,1,2,50.0,1,6,1,5,0,3,2,0
326,Maximilian Breunig,Heidenheim,3.1,4,3,1,2,1,3,4,75.0,1,5,2,3,1,5,3,0
327,David Brooks,Bournemouth,0.5,1,1,0,1,0,1,1,100.0,0,1,1,0,0,1,1,0
328,Moritz Broschinski,Bochum,6.0,9,6,4,3,2,1,9,11.1,8,8,0,8,0,9,5,0
329,Nathaniel Brown,Eint Frankfurt,2.0,3,2,2,1,0,3,5,60.0,2,1,0,1,1,4,10,0
330,Jacob Bruun Larsen,Hoffenheim,1.3,1,0,1,0,0,1,3,33.3,2,3,0,3,1,2,1,0
331,Ante Budimir,Osasuna,10.3,7,2,1,6,0,1,3,33.3,2,10,2,8,1,8,9,0
332,Emi Buendia,Aston Villa,0.3,2,2,1,1,0,0,2,0.0,2,2,0,2,0,2,0,0
333,Santiago Bueno,Wolves,4.9,9,5,5,4,0,6,8,75.0,2,12,8,4,4,13,19,0
334,Marius Bulter,Hoffenheim,7.9,6,6,1,4,1,6,8,75.0,2,3,1,2,1,7,4,0
335,Facundo Buonanotte,Leicester City,8.1,22,9,7,8,7,10,29,34.5,19,19,4,15,5,27,7,0
336,Alessandro Buongiorno,Napoli,11.0,23,16,16,7,0,17,18,94.4,1,20,13,7,17,40,29,0
338,Cameron Burgess,Ipswich Town,4.0,2,2,2,0,0,0,0,0.0,0,4,3,1,5,7,31,1
339,Jonathan Burkardt,Mainz 05,8.7,2,2,1,1,0,1,3,33.3,2,3,1,2,0,2,8,0
340,Oliver Burke,Werder Bremen,0.4,1,1,1,0,0,0,0,0.0,0,0,0,0,0,1,0,0
341,Dan Burn,Newcastle Utd,11.0,9,4,7,2,0,6,12,50.0,6,8,6,2,8,17,49,1
342,Wes Burns,Ipswich Town,4.5,5,5,0,4,1,2,5,40.0,3,3,0,3,3,8,4,2
343,Marnon Busch,Heidenheim,3.6,6,4,4,2,0,6,9,66.7,3,5,4,1,1,7,18,1
344,Gianluca Busio,Venezia,7.6,13,9,8,2,3,7,11,63.6,4,7,2,5,3,16,14,0
345,Aurelio Buta,Reims,6.8,17,9,11,5,1,11,19,57.9,8,1,0,1,7,24,18,0
346,Marcin Bulka,Nice,11.0,0,0,0,0,0,0,0,0.0,0,0,0,0,0,0,5,2
347,Pau Cabanes,Villarreal,0.2,0,0,0,0,0,0,0,0.0,0,0,0,0,0,0,1,0
348,Remy Cabella,Lille,3.3,11,7,1,7,3,7,11,63.6,4,2,0,2,4,15,0,0
349,Leandro Cabrera,Espanyol,7.0,13,8,9,4,0,6,9,66.7,3,9,6,3,9,22,39,1
350,Liberato Cacace,Empoli,3.1,5,2,3,2,0,4,6,66.7,2,6,2,4,0,5,12,0
351,Anthony Caci,Mainz 05,9.1,16,9,5,6,5,8,13,61.5,5,9,2,7,7,23,20,1
352,Mathieu Cafaro,Saint-Étienne,6.1,6,5,3,2,1,2,11,18.2,9,3,1,2,6,12,2,0
353,Moises Caicedo,Chelsea,10.8,38,25,18,17,3,22,34,64.7,12,16,5,11,18,56,15,0
354,Tom Cairney,Fulham,1.4,4,1,1,1,2,1,2,50.0,1,1,0,1,2,6,0,0
355,Jens Cajuste,Ipswich Town,3.0,6,3,1,4,1,2,6,33.3,4,8,1,7,2,8,4,0
356,Davide Calabria,Milan,1.7,4,2,4,0,0,3,5,60.0,2,0,0,0,3,7,4,0
357,Riccardo Calafiori,Arsenal,4.3,12,9,7,4,1,10,16,62.5,6,8,3,5,4,16,13,0
358,Luca Caldirola,Monza,3.1,3,2,2,1,0,1,2,50.0,1,4,4,0,2,5,13,0
359,Fernando Calero,Espanyol,2.1,4,2,4,0,0,1,2,50.0,1,3,3,0,5,9,20,0
360,Duje Caleta-Car,Lyon,10.0,12,7,7,5,0,6,11,54.5,5,20,16,4,12,24,49,0
361,Hakan Calhanoglu,Inter,6.3,14,7,1,6,7,6,10,60.0,4,2,2,0,3,17,7,0
362,Dominic Calvert-Lewin,Everton,10.0,6,4,1,2,3,0,1,0.0,1,3,1,2,5,11,11,0
364,Drissa Camara,Parma,0.8,1,1,0,1,0,0,2,0.0,2,0,0,0,0,1,1,0
365,Issiaga Camara,Nice,0.0,0,0,0,0,0,0,0,0.0,0,0,0,0,1,1,0,0
366,Lamine Camara,Monaco,8.4,31,21,12,14,5,14,24,58.3,10,17,4,13,17,48,5,1
367,Mahdi Camara,Brest,7.9,27,13,3,16,8,7,14,50.0,7,15,1,14,10,37,10,0
368,Francesco Camarda,Milan,0.8,2,0,0,0,2,1,2,50.0,1,0,0,0,0,2,1,0
369,Eduardo Camavinga,Real Madrid,3.3,9,7,2,6,1,5,8,62.5,3,6,2,4,4,13,5,0
370,Nicolo Cambiaghi,Bologna,0.2,1,0,0,1,0,0,0,0.0,0,1,0,1,0,1,0,0
371,Andrea Cambiaso,Juventus,11.0,19,13,11,5,3,13,20,65.0,7,9,1,8,8,27,15,1
372,Axel Camblan,Brest,0.3,1,1,0,0,1,1,2,50.0,1,1,0,1,0,1,0,0
373,Sergio Camello,Rayo Vallecano,7.6,6,1,1,4,1,1,1,100.0,0,6,1,5,4,10,11,0
374,Jose Campana,Las Palmas,4.6,9,8,2,5,2,5,8,62.5,3,2,0,2,13,22,9,1
375,Cole Campbell,Dortmund,0.2,0,0,0,0,0,0,0,0.0,0,0,0,0,0,0,1,0
376,Emre Can,Dortmund,6.6,18,9,11,6,1,6,12,50.0,6,7,4,3,4,22,20,3
377,Peio Canales,Athletic Club,0.2,1,1,0,0,1,0,0,0.0,0,0,0,0,1,2,1,0
378,Matteo Cancellieri,Parma,4.6,9,7,8,1,0,3,8,37.5,5,3,0,3,5,14,10,0
379,Antonio Candela,Venezia,8.3,19,14,9,6,4,12,17,70.6,5,6,5,1,7,26,12,1
380,Sergi Canos,Valencia,2.0,6,4,0,3,3,3,6,50.0,3,2,0,2,2,8,1,0
381,Jaydee Canvot,Toulouse,0.1,1,1,1,0,0,1,1,100.0,0,0,0,0,0,1,0,0
382,Pierrick Capelle,Angers,2.9,11,7,4,5,2,3,7,42.9,4,1,1,0,4,15,0,1
383,Gianluca Caprari,Monza,4.2,8,5,3,4,1,1,4,25.0,3,5,0,5,2,10,1,1
384,Elia Caprile,Napoli,3.6,0,0,0,0,0,0,0,0.0,0,0,0,0,0,0,2,0
385,Francesco Caputo,Empoli,0.1,0,0,0,0,0,0,0,0.0,0,0,0,0,0,0,0,0
386,Maxence Caqueret,Lyon,6.3,19,10,5,10,4,3,19,15.8,16,12,2,10,7,26,2,0
387,Andrea Carboni,Monza,8.3,19,11,12,7,0,12,22,54.5,10,13,5,8,10,29,38,1
388,Franco Carboni,Venezia,0.1,0,0,0,0,0,0,0,0.0,0,0,0,0,0,0,1,0
390,Valentin Carboni,Marseille,1.1,2,2,0,1,1,0,1,0.0,1,1,0,1,1,3,1,0
391,Cardenas,Rayo Vallecano,4.0,0,0,0,0,0,0,0,0.0,0,0,0,0,0,0,3,0
392,Irvin Cardona,Espanyol,3.6,5,4,2,3,0,4,12,33.3,8,4,1,3,3,8,5,0
393,Marc Cardona,Las Palmas,0.8,1,0,0,1,0,0,0,0.0,0,0,0,0,0,1,0,0
394,Sergi Cardona,Villarreal,11.8,23,16,15,7,1,14,26,53.8,12,21,3,18,15,38,38,0
395,Johnny Cardoso,Betis,6.3,18,11,4,10,4,7,18,38.9,11,9,3,6,14,32,23,0
396,Diego Carlos,Aston Villa,5.2,4,1,3,1,0,0,1,0.0,1,3,2,1,4,8,18,2
397,Carmona,Sevilla,12.7,38,28,24,11,3,17,26,65.4,9,15,4,11,31,69,28,0
398,Marco Carnesecchi,Atalanta,11.0,0,0,0,0,0,0,0,0.0,0,1,0,1,0,0,8,1
399,Sergio Carreira,Celta Vigo,2.6,6,4,3,2,1,2,4,50.0,2,2,0,2,1,7,9,0
400,Dani Carvajal,Real Madrid,6.8,12,8,7,3,2,9,12,75.0,3,8,3,5,10,22,19,1
401,Fabio Carvalho,Brentford,3.2,9,6,3,2,4,3,7,42.9,4,5,1,4,2,11,1,0
402,William Carvalho,Betis,2.7,3,2,0,3,0,2,4,50.0,2,4,1,3,3,6,4,0
403,Marc Casado,Barcelona,8.6,22,13,3,13,6,8,16,50.0,8,10,4,6,6,28,12,0
404,Nicolo Casale,Bologna,2.9,3,1,1,2,0,1,2,50.0,1,8,6,2,2,5,7,2
405,Nicolo Casale,Lazio,1.5,5,3,4,1,0,0,0,0.0,0,4,3,1,1,6,2,0
406,Casemiro,Manchester Utd,6.9,31,20,16,9,6,13,29,44.8,16,17,3,14,5,36,25,3
407,Matty Cash,Aston Villa,4.7,10,4,7,3,0,4,8,50.0,4,4,1,3,6,16,19,0
408,Josue Casimir,Le Havre,5.6,8,5,2,4,2,1,4,25.0,3,4,0,4,1,9,7,0
409,Federico Cassa,Atalanta,0.2,0,0,0,0,0,0,0,0.0,0,1,0,1,0,0,0,0
410,Cristian Casseres Jr.,Toulouse,8.5,34,22,18,14,2,11,27,40.7,16,12,3,9,11,45,11,1
411,Timothy Castagne,Fulham,0.4,4,2,2,2,0,3,4,75.0,1,0,0,0,0,4,2,0
412,Valentin Castellanos,Lazio,10.0,4,2,0,1,3,1,7,14.3,6,8,1,7,2,6,5,0
413,Jean-Charles Castelletto,Nantes,9.0,8,3,5,3,0,7,10,70.0,3,7,4,3,6,14,50,0
414,Santiago Castro,Bologna,9.3,7,2,3,4,0,1,6,16.7,5,8,1,7,1,8,11,0
416,Gaetano Castrovilli,Lazio,1.4,5,2,3,1,1,2,4,50.0,2,2,0,2,3,8,1,0
417,Danilo Cataldi,Fiorentina,5.6,13,10,5,6,2,5,7,71.4,2,5,3,2,3,16,10,0
418,Catena,Osasuna,12.0,18,10,12,6,0,11,18,61.1,7,12,6,6,11,29,80,0
419,Maximiliano Caufriez,Valencia,1.0,1,1,1,0,0,1,1,100.0,0,2,1,1,1,2,4,0
420,Dani Ceballos,Real Madrid,0.9,5,3,2,3,0,1,3,33.3,2,1,0,1,0,5,0,0
421,Zeki Celik,Roma,10.4,22,15,9,8,5,10,20,50.0,10,7,2,5,4,26,24,1
422,Alberto Cerri,Como,0.9,0,0,0,0,0,0,0,0.0,0,2,0,2,0,0,1,0
423,Franco Cervi,Celta Vigo,0.1,0,0,0,0,0,0,2,0.0,2,0,0,0,1,1,0,0
424,Julian Chabot,Stuttgart,8.5,15,8,10,4,1,7,17,41.2,10,7,3,4,19,34,41,0
425,El Chadaille Bitshiabu,RB Leipzig,2.5,8,4,3,5,0,3,5,60.0,2,4,2,2,5,13,11,1
426,Fares Chaibi,Eint Frankfurt,4.7,7,4,2,3,2,4,7,57.1,3,7,0,7,5,12,20,1
427,Trevoh Chalobah,Crystal Palace,5.0,9,7,3,5,1,5,11,45.5,6,9,4,5,12,21,28,2
428,Timothy Chandler,Eint Frankfurt,0.2,0,0,0,0,0,0,0,0.0,0,0,0,0,3,3,0,0
429,Conor Chaplin,Ipswich Town,3.1,5,3,3,2,0,3,6,50.0,3,4,0,4,2,7,1,0
430,Brendan Chardonnet,Brest,9.0,14,10,6,6,2,9,16,56.3,7,9,7,2,10,24,49,1
431,Gabriel Charpentier,Parma,2.4,2,2,1,0,1,1,2,50.0,1,2,0,2,0,2,8,0
432,Raul Chasco,Valladolid,1.4,4,1,3,1,0,2,4,50.0,2,1,0,1,2,6,2,0
433,Anrie Chase,Stuttgart,5.6,9,4,6,3,0,5,7,71.4,2,8,5,3,7,16,20,0
434,Pep Chavarria,Rayo Vallecano,5.3,7,5,5,2,0,4,10,40.0,6,6,1,5,7,14,15,0
435,Arthur Chaves,Hoffenheim,3.7,7,4,2,5,0,4,9,44.4,5,6,1,5,5,12,17,0
436,Jhoanner Chavez,Lens,6.3,7,4,3,3,1,2,7,28.6,5,10,1,9,6,13,12,0
437,Walid Cheddira,Napoli,0.1,0,0,0,0,0,0,0,0.0,0,0,0,0,0,0,0,0
438,Walid Cheddira,Espanyol,4.0,3,0,0,0,3,0,0,0.0,0,2,0,2,1,4,4,0
439,Theo Chennahi,Montpellier,0.1,0,0,0,0,0,0,0,0.0,0,1,0,1,0,0,0,0
440,Sidiki Cherif,Angers,3.1,4,4,0,3,1,3,4,75.0,1,2,0,2,0,4,0,1
442,Rayan Cherki,Lyon,4.0,3,3,1,1,1,2,7,28.6,5,3,0,3,1,4,2,0
443,Lucas Chevalier,Lille,11.0,2,2,2,0,0,2,2,100.0,0,0,0,0,0,2,1,0
444,Fabio Chiarodia,Gladbach,0.2,2,1,1,1,0,1,1,100.0,0,0,0,0,0,2,5,0
445,Julian Chicco,Leganés,1.5,6,4,0,6,0,3,5,60.0,2,1,0,1,2,8,1,0
446,Leandro Chichizola,Parma,1.0,0,0,0,0,0,0,0,0.0,0,0,0,0,0,0,2,0
447,Federico Chiesa,Liverpool,0.2,0,0,0,0,0,0,0,0.0,0,0,0,0,0,0,0,0
448,Chiquinho,Wolves,0.1,0,0,0,0,0,0,0,0.0,0,0,0,0,0,0,0,0
449,Chiquinho,Mallorca,1.5,1,0,0,1,0,0,7,0.0,7,3,0,3,2,3,0,0
450,Pedro Chirivella,Nantes,9.8,14,13,6,7,1,8,15,53.3,7,4,0,4,3,17,20,0
451,Joris Chotard,Montpellier,3.9,7,4,2,5,0,4,7,57.1,3,3,0,3,3,10,5,0
452,Hamza Choudhury,Leicester City,0.2,0,0,0,0,0,0,0,0.0,0,0,0,0,1,1,1,0
453,Andreas Christensen,Barcelona,0.3,0,0,0,0,0,0,0,0.0,0,0,0,0,0,0,2,0
454,Ryan Christie,Bournemouth,7.8,11,7,5,5,1,3,13,23.1,10,16,5,11,6,17,18,1
455,Samuel Chukwueze,Milan,5.6,6,2,3,2,1,3,10,30.0,7,1,0,1,0,6,2,0
456,Aaron Ciammaglichella,Torino,0.0,0,0,0,0,0,0,0,0.0,0,0,0,0,0,0,0,0
457,Jasper Cillessen,Las Palmas,10.7,1,0,1,0,0,1,1,100.0,0,0,0,0,0,1,9,0
458,Alessandro Circati,Parma,4.0,4,2,3,1,0,1,1,100.0,0,5,4,1,2,6,29,1
459,Pathe Ciss,Rayo Vallecano,3.8,7,4,4,3,0,1,6,16.7,5,7,4,3,6,13,22,0
460,Alphadjo Cisse,Hellas Verona,0.0,0,0,0,0,0,0,0,0.0,0,0,0,0,0,0,0,0
461,Seydouba Cisse,Leganés,10.1,21,13,7,11,3,7,16,43.8,9,11,0,11,6,27,15,1
462,Harry Clarke,Ipswich Town,1.1,2,2,2,0,0,2,3,66.7,1,1,1,0,1,3,4,0
463,Jack Clarke,Ipswich Town,4.0,10,6,3,6,1,4,11,36.4,7,3,0,3,2,12,6,0
464,Alexis Claude-Maurice,Augsburg,3.3,7,5,1,4,2,2,4,50.0,2,1,0,1,3,10,0,0
465,Jonathan Clauss,Nice,8.8,24,16,12,11,1,13,23,56.5,10,10,2,8,17,41,24,0
466,Silvi Clua,Girona,1.7,7,6,4,3,0,3,5,60.0,2,1,0,1,2,9,6,0
468,Nathaniel Clyne,Crystal Palace,3.3,10,6,7,2,1,5,6,83.3,1,2,1,1,3,13,10,1
469,Conor Coady,Leicester City,0.1,0,0,0,0,0,0,0,0.0,0,2,1,1,1,1,2,0
470,Marcus Coco,Nantes,4.8,14,14,6,6,2,7,16,43.8,9,6,2,4,3,17,12,0
471,Saul Coco,Torino,11.0,11,6,8,3,0,2,7,28.6,5,17,11,6,16,27,56,3
472,Seamus Coleman,Everton,1.0,1,0,0,1,0,1,2,50.0,1,2,1,1,0,1,2,0
473,Nathan Collins,Brentford,11.0,14,9,9,3,2,10,14,71.4,4,32,24,8,12,26,58,0
474,Nnamdi Collins,Eint Frankfurt,1.9,4,4,3,0,1,1,1,100.0,0,4,1,3,3,7,7,1
475,Toby Collyer,Manchester Utd,0.5,4,3,1,3,0,2,2,100.0,0,0,0,0,0,4,1,0
476,Lorenzo Colombo,Empoli,8.5,8,4,2,3,3,2,7,28.6,5,7,1,6,1,9,1,0
477,Andrea Colpani,Fiorentina,9.6,8,3,3,4,1,0,5,0.0,5,3,0,3,1,9,8,0
478,Levi Colwill,Chelsea,11.0,10,7,8,2,0,2,5,40.0,3,14,10,4,15,25,42,1
479,Kingsley Coman,Bayern Munich,5.5,9,5,3,2,4,3,5,60.0,2,6,0,6,5,14,12,0
480,Eray Comert,Valladolid,8.9,13,8,6,7,0,6,10,60.0,4,16,9,7,10,23,27,1
481,Santi Comesana,Villarreal,9.4,24,16,12,11,1,8,18,44.4,10,16,7,9,8,32,13,0
482,Pietro Comuzzo,Fiorentina,9.5,19,9,10,7,2,9,12,75.0,3,14,10,4,8,27,27,0
483,Francisco Conceicao,Juventus,4.2,5,3,3,1,1,2,4,50.0,2,1,0,1,3,8,1,0
484,Diego Conde,Villarreal,12.0,2,2,2,0,0,2,4,50.0,2,0,0,0,1,3,5,1
485,Tomas Conechny,Alavés,5.2,4,2,2,2,0,2,10,20.0,8,7,1,6,4,8,4,0
486,Sirlord Conteh,Heidenheim,2.4,6,3,3,3,0,2,2,100.0,0,0,0,0,0,6,1,0
487,Lewis Cook,Bournemouth,10.9,31,18,16,14,1,12,26,46.2,14,15,4,11,19,50,17,0
488,Copete,Mallorca,4.4,8,6,7,1,0,3,3,100.0,0,5,3,2,4,12,37,0
489,Diego Coppola,Hellas Verona,9.5,18,11,14,3,1,10,14,71.4,4,15,7,8,23,41,40,1
490,Derek Cornelius,Marseille,5.7,9,5,6,3,0,7,9,77.8,2,7,3,4,3,12,23,0
491,Maxwel Cornet,Southampton,0.8,5,5,1,4,0,0,4,0.0,4,0,0,0,0,5,2,0
492,Pierre Cornud,Saint-Étienne,2.3,3,3,2,0,1,3,4,75.0,1,3,1,2,3,6,10,1
494,Angel Correa,Atlético Madrid,3.6,2,0,2,0,0,1,5,20.0,4,4,0,4,2,4,1,0
495,Joaquin Correa,Inter,0.5,1,0,0,1,0,0,0,0.0,0,0,0,0,0,1,0,0
496,Thierry Correia,Valencia,8.5,27,18,19,5,3,13,23,56.5,10,10,1,9,4,31,18,0
497,Danny da Costa,Mainz 05,1.9,3,1,3,0,0,2,2,100.0,0,2,0,2,1,4,0,0
498,David Costa,Lens,2.4,2,0,1,1,0,1,2,50.0,1,4,1,3,1,3,0,0
499,Logan Costa,Villarreal,8.2,7,5,5,2,0,5,6,83.3,1,6,4,2,4,11,30,0
500,Logan Costa,Toulouse,1.0,2,1,0,2,0,1,1,100.0,0,2,2,0,2,4,4,0
501,Samu Costa,Mallorca,11.2,30,15,18,11,1,12,24,50.0,12,15,4,11,13,43,36,0
502,Vladimir Coufal,West Ham,2.5,0,0,0,0,0,0,3,0.0,3,2,2,0,2,2,4,0
503,Lassana Coulibaly,Lecce,6.9,8,5,3,5,0,3,9,33.3,6,9,1,8,4,12,8,0
504,Lasso Coulibaly,Auxerre,0.4,0,0,0,0,0,0,0,0.0,0,0,0,0,0,0,0,0
505,Soumaila Coulibaly,Brest,3.6,2,2,0,2,0,0,0,0.0,0,4,1,3,5,7,13,0
506,Tanguy Coulibaly,Montpellier,4.5,9,6,2,6,1,2,8,25.0,6,3,0,3,4,13,0,0
507,Woyo Coulibaly,Parma,9.3,12,9,8,2,2,5,11,45.5,6,15,2,13,8,20,18,0
508,Thibaut Courtois,Real Madrid,9.0,0,0,0,0,0,0,0,0.0,0,0,0,0,1,1,2,0
509,Yan Couto,Dortmund,3.0,5,3,4,1,0,4,7,57.1,3,6,0,6,3,8,8,1
510,Nicolas Cozza,Nantes,6.3,18,15,10,6,2,7,15,46.7,8,7,2,5,6,24,20,0
511,Aaron Cresswell,West Ham,0.3,1,0,0,1,0,1,1,100.0,0,1,0,1,0,1,3,0
512,Charlie Cresswell,Toulouse,7.8,12,4,5,7,0,11,18,61.1,7,6,5,1,9,21,39,1
513,Bryan Cristante,Roma,9.2,17,12,5,10,2,6,10,60.0,4,10,6,4,11,28,17,0
514,Domen Crnigoj,Venezia,0.9,3,1,0,0,3,1,2,50.0,1,3,2,1,1,4,3,0
515,Juan Cruz Armada,Osasuna,4.2,3,1,2,1,0,1,3,33.3,2,1,0,1,0,3,13,0
516,Juan Cruz,Leganés,8.6,7,5,2,5,0,4,7,57.1,3,6,1,5,5,12,9,0
517,Juan Cuadrado,Atalanta,1.6,1,0,0,0,1,1,5,20.0,4,0,0,0,0,1,3,0
518,Pau Cubarsi,Barcelona,11.4,11,8,9,1,1,7,13,53.8,6,5,4,1,8,19,26,0
520,Marc Cucurella,Chelsea,8.2,14,9,10,4,0,5,14,35.7,9,14,5,9,9,23,26,0
521,Jorge Cuenca,Fulham,0.0,1,1,1,0,0,1,1,100.0,0,0,0,0,0,1,1,0
522,Matheus Cunha,Wolves,9.8,13,9,6,5,2,3,13,23.1,10,11,0,11,5,18,13,0
523,Patrick Cutrone,Como,10.4,9,7,0,5,4,5,7,71.4,2,4,0,4,1,10,6,0
524,Tomas Cvancara,Gladbach,2.2,1,1,0,1,0,1,1,100.0,0,3,2,1,0,1,5,0
525,Wylan Cyprien,Parma,0.3,0,0,0,0,0,0,1,0.0,1,1,0,1,1,1,0,0
526,Danilo D'Ambrosio,Monza,2.3,9,3,8,0,1,3,7,42.9,4,3,1,2,2,11,4,0
527,Lucas Da Cunha,Como,4.9,10,3,4,4,2,3,6,50.0,3,5,0,5,3,13,3,0
528,Samuel Dahl,Roma,0.3,2,2,0,2,0,1,2,50.0,1,1,0,1,0,2,0,0
529,Mahmoud Dahoud,Eint Frankfurt,2.2,5,2,4,1,0,2,3,66.7,1,4,1,3,1,6,2,0
530,Ameen Al-Dakhil,Stuttgart,0.1,0,0,0,0,0,0,0,0.0,0,0,0,0,0,0,2,0
531,Thijs Dallinga,Bologna,2.2,4,2,0,1,3,1,1,100.0,0,1,1,0,0,4,4,0
532,Diogo Dalot,Manchester Utd,10.6,24,18,13,9,2,11,20,55.0,9,10,5,5,18,42,25,0
533,Mikkel Damsgaard,Brentford,8.8,28,17,13,7,8,10,22,45.5,12,15,1,14,10,38,19,1
534,Flavius Daniliuc,Hellas Verona,5.3,12,8,7,5,0,8,14,57.1,6,4,1,3,5,17,12,0
535,Danilo,Nott'ham Forest,0.2,0,0,0,0,0,0,0,0.0,0,0,0,0,0,0,0,0
536,Danilo,Juventus,3.5,5,2,2,2,1,1,4,25.0,3,4,3,1,6,11,15,0
537,Arnaut Danjuma,Villarreal,2.2,2,1,0,1,1,0,1,0.0,1,1,0,1,0,2,0,0
538,Arnaut Danjuma,Girona,5.7,5,3,2,2,1,1,3,33.3,2,3,0,3,1,6,0,0
539,Kevin Danois,Auxerre,6.8,25,17,10,12,3,9,23,39.1,14,1,0,1,13,38,7,0
540,Kevin Danso,Lens,6.0,6,0,5,1,0,3,4,75.0,1,12,12,0,6,12,22,1
541,Dante,Nice,7.3,17,7,9,6,2,10,13,76.9,3,5,1,4,9,26,24,0
542,Pape Daouda Diongue,Strasbourg,0.6,1,0,0,1,0,0,0,0.0,0,0,0,0,3,4,0,0
543,Mohammed Daramy,Reims,0.2,0,0,0,0,0,0,0,0.0,0,0,0,0,0,0,1,0
544,Bence Dardai,Wolfsburg,2.0,5,5,1,4,0,2,5,40.0,3,3,0,3,1,6,0,0
546,Sergi Darder,Mallorca,9.0,17,10,9,3,5,5,15,33.3,10,4,0,4,4,21,6,1
547,Matteo Darmian,Inter,7.4,16,9,6,7,3,8,13,61.5,5,2,2,0,2,18,13,0
548,Lukas Daschner,Bochum,3.5,4,2,1,2,1,2,8,25.0,6,5,0,5,0,4,3,0
549,Juan David Cabal,Juventus,5.1,10,4,7,3,0,8,12,66.7,4,2,0,2,2,12,14,1
550,Jonathan David,Lille,9.1,7,1,2,3,2,3,8,37.5,5,5,1,4,2,9,2,0
551,Alphonso Davies,Bayern Munich,8.2,15,9,5,8,2,7,8,87.5,1,3,0,3,6,21,10,1
552,Ben Davies,Tottenham,0.3,1,0,0,1,0,1,1,100.0,0,0,0,0,1,2,2,0
553,Keinan Davis,Udinese,5.7,5,3,0,3,2,1,2,50.0,1,2,1,1,1,6,4,0
554,Leif Davis,Ipswich Town,11.0,21,12,18,2,1,16,26,61.5,10,10,1,9,11,32,31,0
555,Zuriko Davitashvili,Saint-Étienne,10.7,10,5,3,5,2,8,20,40.0,12,6,0,6,7,17,3,0
556,Pawel Dawidowicz,Hellas Verona,4.2,8,6,2,6,0,3,4,75.0,1,2,1,1,3,11,11,0
557,Craig Dawson,Wolves,8.3,13,3,7,5,1,11,14,78.6,3,14,11,3,8,21,43,1
558,Kevin De Bruyne,Manchester City,4.1,2,1,2,0,0,0,3,0.0,3,2,0,2,2,4,0,0
559,Charles De Ketelaere,Atalanta,8.5,4,4,0,3,1,1,5,20.0,4,4,2,2,0,4,4,0
560,Rodrigo De Paul,Atlético Madrid,6.2,5,4,2,3,0,5,8,62.5,3,4,0,4,2,7,6,1
561,Mattia De Sciglio,Empoli,1.9,3,1,0,3,0,3,4,75.0,1,2,0,2,2,5,8,0
562,Lorenzo De Silvestri,Bologna,3.2,5,3,3,1,1,3,6,50.0,3,4,0,4,2,7,9,0
563,Thibault De Smet,Reims,0.1,0,0,0,0,0,0,0,0.0,0,1,1,0,1,1,2,0
564,Koni De Winter,Genoa,7.0,12,9,6,5,1,4,6,66.7,2,2,1,1,8,20,34,0
565,Alessandro Deiola,Cagliari,6.2,14,8,4,9,1,5,17,29.4,12,7,5,2,3,17,15,0
566,Romain Del Castillo,Brest,6.8,15,10,3,6,6,9,11,81.8,2,10,0,10,2,17,0,0
567,Enrico Del Prato,Parma,10.2,6,4,4,2,0,3,7,42.9,4,25,12,13,8,14,43,1
568,Liam Delap,Ipswich Town,8.6,3,1,1,1,1,0,6,0.0,6,4,0,4,1,4,10,0
569,Fisayo Dele-Bashiru,Lazio,1.9,3,3,1,1,1,0,0,0.0,0,2,0,2,0,3,0,0
570,Olivier Deman,Werder Bremen,0.5,3,1,0,3,0,1,5,20.0,4,0,0,0,0,3,2,0
572,Ali Dembele,Torino,0.7,2,1,1,1,0,2,2,100.0,0,0,0,0,0,2,2,0
573,Ousmane Dembele,Paris S-G,6.7,5,2,0,2,3,2,3,66.7,1,1,0,1,4,9,0,1
574,Ermedin Demirovic,Stuttgart,5.9,4,3,1,1,2,0,4,0.0,4,3,0,3,1,5,2,0
575,Sepp van den Berg,Brentford,8.1,14,8,10,2,2,5,9,55.6,4,14,7,7,6,20,30,2
576,Arthur Desmas,Le Havre,11.0,0,0,0,0,0,0,1,0.0,1,0,0,0,0,0,3,1
577,Justin Devenny,Crystal Palace,0.8,3,2,3,0,0,2,2,100.0,0,0,0,0,0,3,1,0
578,Kiernan Dewsbury-Hall,Chelsea,0.5,0,0,0,0,0,0,0,0.0,0,1,0,1,1,1,1,1
579,Michele Di Gregorio,Juventus,9.0,0,0,0,0,0,0,0,0.0,0,0,0,0,0,0,1,0
580,Giovanni Di Lorenzo,Napoli,12.0,29,20,16,12,1,20,26,76.9,6,4,2,2,12,41,35,1
581,Boulaye Dia,Lazio,7.7,7,3,3,1,3,3,6,50.0,3,2,0,2,3,10,2,1
582,Mamadou Diakhon,Reims,1.3,4,4,2,0,2,4,5,80.0,1,0,0,0,1,5,1,0
583,Bafode Diakite,Lille,11.0,12,6,8,2,2,9,14,64.3,5,11,6,5,11,23,30,2
584,Oumar Diakite,Reims,8.2,10,7,5,4,1,6,11,54.5,5,7,1,6,2,12,6,0
585,Amad Diallo,Manchester Utd,5.4,16,12,4,8,4,8,11,72.7,3,2,0,2,4,20,2,0
586,Assane Diao,Betis,2.6,4,2,0,3,1,3,7,42.9,4,1,0,1,0,4,3,0
587,Habib Diarra,Strasbourg,10.3,8,5,0,7,1,4,7,57.1,3,5,0,5,2,10,11,1
588,Moussa Diarra,Alavés,6.2,14,9,5,9,0,8,13,61.5,5,4,1,3,8,22,2,0
589,Ruben Dias,Manchester City,8.1,7,4,3,3,1,3,4,75.0,1,4,3,1,10,17,21,1
590,Krepin Diatta,Monaco,2.2,11,7,8,1,2,7,13,53.8,6,4,1,3,3,14,7,1
591,Kandet Diawara,Le Havre,0.0,0,0,0,0,0,0,0,0.0,0,1,0,1,0,0,1,0
592,Mahamadou Diawara,Lyon,0.2,1,0,0,1,0,1,3,33.3,2,2,0,2,0,1,0,0
593,Brahim Diaz,Real Madrid,2.3,7,6,3,3,1,0,3,0.0,3,1,0,1,1,8,0,0
594,Luis Diaz,Liverpool,7.2,12,7,5,6,1,5,12,41.7,7,7,0,7,3,15,4,1
595,Pedro Diaz,Rayo Vallecano,0.7,1,1,0,1,0,1,1,100.0,0,2,0,2,1,2,0,0
596,Tyler Dibling,Southampton,6.3,11,9,5,5,1,5,9,55.6,4,4,1,3,2,13,3,0
598,Diego,Leganés,2.1,0,0,0,0,0,0,1,0.0,1,0,0,0,0,0,3,0
599,Justin Diehl,Stuttgart,0.6,0,0,0,0,0,0,0,0.0,0,2,0,2,0,0,0,0
600,Bamba Dieng,Angers,2.6,2,0,0,1,1,0,0,0.0,0,1,0,1,0,2,3,0
601,Eric Dier,Bayern Munich,0.5,1,1,1,0,0,0,1,0.0,1,1,0,1,0,1,3,0
602,Lucas Digne,Aston Villa,9.3,24,15,14,7,3,16,25,64.0,9,11,3,8,14,38,29,0
603,Federico Dimarco,Inter,10.6,8,3,3,3,2,5,7,71.4,2,10,2,8,6,14,11,0
604,Junior Dina Ebimbe,Eint Frankfurt,3.1,2,1,1,1,0,0,2,0.0,2,4,0,4,7,9,6,0
605,Eren Dinkci,Freiburg,6.5,12,7,3,6,3,3,13,23.1,10,10,1,9,4,16,1,0
606,Sinaly Diomande,Auxerre,7.3,10,7,3,6,1,8,12,66.7,4,12,8,4,9,19,23,0
607,Lois Diony,Angers,0.2,0,0,0,0,0,0,0,0.0,0,0,0,0,0,0,0,0
608,Issa Diop,Fulham,4.4,8,5,5,3,0,3,5,60.0,2,4,3,1,1,9,19,0
609,Sofiane Diop,Nice,1.6,3,3,1,0,2,0,3,0.0,3,3,0,3,2,5,2,0
610,Andy Diouf,Lens,9.6,14,10,3,9,2,9,18,50.0,9,13,1,12,5,19,7,0
611,Yehvann Diouf,Reims,11.0,0,0,0,0,0,0,1,0.0,1,0,0,0,0,0,4,1
612,Assane Diousse,Auxerre,0.3,1,1,0,1,0,0,0,0.0,0,0,0,0,0,1,1,0
613,Axel Disasi,Chelsea,1.0,1,1,1,0,0,1,3,33.3,2,1,0,1,1,2,3,0
614,Roman Dixon,Everton,1.0,5,5,3,2,0,4,4,100.0,0,1,0,1,1,6,3,0
615,Alvaro djalo,Athletic Club,3.8,2,1,1,1,0,0,2,0.0,2,1,0,1,1,3,1,0
616,Djene,Getafe,10.5,6,1,3,3,0,1,8,12.5,7,8,5,3,11,17,40,0
617,Berat Djimsiti,Atalanta,10.3,24,14,12,12,0,12,14,85.7,2,12,8,4,19,43,35,1
618,Marko Dmitrovic,Leganés,7.0,0,0,0,0,0,0,1,0.0,1,0,0,0,0,0,8,2
619,Ritsu Doan,Freiburg,9.4,16,13,9,5,2,8,14,57.1,6,16,0,16,6,22,8,0
620,Dodo,Fiorentina,12.0,12,9,6,3,3,8,15,53.3,7,10,3,7,16,28,22,0
621,Danilho Doekhi,Union Berlin,10.0,14,9,7,5,2,6,9,66.7,3,14,5,9,12,26,27,0
622,Matt Doherty,Wolves,2.3,8,6,6,2,0,4,5,80.0,1,4,1,3,2,10,8,0
624,Jeremy Doku,Manchester City,4.5,9,4,2,3,4,1,3,33.3,2,4,0,4,0,9,1,0
625,Marc Domenech,Mallorca,1.3,0,0,0,0,0,0,2,0.0,2,2,0,2,0,0,0,0
626,Benjamin Dominguez,Bologna,0.7,1,0,0,1,0,0,0,0.0,0,0,0,0,0,1,0,0
627,Carlos Dominguez,Celta Vigo,3.8,7,4,4,3,0,4,7,57.1,3,4,4,0,4,11,22,0
628,Israel Dominguez,Sevilla,0.2,0,0,0,0,0,0,0,0.0,0,0,0,0,0,0,0,0
629,Nicolas Dominguez,Nott'ham Forest,5.8,20,10,7,9,4,11,19,57.9,8,14,4,10,9,29,11,0
630,Sergi Dominguez,Barcelona,1.9,1,1,1,0,0,0,0,0.0,0,0,0,0,3,4,7,0
631,Gianluigi Donnarumma,Paris S-G,8.0,1,1,1,0,0,1,1,100.0,0,0,0,0,0,1,3,0
632,Patrick Dorgu,Lecce,10.4,22,12,10,9,3,13,24,54.2,11,10,3,7,12,34,18,0
633,Niklas Dorsch,Augsburg,0.4,0,0,0,0,0,0,0,0.0,0,1,0,1,0,0,0,0
634,Niklas Dorsch,Heidenheim,3.6,4,2,2,2,0,1,4,25.0,3,5,0,5,4,8,3,0
635,Alberto Dossena,Como,10.6,15,8,12,3,0,6,11,54.5,5,8,5,3,11,26,52,1
636,Abdoulaye Doucoure,Everton,7.2,12,6,7,5,0,4,4,100.0,0,11,3,8,3,15,5,0
637,Cheick Doucoure,Crystal Palace,1.5,6,3,1,4,1,1,4,25.0,3,2,0,2,3,9,1,0
638,Desire Doue,Paris S-G,3.6,5,3,1,4,0,2,9,22.2,7,3,0,3,0,5,1,0
639,Guela Doue,Strasbourg,10.0,21,16,12,4,5,12,16,75.0,4,10,0,10,17,38,46,0
640,Douglas,Nantes,8.4,21,12,8,9,4,5,12,41.7,7,15,2,13,7,28,11,0
641,Ismael Doukoure,Strasbourg,9.5,15,6,6,9,0,8,8,100.0,0,15,5,10,8,23,27,2
642,Issa Doumbia,Venezia,1.6,3,1,1,2,0,3,4,75.0,1,3,1,2,1,4,2,0
643,Kamory Doumbia,Brest,3.7,13,8,5,6,2,8,15,53.3,7,4,0,4,6,19,4,0
644,Anastasios Douvikas,Celta Vigo,5.4,6,1,2,4,0,2,4,50.0,2,4,2,2,3,9,5,0
645,Artem Dovbyk,Roma,10.6,1,1,0,0,1,0,1,0.0,1,5,2,3,1,2,3,0
646,Flynn Downes,Southampton,10.0,23,12,12,9,2,6,19,31.6,13,16,3,13,15,38,15,2
647,Tommy Doyle,Wolves,3.0,3,1,0,3,0,2,5,40.0,3,3,1,2,2,5,5,0
648,Radu Dragusin,Tottenham,3.1,1,0,1,0,0,1,4,25.0,3,4,3,1,3,4,12,2
650,Patrick Drewes,Bochum,10.0,0,0,0,0,0,0,1,0.0,1,0,0,0,0,0,9,1
651,Tim Drexler,Hoffenheim,4.0,17,7,11,6,0,9,12,75.0,3,6,4,2,1,18,9,1
652,Domingos Duarte,Getafe,1.0,0,0,0,0,0,0,0,0.0,0,0,0,0,1,1,2,0
653,Marvin Ducksch,Werder Bremen,8.9,5,3,1,3,1,1,8,12.5,7,2,0,2,2,7,12,0
654,Ondrej Duda,Hellas Verona,7.9,11,7,5,6,0,6,15,40.0,9,8,2,6,9,20,5,3
655,Denzel Dumfries,Inter,5.3,5,4,1,2,2,2,6,33.3,4,5,0,5,2,7,5,0
656,Alfred Duncan,Venezia,7.3,13,5,3,9,1,3,8,37.5,5,4,2,2,7,20,5,0
657,Lewis Dunk,Brighton,7.8,3,1,3,0,0,1,1,100.0,0,9,5,4,7,10,20,0
658,Jhon Duran,Aston Villa,3.2,5,4,1,0,4,1,3,33.3,2,3,0,3,0,5,7,0
659,Pablo Duran,Celta Vigo,2.1,3,2,0,2,1,2,4,50.0,2,1,1,0,2,5,2,0
660,Julien Duranville,Dortmund,0.3,0,0,0,0,0,0,0,0.0,0,0,0,0,0,0,0,0
661,Hugo Duro,Valencia,7.8,7,5,3,3,1,2,2,100.0,0,6,1,5,6,13,5,0
662,Jean-Kevin Duverne,Nantes,4.6,14,11,8,3,3,11,22,50.0,11,8,1,7,8,22,18,0
663,Paulo Dybala,Roma,5.9,9,4,1,5,3,4,6,66.7,2,4,0,4,1,10,0,0
664,Stefan Dzodic,Montpellier,1.9,5,2,3,2,0,3,5,60.0,2,2,1,1,4,9,7,0
665,Adam Dzwigala,St. Pauli,1.1,8,3,7,1,0,5,7,71.4,2,0,0,0,0,8,5,0
666,Aron Donnum,Toulouse,8.1,10,6,4,6,0,3,13,23.1,10,4,2,2,6,16,13,0
667,Enzo Ebosse,Udinese,0.5,0,0,0,0,0,0,0,0.0,0,2,2,0,0,0,0,0
668,Ederson,Manchester City,11.0,0,0,0,0,0,0,0,0.0,0,0,0,0,1,1,3,1
669,Ederson,Atalanta,10.8,11,9,4,6,1,6,12,50.0,6,5,1,4,14,25,12,0
670,George Edmundson,Ipswich Town,0.0,0,0,0,0,0,0,0,0.0,0,0,0,0,0,0,0,0
671,Odsonne Edouard,Crystal Palace,1.3,1,0,0,1,0,0,2,0.0,2,1,0,1,0,1,1,0
672,Odsonne Edouard,Leicester City,0.3,1,1,1,0,0,0,0,0.0,0,0,0,0,0,1,1,0
673,Samuel Edozie,Southampton,0.7,3,1,0,1,2,2,2,100.0,0,0,0,0,0,3,0,0
674,Johannes Eggestein,St. Pauli,9.1,1,0,0,0,1,0,1,0.0,1,1,0,1,0,1,3,0
676,Maximilian Eggestein,Freiburg,8.4,13,7,3,8,2,6,11,54.5,5,8,1,7,14,27,10,0
677,Kingsley Ehizibue,Udinese,11.2,20,13,13,7,0,11,20,55.0,9,14,4,10,10,30,24,1
678,Chidera Ejuke,Sevilla,6.0,5,3,0,3,2,3,9,33.3,6,6,0,6,1,6,2,0
679,Jeff Ekhator,Genoa,4.0,0,0,0,0,0,0,0,0.0,0,4,0,4,0,0,1,0
680,Hugo Ekitike,Eint Frankfurt,7.5,5,2,2,2,1,3,4,75.0,1,4,0,4,4,9,5,0
681,Jurgen Ekkelenkamp,Udinese,3.5,6,4,1,5,0,4,5,80.0,1,5,0,5,3,9,4,0
682,Jacques Ekomie,Angers,2.5,5,5,2,2,1,2,4,50.0,2,6,0,6,2,7,6,0
683,Emmanuel Ekong,Empoli,1.2,3,2,0,2,1,2,2,100.0,0,1,0,1,1,4,1,0
684,Caleb Ekuban,Genoa,2.3,1,1,0,1,0,0,0,0.0,0,2,0,2,0,1,3,0
685,Pierre Ekwah Elimby,Saint-Étienne,8.0,15,10,7,8,0,10,16,62.5,6,9,5,4,14,29,27,0
686,Anthony Elanga,Nott'ham Forest,7.2,7,4,3,3,1,2,5,40.0,3,4,0,4,3,10,9,0
687,Mikael Ellertsson,Venezia,7.9,12,6,5,5,2,4,9,44.4,5,9,2,7,3,15,19,0
688,Harvey Elliott,Liverpool,0.1,0,0,0,0,0,0,0,0.0,0,0,0,0,0,0,0,0
689,Elif Elmas,RB Leipzig,0.5,3,1,3,0,0,1,3,33.3,2,2,0,2,0,3,2,0
690,Aritz Elustondo,Real Sociedad,3.1,4,2,2,1,1,1,1,100.0,0,6,5,1,2,6,15,0
691,Nico Elvedi,Gladbach,5.5,10,5,5,2,3,6,6,100.0,0,10,8,2,8,18,19,0
692,Adri Embarba,Rayo Vallecano,6.6,12,5,6,5,1,7,14,50.0,7,4,0,4,4,16,4,0
693,Breel Embolo,Monaco,6.5,3,2,1,1,1,1,5,20.0,4,2,0,2,1,4,3,0
694,Emanuel Emegha,Strasbourg,7.1,4,4,0,2,2,1,1,100.0,0,6,4,2,0,4,8,0
695,Emerson,Milan,7.6,16,10,8,6,2,9,16,56.3,7,5,2,3,5,21,22,0
696,Yunus Emre Konak,Brentford,0.2,1,1,0,1,0,0,1,0.0,1,0,0,0,0,1,0,0
697,Julio Enciso,Brighton,1.0,0,0,0,0,0,0,1,0.0,1,1,0,1,0,0,0,0
698,Wataru Endo,Liverpool,0.2,3,2,0,3,0,2,2,100.0,0,2,0,2,0,3,1,0
699,Endrick,Real Madrid,0.7,0,0,0,0,0,0,1,0.0,1,0,0,0,1,1,0,0
700,Yannik Engelhardt,Como,3.1,6,4,3,2,1,4,7,57.1,3,0,0,0,3,9,1,0
702,Arne Engels,Augsburg,0.9,0,0,0,0,0,0,0,0.0,0,1,1,0,0,0,0,0
703,Christian Eriksen,Manchester Utd,4.9,7,2,0,5,2,4,9,44.4,5,4,1,3,2,9,4,0
704,Martin Erlic,Bologna,2.5,2,0,0,2,0,1,2,50.0,1,5,4,1,1,3,5,0
705,Patrick Erras,Holstein Kiel,7.2,5,4,4,1,0,1,7,14.3,6,10,8,2,5,10,55,0
706,Alfonso Espino,Rayo Vallecano,3.4,16,9,10,5,1,9,20,45.0,11,6,2,4,7,23,7,0
707,Sebastiano Esposito,Empoli,6.0,16,9,5,9,2,8,15,53.3,7,4,1,3,5,21,2,0
708,Samuel Essende,Augsburg,5.0,0,0,0,0,0,0,0,0.0,0,4,1,3,0,0,1,0
709,Dario Essugo,Las Palmas,7.4,20,14,12,5,3,9,14,64.3,5,8,5,3,19,39,18,5
710,Nahuel Estevez,Parma,2.6,3,1,3,0,0,1,6,16.7,5,3,2,1,2,5,11,0
711,Pervis Estupinan,Brighton,5.8,17,11,10,6,1,5,11,45.5,6,2,1,1,11,28,18,0
712,Evanilson,Bournemouth,7.9,4,2,0,1,3,2,3,66.7,1,6,1,5,0,4,9,0
713,Jonny Evans,Manchester Utd,2.6,7,5,4,3,0,2,3,66.7,1,2,1,1,1,8,10,0
714,Eberechi Eze,Crystal Palace,9.0,15,8,6,7,2,6,14,42.9,8,6,0,6,3,18,3,1
715,Abde Ezzalzouli,Betis,10.3,17,12,10,7,0,5,9,55.6,4,11,1,10,4,21,5,0
716,Giovanni Fabbian,Bologna,4.1,6,5,1,2,3,3,6,50.0,3,0,0,0,1,7,4,0
717,Lukasz Fabianski,West Ham,3.5,0,0,0,0,0,0,1,0.0,1,0,0,0,0,0,2,0
718,Alieu Fadera,Como,7.6,25,21,11,8,6,8,23,34.8,15,7,1,6,3,28,3,0
719,Wout Faes,Leicester City,11.0,17,12,14,2,1,7,19,36.8,12,25,18,7,6,23,65,2
720,Nicolo Fagioli,Juventus,4.9,10,7,6,3,1,5,7,71.4,2,1,0,1,2,12,3,0
721,Romain Faivre,Brest,4.5,6,6,2,3,1,2,6,33.3,4,1,0,1,3,9,2,0
722,Wladimiro Falcone,Lecce,12.0,0,0,0,0,0,0,0,0.0,0,0,0,0,0,0,8,1
723,Davide Faraoni,Hellas Verona,0.5,1,1,0,1,0,0,2,0.0,2,1,1,0,0,1,2,1
724,Abdul Fatawu Issahaku,Leicester City,6.4,21,15,13,2,6,11,19,57.9,8,7,0,7,4,25,12,0
725,Ansu Fati,Barcelona,1.4,1,1,0,1,0,0,0,0.0,0,0,0,0,0,1,0,1
726,Khalil Fayad,Montpellier,2.8,14,7,5,9,0,5,8,62.5,3,4,0,4,1,15,4,0
728,Jacopo Fazzini,Empoli,6.1,16,9,8,7,1,9,13,69.2,4,7,1,6,2,18,10,0
729,Peter Federico,Getafe,2.6,5,2,1,2,2,3,3,100.0,0,3,0,3,0,5,3,0
730,Nabil Fekir,Betis,2.0,3,2,1,1,1,1,2,50.0,1,2,0,2,0,3,0,0
731,Mattia Felici,Cagliari,0.8,0,0,0,0,0,0,2,0.0,2,0,0,0,4,4,0,0
732,Joao Felix,Chelsea,1.4,2,0,1,0,1,1,2,50.0,1,1,0,1,1,3,2,0
733,Kiko Femenia,Villarreal,11.3,22,13,16,5,1,15,28,53.6,13,14,7,7,17,39,21,0
734,Evan Ferguson,Brighton,1.2,1,1,0,1,0,0,1,0.0,1,2,1,1,0,1,1,0
735,Lewis Ferguson,Bologna,0.1,0,0,0,0,0,0,0,0.0,0,0,0,0,0,0,0,0
736,Zinedine Ferhat,Angers,2.3,1,0,0,1,0,0,2,0.0,2,1,0,1,2,3,2,0
737,Bruno Fernandes,Manchester Utd,10.3,28,19,7,15,6,10,24,41.7,14,10,1,9,8,36,13,0
738,Edimilson Fernandes,Brest,2.2,2,2,1,1,0,2,3,66.7,1,5,2,3,5,7,6,0
739,Mateus Fernandes,Southampton,7.9,27,15,12,10,5,7,17,41.2,10,10,1,9,5,32,12,1
740,Alvaro Fernandez,Sevilla,2.3,0,0,0,0,0,0,0,0.0,0,0,0,0,0,0,1,0
741,Enzo Fernandez,Chelsea,6.8,21,10,6,8,7,10,25,40.0,15,7,1,6,2,23,6,2
742,Valery Fernandez,Mallorca,1.4,3,3,1,0,2,2,4,50.0,2,2,1,1,0,3,1,0
743,Matias Fernandez-Pardo,Lille,2.1,5,3,3,2,0,4,7,57.1,3,3,0,3,1,6,2,0
744,Jordan Ferri,Montpellier,6.5,16,10,5,10,1,8,13,61.5,5,4,0,4,3,19,6,0
745,Karol Fila,Strasbourg,0.1,0,0,0,0,0,0,0,0.0,0,0,0,0,0,0,0,0
746,Kilian Fischer,Wolfsburg,7.7,19,15,14,3,2,14,34,41.2,20,16,2,14,7,26,34,2
747,Mark Flekken,Brentford,11.0,1,1,1,0,0,1,3,33.3,2,0,0,0,0,1,12,0
748,Mateo Flores,Betis,0.3,0,0,0,0,0,0,0,0.0,0,0,0,0,0,0,1,0
749,Phil Foden,Manchester City,5.1,1,0,1,0,0,1,4,25.0,3,4,1,3,3,4,2,0
750,Malick Fofana,Lyon,6.7,7,4,4,3,0,4,6,66.7,2,6,0,6,2,9,4,0
751,Wesley Fofana,Chelsea,9.6,10,9,4,6,0,4,9,44.4,5,14,9,5,12,22,46,1
752,Yahia Fofana,Angers,11.0,0,0,0,0,0,0,1,0.0,1,0,0,0,0,0,11,0
754,Youssouf Fofana,Milan,8.8,12,7,3,8,1,6,12,50.0,6,6,2,4,9,21,11,2
755,Jonas Fohrenbach,Heidenheim,9.6,16,11,9,6,1,7,10,70.0,3,8,2,6,8,24,22,0
756,Michael Folorunsho,Napoli,0.3,2,1,0,2,0,2,4,50.0,2,0,0,0,0,2,0,1
757,Lamine Fomba,Saint-Étienne,0.8,2,1,1,1,0,1,2,50.0,1,4,1,3,2,4,3,1
758,Carlos Forbs,Wolves,2.0,6,5,3,2,1,4,5,80.0,1,3,0,3,0,6,2,1
759,Pablo Fornals,Betis,10.6,11,7,5,5,1,4,14,28.6,10,17,0,17,13,24,8,1
760,Omari Forson,Monza,0.3,0,0,0,0,0,0,0,0.0,0,2,0,2,0,0,0,0
761,Hector Fort,Barcelona,2.1,3,2,1,2,0,3,5,60.0,2,2,0,2,1,4,5,0
762,Dimitri Foulquier,Valencia,5.4,17,12,8,6,3,9,13,69.2,4,5,0,5,1,18,9,1
763,Alejandro Frances,Girona,6.2,19,13,11,7,1,16,22,72.7,6,6,2,4,9,28,19,0
764,Przemyslaw Frankowski,Lens,6.5,14,10,7,5,2,8,13,61.5,5,5,0,5,1,15,10,0
765,Enric Franquesa,Leganés,6.8,17,9,9,6,2,9,13,69.2,4,7,1,6,5,22,12,0
766,Ryan Fraser,Southampton,1.6,5,2,1,4,0,4,5,80.0,1,0,0,0,0,5,4,0
767,Davide Frattesi,Inter,6.1,7,3,3,4,0,5,10,50.0,5,4,2,2,2,9,2,1
768,Morten Frendrup,Genoa,10.5,32,21,8,13,11,11,22,50.0,11,17,7,10,15,47,16,0
769,Martin Frese,Hellas Verona,3.7,13,7,6,7,0,5,8,62.5,3,2,1,1,6,19,14,1
770,Remo Freuler,Bologna,10.9,29,16,16,9,4,15,25,60.0,10,12,2,10,8,37,21,1
771,Marco Friedl,Werder Bremen,7.5,18,12,11,7,0,10,14,71.4,4,13,6,7,13,31,38,0
772,Marvin Friedrich,Gladbach,4.5,5,0,5,0,0,3,4,75.0,1,7,6,1,2,7,22,0
773,Jeremie Frimpong,Leverkusen,8.3,10,9,6,2,2,6,13,46.2,7,9,0,9,5,15,5,0
774,Jorge de Frutos,Rayo Vallecano,9.7,16,10,6,5,5,7,22,31.8,15,5,0,5,5,21,10,0
775,Chris Fuhrich,Stuttgart,4.1,4,3,1,2,1,4,8,50.0,4,3,0,3,0,4,6,0
776,Angelo Fulgini,Lens,3.9,3,3,1,0,2,2,3,66.7,1,6,1,5,0,3,2,0
777,Niclas Fullkrug,West Ham,0.7,0,0,0,0,0,0,0,0.0,0,0,0,0,0,0,2,0
778,Manuel Fuster,Las Palmas,2.6,4,0,1,3,0,4,8,50.0,4,4,1,3,1,5,4,0
780,Matteo Gabbia,Milan,4.0,2,0,0,1,1,0,1,0.0,1,4,2,2,2,4,11,1
781,Alessandro Gabrielloni,Como,0.9,0,0,0,0,0,0,3,0.0,3,0,0,0,0,0,0,0
782,Gianluca Gaetano,Cagliari,4.0,5,3,2,3,0,3,8,37.5,5,3,0,3,2,7,4,0
783,Roberto Gagliardini,Monza,1.1,1,0,0,1,0,0,2,0.0,2,0,0,0,1,2,4,0
784,Cody Gakpo,Liverpool,4.7,9,5,4,3,2,6,8,75.0,2,6,0,6,4,13,5,0
785,Javi Galan,Atlético Madrid,3.5,8,5,5,2,1,6,13,46.2,7,4,1,3,3,11,2,0
786,Inigo Ruiz de Galarreta,Athletic Club,5.3,11,9,5,6,0,7,12,58.3,5,3,1,2,3,14,2,0
787,Conor Gallagher,Atlético Madrid,6.7,19,13,6,10,3,8,16,50.0,8,9,1,8,7,26,11,0
788,Antonino Gallo,Lecce,10.4,23,14,15,5,3,7,17,41.2,10,11,1,10,9,32,39,0
789,Gauthier Gallon,Rennes,0.5,0,0,0,0,0,0,0,0.0,0,0,0,0,0,0,0,0
790,Cristian Gamboa,Bochum,1.3,1,1,1,0,0,1,2,50.0,1,0,0,0,0,1,2,0
791,Idrissa Gana Gueye,Everton,8.2,30,18,17,8,5,12,20,60.0,8,12,2,10,11,41,8,0
792,Ignatius Ganago,Nantes,1.4,1,1,0,1,0,1,1,100.0,0,2,1,1,2,3,0,0
793,Aleix Garcia,Leverkusen,2.8,4,1,1,2,1,2,4,50.0,2,2,0,2,2,6,3,0
794,Alvaro Garcia,Rayo Vallecano,7.0,14,9,9,4,1,5,10,50.0,5,4,0,4,11,25,13,1
795,Eric Garcia,Barcelona,4.9,10,4,2,6,2,4,6,66.7,2,8,3,5,4,14,9,0
796,Fran Garcia,Real Madrid,4.6,7,6,4,1,2,3,5,60.0,2,3,2,1,3,10,6,0
797,Joan Garcia,Espanyol,12.0,0,0,0,0,0,0,0,0.0,0,0,0,0,0,0,4,3
798,Ruben Garcia,Osasuna,7.0,16,13,7,6,3,11,19,57.9,8,13,1,12,8,24,10,0
799,Ulisses Garcia,Marseille,2.7,6,5,3,2,1,3,10,30.0,7,3,0,3,1,7,8,0
800,Alejandro Garnacho,Manchester Utd,7.9,12,10,4,3,5,3,11,27.3,8,4,0,4,5,17,6,1
801,James Garner,Everton,2.8,10,8,6,4,0,7,10,70.0,3,2,2,0,4,14,9,0
802,Yarek Gasiorowski,Valencia,3.2,7,5,6,1,0,4,7,57.1,3,6,3,3,3,10,17,0
803,Federico Gatti,Juventus,8.9,10,7,8,2,0,7,9,77.8,2,11,8,3,8,18,27,0
804,Gavi,Barcelona,0.3,2,1,1,1,0,2,2,100.0,0,2,0,2,0,2,1,0
806,Paulo Gazzaniga,Girona,13.0,1,1,1,0,0,1,1,100.0,0,0,0,0,0,1,3,0
807,Jean-Philippe Gbamin,Nantes,2.0,2,1,0,2,0,1,3,33.3,2,4,1,3,3,5,2,0
808,Yann Gboho,Toulouse,10.4,13,6,3,6,4,5,11,45.5,6,7,0,7,2,15,1,0
809,David de Gea,Fiorentina,9.0,0,0,0,0,0,0,0,0.0,0,0,0,0,0,0,2,0
810,Lutsharel Geertruida,RB Leipzig,6.1,14,8,8,6,0,7,16,43.8,9,6,1,5,5,19,18,1
811,Dennis Geiger,Hoffenheim,1.9,6,5,2,3,1,3,5,60.0,2,1,0,1,1,7,0,0
812,Valentin Gendrey,Lecce,2.0,2,2,1,0,1,1,1,100.0,0,3,1,2,2,4,1,0
813,Valentin Gendrey,Hoffenheim,5.0,12,6,7,4,1,4,7,57.1,3,5,2,3,5,17,22,0
814,Denis Genreau,Toulouse,0.4,0,0,0,0,0,0,1,0.0,1,0,0,0,0,0,0,0
815,Yannick Gerhardt,Wolfsburg,3.4,7,5,5,2,0,3,5,60.0,2,5,0,5,6,13,12,0
816,Max Geschwill,Holstein Kiel,6.7,11,10,5,6,0,7,9,77.8,2,7,5,2,14,25,24,0
817,Daniele Ghilardi,Hellas Verona,4.0,5,3,2,3,0,4,7,57.1,3,5,3,2,4,9,20,0
818,Lautaro Gianetti,Udinese,5.9,14,5,9,4,1,7,13,53.8,6,11,3,8,10,24,21,0
819,Dimitris Giannoulis,Augsburg,9.8,16,11,8,7,1,14,22,63.6,8,19,5,14,15,31,25,0
820,Morgan Gibbs-White,Nott'ham Forest,7.0,13,4,4,7,2,3,5,60.0,2,2,1,1,4,17,5,0
821,Samuel Gigot,Lazio,0.2,0,0,0,0,0,0,1,0.0,1,1,0,1,1,1,1,0
822,Armin Gigovic,Holstein Kiel,5.9,9,5,5,3,1,2,10,20.0,8,4,0,4,7,16,12,0
823,Bryan Gil,Girona,7.8,17,12,6,7,4,8,15,53.3,7,10,0,10,4,21,5,1
824,Mario Gila,Lazio,8.9,18,14,11,7,0,12,19,63.2,7,6,4,2,6,24,38,1
825,Billy Gilmour,Brighton,1.1,3,3,2,1,0,3,4,75.0,1,1,0,1,0,3,1,0
826,Billy Gilmour,Napoli,4.4,8,3,2,1,5,3,7,42.9,4,5,1,4,2,10,6,0
827,Benedikt Gimber,Heidenheim,9.7,30,18,21,9,0,17,24,70.8,7,21,5,16,11,41,50,0
828,Gvidas Gineitis,Torino,2.6,4,1,2,1,1,1,2,50.0,1,3,2,1,3,7,10,0
829,Matthias Ginter,Freiburg,6.7,8,6,5,2,1,3,4,75.0,1,7,6,1,2,10,27,0
830,Jamie Gittens,Dortmund,6.2,11,4,2,5,4,4,6,66.7,2,4,0,4,4,15,2,0
832,Serge Gnabry,Bayern Munich,5.3,6,5,3,1,2,3,7,42.9,4,3,0,3,4,10,3,0
833,Ben Godfrey,Atalanta,0.3,0,0,0,0,0,0,1,0.0,1,1,1,0,0,0,0,0
834,Saba Goglichidze,Empoli,7.9,19,12,12,7,0,10,15,66.7,5,8,4,4,8,27,28,0
835,Edoardo Goldaniga,Como,5.5,8,6,7,0,1,4,4,100.0,0,2,1,1,7,15,21,0
836,Pierluigi Gollini,Genoa,7.0,0,0,0,0,0,0,0,0.0,0,1,0,1,0,0,2,1
837,Aleksandr Golovin,Monaco,6.0,16,11,3,10,3,8,17,47.1,9,6,3,3,4,20,5,0
838,Andre Gomes,Lille,4.0,4,3,2,1,1,1,5,20.0,4,2,1,1,3,7,2,1
839,Angel Gomes,Lille,6.8,7,4,3,2,2,1,7,14.3,6,0,0,0,0,7,2,0
840,Joao Gomes,Wolves,10.3,35,20,21,13,1,7,29,24.1,22,13,1,12,10,45,8,0
841,Rodrigo Gomes,Wolves,1.3,4,1,2,2,0,1,4,25.0,3,2,0,2,0,4,1,0
842,Toti Gomes,Wolves,8.2,18,14,12,5,1,7,9,77.8,2,4,2,2,4,22,36,1
843,Carlos Gomez,Rennes,2.5,3,3,0,3,0,1,4,25.0,3,3,0,3,1,4,0,0
844,Dani Gomez,Valencia,4.5,3,2,0,0,3,0,0,0.0,0,1,0,1,2,5,3,0
845,Joe Gomez,Liverpool,0.6,5,4,2,3,0,5,6,83.3,1,3,2,1,1,6,3,0
846,Moi Gomez,Osasuna,4.1,9,5,3,5,1,2,4,50.0,2,2,1,1,5,14,3,1
847,Sergi Gomez,Espanyol,5.5,5,3,5,0,0,2,2,100.0,0,11,7,4,5,10,28,0
848,Sergio Gomez,Real Sociedad,11.0,29,19,14,12,3,10,21,47.6,11,15,1,14,6,35,9,1
849,Unai Gomez,Athletic Club,4.0,1,1,0,1,0,1,1,100.0,0,2,0,2,1,2,5,0
850,Fabio Gonzalez,Las Palmas,0.5,0,0,0,0,0,0,1,0.0,1,0,0,0,0,0,0,0
851,Nicolas Gonzalez,Juventus,2.5,3,1,1,0,2,1,2,50.0,1,4,1,3,0,3,0,0
852,Urko Gonzalez,Real Sociedad,0.5,0,0,0,0,0,0,0,0.0,0,1,1,0,0,0,0,0
853,Anthony Gordon,Newcastle Utd,9.4,12,7,7,4,1,6,11,54.5,5,10,0,10,4,16,1,1
854,Leon Goretzka,Bayern Munich,1.6,2,0,1,1,0,2,2,100.0,0,4,0,4,3,5,3,0
855,Andoni Gorosabel,Athletic Club,3.1,5,1,3,1,1,2,6,33.3,4,3,1,2,0,5,13,0
856,Robin Gosens,Fiorentina,9.7,18,11,11,3,4,8,10,80.0,2,7,1,6,6,24,29,0
858,Robin Gosens,Union Berlin,1.0,0,0,0,0,0,0,3,0.0,3,1,0,1,1,1,2,0
859,Mario Gotze,Eint Frankfurt,4.5,12,11,5,5,2,4,13,30.8,9,4,1,3,4,16,5,0
860,Amine Gouiri,Rennes,7.4,6,3,3,2,1,2,6,33.3,4,5,0,5,1,7,1,0
861,Jeffrey Gouweleeuw,Augsburg,10.0,14,8,6,5,3,9,14,64.3,5,14,7,7,14,28,44,0
862,Kamil Grabara,Wolfsburg,10.0,0,0,0,0,0,0,2,0.0,2,1,0,1,0,0,4,1
863,Jonathan Gradit,Lens,8.3,18,9,10,7,1,10,19,52.6,9,9,4,5,12,30,26,0
864,Jose Gragera,Espanyol,6.3,25,16,11,14,0,9,17,52.9,8,9,1,8,5,30,13,0
865,Samuel Grandsir,Le Havre,0.6,3,3,0,2,1,2,2,100.0,0,2,0,2,0,3,0,0
866,Alberto Grassi,Empoli,6.0,13,7,3,8,2,5,6,83.3,1,5,3,2,8,21,8,0
867,Ryan Gravenberch,Liverpool,11.0,20,14,8,7,5,10,18,55.6,8,16,3,13,21,41,14,0
868,Archie Gray,Tottenham,0.5,2,1,0,0,2,1,3,33.3,2,2,0,2,0,2,2,0
869,Jack Grealish,Manchester City,3.8,5,2,3,0,2,1,3,33.3,2,5,1,4,0,5,3,0
870,Jacob Greaves,Ipswich Town,7.0,14,6,6,8,0,7,11,63.6,4,8,6,2,8,22,41,1
871,Mason Greenwood,Marseille,10.4,10,6,3,5,2,6,16,37.5,10,2,0,2,3,13,5,1
872,Michael Gregoritsch,Freiburg,0.9,2,1,1,0,1,0,0,0.0,0,0,0,0,0,2,1,0
873,Dominik Greif,Mallorca,9.0,0,0,0,0,0,0,0,0.0,0,0,0,0,0,0,3,1
874,Antoine Griezmann,Atlético Madrid,10.6,11,8,7,2,2,4,14,28.6,10,11,0,11,4,15,11,0
875,Vincenzo Grifo,Freiburg,8.6,6,6,3,2,1,2,10,20.0,8,7,1,6,0,6,7,0
876,Florian Grillitsch,Hoffenheim,6.7,15,9,5,9,1,8,14,57.1,6,6,2,4,8,23,18,0
877,Alex Grimaldo,Leverkusen,10.0,9,5,5,2,2,6,17,35.3,11,5,2,3,9,18,13,2
878,Pascal Gross,Dortmund,8.2,15,10,4,9,2,4,14,28.6,10,10,1,9,3,18,9,1
879,Brajan Gruda,Brighton,0.7,3,1,0,3,0,3,4,75.0,1,1,0,1,0,3,1,0
880,Marco Grull,Werder Bremen,3.5,3,2,0,1,2,0,4,0.0,4,5,1,4,1,4,2,0
881,Albert Gronbaek,Rennes,6.4,12,5,4,6,2,7,16,43.8,9,6,0,6,3,15,4,0
882,Vicente Guaita,Celta Vigo,9.0,0,0,0,0,0,0,0,0.0,0,0,0,0,0,0,2,0
884,Sergi Guardiola,Rayo Vallecano,0.9,3,2,0,3,0,0,0,0.0,0,0,0,0,0,3,2,0
885,Nemanja Gudelj,Sevilla,10.0,16,7,5,9,2,5,6,83.3,1,10,3,7,13,29,25,0
886,Gabriel Gudmundsson,Lille,7.7,14,9,3,8,3,10,17,58.8,7,13,4,9,5,19,14,1
887,Goncalo Guedes,Wolves,1.4,7,2,0,0,7,2,5,40.0,3,4,0,4,2,9,1,0
888,Axel Gueguin,Montpellier,0.3,1,1,0,1,0,1,1,100.0,0,0,0,0,0,1,0,0
889,Marc Guehi,Crystal Palace,11.0,13,7,9,4,0,7,11,63.6,4,22,12,10,8,21,66,1
890,Matteo Guendouzi,Lazio,11.5,14,7,3,8,3,8,20,40.0,12,8,2,6,13,27,15,0
891,Javier Guerra,Valencia,5.8,13,7,5,6,2,7,12,58.3,5,2,0,2,1,14,12,1
892,Raphael Guerreiro,Bayern Munich,6.4,10,7,6,2,2,7,9,77.8,2,5,0,5,4,14,7,1
893,Evann Guessand,Nice,10.4,10,5,1,7,2,0,1,0.0,1,8,0,8,6,16,6,0
894,Ander Guevara,Alavés,8.4,13,8,7,5,1,7,21,33.3,14,10,1,9,6,19,17,1
895,Pape Gueye,Villarreal,7.1,16,9,7,6,3,7,9,77.8,2,5,0,5,8,24,14,0
896,Morgan Guilavogui,St. Pauli,6.2,13,7,4,8,1,6,10,60.0,4,10,0,10,4,17,11,0
897,Frederic Guilbert,Lecce,6.3,17,6,9,7,1,5,8,62.5,3,7,2,5,11,28,18,0
898,Luis Guilherme,West Ham,0.1,0,0,0,0,0,0,0,0.0,0,1,0,1,0,0,0,0
899,Hugo Guillamon,Valencia,3.5,7,5,0,6,1,5,6,83.3,1,2,1,1,5,12,6,0
900,Bruno Guimaraes,Newcastle Utd,10.9,27,15,14,9,4,12,21,57.1,9,12,4,8,12,39,11,2
901,Bahereba Guirassy,Nantes,0.8,1,1,0,0,1,0,2,0.0,2,2,0,2,0,1,1,0
902,Serhou Guirassy,Dortmund,7.8,1,1,1,0,0,0,0,0.0,0,2,0,2,1,2,9,0
903,Marc Guiu,Chelsea,0.3,0,0,0,0,0,0,0,0.0,0,0,0,0,0,0,0,0
904,Peter Gulacsi,RB Leipzig,9.5,0,0,0,0,0,0,0,0.0,0,0,0,0,0,0,4,1
905,Arda Guler,Real Madrid,3.0,10,4,4,2,4,4,7,57.1,3,6,0,6,1,11,3,0
906,Gerard Gumbau,Rayo Vallecano,4.0,11,9,5,5,1,5,9,55.6,4,5,3,2,2,13,7,0
907,Ilkay Gundogan,Manchester City,7.0,6,3,1,4,1,3,9,33.3,6,1,0,1,3,9,8,0
908,Christian Gunter,Freiburg,9.6,8,6,4,4,0,5,11,45.5,6,8,2,6,2,10,15,0
910,Jon Guridi,Alavés,7.7,10,5,4,5,1,5,16,31.3,11,6,0,6,6,16,4,0
911,Gorka Guruzeta,Athletic Club,7.5,7,2,0,6,1,4,10,40.0,6,11,1,10,3,10,8,0
912,Malo Gusto,Chelsea,8.1,19,13,12,6,1,10,23,43.5,13,14,4,10,10,29,16,1
913,Miguel Gutierrez,Girona,12.0,20,14,8,11,1,7,15,46.7,8,4,2,2,9,29,13,1
914,Albert Gudmundsson,Fiorentina,2.2,0,0,0,0,0,0,2,0.0,2,1,0,1,2,2,2,0
915,Josko Gvardiol,Manchester City,10.5,20,14,11,5,4,10,13,76.9,3,12,5,7,15,35,27,0
916,Emmanuel Gyasi,Empoli,11.8,17,9,12,5,0,10,15,66.7,5,12,4,8,2,19,32,0
917,Christian Gytkjaer,Venezia,2.5,1,1,1,0,0,1,2,50.0,1,1,1,0,0,1,3,0
918,Erling Haaland,Manchester City,11.0,2,2,0,1,1,1,1,100.0,0,3,0,3,1,3,8,0
919,Nicolas Haas,Empoli,3.2,11,8,4,5,2,5,9,55.6,4,2,1,1,4,15,6,0
920,Janik Haberer,Union Berlin,4.4,8,6,4,3,1,8,15,53.3,7,1,0,1,1,9,7,0
921,Robin Hack,Gladbach,5.2,7,7,3,2,2,5,8,62.5,3,4,0,4,0,7,6,0
922,Saad El Haddad,Venezia,0.3,0,0,0,0,0,0,0,0.0,0,0,0,0,0,0,0,0
923,Munir El Haddadi,Leganés,3.4,9,6,3,4,2,3,8,37.5,5,5,1,4,0,9,1,0
924,Amadou Haidara,RB Leipzig,6.4,14,8,7,6,1,6,12,50.0,6,17,6,11,5,19,25,0
925,Massadio Haidara,Brest,3.2,4,2,2,2,0,2,6,33.3,4,3,0,3,3,7,15,0
926,Antoine Hainaut,Parma,4.9,10,7,5,4,1,5,5,100.0,0,5,2,3,4,14,19,0
927,Mohamed Haj,Parma,0.7,0,0,0,0,0,0,0,0.0,0,0,0,0,1,1,1,0
928,Achraf Hakimi,Paris S-G,8.4,16,13,6,6,4,7,13,53.8,6,7,0,7,12,28,5,1
929,Lewis Hall,Newcastle Utd,8.7,17,12,6,7,4,11,25,44.0,14,18,11,7,12,29,30,1
930,Sebastien Haller,Leganés,4.3,2,0,1,0,1,1,2,50.0,1,1,0,1,0,2,7,0
931,Ali Al Hamadi,Ipswich Town,0.4,1,0,0,0,1,0,1,0.0,1,0,0,0,0,1,2,0
932,Andreas Hanche-Olsen,Mainz 05,3.3,4,1,1,2,1,0,0,0.0,0,7,6,1,3,7,20,1
933,Florent Hanin,Angers,8.4,22,17,12,7,3,12,21,57.1,9,3,1,2,14,36,31,2
934,Ridgeciano Haps,Venezia,6.9,12,7,10,1,1,7,11,63.6,4,6,1,5,2,14,19,0
936,Amine Harit,Marseille,5.2,7,6,0,5,2,1,2,50.0,1,6,0,6,3,10,1,1
937,Marcus Harness,Ipswich Town,0.5,1,0,0,0,1,0,3,0.0,3,2,1,1,0,1,1,0
938,Phil Harres,Holstein Kiel,2.0,1,1,0,0,1,1,1,100.0,0,2,0,2,1,2,1,0
939,Jack Harrison,Everton,7.0,10,5,5,2,3,5,13,38.5,8,4,0,4,4,14,12,2
940,Abdou Harroui,Hellas Verona,3.2,6,3,4,2,0,2,2,100.0,0,3,0,3,0,6,4,0
941,Taylor Harwood-Bellis,Southampton,9.6,6,4,5,1,0,4,7,57.1,3,23,14,9,8,14,40,2
942,Hans Hateboer,Rennes,6.3,12,6,4,4,4,6,12,50.0,6,5,1,4,5,17,12,0
943,Kai Havertz,Arsenal,11.0,9,6,2,4,3,3,10,30.0,7,15,3,12,5,14,25,1
944,Jan Paul van Hecke,Brighton,8.1,12,7,9,3,0,6,10,60.0,4,9,5,4,7,19,23,0
945,Hwang Hee-chan,Wolves,2.8,1,0,0,0,1,0,1,0.0,1,5,0,5,1,2,3,0
946,Dean Henderson,Crystal Palace,11.0,1,0,1,0,0,1,2,50.0,1,0,0,0,0,1,8,0
947,Liam Henderson,Empoli,8.8,16,7,9,7,0,9,18,50.0,9,8,4,4,7,23,16,0
948,Ramon Hendriks,Stuttgart,1.3,3,2,2,1,0,2,3,66.7,1,0,0,0,4,7,7,0
949,Benjamin Henrichs,RB Leipzig,5.4,26,11,14,8,4,12,19,63.2,7,9,2,7,13,39,16,0
950,Luis Henrique,Marseille,8.6,2,2,1,1,0,2,2,100.0,0,6,2,4,4,6,5,0
951,Mads Hermansen,Leicester City,11.0,1,1,1,0,0,1,1,100.0,0,1,0,1,0,1,7,1
952,Mario Hermoso,Roma,1.7,1,0,1,0,0,0,1,0.0,1,1,1,0,3,4,9,0
953,Javi Hernandez,Leganés,7.9,12,6,5,5,2,5,14,35.7,9,7,1,6,10,22,33,0
954,Aridane Hernandez,Rayo Vallecano,1.3,2,1,2,0,0,0,0,0.0,0,0,0,0,2,4,9,0
955,Theo Hernandez,Milan,7.4,8,6,7,0,1,2,5,40.0,3,7,4,3,10,18,21,1
956,Hernani,Parma,4.5,10,6,2,6,2,5,11,45.5,6,9,1,8,3,13,2,1
957,Jorge Herrando,Osasuna,4.1,2,1,1,1,0,1,2,50.0,1,6,5,1,1,3,16,0
958,Ander Herrera,Athletic Club,2.9,8,4,1,7,0,3,6,50.0,3,0,0,0,2,10,9,0
959,Sergio Herrera,Osasuna,13.0,1,0,1,0,0,1,2,50.0,1,0,0,0,0,1,11,1
960,Yangel Herrera,Girona,8.9,28,17,12,14,2,13,23,56.5,10,7,1,6,12,40,17,0
962,Juan Herzog,Las Palmas,4.2,2,2,2,0,0,2,4,50.0,2,4,3,1,4,6,20,0
963,Son Heung-min,Tottenham,7.4,4,2,0,3,1,2,12,16.7,10,4,0,4,2,6,5,0
964,Isak Hien,Atalanta,7.8,16,9,9,7,0,6,10,60.0,4,14,8,6,14,30,25,1
965,Omar El Hilali,Espanyol,11.6,37,24,26,8,3,16,26,61.5,10,12,2,10,12,49,46,0
966,Piero Hincapie,Leverkusen,8.7,16,14,7,6,3,10,16,62.5,6,16,8,8,11,27,21,0
967,Jack Hinshelwood,Brighton,9.3,12,9,4,6,2,5,11,45.5,6,4,2,2,4,16,14,1
968,George Hirst,Ipswich Town,2.0,1,1,1,0,0,0,1,0.0,1,0,0,0,0,1,4,0
969,Adam Hlozek,Hoffenheim,6.1,7,3,3,1,3,3,7,42.9,4,4,1,3,0,7,6,0
970,Ki-Jana Hoever,Auxerre,7.8,14,10,11,2,1,7,14,50.0,7,10,1,9,7,21,23,0
971,Nicolas Hofler,Freiburg,2.4,5,4,1,4,0,4,7,57.1,3,2,0,2,4,9,12,0
972,Jonas Hofmann,Leverkusen,2.5,0,0,0,0,0,0,1,0.0,1,2,0,2,0,0,2,0
973,Philipp Hofmann,Bochum,7.6,5,3,2,2,1,2,4,50.0,2,4,0,4,1,6,14,0
974,Lucas Holer,Freiburg,1.5,4,4,1,3,0,1,3,33.3,2,3,1,2,1,5,4,0
975,Mason Holgate,Everton,0.1,0,0,0,0,0,0,0,0.0,0,0,0,0,0,0,0,0
976,Benedict Hollerbach,Union Berlin,7.9,14,8,4,7,3,7,11,63.6,4,10,0,10,1,15,1,0
977,Emil Holm,Bologna,1.1,4,4,2,2,0,3,5,60.0,2,1,1,0,0,4,2,0
978,Lewis Holtby,Holstein Kiel,5.5,14,6,9,4,1,4,9,44.4,5,4,0,4,11,25,6,1
979,Gerrit Holtmann,Bochum,1.6,3,2,2,1,0,1,2,50.0,1,1,0,1,5,8,4,0
980,Franck Honorat,Gladbach,6.2,4,1,1,1,2,1,3,33.3,2,5,1,4,0,4,10,1
981,Mathias Honsak,Heidenheim,2.7,4,4,1,3,0,3,4,75.0,1,2,1,1,2,6,7,0
982,Dinko Horkas,Las Palmas,2.3,0,0,0,0,0,0,0,0.0,0,0,0,0,0,0,2,0
983,Cedric Hountondji,Angers,3.0,6,4,4,2,0,3,7,42.9,4,3,3,0,4,10,14,0
984,Ilyes Housni,Le Havre,1.6,5,4,0,3,2,2,4,50.0,2,2,0,2,1,6,1,0
985,Lukas Hradecky,Leverkusen,9.0,0,0,0,0,0,0,0,0.0,0,0,0,0,0,0,3,1
986,Robin Hranac,Hoffenheim,1.0,0,0,0,0,0,0,1,0.0,1,1,0,1,2,2,3,1
988,Callum Hudson-Odoi,Nott'ham Forest,8.7,9,6,1,5,3,5,7,71.4,2,4,0,4,5,14,4,1
989,Will Hughes,Crystal Palace,5.1,17,9,2,9,6,7,17,41.2,10,6,2,4,5,22,3,0
990,Dean Huijsen,Bournemouth,2.4,2,1,2,0,0,0,0,0.0,0,3,2,1,3,5,10,0
991,Mats Hummels,Roma,0.3,0,0,0,0,0,0,0,0.0,0,1,0,1,0,0,4,0
992,Omari Hutchinson,Ipswich Town,9.7,8,4,3,3,2,5,20,25.0,15,11,1,10,5,13,4,0
993,Elseid Hysaj,Lazio,0.1,1,1,0,1,0,0,0,0.0,0,0,0,0,0,1,1,0
994,Hong Hyunseok,Mainz 05,2.9,4,1,2,1,1,0,1,0.0,1,2,1,1,3,7,5,0
995,Pierre Hojbjerg,Marseille,10.9,29,22,15,12,2,20,35,57.1,15,13,3,10,19,48,20,1
996,Oscar Hojlund,Eint Frankfurt,0.2,2,1,2,0,0,0,0,0.0,0,1,0,1,1,3,0,0
997,Rasmus Hojlund,Manchester Utd,4.6,1,0,0,0,1,0,1,0.0,1,2,0,2,0,1,2,0
998,Pablo Ibanez,Osasuna,4.5,7,3,4,2,1,3,13,23.1,10,9,3,6,8,15,8,0
999,Stanis Idumbo,Sevilla,1.3,4,3,2,1,1,2,3,66.7,1,2,0,2,3,7,0,0
1000,Jay Idzes,Venezia,9.7,14,9,9,3,2,5,9,55.6,4,16,8,8,6,20,28,0
1001,Iglesias,Getafe,10.5,31,19,17,12,2,13,32,40.6,19,12,2,10,20,51,39,0
1002,Borja Iglesias,Celta Vigo,7.6,4,4,1,2,1,0,3,0.0,3,4,1,3,3,7,4,0
1003,Igor,Brighton,5.3,1,1,0,0,1,1,2,50.0,1,12,6,6,2,3,22,0
1004,Kelechi Iheanacho,Sevilla,3.9,1,0,0,1,0,1,2,50.0,1,0,0,0,0,1,1,0
1005,Jonathan Ikone,Fiorentina,1.9,3,2,3,0,0,1,3,33.3,2,2,0,2,0,3,0,0
1006,George Ilenikhena,Monaco,4.4,1,1,0,1,0,0,1,0.0,1,0,0,0,1,2,0,0
1007,Ivan Ilic,Torino,6.4,2,1,0,1,1,0,4,0.0,4,0,0,0,4,6,3,0
1008,Samuel Iling-Junior,Bologna,1.0,2,1,1,1,0,0,0,0.0,0,0,0,0,2,4,0,0
1009,Danny Ings,West Ham,0.8,1,0,1,0,0,1,1,100.0,0,0,0,0,0,1,1,0
1010,Alessio Iovine,Como,2.5,1,0,0,1,0,1,3,33.3,2,4,1,3,2,3,17,0
1011,Tim Iroegbunam,Everton,4.3,18,9,9,4,5,7,12,58.3,5,6,0,6,8,26,5,1
1012,Jackson Irvine,St. Pauli,10.0,22,9,9,10,3,9,18,50.0,9,9,2,7,16,38,26,0
1014,Andy Irving,West Ham,0.3,3,2,1,1,1,0,3,0.0,3,1,0,1,0,3,2,0
1015,Alexander Isak,Newcastle Utd,8.5,4,2,0,2,2,3,5,60.0,2,9,1,8,1,5,5,0
1016,Gustav Isaksen,Lazio,7.1,5,3,1,4,0,1,9,11.1,8,2,0,2,2,7,5,0
1017,Ismaily,Lille,0.9,2,0,0,1,1,0,1,0.0,1,4,0,4,0,2,2,0
1018,Ardian Ismajli,Empoli,12.0,9,8,7,2,0,3,5,60.0,2,17,13,4,21,30,113,0
1019,Yanis Issoufou,Montpellier,0.8,5,3,4,1,0,3,5,60.0,2,1,0,1,0,5,1,0
1020,Ko Itakura,Gladbach,10.0,17,12,8,8,1,10,14,71.4,4,9,6,3,9,26,51,0
1021,Junya Ito,Reims,10.6,16,13,4,9,3,5,20,25.0,15,11,0,11,4,20,1,1
1022,Marko Ivezic,Holstein Kiel,6.0,16,10,11,4,1,9,14,64.3,5,10,7,3,9,25,26,1
1023,Alex Iwobi,Fulham,10.5,18,11,7,8,3,6,9,66.7,3,6,0,6,4,22,13,0
1024,Armando Izzo,Monza,10.6,19,9,15,4,0,7,16,43.8,9,19,13,6,20,39,32,0
1025,Nicolas Jackson,Chelsea,9.6,3,3,0,2,1,0,2,0.0,2,8,1,7,1,4,8,0
1026,Lee Jae-sung,Mainz 05,8.5,13,7,3,8,2,4,7,57.1,3,10,1,9,9,22,10,0
1027,Kristijan Jakic,Augsburg,7.4,16,7,5,10,1,6,13,46.2,7,15,2,13,8,24,14,1
1028,Karl Jakob Hein,Valladolid,13.0,0,0,0,0,0,0,1,0.0,1,0,0,0,0,0,10,0
1029,Ismail Jakobs,Monaco,2.0,5,5,3,0,2,3,5,60.0,2,0,0,0,2,7,6,0
1030,Jordan James,Rennes,0.3,2,0,1,0,1,1,3,33.3,2,0,0,0,0,2,1,0
1031,Reece James,Chelsea,2.7,2,2,2,0,0,1,3,33.3,2,4,2,2,3,5,5,1
1032,Vitaly Janelt,Brentford,10.0,13,9,5,4,4,6,12,50.0,6,14,2,12,10,23,26,0
1033,Adnan Januzaj,Las Palmas,2.8,3,2,1,2,0,1,2,50.0,1,2,0,2,0,3,2,0
1034,Vitezslav Jaros,Liverpool,0.1,0,0,0,0,0,0,0,0.0,0,0,0,0,0,0,0,0
1035,Ali Jasim,Como,0.1,1,0,1,0,0,1,1,100.0,0,0,0,0,0,1,0,0
1036,Mikel Jauregizar,Athletic Club,6.8,21,12,6,10,5,13,21,61.9,8,6,1,5,7,28,7,1
1037,Dominik Javorcek,Holstein Kiel,0.5,1,0,1,0,0,1,1,100.0,0,1,1,0,1,2,4,1
1038,Gaby Jean,Lecce,0.2,0,0,0,0,0,0,1,0.0,1,1,1,0,0,0,2,0
1040,Daniel Jebbison,Bournemouth,0.3,0,0,0,0,0,0,1,0.0,1,0,0,0,0,0,1,0
1041,Fredrik Jensen,Augsburg,1.3,1,1,0,0,1,1,1,100.0,0,2,0,2,0,1,1,0
1042,Mathias Jensen,Brentford,3.9,1,1,1,0,0,0,3,0.0,3,5,1,4,3,4,3,1
1043,Moritz Jenz,Mainz 05,6.0,13,6,6,7,0,4,7,57.1,3,7,6,1,5,18,45,0
1044,Gabriel Jesus,Arsenal,1.4,3,2,3,0,0,2,4,50.0,2,4,1,3,2,5,0,0
1045,Juan Jesus,Napoli,0.9,0,0,0,0,0,0,0,0.0,0,0,0,0,0,0,3,0
1046,Raul Jimenez,Fulham,7.4,10,5,1,6,3,2,7,28.6,5,5,1,4,4,14,5,2
1047,Joao Pedro,Brighton,3.4,5,3,1,3,1,1,3,33.3,2,2,0,2,3,8,3,0
1048,John Joe,Getafe,0.1,0,0,0,0,0,0,0,0.0,0,1,1,0,0,0,1,0
1049,Joelinton,Newcastle Utd,10.3,28,18,11,11,6,13,23,56.5,10,14,3,11,8,36,17,1
1050,Jofre,Espanyol,8.5,5,5,3,2,0,2,7,28.6,5,3,0,3,7,12,9,0
1051,Carl Johansson,Holstein Kiel,3.9,4,2,4,0,0,3,6,50.0,3,7,6,1,6,10,23,1
1052,Ben Johnson,Ipswich Town,4.5,18,9,13,5,0,12,18,66.7,6,6,2,4,8,26,8,0
1053,Brennan Johnson,Tottenham,9.6,19,12,3,11,5,8,16,50.0,8,11,1,10,2,21,8,0
1054,Karl-Johan Johnsson,Strasbourg,3.0,0,0,0,0,0,0,1,0.0,1,0,0,0,0,0,3,0
1055,Sam Johnstone,Wolves,5.0,0,0,0,0,0,0,0,0.0,0,0,0,0,0,0,5,0
1056,Paul Joly,Auxerre,4.4,16,11,11,5,0,8,15,53.3,7,5,0,5,11,27,14,3
1057,Curtis Jones,Liverpool,4.6,10,5,2,7,1,5,7,71.4,2,8,4,4,1,11,5,0
1058,Frenkie de Jong,Barcelona,1.5,1,1,0,1,0,0,0,0.0,0,1,0,1,0,1,0,0
1059,Joan Jordan,Alavés,3.7,11,7,5,4,2,5,11,45.5,6,4,0,4,2,13,5,0
1060,Jorginho,Arsenal,1.7,2,1,0,1,1,2,4,50.0,2,0,0,0,0,2,0,1
1061,Jesse Joronen,Venezia,7.0,0,0,0,0,0,0,0,0.0,0,0,0,0,0,0,3,0
1062,Jota,Rennes,3.2,3,2,1,2,0,3,6,50.0,3,1,0,1,3,6,2,0
1063,Diogo Jota,Liverpool,5.5,3,1,0,2,1,2,6,33.3,4,1,0,1,3,6,3,0
1064,Antoine Joujou,Le Havre,3.5,6,5,4,1,1,2,4,50.0,2,8,2,6,3,9,3,0
1066,Luka Jovic,Milan,0.9,0,0,0,0,0,0,0,0.0,0,0,0,0,1,1,0,0
1067,Juanmi,Betis,1.8,6,3,3,2,1,3,5,60.0,2,4,0,4,1,7,4,0
1068,Juanpe,Girona,3.0,7,4,4,3,0,6,6,100.0,0,7,3,4,4,11,20,0
1069,Jubal,Auxerre,8.4,14,11,12,2,0,10,16,62.5,6,15,5,10,6,20,44,0
1070,Abdulai Juma Bah,Valladolid,4.0,4,3,2,2,0,0,2,0.0,2,6,3,3,4,8,27,0
1071,Anthony Jung,Werder Bremen,7.3,10,7,8,2,0,5,7,71.4,2,4,1,3,9,19,27,0
1072,Hamed Junior Traore,Auxerre,8.2,15,7,4,7,4,4,22,18.2,18,4,0,4,3,18,7,0
1073,Vinicius Junior,Real Madrid,10.9,11,6,4,2,5,3,6,50.0,3,5,0,5,0,11,1,1
1074,David Jurasek,Hoffenheim,1.5,2,1,1,0,1,0,0,0.0,0,3,0,3,0,2,4,0
1075,Stanko Juric,Valladolid,7.1,20,10,12,7,1,12,25,48.0,13,12,4,8,9,29,21,0
1076,James Justin,Leicester City,9.9,24,14,14,7,3,12,23,52.2,11,10,2,8,14,38,46,0
1077,Mohamed Kaba,Lecce,0.2,1,0,0,1,0,0,0,0.0,0,0,0,0,0,1,0,0
1078,Yusuf Kabadayi,Augsburg,0.8,1,0,0,1,0,0,0,0.0,0,1,0,1,0,1,0,0
1079,Almugera Kabar,Dortmund,0.4,2,2,0,2,0,0,0,0.0,0,1,0,1,1,3,2,0
1080,Christian Kabasele,Udinese,7.2,9,5,5,4,0,4,5,80.0,1,8,2,6,7,16,27,1
1081,Yaya Kader Fofana,Reims,6.5,15,10,7,5,3,4,10,40.0,6,9,2,7,3,18,2,0
1082,Pavel Kaderabek,Hoffenheim,6.1,8,5,4,1,3,5,12,41.7,7,5,2,3,8,16,17,0
1083,Tino Kadewere,Nantes,5.3,13,7,4,3,6,6,12,50.0,6,3,0,3,5,18,8,0
1084,Ferdi Kadioglu,Brighton,4.3,10,6,4,5,1,6,15,40.0,9,2,2,0,8,18,17,0
1085,Arnaud Kalimuendo,Rennes,8.1,4,2,0,2,2,2,2,100.0,0,1,0,1,1,5,0,0
1086,Pierre Kalulu,Juventus,8.0,8,5,8,0,0,4,5,80.0,1,11,7,4,4,12,8,0
1087,Daichi Kamada,Crystal Palace,6.9,19,9,6,11,2,5,16,31.3,11,9,2,7,7,26,8,0
1088,Waren Kamanzi,Toulouse,6.8,21,10,7,11,3,10,19,52.6,9,1,0,1,2,23,15,0
1089,Boubacar Kamara,Aston Villa,0.4,1,1,0,1,0,0,2,0.0,2,0,0,0,1,2,1,0
1090,Glen Kamara,Rennes,6.5,21,10,8,11,2,10,16,62.5,6,7,0,7,7,28,5,0
1092,Hassane Kamara,Udinese,6.6,14,10,5,7,2,3,9,33.3,6,8,2,6,9,23,15,0
1093,Willy Kambwala,Villarreal,1.0,4,2,3,0,1,2,2,100.0,0,1,1,0,0,4,6,0
1094,Jakub Kaminski,Wolfsburg,7.3,11,5,5,2,4,5,16,31.3,11,12,6,6,8,19,11,1
1095,Kevin Kampl,RB Leipzig,5.6,8,6,2,3,3,5,8,62.5,3,7,1,6,8,16,7,0
1096,Nordine Kandil,Strasbourg,0.1,0,0,0,0,0,0,0,0.0,0,0,0,0,0,0,1,0
1097,Harry Kane,Bayern Munich,9.3,2,2,0,1,1,0,1,0.0,1,3,0,3,0,2,5,0
1098,Lee Kang-in,Paris S-G,7.2,11,8,4,3,4,10,16,62.5,6,1,0,1,1,12,2,0
1099,Yann Karamoh,Torino,1.0,1,0,0,0,1,1,3,33.3,2,2,1,1,0,1,0,0
1100,Atakan Karazor,Stuttgart,7.8,19,5,4,9,6,10,17,58.8,7,9,1,8,9,28,8,0
1101,Jesper Karlsson,Bologna,2.1,0,0,0,0,0,0,1,0.0,1,3,0,3,0,0,1,0
1102,Jesper Karlstrom,Udinese,11.1,22,11,11,8,3,7,17,41.2,10,9,5,4,14,36,27,1
1103,Lior Kasa,Genoa,0.2,0,0,0,0,0,0,0,0.0,0,0,0,0,1,1,0,0
1104,Grigoris Kastanos,Hellas Verona,4.8,9,4,3,2,4,4,9,44.4,5,10,1,9,4,13,2,0
1105,Mikkel Kaufmann,Heidenheim,2.1,3,2,1,1,1,1,2,50.0,1,3,1,2,0,3,5,0
1106,Michael Kayode,Fiorentina,0.3,1,1,1,0,0,0,0,0.0,0,2,1,1,0,1,3,0
1107,Moise Kean,Fiorentina,10.1,4,2,0,2,2,1,2,50.0,1,4,0,4,0,4,7,1
1108,Michael Keane,Everton,9.0,10,7,7,2,1,7,10,70.0,3,9,6,3,10,20,50,0
1109,Yassine Kechta,Le Havre,8.5,23,13,10,10,3,13,34,38.2,21,11,2,9,7,30,5,0
1110,Thilo Kehrer,Monaco,9.0,20,15,14,6,0,12,20,60.0,8,3,2,1,7,27,40,1
1111,Abdoulaye Keita,Getafe,0.3,0,0,0,0,0,0,0,0.0,0,1,0,1,0,0,0,0
1112,Mandela Keita,Parma,2.6,5,1,1,3,1,1,3,33.3,2,3,2,1,4,9,4,1
1113,Andu Kelati,Holstein Kiel,1.1,1,1,1,0,0,0,1,0.0,1,1,0,1,2,3,1,0
1114,Caoimhin Kelleher,Liverpool,5.0,0,0,0,0,0,0,0,0.0,0,0,0,0,0,0,0,1
1115,Lloyd Kelly,Newcastle Utd,2.3,2,2,2,0,0,0,0,0.0,0,4,2,2,1,3,14,0
1116,Aljoscha Kemlein,Union Berlin,4.2,4,2,2,2,0,2,6,33.3,4,7,1,6,3,7,4,0
1118,Marc-Oliver Kempf,Como,10.0,9,7,3,5,1,3,6,50.0,3,9,4,5,20,29,40,1
1119,Kenedy,Valladolid,0.1,0,0,0,0,0,0,0,0.0,0,1,0,1,0,0,0,0
1120,Luca Kerber,Heidenheim,1.0,2,2,1,1,0,2,3,66.7,1,3,1,2,0,2,5,0
1121,Milos Kerkez,Bournemouth,10.3,15,7,4,9,2,5,10,50.0,5,11,4,7,12,27,27,0
1122,Reda Khadra,Reims,0.9,1,1,1,0,0,0,1,0.0,1,0,0,0,0,1,1,0
1123,Bilal El Khannouss,Leicester City,2.2,3,2,1,1,1,0,1,0.0,1,0,0,0,0,3,1,0
1124,Wahbi Khazri,Montpellier,4.8,10,6,2,6,2,2,5,40.0,3,4,1,3,3,13,4,0
1125,Rani Khedira,Union Berlin,10.0,14,10,5,7,2,6,10,60.0,4,11,3,8,15,29,10,0
1126,Abdukodir Khusanov,Lens,7.8,13,9,7,5,1,6,9,66.7,3,15,9,6,20,33,38,0
1127,Kialonda,Lecce,12.0,19,6,15,4,0,7,8,87.5,1,26,19,7,16,35,57,0
1128,Kike,Alavés,6.7,3,3,0,3,0,1,2,50.0,1,0,0,0,0,3,7,0
1129,Max Kilman,West Ham,11.0,10,5,4,4,2,8,11,72.7,3,16,10,6,13,23,64,1
1130,Joshua Kimmich,Bayern Munich,10.0,16,12,4,10,2,10,17,58.8,7,6,0,6,8,24,11,2
1131,Joshua King,Toulouse,5.5,4,4,1,2,1,1,1,100.0,0,3,2,1,1,5,7,0
1132,Cedric Kipre,Reims,5.8,14,11,13,1,0,13,16,81.3,3,11,4,7,3,17,33,0
1133,Jakub Kiwior,Arsenal,1.1,0,0,0,0,0,0,1,0.0,1,3,1,2,0,0,9,0
1134,Tim Kleindienst,Gladbach,9.7,9,5,1,4,4,2,10,20.0,8,13,2,11,3,12,23,0
1135,Lukas Klostermann,RB Leipzig,7.3,11,7,7,3,1,5,8,62.5,3,14,7,7,8,19,32,1
1136,Justin Kluivert,Bournemouth,6.9,8,5,3,3,2,2,5,40.0,3,8,0,8,5,13,11,0
1137,Ansgar Knauff,Eint Frankfurt,4.7,15,9,9,3,3,4,5,80.0,1,10,1,9,4,19,6,0
1138,Magnus Knudsen,Holstein Kiel,8.8,25,14,13,7,5,14,20,70.0,6,10,4,6,8,33,15,0
1139,Gregor Kobel,Dortmund,8.0,0,0,0,0,0,0,0,0.0,0,0,0,0,0,0,4,1
1140,Robin Koch,Eint Frankfurt,9.8,7,3,4,3,0,3,6,50.0,3,21,14,7,7,14,55,2
1141,Magnus Kofod Andersen,Venezia,5.3,9,2,2,6,1,2,5,40.0,3,2,1,1,5,14,7,0
1142,Derrick Kohn,Werder Bremen,4.1,2,1,1,0,1,0,0,0.0,0,7,4,3,2,4,6,0
1144,Philipp Kohn,Monaco,7.0,0,0,0,0,0,0,1,0.0,1,0,0,0,0,0,4,0
1145,Dominik Kohr,Mainz 05,8.8,23,17,15,5,3,14,20,70.0,6,17,9,8,9,32,45,0
1146,Koke,Atlético Madrid,10.7,25,18,10,10,5,13,23,56.5,10,11,0,11,11,36,13,0
1147,Sead Kolasinac,Atalanta,6.5,10,6,4,6,0,4,8,50.0,4,3,0,3,9,19,11,0
1148,Randal Kolo Muani,Paris S-G,3.5,4,4,1,1,2,0,0,0.0,0,0,0,0,0,4,3,0
1149,Marco Komenda,Holstein Kiel,2.2,6,4,3,2,1,4,4,100.0,0,3,1,2,0,6,10,0
1150,Mert Komur,Augsburg,0.7,1,0,1,0,0,0,0,0.0,0,2,2,0,2,3,1,1
1151,Ibrahima Konate,Liverpool,9.8,13,9,9,3,1,8,10,80.0,2,13,5,8,4,17,44,1
1152,Ismael Konate,Empoli,0.1,0,0,0,0,0,0,0,0.0,0,0,0,0,0,0,0,0
1153,Geoffrey Kondogbia,Marseille,8.2,20,11,13,7,0,14,15,93.3,1,4,0,4,8,28,23,2
1154,Abdoul Kone,Reims,1.2,5,3,4,1,0,3,5,60.0,2,2,1,1,1,6,4,0
1155,Amadou Kone,Reims,2.1,12,7,6,6,0,8,10,80.0,2,2,0,2,4,16,1,0
1156,Ismael Kone,Marseille,3.5,6,3,3,2,1,2,3,66.7,1,4,1,3,3,9,2,1
1157,Manu Kone,Roma,6.9,11,7,5,4,2,7,12,58.3,5,3,0,3,4,15,4,0
1158,Ezri Konsa,Aston Villa,9.1,13,8,8,3,2,8,10,80.0,2,4,1,3,6,19,32,0
1159,Teun Koopmeiners,Juventus,6.2,9,7,1,7,1,5,7,71.4,2,2,2,0,2,11,3,0
1160,Odilon Kossounou,Atalanta,2.9,6,4,4,2,0,3,5,60.0,2,3,1,2,2,8,6,0
1161,Christian Kouame,Fiorentina,5.5,10,6,4,3,3,0,3,0.0,3,2,0,2,2,12,8,0
1162,Henri Koudossou,Augsburg,1.6,5,4,2,2,1,4,6,66.7,2,1,1,0,1,6,7,0
1163,Konstantinos Koulierakis,Wolfsburg,6.3,10,4,7,2,1,5,10,50.0,5,14,9,5,5,15,34,0
1164,Jules Kounde,Barcelona,11.3,26,17,12,10,4,21,29,72.4,8,14,2,12,5,31,28,1
1165,Boubakar Kouyate,Montpellier,1.2,4,1,3,1,0,3,5,60.0,2,0,0,0,3,7,5,0
1166,Mateo Kovacic,Manchester City,9.8,22,14,5,12,5,11,25,44.0,14,11,0,11,5,27,6,0
1167,Matej Kovar,Leverkusen,1.0,0,0,0,0,0,0,0,0.0,0,0,0,0,0,0,0,0
1168,Mateusz Kowalski,Parma,0.6,0,0,0,0,0,0,0,0.0,0,1,0,1,0,0,1,0
1170,Caleb Kporha,Crystal Palace,0.0,0,0,0,0,0,0,0,0.0,0,0,0,0,0,0,0,0
1171,Emil Krafth,Newcastle Utd,2.7,2,1,0,1,1,1,2,50.0,1,5,4,1,2,4,10,0
1172,Alex Kral,Espanyol,11.4,31,21,18,13,0,7,11,63.6,4,16,8,8,11,42,20,0
1173,Andrej Kramaric,Hoffenheim,8.7,3,1,0,3,0,2,4,50.0,2,4,2,2,0,3,4,0
1174,Frans Kratzig,Stuttgart,0.6,2,1,1,0,1,1,3,33.3,2,2,1,1,0,2,1,0
1175,Ladislav Krejci,Girona,5.1,6,3,5,1,0,3,7,42.9,4,5,3,2,9,15,19,0
1176,Rasmus Kristensen,Eint Frankfurt,7.4,19,10,15,2,2,15,27,55.6,12,9,3,6,4,23,25,0
1177,Thomas Kristensen,Udinese,2.1,2,1,1,1,0,1,2,50.0,1,1,1,0,0,2,7,0
1178,Nikola Krstovic,Lecce,11.6,10,5,4,3,3,5,10,50.0,5,4,1,3,3,13,8,0
1179,Lukas Kubler,Freiburg,8.8,16,7,8,6,2,9,13,69.2,4,17,5,12,23,39,19,1
1180,Takefusa Kubo,Real Sociedad,9.7,11,6,3,4,4,8,17,47.1,9,20,1,19,5,16,4,1
1181,Mohammed Kudus,West Ham,7.4,9,7,2,4,3,3,10,30.0,7,9,1,8,1,10,1,0
1182,Dejan Kulusevski,Tottenham,9.5,12,7,2,2,8,3,15,20.0,12,14,3,11,7,19,7,0
1183,Sael Kumbedi,Lyon,2.0,5,2,1,3,1,4,5,80.0,1,0,0,0,4,9,5,0
1184,Marash Kumbulla,Espanyol,9.9,13,7,9,3,1,6,13,46.2,7,20,14,6,11,24,63,0
1185,Daler Kuzyaev,Le Havre,4.1,7,5,3,3,1,1,5,20.0,4,6,3,3,4,11,3,0
1186,Khvicha Kvaratskhelia,Napoli,9.5,12,8,3,8,1,4,10,40.0,6,9,0,9,2,14,7,0
1187,Moritz-Broni Kwarteng,Bochum,1.2,2,2,0,1,1,0,1,0.0,1,0,0,0,0,2,0,0
1188,Giorgos Kyriakopoulos,Monza,12.0,23,15,10,11,2,13,26,50.0,13,15,3,12,11,34,37,0
1189,Remy Labeau Lascary,Lens,4.4,6,2,3,1,2,2,6,33.3,4,3,0,3,0,6,2,0
1190,Gaetan Laborde,Nice,2.0,3,2,2,1,0,3,7,42.9,4,0,0,0,1,4,1,0
1191,Nediljko Labrovic,Augsburg,10.0,0,0,0,0,0,0,0,0.0,0,0,0,0,0,0,9,0
1192,Alexandre Lacazette,Lyon,7.7,3,1,1,1,1,2,7,28.6,5,3,0,3,1,4,1,0
1193,Maxence Lacroix,Crystal Palace,8.0,13,8,11,1,1,4,11,36.4,7,12,5,7,14,27,34,1
1194,Alban Lafont,Nantes,11.0,1,1,1,0,0,1,1,100.0,0,2,0,2,0,1,7,1
1196,Konrad Laimer,Bayern Munich,2.8,5,4,0,4,1,3,6,50.0,3,1,0,1,1,6,4,0
1197,Stefan Lainer,Gladbach,2.2,4,2,2,2,0,1,1,100.0,0,4,3,1,3,7,8,0
1198,Kenny Lala,Brest,8.8,25,17,15,9,1,20,29,69.0,9,14,6,8,11,36,19,0
1199,Adam Lallana,Southampton,3.1,5,4,3,2,0,2,7,28.6,5,3,1,2,3,8,5,0
1200,Mathis Lambourde,Hellas Verona,0.4,2,0,1,1,0,1,2,50.0,1,1,0,1,0,2,0,0
1201,Mohamed Lamine Bayo,Lille,2.3,0,0,0,0,0,0,0,0.0,0,0,0,0,0,0,0,0
1202,Tariq Lamptey,Brighton,0.1,0,0,0,0,0,0,1,0.0,1,1,1,0,0,0,0,0
1203,Gianluca Lapadula,Cagliari,2.0,2,0,1,0,1,0,0,0.0,0,0,0,0,0,2,1,0
1204,Cyle Larin,Mallorca,7.1,4,2,1,2,1,0,2,0.0,2,5,0,5,1,5,3,0
1205,Gautier Larsonneur,Saint-Étienne,11.0,0,0,0,0,0,0,1,0.0,1,0,0,0,0,0,7,0
1206,Hugo Larsson,Eint Frankfurt,8.3,10,4,7,3,0,8,19,42.1,11,15,6,9,10,20,15,0
1207,Juanmi Latasa,Valladolid,4.9,1,0,0,1,0,0,2,0.0,2,1,0,1,0,1,5,0
1208,Toni Lato,Mallorca,2.9,7,5,2,1,4,3,5,60.0,2,3,0,3,3,10,10,0
1209,Romeo Lavia,Chelsea,3.7,11,5,4,6,1,5,11,45.5,6,4,0,4,7,18,5,0
1210,Valentino Lazaro,Torino,10.4,15,6,7,6,2,9,13,69.2,4,11,3,8,3,18,16,1
1211,Darko Lazovic,Hellas Verona,9.5,15,7,3,10,2,7,14,50.0,7,11,1,10,7,22,19,0
1212,Manuel Lazzari,Lazio,6.5,8,7,3,4,1,4,8,50.0,4,2,2,0,1,9,6,0
1213,Julien Le Cardinal,Brest,5.8,10,6,6,4,0,6,10,60.0,4,8,6,2,12,22,27,0
1214,Jeremy Le Douaron,Brest,1.1,1,0,0,0,1,0,1,0.0,1,1,0,1,0,1,0,0
1215,Enzo Le Fee,Roma,2.9,6,3,4,2,0,2,6,33.3,4,7,2,5,3,9,1,0
1216,Robin Le Normand,Atlético Madrid,7.0,11,8,11,0,0,3,5,60.0,2,3,2,1,2,13,25,0
1217,Nicola Leali,Genoa,5.0,0,0,0,0,0,0,0,0.0,0,0,0,0,0,0,5,0
1218,Rafael Leao,Milan,7.2,6,5,0,4,2,4,7,57.1,3,5,0,5,4,10,0,0
1219,Benjamin Lecomte,Montpellier,8.0,0,0,0,0,0,0,0,0.0,0,0,0,0,0,0,4,0
1220,Pierre Lees-Melou,Brest,3.7,10,6,2,5,3,6,9,66.7,3,4,2,2,3,13,1,0
1222,Jordan Lefort,Angers,11.0,19,16,15,3,1,11,19,57.9,8,21,10,11,13,32,55,1
1223,Diogo Leite,Union Berlin,10.0,31,15,21,8,2,13,24,54.2,11,24,8,16,20,51,41,0
1224,Maxim Leitsch,Mainz 05,6.1,11,3,6,3,2,7,8,87.5,1,9,4,5,8,19,32,1
1225,Florian Lejeune,Rayo Vallecano,12.0,18,11,11,5,2,7,12,58.3,5,13,11,2,7,25,52,0
1226,Inigo Lekue,Athletic Club,3.5,4,3,3,1,0,3,6,50.0,3,2,1,1,3,7,13,2
1227,Nunzio Lella,Venezia,0.1,0,0,0,0,0,0,0,0.0,0,0,0,0,0,0,0,0
1228,Thomas Lemar,Atlético Madrid,0.1,0,0,0,0,0,0,1,0.0,1,0,0,0,0,0,0,0
1229,Felix Lemarechal,Strasbourg,1.5,2,1,0,0,2,1,1,100.0,0,3,0,3,2,4,2,0
1230,Mario Lemina,Wolves,9.8,33,19,16,13,4,14,19,73.7,5,8,4,4,21,54,26,1
1231,Clement Lenglet,Atlético Madrid,3.4,2,2,1,1,0,1,2,50.0,1,3,1,2,6,8,14,0
1232,Bernd Leno,Fulham,11.0,0,0,0,0,0,0,0,0.0,0,1,0,1,0,0,1,3
1233,Donovan Leon,Auxerre,11.0,0,0,0,0,0,0,0,0.0,0,0,0,0,0,0,7,1
1234,Giovanni Leoni,Parma,0.7,0,0,0,0,0,0,0,0.0,0,1,0,1,2,2,1,0
1235,Esteban Lepaul,Angers,1.7,1,1,0,0,1,0,4,0.0,4,2,1,1,1,2,2,0
1236,Johann Lepenant,Nantes,6.0,14,6,6,6,2,5,16,31.3,11,8,2,6,7,21,4,0
1237,Jefferson Lerma,Crystal Palace,4.6,4,2,1,2,1,3,6,50.0,3,9,4,5,7,11,9,0
1238,Louis Leroux,Nantes,0.2,1,1,1,0,0,1,1,100.0,0,0,0,0,0,1,0,0
1239,Robert Lewandowski,Barcelona,11.9,6,3,1,4,1,2,4,50.0,2,8,2,6,1,7,16,0
1240,Jamie Leweling,Stuttgart,7.3,5,2,2,0,3,3,9,33.3,6,10,0,10,4,9,7,0
1241,Rico Lewis,Manchester City,8.6,17,8,7,8,2,5,6,83.3,1,10,2,8,7,24,20,1
1242,Keane Lewis-Potter,Brentford,8.5,16,7,4,9,3,8,12,66.7,4,7,3,4,4,20,14,0
1243,Myles Lewis-Skelly,Arsenal,0.2,1,1,1,0,0,0,0,0.0,0,0,0,0,0,1,1,0
1244,Philipp Lienhart,Freiburg,9.2,8,6,6,2,0,5,10,50.0,5,4,3,1,12,20,29,1
1245,Matthijs de Ligt,Manchester Utd,8.5,11,5,8,3,0,8,12,66.7,4,10,7,3,13,24,28,0
1246,Victor Lindelof,Manchester Utd,0.7,3,0,3,0,0,1,1,100.0,0,1,0,1,2,5,3,0
1248,Jesper Lindstrom,Everton,3.9,12,5,4,8,0,4,11,36.4,7,8,2,6,3,15,1,0
1249,Karol Linetty,Torino,8.5,17,11,7,10,0,9,17,52.9,8,11,4,7,5,22,14,1
1250,Samuel Lino,Atlético Madrid,6.4,9,3,6,2,1,6,19,31.6,13,10,1,9,4,13,4,0
1251,Pol Lirola,Marseille,3.8,8,5,4,4,0,3,9,33.3,6,4,2,2,0,8,4,0
1252,Dailon Livramento,Hellas Verona,4.0,7,5,1,3,3,3,6,50.0,3,4,0,4,2,9,2,0
1253,Valentino Livramento,Newcastle Utd,7.9,15,9,11,4,0,9,14,64.3,5,13,4,9,10,25,25,1
1254,Diego Llorente,Betis,12.6,16,6,9,7,0,8,15,53.3,7,14,11,3,23,39,63,1
1255,Marcos Llorente,Atlético Madrid,7.0,16,12,10,4,2,9,13,69.2,4,6,1,5,5,21,13,1
1256,Gautier Lloris,Le Havre,11.0,27,18,19,8,0,18,28,64.3,10,9,4,5,6,33,59,0
1257,Giovani Lo Celso,Betis,5.5,11,7,3,3,5,6,9,66.7,3,3,0,3,1,12,1,0
1258,Stanislav Lobotka,Napoli,7.1,15,9,2,8,5,5,7,71.4,2,6,2,4,4,19,8,0
1259,Manuel Locatelli,Juventus,9.6,23,19,14,8,1,7,15,46.7,8,18,7,11,7,30,21,0
1260,Ruben Loftus-Cheek,Milan,6.0,9,5,2,3,4,1,3,33.3,2,1,0,1,1,10,9,0
1261,Enzo Loiodice,Las Palmas,2.6,2,2,1,1,0,1,3,33.3,2,3,0,3,2,4,2,0
1262,Sean Longstaff,Newcastle Utd,5.7,24,16,9,8,7,15,21,71.4,6,11,1,10,5,29,3,0
1263,Ademola Lookman,Atalanta,6.6,13,7,7,4,2,5,8,62.5,3,9,0,9,1,14,0,1
1264,David Lopez,Girona,11.4,11,6,7,2,2,7,14,50.0,7,13,7,6,7,18,45,1
1265,Diego Lopez,Valencia,8.6,6,4,1,2,3,4,14,28.6,10,5,0,5,3,9,2,0
1266,Fermin Lopez,Barcelona,2.6,6,5,3,1,2,2,5,40.0,3,1,0,1,1,7,1,0
1267,Javi Lopez,Real Sociedad,7.1,14,7,8,5,1,7,12,58.3,5,5,2,3,3,17,19,1
1268,Roberto Lopez,Leganés,4.0,7,5,4,3,0,4,13,30.8,9,4,0,4,1,8,7,2
1269,Unai Lopez,Rayo Vallecano,6.9,8,6,4,2,2,3,11,27.3,8,7,1,6,12,20,7,0
1270,Iker Losada,Betis,2.7,9,6,2,4,3,5,9,55.6,4,1,0,1,3,12,2,0
1271,Anthony Losilla,Bochum,7.5,15,12,8,6,1,10,20,50.0,10,12,5,7,10,25,10,1
1272,Jordan Lotomba,Nice,0.4,0,0,0,0,0,0,0,0.0,0,0,0,0,0,0,1,0
1274,Tom Louchet,Nice,1.6,5,5,3,0,2,4,5,80.0,1,1,1,0,0,5,3,0
1275,Sandi Lovric,Udinese,7.2,14,9,8,4,2,7,14,50.0,7,10,1,9,9,23,3,0
1276,Pol Lozano,Espanyol,6.2,19,14,8,8,3,9,20,45.0,11,7,2,5,5,24,10,0
1277,Lorenzo Lucca,Udinese,8.3,7,4,1,2,4,3,5,60.0,2,5,0,5,2,9,6,0
1278,Jhon Lucumi,Bologna,6.4,9,6,4,5,0,3,8,37.5,5,10,5,5,3,12,15,0
1279,Yannik Luhrs,Dortmund,0.4,1,1,1,0,0,0,0,0.0,0,0,0,0,1,2,3,0
1280,Jose Luis Gaya,Valencia,1.1,1,1,1,0,0,1,3,33.3,2,0,0,0,2,3,5,0
1281,Jose Luis Palomino,Cagliari,3.2,5,4,0,3,2,2,3,66.7,1,4,4,0,6,11,8,0
1282,Douglas Luiz,Juventus,3.0,6,2,2,3,1,4,5,80.0,1,2,0,2,2,8,0,0
1283,Romelu Lukaku,Napoli,7.9,1,1,0,1,0,0,2,0.0,2,1,1,0,0,1,7,0
1284,Castello Lukeba,RB Leipzig,6.8,13,5,4,6,3,4,7,57.1,3,11,5,6,3,16,26,0
1285,Dodi Lukebakio,Sevilla,11.3,6,4,3,2,1,2,8,25.0,6,7,0,7,1,7,7,1
1286,Sasa Lukic,Fulham,6.1,12,6,6,5,1,3,15,20.0,12,6,3,3,8,20,6,0
1287,Milos Lukovic,Strasbourg,0.1,0,0,0,0,0,0,0,0.0,0,0,0,0,0,0,0,0
1288,Daniel Luna,Mallorca,0.2,0,0,0,0,0,0,0,0.0,0,1,0,1,0,0,0,0
1289,Andriy Lunin,Real Madrid,3.0,0,0,0,0,0,0,0,0.0,0,0,0,0,0,0,1,0
1290,Massimo Luongo,Ipswich Town,1.6,5,3,5,0,0,4,6,66.7,2,3,2,1,2,7,2,0
1291,Sebastiano Luperto,Cagliari,12.0,16,8,12,3,1,5,10,50.0,5,8,6,2,11,27,52,0
1292,Zito Luvumbo,Cagliari,8.2,2,1,1,1,0,1,6,16.7,5,2,0,2,0,2,3,0
1293,Charalambos Lykogiannis,Bologna,4.5,5,2,3,2,0,3,7,42.9,4,1,1,0,3,8,13,0
1294,Senne Lynen,Werder Bremen,8.8,22,11,9,10,3,13,16,81.3,3,15,2,13,17,39,17,4
1295,Othmane Maamma,Montpellier,0.7,0,0,0,0,0,0,1,0.0,1,2,0,2,0,0,1,0
1296,Ian Maatsen,Aston Villa,1.8,6,4,2,4,0,2,4,50.0,2,1,0,1,0,6,5,1
1297,Alexis Mac Allister,Liverpool,8.6,26,19,8,16,2,16,31,51.6,15,20,0,20,4,30,8,0
1298,Deiver Machado,Lens,4.8,11,8,7,4,0,7,7,100.0,0,6,1,5,2,13,6,0
1300,Shuto Machino,Holstein Kiel,5.1,2,2,1,0,1,2,5,40.0,3,1,0,1,3,5,2,0
1301,Darwin Machis,Valladolid,3.0,0,0,0,0,0,0,4,0.0,4,2,0,2,1,1,3,0
1302,Yvann Macon,Saint-Étienne,3.2,4,3,0,3,1,1,5,20.0,4,7,2,5,0,4,6,1
1303,James Maddison,Tottenham,7.6,13,7,4,6,3,6,16,37.5,10,5,2,3,6,19,10,0
1304,Eros Maddy,Auxerre,0.1,0,0,0,0,0,0,0,0.0,0,0,0,0,0,0,0,0
1305,Noni Madueke,Chelsea,8.4,12,9,5,6,1,7,17,41.2,10,7,0,7,3,15,4,0
1306,Pablo Maffeo,Mallorca,9.2,19,11,13,5,1,11,16,68.8,5,13,5,8,8,27,22,1
1307,Gabriel Magalhaes,Arsenal,10.6,7,4,4,3,0,4,7,57.1,3,23,17,6,6,13,39,1
1308,Soungoutou Magassa,Monaco,3.4,14,9,3,10,1,9,14,64.3,5,2,0,2,6,20,4,1
1309,Giangiacomo Magnani,Hellas Verona,7.4,15,11,11,4,0,5,5,100.0,0,12,6,6,10,25,32,0
1310,Hugo Magnetti,Brest,8.0,9,3,4,5,0,4,10,40.0,6,7,2,5,6,15,9,0
1311,Frank Magri,Toulouse,3.5,1,0,0,0,1,1,4,25.0,3,7,0,7,1,2,4,0
1312,Harry Maguire,Manchester Utd,2.7,2,1,2,0,0,2,2,100.0,0,2,2,0,6,8,10,0
1313,Jon Magunacelaya,Real Sociedad,0.1,1,1,1,0,0,0,0,0.0,0,0,0,0,0,1,0,0
1314,Arne Maier,Augsburg,3.3,6,1,1,5,0,4,5,80.0,1,6,0,6,1,7,3,0
1315,Mike Maignan,Milan,11.0,0,0,0,0,0,0,0,0.0,0,0,0,0,0,0,7,1
1316,Patrick Mainka,Heidenheim,10.0,16,8,10,6,0,9,11,81.8,2,17,11,6,14,30,46,0
1317,Kobbie Mainoo,Manchester Utd,6.3,16,13,12,3,1,10,15,66.7,5,5,1,4,14,30,2,1
1318,Ainsley Maitland-Niles,Lyon,8.2,31,19,12,10,9,19,27,70.4,8,10,1,9,12,43,19,3
1319,Radoslaw Majecki,Monaco,4.0,0,0,0,0,0,0,0,0.0,0,0,0,0,0,0,3,0
1320,Lovro Majer,Wolfsburg,1.6,0,0,0,0,0,0,2,0.0,2,2,0,2,0,0,1,0
1321,Jordy Makengo,Freiburg,0.4,4,3,3,1,0,2,2,100.0,0,0,0,0,0,4,4,0
1322,Antoine Makoumbou,Cagliari,5.4,5,3,4,1,0,1,3,33.3,2,8,2,6,4,9,4,0
1323,Nikola Maksimovic,Montpellier,2.0,4,3,2,2,0,2,2,100.0,0,0,0,0,3,7,12,1
1324,Julian Malatini,Werder Bremen,4.8,10,9,4,5,1,4,10,40.0,6,6,3,3,7,17,16,0
1326,Daniel Maldini,Monza,7.8,11,5,3,8,0,5,7,71.4,2,6,2,4,2,13,6,2
1327,Youssef Maleh,Empoli,5.6,6,4,3,3,0,2,8,25.0,6,11,3,8,6,12,6,0
1328,Donyell Malen,Dortmund,4.4,0,0,0,0,0,0,0,0.0,0,2,0,2,1,1,1,0
1329,Ruslan Malinovskyi,Genoa,2.5,8,6,2,5,1,2,3,66.7,1,1,0,1,1,9,3,0
1330,Lennard Maloney,Heidenheim,5.9,13,5,7,5,1,9,13,69.2,4,8,2,6,8,21,30,0
1331,Giorgi Mamardashvili,Valencia,11.0,0,0,0,0,0,0,0,0.0,0,0,0,0,0,0,3,0
1332,Dennis Man,Parma,9.9,5,3,3,1,1,4,13,30.8,9,4,1,3,7,12,6,0
1333,Hianga Mananga Mbock,Brest,0.2,0,0,0,0,0,0,0,0.0,0,0,0,0,1,1,0,0
1334,Gianluca Mancini,Roma,11.1,15,7,7,6,2,9,11,81.8,2,8,6,2,12,27,18,0
1335,Steve Mandanda,Rennes,10.5,0,0,0,0,0,0,1,0.0,1,0,0,0,0,0,0,1
1336,Reinildo Mandava,Atlético Madrid,6.7,16,10,8,7,1,9,14,64.3,5,7,3,4,10,26,24,0
1337,Aissa Mandi,Lille,5.8,10,6,2,7,1,4,7,57.1,3,9,7,2,3,13,13,0
1338,Rolando Mandragora,Fiorentina,3.4,2,0,1,0,1,0,1,0.0,1,3,1,2,6,8,5,1
1339,Orel Mangala,Everton,5.1,11,5,1,10,0,4,6,66.7,2,0,0,0,11,22,3,0
1340,Orel Mangala,Lyon,0.7,1,0,0,0,1,0,1,0.0,1,2,0,2,0,1,1,0
1341,Ryan Manning,Southampton,3.7,3,2,1,2,0,1,2,50.0,1,5,3,2,3,6,8,0
1342,Javier Manquillo,Celta Vigo,5.4,7,5,4,3,0,2,9,22.2,7,5,3,2,6,13,15,0
1343,Johan Manzambi,Freiburg,0.1,0,0,0,0,0,0,0,0.0,0,0,0,0,0,0,0,0
1344,Alberto Manzoni,Atalanta,0.1,0,0,0,0,0,0,0,0.0,0,0,0,0,0,0,0,0
1345,Sekou Mara,Strasbourg,4.7,5,3,0,3,2,1,4,25.0,3,2,0,2,3,8,2,0
1346,Alessandro Marcandalli,Genoa,0.5,1,0,1,0,0,0,0,0.0,0,0,0,0,0,1,2,0
1347,Marcao,Sevilla,5.1,9,6,6,3,0,2,3,66.7,1,9,6,3,6,15,23,1
1348,Filip Marchwinski,Lecce,0.2,0,0,0,0,0,0,0,0.0,0,0,0,0,0,0,0,0
1349,Oscar de Marcos,Athletic Club,7.6,18,9,9,7,2,12,19,63.2,7,9,1,8,10,28,14,0
1350,Alberto Mari,Valencia,0.1,0,0,0,0,0,0,0,0.0,0,0,0,0,0,0,0,0
1352,Pablo Mari,Monza,12.0,15,8,9,6,0,7,14,50.0,7,15,14,1,25,40,62,1
1353,Jose Maria Gimenez,Atlético Madrid,10.3,10,7,6,4,0,8,14,57.1,6,14,10,4,14,24,44,0
1354,Luca Marianucci,Empoli,0.1,0,0,0,0,0,0,1,0.0,1,0,0,0,0,0,1,0
1355,Mirko Maric,Monza,0.8,0,0,0,0,0,0,0,0.0,0,1,1,0,1,1,1,0
1356,Pablo Marin,Real Sociedad,0.5,1,1,0,1,0,1,1,100.0,0,0,0,0,0,1,0,0
1357,Razvan Marin,Cagliari,7.7,10,6,3,6,1,6,12,50.0,6,4,0,4,1,11,12,1
1358,Guillermo Maripan,Torino,4.0,6,2,3,2,1,3,4,75.0,1,3,0,3,8,14,21,0
1359,Mika Marmol,Las Palmas,5.7,13,4,8,4,1,5,7,71.4,2,9,3,6,8,21,19,0
1360,Omar Marmoush,Eint Frankfurt,9.3,7,4,0,3,4,1,3,33.3,2,7,1,6,1,8,1,0
1361,Mario Maroto,Valladolid,0.2,0,0,0,0,0,0,1,0.0,1,0,0,0,2,2,1,0
1362,Marquinhos,Paris S-G,8.0,12,9,4,5,3,8,11,72.7,3,14,6,8,3,15,21,0
1363,Aaron Martin,Genoa,10.2,26,19,12,12,2,11,17,64.7,6,10,3,7,5,31,18,1
1364,Carlos Martin,Alavés,3.2,6,2,2,3,1,3,14,21.4,11,5,1,4,0,6,4,0
1365,Gerard Martin,Barcelona,3.1,8,3,3,2,3,5,7,71.4,2,5,1,4,2,10,9,0
1366,Ivan Martin,Girona,8.3,12,7,7,4,1,5,14,35.7,9,10,1,9,5,17,3,0
1367,Jon Martin,Real Sociedad,1.0,0,0,0,0,0,0,0,0.0,0,1,1,0,1,1,6,0
1368,Jonas Martin,Brest,5.0,10,4,8,1,1,4,9,44.4,5,3,0,3,6,16,10,0
1369,Mario Martin,Valladolid,6.8,20,11,10,9,1,10,22,45.5,12,8,1,7,5,25,16,3
1370,Gabriel Martinelli,Arsenal,7.6,9,7,1,3,5,4,11,36.4,7,4,0,4,1,10,9,0
1371,Arnau Martinez,Girona,8.1,17,10,10,4,3,11,16,68.8,5,2,2,0,3,20,20,2
1372,Emiliano Martinez,Aston Villa,11.0,0,0,0,0,0,0,0,0.0,0,0,0,0,0,0,8,2
1373,Inigo Martinez,Barcelona,11.8,12,7,10,2,0,7,7,100.0,0,7,5,2,7,19,38,1
1374,Javi Martinez,Osasuna,0.1,0,0,0,0,0,0,0,0.0,0,0,0,0,0,0,0,0
1375,Lautaro Martinez,Inter,10.0,7,3,2,3,2,3,5,60.0,2,5,1,4,3,10,3,0
1376,Lisandro Martinez,Manchester Utd,9.8,22,13,15,5,2,11,19,57.9,8,11,3,8,22,44,27,1
1378,Lucas Martinez Quarta,Fiorentina,3.6,11,6,9,2,0,7,12,58.3,5,5,2,3,3,14,22,1
1379,Toni Martinez,Alavés,5.0,5,3,0,3,2,0,1,0.0,1,5,2,3,0,5,7,0
1380,Kevin Martins,Monza,0.0,0,0,0,0,0,0,0,0.0,0,0,0,0,0,0,0,0
1381,Javi Marton,Athletic Club,0.6,0,0,0,0,0,0,0,0.0,0,0,0,0,0,0,0,0
1382,Adam Marusic,Lazio,7.4,13,6,8,5,0,6,11,54.5,5,5,2,3,5,18,21,0
1383,Marvin,Las Palmas,4.5,10,5,5,3,2,5,16,31.3,11,4,1,3,5,15,13,0
1384,Omar Mascarell,Mallorca,6.9,14,7,7,7,0,8,13,61.5,5,11,6,5,13,27,22,2
1385,Adam Masina,Torino,10.6,15,8,11,4,0,12,21,57.1,9,16,11,5,7,22,43,1
1386,Patrizio Masini,Genoa,0.6,2,1,1,1,0,0,0,0.0,0,4,0,4,0,2,1,0
1387,Erhan Masovic,Bochum,6.2,7,6,5,2,0,6,14,42.9,8,11,7,4,8,15,27,0
1388,Clinton Mata,Lyon,7.1,14,8,7,6,1,11,12,91.7,1,7,4,3,16,30,14,2
1389,Jaime Mata,Las Palmas,2.6,2,0,1,1,0,2,6,33.3,4,2,0,2,1,3,1,0
1390,Igor Matanovic,Eint Frankfurt,2.2,1,0,0,1,0,0,1,0.0,1,1,0,1,0,1,5,0
1391,Pape Matar Sarr,Tottenham,4.9,13,8,4,8,1,1,4,25.0,3,8,2,6,8,21,4,0
1392,Eliot Matazo,Monaco,0.0,0,0,0,0,0,0,0,0.0,0,0,0,0,0,0,0,0
1393,Jean-Philippe Mateta,Crystal Palace,8.4,2,1,0,1,1,0,4,0.0,4,5,0,5,0,2,7,0
1394,Nemanja Matic,Lyon,6.5,12,10,4,7,1,5,10,50.0,5,8,3,5,4,16,12,0
1395,Chrislain Matsima,Augsburg,4.5,2,2,2,0,0,1,3,33.3,2,9,5,4,14,16,20,0
1396,Jean Matteo Bahoya,Eint Frankfurt,1.4,5,5,3,2,0,4,8,50.0,4,1,0,1,1,6,0,0
1397,Alan Matturro,Genoa,5.2,7,4,3,4,0,3,10,30.0,7,5,2,3,6,13,12,0
1398,Azor Matusiwa,Rennes,8.5,28,17,13,14,1,15,20,75.0,5,12,4,8,12,40,16,0
1399,Neal Maupay,Marseille,3.2,5,2,1,3,1,2,2,100.0,0,2,0,2,0,5,0,0
1400,Stephy Mavididi,Leicester City,6.8,13,9,5,5,3,6,16,37.5,10,12,1,11,1,14,4,0
1401,Konstantinos Mavropanos,West Ham,7.2,12,9,9,2,1,6,10,60.0,4,11,9,2,14,26,39,0
1402,Christian Mawissa,Monaco,2.3,11,6,4,5,2,10,13,76.9,3,5,1,4,8,19,2,0
1404,Keke Maximilian Topp,Werder Bremen,2.0,1,0,0,0,1,0,1,0.0,1,0,0,0,1,2,1,0
1405,Borja Mayoral,Getafe,1.4,1,1,1,0,0,0,0,0.0,0,1,0,1,0,1,1,0
1406,Senny Mayulu,Paris S-G,2.1,9,5,4,4,1,3,6,50.0,3,5,3,2,2,11,3,0
1407,Noussair Mazraoui,Manchester Utd,9.1,39,20,20,13,6,20,31,64.5,11,12,2,10,10,49,31,0
1408,Luca Mazzitelli,Como,3.2,9,6,4,5,0,5,7,71.4,2,5,2,3,2,11,10,0
1409,Pasquale Mazzocchi,Napoli,4.3,5,2,3,1,1,2,6,33.3,4,3,1,2,3,8,11,0
1410,Samuel Mbangula,Juventus,3.6,9,7,7,1,1,5,8,62.5,3,4,0,4,0,9,2,0
1411,Ethan Mbappe,Lille,0.9,1,0,0,1,0,0,2,0.0,2,4,0,4,0,1,0,0
1412,Kylian Mbappe,Real Madrid,10.4,1,1,0,1,0,0,0,0.0,0,1,0,1,0,1,0,0
1413,Ibrahim Mbaye,Paris S-G,1.0,0,0,0,0,0,0,3,0.0,3,0,0,0,0,0,0,0
1414,Bryan Mbeumo,Brentford,10.9,11,8,5,3,3,5,7,71.4,2,5,2,3,3,14,11,0
1415,James Mcatee,Manchester City,0.0,0,0,0,0,0,0,0,0.0,0,1,0,1,0,0,0,0
1416,Kasey McAteer,Leicester City,0.4,4,2,4,0,0,2,3,66.7,1,4,0,4,0,4,3,0
1417,Oliver McBurnie,Las Palmas,7.9,5,4,2,2,1,2,4,50.0,2,3,1,2,3,8,8,0
1418,Alex McCarthy,Southampton,2.0,0,0,0,0,0,0,0,0.0,0,0,0,0,0,0,0,1
1419,John McGinn,Aston Villa,6.1,9,5,3,6,0,4,7,57.1,3,7,0,7,2,11,3,0
1420,Scott McKenna,Las Palmas,8.1,7,6,6,1,0,4,5,80.0,1,13,10,3,2,9,46,1
1421,Weston McKennie,Juventus,4.1,4,2,2,2,0,1,2,50.0,1,3,0,3,2,6,1,0
1422,Mark McKenzie,Toulouse,8.7,15,10,8,7,0,10,14,71.4,4,11,8,3,5,20,44,0
1423,Dwight McNeil,Everton,9.9,8,4,5,3,0,5,12,41.7,7,5,0,5,5,13,1,0
1424,Scott McTominay,Manchester Utd,0.2,0,0,0,0,0,0,1,0.0,1,0,0,0,0,0,1,0
1425,Scott McTominay,Napoli,8.2,14,10,4,9,1,9,17,52.9,8,7,0,7,7,21,7,0
1426,Jakov Medic,Bochum,7.8,4,3,2,2,0,2,6,33.3,4,19,14,5,8,12,44,2
1427,Facundo Medina,Lens,9.8,20,11,10,9,1,8,13,61.5,5,8,2,6,11,31,25,0
1428,Ben Mee,Brentford,0.1,1,1,0,1,0,1,1,100.0,0,1,1,0,1,2,0,0
1430,Henrik Meister,Rennes,0.7,2,0,0,2,0,0,0,0.0,0,4,0,4,1,3,0,0
1431,Bamo Meite,Marseille,0.3,0,0,0,0,0,0,0,0.0,0,0,0,0,0,0,1,0
1432,Mohamed Meite,Rennes,0.1,0,0,0,0,0,0,0,0.0,0,0,0,0,0,0,0,0
1433,Mateo Mejia,Sevilla,0.1,0,0,0,0,0,0,0,0.0,0,0,0,0,0,0,0,0
1434,Farid El Melali,Angers,7.8,12,6,4,4,4,5,18,27.8,13,6,1,5,3,15,5,1
1435,Filippo Melegoni,Genoa,1.0,1,1,1,0,0,0,4,0.0,4,0,0,0,0,1,2,0
1436,Nuno Mendes,Paris S-G,4.3,6,4,2,3,1,5,10,50.0,5,7,4,3,5,11,5,0
1437,Brais Mendez,Real Sociedad,7.3,7,4,3,2,2,4,12,33.3,8,5,0,5,2,9,6,0
1438,Antoine Mendy,Nice,4.5,19,13,10,9,0,12,18,66.7,6,6,2,4,4,23,15,0
1439,Ferland Mendy,Real Madrid,7.4,15,12,6,5,4,8,10,80.0,2,7,2,5,8,23,6,1
1440,Nampalys Mendy,Lens,1.2,4,2,3,1,0,2,5,40.0,3,2,1,1,1,5,0,0
1441,Gideon Mensah,Auxerre,5.3,18,12,12,5,1,7,17,41.2,10,2,0,2,8,26,20,0
1442,Alex Meret,Napoli,8.4,0,0,0,0,0,0,0,0.0,0,1,0,1,0,0,4,0
1443,Mikel Merino,Arsenal,3.1,11,8,4,3,4,4,9,44.4,5,8,5,3,6,17,4,1
1444,Quentin Merlin,Marseille,4.1,3,2,1,1,1,1,5,20.0,4,1,1,0,5,8,4,1
1445,Victor Meseguer,Valladolid,3.7,10,6,4,4,2,2,10,20.0,8,3,0,3,2,12,3,1
1446,Rafik Messali,Toulouse,0.0,0,0,0,0,0,0,0,0.0,0,0,0,0,0,0,0,0
1447,Junior Messias,Genoa,2.9,4,1,3,1,0,1,1,100.0,0,1,1,0,3,7,5,0
1448,Connor Metcalfe,St. Pauli,2.5,1,0,0,1,0,0,3,0.0,3,3,0,3,2,3,4,0
1449,Karol Mets,St. Pauli,10.0,13,8,6,7,0,4,7,57.1,3,9,3,6,12,25,60,0
1450,Thomas Meunier,Lille,6.6,13,9,9,3,1,8,13,61.5,5,8,2,6,12,25,20,0
1451,Alexander Meyer,Dortmund,2.0,0,0,0,0,0,0,0,0.0,0,0,0,0,0,0,0,0
1452,Florian Micheler,Hoffenheim,0.4,0,0,0,0,0,0,2,0.0,2,0,0,0,0,0,0,0
1453,Miguel,Leganés,8.7,4,2,2,2,0,3,7,42.9,4,10,2,8,2,6,7,0
1454,Valentin Mihaila,Parma,7.5,23,11,6,11,6,7,14,50.0,7,10,0,10,3,26,2,0
1456,Georges Mikautadze,Lyon,5.1,4,3,1,1,2,1,3,33.3,2,2,0,2,1,5,0,0
1457,Nikola Milenkovic,Nott'ham Forest,10.0,10,8,6,4,0,4,5,80.0,1,10,6,4,10,20,39,0
1458,Vanja Milinkovic-Savic,Torino,11.0,0,0,0,0,0,0,2,0.0,2,0,0,0,0,0,3,1
1459,Eder Militao,Real Madrid,10.4,19,17,14,5,0,7,12,58.3,5,13,8,5,12,31,35,0
1460,Luis Milla,Getafe,12.8,26,18,14,10,2,15,31,48.4,16,19,0,19,9,35,8,0
1461,Pere Milla,Espanyol,2.3,3,1,2,0,1,0,10,0.0,10,6,2,4,2,5,2,0
1462,Enzo Millot,Stuttgart,7.7,11,9,4,5,2,4,14,28.6,10,9,0,9,4,15,2,0
1463,James Milner,Brighton,1.9,5,2,1,3,1,3,3,100.0,0,4,2,2,2,7,2,1
1464,Kim Min-jae,Bayern Munich,9.5,11,7,3,7,1,3,8,37.5,5,11,6,5,14,25,28,1
1465,Yerry Mina,Cagliari,8.1,19,6,12,6,1,14,17,82.4,3,15,9,6,7,26,45,1
1466,Takumi Minamino,Monaco,8.4,8,5,2,4,2,2,9,22.2,7,9,1,8,4,12,5,0
1467,Lucas Mincarelli,Montpellier,2.8,4,4,1,2,1,1,5,20.0,4,1,1,0,1,5,8,0
1468,Oscar Mingueza,Celta Vigo,10.2,16,9,7,6,3,12,26,46.2,14,13,3,10,6,22,16,2
1469,Kim Minsu,Girona,0.2,1,0,0,1,0,0,0,0.0,0,0,0,0,0,1,0,0
1470,Yankuba Minteh,Brighton,4.5,5,3,1,1,3,3,11,27.3,8,7,0,7,3,8,4,0
1471,Bojan Miovski,Girona,5.0,6,4,1,2,3,2,6,33.3,4,3,0,3,1,7,4,0
1472,Rafa Mir,Valencia,2.7,6,3,4,2,0,1,3,33.3,2,1,0,1,0,6,5,0
1473,Juan Miranda,Bologna,6.5,12,8,6,4,2,6,12,50.0,6,9,1,8,8,20,8,0
1474,Fabio Miretti,Genoa,3.6,10,5,3,4,3,8,9,88.9,1,3,0,3,1,11,3,0
1475,Tyrick Mitchell,Crystal Palace,10.4,31,22,19,9,3,6,12,50.0,6,20,3,17,5,36,25,1
1476,Kaoru Mitoma,Brighton,10.2,16,9,4,7,5,9,17,52.9,8,18,0,18,6,22,2,0
1477,Maximilian Mittelstadt,Stuttgart,8.0,21,14,14,6,1,14,20,70.0,6,17,8,9,11,32,20,1
1478,Koji Miyoshi,Bochum,2.4,4,4,0,1,3,2,6,33.3,4,5,1,4,1,5,2,0
1479,Henrikh Mkhitaryan,Inter,10.6,15,9,3,9,3,7,16,43.8,9,6,0,6,9,24,15,0
1480,Jakub Moder,Brighton,0.1,0,0,0,0,0,0,2,0.0,2,0,0,0,0,0,2,0
1482,Rui Modesto,Udinese,0.2,1,1,0,1,0,1,1,100.0,0,0,0,0,1,2,0,0
1483,Luka Modric,Real Madrid,6.6,5,2,4,0,1,4,9,44.4,5,6,1,5,7,12,6,0
1484,Max Moerstedt,Hoffenheim,0.6,0,0,0,0,0,0,0,0.0,0,0,0,0,0,0,2,0
1485,Mostafa Mohamed,Nantes,4.4,8,5,3,4,1,2,6,33.3,4,2,0,2,2,10,10,0
1486,Johan Mojica,Mallorca,10.1,14,9,11,1,2,8,13,61.5,5,3,1,2,11,25,33,0
1487,Alberto Moleiro,Las Palmas,11.3,11,5,5,5,1,8,20,40.0,12,12,0,12,6,17,5,0
1488,Nahuel Molina,Atlético Madrid,7.8,17,8,9,8,0,12,25,48.0,13,8,0,8,6,23,20,0
1489,Florent Mollet,Nantes,1.1,1,1,1,0,0,1,1,100.0,0,1,0,1,1,2,1,0
1490,Jon Moncayola,Osasuna,8.6,30,15,7,19,4,10,22,45.5,12,15,1,14,6,36,10,0
1491,Gonzalo Montiel,Sevilla,0.1,0,0,0,0,0,0,0,0.0,0,0,0,0,0,0,0,0
1492,Lorenzo Montipo,Hellas Verona,11.0,0,0,0,0,0,0,1,0.0,1,0,0,0,0,0,5,2
1493,Mikey Moore,Tottenham,0.9,0,0,0,0,0,0,0,0.0,0,0,0,0,1,1,0,0
1494,Alvaro Morata,Milan,5.9,5,4,1,4,0,2,3,66.7,1,4,1,3,5,10,1,0
1495,Morato,Nott'ham Forest,0.8,1,1,1,0,0,0,0,0.0,0,1,1,0,2,3,14,0
1496,Diego Moreira,Strasbourg,9.2,15,10,4,7,4,6,11,54.5,5,5,1,4,12,27,16,0
1497,Alberto Moreno,Como,11.3,17,9,10,7,0,8,14,57.1,6,9,1,8,11,28,18,2
1498,Alex Moreno,Nott'ham Forest,6.8,17,12,14,3,0,8,22,36.4,14,8,4,4,10,27,26,0
1499,Gerard Moreno,Villarreal,1.3,2,2,0,0,2,1,1,100.0,0,0,0,0,0,2,1,0
1500,Tete Morente,Lecce,4.3,7,4,2,4,1,2,10,20.0,8,6,0,6,3,10,3,0
1501,Ilaix Moriba,Celta Vigo,4.8,12,9,3,9,0,7,18,38.9,11,5,2,3,4,16,7,0
1502,Manu Morlanes,Mallorca,7.7,21,13,11,6,4,10,15,66.7,5,13,6,7,17,38,11,0
1503,Nikola Moro,Bologna,5.8,14,12,4,8,2,10,13,76.9,3,10,5,5,4,18,5,0
1504,Raul Moro,Valladolid,10.4,12,7,9,2,1,6,17,35.3,11,5,0,5,8,20,6,0
1505,Sam Morsy,Ipswich Town,9.9,29,17,15,11,3,13,23,56.5,10,12,4,8,6,35,16,1
1506,Cristhian Mosquera,Valencia,11.0,9,4,8,1,0,2,4,50.0,2,12,8,4,12,21,39,0
1508,Daniel Mosquera,Hellas Verona,4.6,4,2,1,1,2,0,2,0.0,2,3,1,2,0,4,4,0
1509,Yerson Mosquera,Wolves,4.9,11,7,9,2,0,9,14,64.3,5,13,10,3,10,21,14,0
1510,Dany Mota,Monza,7.0,5,1,1,0,4,1,3,33.3,2,9,0,9,7,12,6,0
1511,Yael Mouanga,Montpellier,1.0,2,2,2,0,0,1,1,100.0,0,3,3,0,0,2,7,0
1512,Aimen Moueffek,Saint-Étienne,4.8,9,5,1,7,1,2,10,20.0,8,6,3,3,2,11,14,0
1513,Youssoufa Moukoko,Nice,2.0,1,0,1,0,0,0,1,0.0,1,0,0,0,0,1,0,0
1514,Steve Mounie,Augsburg,2.2,2,2,0,0,2,0,1,0.0,1,1,1,0,0,2,2,0
1515,Mason Mount,Manchester Utd,1.6,5,1,2,3,0,4,5,80.0,1,3,0,3,0,5,0,0
1516,Santiago Mourino,Alavés,3.1,11,8,10,1,0,6,12,50.0,6,4,0,4,4,15,12,0
1517,Louis Mouton,Saint-Étienne,3.2,9,5,2,3,4,2,7,28.6,5,2,1,1,5,14,5,0
1518,Mykhailo Mudryk,Chelsea,1.7,2,2,2,0,0,0,0,0.0,0,3,1,2,0,2,1,0
1519,Ngal'Ayel Mukau,Lille,3.7,13,9,4,8,1,9,15,60.0,6,7,0,7,8,21,8,0
1520,Nordi Mukiele,Leverkusen,1.1,3,2,0,2,1,2,2,100.0,0,1,0,1,2,5,4,1
1521,Florian Muller,Freiburg,2.0,0,0,0,0,0,0,0,0.0,0,0,0,0,0,0,0,0
1522,Kevin Muller,Heidenheim,10.0,1,0,1,0,0,1,1,100.0,0,0,0,0,0,1,4,2
1523,Thomas Muller,Bayern Munich,3.9,4,2,1,2,1,2,5,40.0,3,4,0,4,0,4,5,0
1524,Abdul Mumin,Rayo Vallecano,10.0,8,7,5,3,0,1,8,12.5,7,17,12,5,14,22,55,0
1525,Marshall Munetsi,Reims,9.9,18,10,12,2,4,11,20,55.0,9,13,3,10,9,27,15,0
1526,Rodrigo Muniz,Fulham,3.6,0,0,0,0,0,0,0,0.0,0,1,1,0,1,1,4,0
1527,Aihen Munoz,Real Sociedad,2.4,1,1,1,0,0,1,5,20.0,4,1,1,0,3,4,10,0
1528,Alex Munoz,Las Palmas,9.6,28,22,16,11,1,15,24,62.5,9,20,7,13,14,42,43,0
1529,Daniel Munoz,Crystal Palace,10.0,38,27,20,13,5,15,27,55.6,12,11,1,10,12,50,31,0
1530,Iker Munoz,Osasuna,0.7,0,0,0,0,0,0,0,0.0,0,0,0,0,1,1,1,0
1531,Javier Munoz,Las Palmas,8.8,18,13,7,8,3,7,17,41.2,10,10,0,10,9,27,12,1
1532,Arijanet Muric,Ipswich Town,10.0,0,0,0,0,0,0,2,0.0,2,0,0,0,0,0,5,3
1534,Murillo,Nott'ham Forest,11.0,13,8,9,3,1,9,19,47.4,10,17,13,4,6,19,67,1
1535,Vedat Muriqi,Mallorca,8.5,0,0,0,0,0,0,1,0.0,1,0,0,0,4,4,16,0
1536,Jacob Murphy,Newcastle Utd,5.5,8,6,4,3,1,5,9,55.6,4,7,0,7,2,10,2,0
1537,Yunus Musah,Milan,3.3,7,6,3,2,2,1,1,100.0,0,2,0,2,3,10,2,1
1538,Jamal Musiala,Bayern Munich,6.8,11,7,2,6,3,1,7,14.3,6,6,0,6,5,16,3,0
1539,Florent Muslija,Freiburg,1.4,4,3,3,0,1,2,2,100.0,0,0,0,0,1,5,1,0
1540,Juan Musso,Atalanta,1.0,0,0,0,0,0,0,0,0.0,0,0,0,0,0,0,0,0
1541,Juan Musso,Atlético Madrid,1.0,0,0,0,0,0,0,0,0.0,0,0,0,0,0,0,0,0
1542,Kingstone Mutandwa,Cagliari,0.5,0,0,0,0,0,0,0,0.0,0,0,0,0,0,0,0,0
1543,Junior Mwanga,Strasbourg,2.6,13,6,9,3,1,5,7,71.4,2,1,0,1,2,15,1,0
1544,Phillipp Mwene,Mainz 05,9.9,16,9,7,7,2,4,9,44.4,5,9,2,7,11,27,19,0
1545,Vitaliy Mykolenko,Everton,8.3,12,8,9,3,0,6,11,54.5,5,5,2,3,7,19,32,1
1546,Joakim Maehle,Wolfsburg,2.4,1,0,0,1,0,0,0,0.0,0,1,0,1,2,3,4,0
1547,Obite N'Dicka,Roma,12.0,14,12,7,7,0,8,9,88.9,1,18,13,5,15,29,39,1
1548,Nathan N'Goumou,Gladbach,2.7,5,5,3,1,1,2,4,50.0,2,5,0,5,2,7,3,0
1549,Stanley N'Soki,Hoffenheim,2.1,4,3,3,1,0,3,4,75.0,1,4,2,2,4,8,7,0
1550,Mickael Nade,Saint-Étienne,6.6,21,15,13,8,0,10,10,100.0,0,12,4,8,8,29,26,2
1551,Mahamadou Nagida,Rennes,0.5,1,1,0,0,1,1,1,100.0,0,1,0,1,2,3,0,0
1552,Keito Nakamura,Reims,9.3,12,9,4,5,3,5,10,50.0,5,9,0,9,5,17,4,0
1553,Sebastian Nanasi,Strasbourg,8.2,3,2,0,3,0,1,6,16.7,5,7,1,6,2,5,5,0
1554,Matija Nastasic,Leganés,7.5,9,5,8,1,0,5,9,55.6,4,17,13,4,7,16,46,0
1555,Natan,Betis,8.1,10,7,7,2,1,7,7,100.0,0,9,5,4,13,23,38,0
1556,Pau Navarro,Villarreal,1.4,4,3,2,2,0,3,5,60.0,2,2,2,0,0,4,11,0
1557,Roberto Navarro,Mallorca,6.9,16,11,8,5,3,5,11,45.5,6,9,0,9,10,26,4,0
1558,Jesus Navas,Sevilla,3.4,4,2,2,0,2,0,1,0.0,1,0,0,0,2,6,4,0
1560,Michel Ndary Adopo,Cagliari,5.6,13,8,4,9,0,2,5,40.0,3,3,0,3,5,18,3,0
1561,Youssouf Ndayishimiye,Nice,6.5,16,7,12,3,1,7,11,63.6,4,8,5,3,7,23,32,1
1562,Iliman Ndiaye,Everton,9.0,20,11,8,5,7,11,18,61.1,7,11,3,8,13,33,8,0
1563,Junior Ndiaye,Montpellier,0.1,1,0,1,0,0,0,0,0.0,0,0,0,0,0,1,1,0
1564,Rassoul Ndiaye,Le Havre,4.8,14,10,7,7,0,1,11,9.1,10,4,0,4,3,17,0,0
1565,Wilfred Ndidi,Leicester City,10.2,36,20,21,12,3,10,21,47.6,11,25,10,15,6,42,31,0
1566,Tanguy Ndombele,Nice,6.6,22,15,5,15,2,8,11,72.7,3,6,0,6,6,28,3,0
1567,Dan Ndoye,Bologna,6.8,3,2,2,1,0,0,4,0.0,4,7,0,7,1,4,2,0
1568,Paul Nebel,Mainz 05,3.9,7,4,2,3,2,2,6,33.3,4,9,0,9,5,12,5,0
1569,Kosta Nedeljkovic,Aston Villa,1.1,7,5,1,3,3,2,3,66.7,1,1,0,1,0,7,3,0
1570,Loic Nego,Le Havre,8.0,17,10,10,5,2,13,21,61.9,8,4,0,4,12,29,19,0
1571,Reiss Nelson,Arsenal,0.0,1,0,0,1,0,0,1,0.0,1,0,0,0,0,1,1,0
1572,Reiss Nelson,Fulham,3.2,4,2,2,1,1,2,8,25.0,6,9,0,9,0,4,0,0
1573,David Neres,Napoli,2.1,2,1,0,1,1,0,0,0.0,0,2,0,2,0,2,0,0
1574,Neto,Bournemouth,2.0,0,0,0,0,0,0,0,0.0,0,0,0,0,0,0,1,1
1575,Pedro Neto,Chelsea,6.2,7,3,1,5,1,4,7,57.1,3,7,0,7,4,11,3,0
1576,Luca Netz,Gladbach,5.9,13,6,9,3,1,5,10,50.0,5,9,2,7,7,20,13,0
1577,Manuel Neuer,Bayern Munich,9.0,0,0,0,0,0,0,0,0.0,0,0,0,0,0,0,4,1
1578,Florian Neuhaus,Gladbach,0.7,2,0,1,1,0,1,6,16.7,5,2,0,2,1,3,0,0
1579,Joao Neves,Paris S-G,8.7,36,18,10,18,8,13,23,56.5,10,11,3,8,6,42,3,0
1580,Yvan Neyou,Leganés,7.8,16,12,5,9,2,8,16,50.0,8,12,0,12,6,22,12,0
1581,Cyril Ngonge,Napoli,1.2,2,1,0,2,0,0,2,0.0,2,0,0,0,0,2,3,0
1582,Mikayil Ngor Faye,Rennes,3.4,8,5,5,2,1,5,5,100.0,0,3,1,2,4,12,14,0
1583,Steve Ngoura,Le Havre,0.8,0,0,0,0,0,0,0,0.0,0,1,0,1,0,0,0,0
1584,Moussa Niakhate,Lyon,9.0,23,14,20,3,0,11,14,78.6,3,8,5,3,5,28,32,2
1586,Abdoulaye Niakhate Ndiaye,Brest,3.6,7,4,5,2,0,5,6,83.3,1,5,1,4,4,11,22,0
1587,Ibrahima Niane,Angers,5.1,3,1,2,1,0,2,2,100.0,0,5,1,4,1,4,3,1
1588,Tanguy Nianzou,Sevilla,5.8,7,5,6,0,1,5,6,83.3,1,1,0,1,8,15,27,0
1589,Rasmus Nicolaisen,Toulouse,6.9,6,3,4,2,0,3,5,60.0,2,10,5,5,10,16,25,0
1590,Moritz Nicolas,Gladbach,7.0,0,0,0,0,0,0,0,0.0,0,0,0,0,0,0,4,1
1591,Hans Nicolussi Caviglia,Venezia,7.1,11,4,1,5,5,8,11,72.7,3,7,2,5,4,15,9,1
1592,Saul Niguez,Sevilla,3.6,9,6,3,3,3,1,4,25.0,3,6,1,5,2,11,4,0
1593,Eybi Nije,Torino,2.2,5,1,3,1,1,0,2,0.0,2,3,0,3,0,5,0,0
1594,Justin Njinmah,Werder Bremen,3.3,1,1,1,0,0,1,1,100.0,0,1,0,1,2,3,0,0
1595,Eddie Nketiah,Crystal Palace,5.4,8,3,3,2,3,3,7,42.9,4,5,0,5,1,9,5,0
1596,Niels Nkounkou,Eint Frankfurt,2.8,3,2,1,0,2,0,1,0.0,1,3,2,1,3,6,6,0
1597,Christopher Nkunku,Chelsea,1.8,3,3,0,1,2,2,2,100.0,0,3,1,2,1,4,3,0
1598,Felix Nmecha,Dortmund,4.7,7,5,0,4,3,2,5,40.0,3,5,1,4,7,14,9,0
1599,Lukas Nmecha,Wolfsburg,0.1,0,0,0,0,0,0,0,0.0,0,0,0,0,0,0,0,0
1600,Arnaud Nordin,Montpellier,9.0,16,9,4,11,1,9,16,56.3,7,6,0,6,2,18,6,0
1601,Brooke Norton-Cuffy,Genoa,1.1,0,0,0,0,0,0,1,0.0,1,1,0,1,1,1,0,0
1602,Tijjani Noslin,Lazio,4.7,1,1,0,0,1,0,3,0.0,3,9,0,9,0,1,7,0
1603,Hugo Novoa,Alavés,2.5,8,5,4,3,1,5,5,100.0,0,2,1,1,0,8,6,0
1604,Randy Nteka,Rayo Vallecano,3.2,4,2,0,4,0,2,3,66.7,1,3,1,2,1,5,3,0
1605,Ernest Nuamah,Lyon,2.0,4,1,2,1,1,3,4,75.0,1,0,0,0,1,5,2,0
1606,Alexander Nubel,Stuttgart,10.0,0,0,0,0,0,0,0,0.0,0,0,0,0,0,0,2,0
1607,Matheus Nunes,Manchester City,3.3,9,4,6,2,1,3,6,50.0,3,3,1,2,1,10,3,0
1608,Darwin Nunez,Liverpool,4.7,10,8,6,2,2,2,8,25.0,6,1,0,1,1,11,5,0
1609,Unai Nunez,Athletic Club,3.0,2,2,1,1,0,0,1,0.0,1,2,2,0,12,14,13,1
1610,Antonio Nusa,RB Leipzig,6.7,14,8,9,3,2,8,16,50.0,8,9,1,8,4,18,7,0
1612,Ethan Nwaneri,Arsenal,0.6,1,0,0,1,0,0,0,0.0,0,4,1,3,0,1,1,0
1613,Orjan Nyland,Sevilla,10.7,1,1,1,0,0,1,1,100.0,0,0,0,0,0,1,6,1
1614,Allan Nyom,Getafe,2.2,3,2,1,1,1,2,4,50.0,2,0,0,0,2,5,2,0
1615,Rabby Nzingoula,Montpellier,6.7,21,13,8,10,3,8,16,50.0,8,9,2,7,11,32,6,0
1616,M'Bala Nzola,Lens,4.7,2,1,0,0,2,2,2,100.0,0,3,1,2,2,4,3,0
1617,Marwann Nzuzi,Saint-Étienne,1.4,2,2,1,0,1,1,2,50.0,1,0,0,0,2,4,6,0
1618,Christian Norgaard,Brentford,8.6,22,15,10,12,0,11,16,68.8,5,18,4,14,14,36,20,1
1619,Jake O'Brien,Everton,0.3,2,2,1,1,0,2,2,100.0,0,1,0,1,0,2,0,0
1620,Matt O'Riley,Brighton,0.4,1,1,1,0,0,0,0,0.0,0,0,0,0,1,2,0,0
1621,Dara O'Shea,Ipswich Town,7.7,8,5,5,3,0,3,5,60.0,2,17,15,2,13,21,45,1
1622,Adam Obert,Cagliari,2.9,6,4,1,5,0,3,8,37.5,5,8,4,4,7,13,14,1
1623,Jan Oblak,Atlético Madrid,12.0,0,0,0,0,0,0,0,0.0,0,0,0,0,0,0,3,1
1624,Lucas Ocampos,Sevilla,1.9,3,2,2,0,1,1,2,50.0,1,2,0,2,0,3,2,0
1625,Jens Odgaard,Bologna,5.3,6,5,1,5,0,1,4,25.0,3,6,1,5,1,7,2,0
1626,Wilson Odobert,Tottenham,1.8,5,2,2,2,1,4,6,66.7,2,1,0,1,0,5,1,1
1627,Alvaro Odriozola,Real Sociedad,0.5,1,1,1,0,0,0,0,0.0,0,0,0,0,0,1,1,0
1628,Tim Oermann,Bochum,3.3,6,3,4,2,0,4,9,44.4,5,2,2,0,6,12,10,0
1629,Chiedozie Ogbene,Ipswich Town,2.6,7,3,1,2,4,2,4,50.0,2,1,0,1,1,8,3,0
1630,Ifechukwu Ogbus,Freiburg,0.2,1,1,0,0,1,0,1,0.0,1,0,0,0,1,2,2,0
1631,Hamzat Ojediran,Lens,2.2,12,8,5,7,0,3,7,42.9,4,5,1,4,4,16,3,0
1632,Noah Okafor,Milan,4.4,2,1,0,0,2,0,1,0.0,1,1,0,1,2,4,1,0
1633,Caleb Okoli,Leicester City,7.0,17,9,6,10,1,8,10,80.0,2,15,10,5,7,24,48,1
1634,Yllan Okou,Hellas Verona,0.0,0,0,0,0,0,0,0,0.0,0,1,0,1,0,0,0,0
1635,Maduka Okoye,Udinese,12.0,0,0,0,0,0,0,0,0.0,0,0,0,0,0,0,4,1
1636,Joseph Okumu,Reims,6.3,16,8,13,3,0,9,13,69.2,4,13,9,4,11,27,29,2
1638,Olasagasti,Real Sociedad,0.8,3,2,2,1,0,0,2,0.0,2,0,0,0,1,4,1,0
1639,Ben Old,Saint-Étienne,4.2,4,4,3,1,0,2,8,25.0,6,5,1,4,1,5,1,0
1640,Michael Olise,Bayern Munich,6.8,12,8,3,7,2,4,9,44.4,5,6,0,6,2,14,4,0
1641,Brian Olivan,Espanyol,3.7,6,5,4,2,0,1,5,20.0,4,3,1,2,3,9,9,0
1642,Lucas Oliveira Rosa,Valladolid,12.0,31,21,25,5,1,21,31,67.7,10,15,7,8,17,48,32,2
1643,Mathias Olivera,Napoli,9.4,30,16,18,9,3,15,21,71.4,6,14,5,9,11,41,21,0
1644,Dani Olmo,Barcelona,3.5,3,1,1,1,1,1,6,16.7,5,1,1,0,2,5,0,0
1645,Warmed Omari,Lyon,0.1,0,0,0,0,0,0,0,0.0,0,0,0,0,0,0,1,0
1646,Becir Omeragic,Montpellier,5.4,13,5,9,4,0,7,11,63.6,4,5,3,2,5,18,17,0
1647,Jonas Omlin,Gladbach,3.0,0,0,0,0,0,0,0,0.0,0,0,0,0,0,0,0,0
1648,Ado Onaiwu,Auxerre,4.0,5,4,0,5,0,2,3,66.7,1,1,0,1,1,6,6,0
1649,Amadou Onana,Aston Villa,7.8,25,15,13,10,2,8,16,50.0,8,9,5,4,16,41,16,2
1650,Andre Onana,Manchester Utd,11.0,1,1,1,0,0,1,1,100.0,0,0,0,0,0,1,4,1
1651,Karim Onisiwo,Mainz 05,1.0,0,0,0,0,0,0,0,0.0,0,0,0,0,0,0,0,0
1652,Paul Onuachu,Southampton,0.7,0,0,0,0,0,0,0,0.0,0,0,0,0,1,1,0,0
1653,Frank Onyeka,Brentford,0.3,0,0,0,0,0,0,0,0.0,0,0,0,0,0,0,0,0
1654,Frank Onyeka,Augsburg,7.7,19,15,7,8,4,7,15,46.7,8,7,2,5,11,30,6,0
1655,Lois Openda,RB Leipzig,9.2,4,3,1,3,0,1,4,25.0,3,7,0,7,1,5,1,0
1656,Christopher Operi,Le Havre,9.0,10,7,4,2,4,5,9,55.6,4,11,3,8,11,21,21,0
1657,Victor Orakpo,Nice,0.4,0,0,0,0,0,0,0,0.0,0,0,0,0,0,0,0,0
1658,Gift Orban,Lyon,2.1,0,0,0,0,0,0,1,0.0,1,0,0,0,0,0,0,0
1659,Willi Orban,RB Leipzig,7.9,19,11,10,9,0,11,14,78.6,3,16,12,4,7,26,52,1
1660,Ivan Ordets,Bochum,4.0,3,1,2,1,0,3,3,100.0,0,3,2,1,2,5,22,0
1661,Gaetano Oristanio,Venezia,9.2,7,5,3,3,1,3,7,42.9,4,10,0,10,5,12,4,0
1662,Aimar Oroz,Osasuna,11.5,15,8,7,5,3,7,18,38.9,11,15,2,13,12,27,1,0
1664,Riccardo Orsolini,Bologna,8.1,4,4,1,2,1,1,4,25.0,3,10,0,10,3,7,2,0
1665,Gabriel Osei Misehouy,Girona,2.1,0,0,0,0,0,0,0,0.0,0,0,0,0,0,0,0,0
1666,Gabriel Osho,Auxerre,8.1,8,7,8,0,0,5,9,55.6,4,19,12,7,5,13,42,0
1667,Yordan Osorio,Parma,1.9,5,3,4,1,0,2,2,100.0,0,3,1,2,4,9,6,1
1668,Patrick Osterhage,Freiburg,8.8,20,13,7,12,1,5,13,38.5,8,8,0,8,9,29,9,0
1669,William Osula,Newcastle Utd,0.1,0,0,0,0,0,0,0,0.0,0,0,0,0,0,0,0,0
1670,Jibril Othman,Saint-Étienne,0.1,0,0,0,0,0,0,0,0.0,0,0,0,0,0,0,0,0
1671,David Otorbi,Valencia,0.2,0,0,0,0,0,0,0,0.0,0,1,0,1,0,0,0,0
1672,Dango Ouattara,Bournemouth,4.6,12,12,2,5,5,7,12,58.3,5,7,1,6,3,15,13,0
1673,Guimissongui Ouattara,Strasbourg,0.2,1,1,0,0,1,0,0,0.0,0,0,0,0,0,1,0,0
1674,Kassoum Ouattara,Monaco,1.9,6,4,3,3,0,3,6,50.0,3,2,0,2,3,9,1,0
1675,Remi Oudin,Lecce,2.4,2,0,1,0,1,2,4,50.0,2,2,1,1,1,3,0,0
1676,Assan Ouedraogo,RB Leipzig,0.2,0,0,0,0,0,0,0,0.0,0,1,0,1,0,0,0,0
1677,Zinedine Ould Khaled,Angers,0.6,1,1,1,0,0,0,1,0.0,1,2,0,2,0,1,1,0
1678,Beres Owusu,Saint-Étienne,1.0,2,2,1,1,0,2,2,100.0,0,2,2,0,0,2,5,0
1679,Elisha Owusu,Auxerre,9.6,33,19,13,20,0,13,21,61.9,8,13,2,11,17,50,18,0
1680,Mikel Oyarzabal,Real Sociedad,7.8,7,3,3,3,1,4,6,66.7,2,3,0,3,0,7,3,0
1681,Salih Ozcan,Wolfsburg,3.5,2,2,1,0,1,1,5,20.0,4,5,1,4,7,9,3,0
1682,Cenk Ozkacar,Valladolid,1.2,2,2,2,0,0,2,5,40.0,3,2,1,1,3,5,7,0
1683,Jon Pacheco,Real Sociedad,3.8,3,2,2,1,0,2,3,66.7,1,5,4,1,3,6,20,1
1684,Willian Pacho,Paris S-G,9.3,21,11,14,7,0,9,13,69.2,4,17,9,8,18,39,31,0
1685,Alex Padilla,Athletic Club,3.6,0,0,0,0,0,0,0,0.0,0,0,0,0,0,0,2,1
1686,Exequiel Palacios,Leverkusen,1.0,0,0,0,0,0,0,0,0.0,0,1,0,1,0,0,0,0
1687,Tiago Palacios,Inter,0.1,0,0,0,0,0,0,0,0.0,0,0,0,0,1,1,0,0
1688,Isaac Palazon Camacho,Rayo Vallecano,7.8,8,7,3,4,1,3,10,30.0,7,7,1,6,3,11,3,0
1690,Alberto Paleari,Torino,1.0,0,0,0,0,0,0,0,0.0,0,0,0,0,0,0,2,0
1691,Marco Palestra,Atalanta,0.7,2,1,1,1,0,1,1,100.0,0,0,0,0,0,2,0,0
1692,Joao Palhinha,Bayern Munich,3.9,7,7,1,5,1,4,7,57.1,3,5,0,5,3,10,4,0
1693,Nicolas Pallois,Nantes,6.0,17,7,12,5,0,11,17,64.7,6,7,3,4,11,28,40,1
1694,Cole Palmer,Chelsea,10.6,9,6,5,4,0,3,9,33.3,6,5,1,4,3,12,6,0
1695,Emerson Palmieri,West Ham,9.5,28,16,18,8,2,13,21,61.9,8,15,3,12,10,38,21,0
1696,Mats Pannewig,Bochum,1.0,2,2,1,1,0,0,4,0.0,4,4,0,4,0,2,4,0
1697,Lucas Paqueta,West Ham,9.0,15,9,8,6,1,5,13,38.5,8,15,2,13,5,20,10,2
1698,Aitor Paredes,Athletic Club,7.4,4,3,2,2,0,3,8,37.5,5,8,6,2,6,10,44,1
1699,Leandro Paredes,Roma,1.4,2,1,0,2,0,0,1,0.0,1,2,1,1,2,4,1,1
1700,Daniel Parejo,Villarreal,9.4,15,13,9,5,1,6,18,33.3,12,7,2,5,5,20,16,1
1701,Fabiano Parisi,Fiorentina,1.7,6,4,1,3,2,1,2,50.0,1,1,0,1,1,7,3,0
1702,Thomas Partey,Arsenal,10.8,32,20,13,9,10,17,31,54.8,14,8,5,3,13,45,25,2
1703,Mario Pasalic,Atalanta,8.1,8,6,3,4,1,4,12,33.3,8,6,1,5,2,10,13,0
1704,Felix Passlack,Bochum,8.8,21,11,16,3,2,15,29,51.7,14,17,7,10,8,29,18,0
1705,Patric,Lazio,5.2,6,4,4,2,0,3,6,50.0,3,1,1,0,2,8,16,1
1706,Benjamin Pavard,Inter,8.5,16,8,7,6,3,10,14,71.4,4,7,5,2,10,26,18,0
1707,Aleksandar Pavlovic,Bayern Munich,4.6,11,6,2,6,3,5,8,62.5,3,6,1,5,0,11,6,0
1708,Strahinja Pavlovic,Milan,7.0,17,10,11,6,0,10,19,52.6,9,4,2,2,4,21,27,0
1709,Leonardo Pavoletti,Cagliari,1.2,0,0,0,0,0,0,0,0.0,0,1,1,0,0,0,1,0
1710,Martin Payero,Udinese,6.4,8,5,1,3,4,5,9,55.6,4,8,1,7,5,13,5,0
1711,Nicolas Paz,Como,8.9,14,10,6,5,3,8,14,57.1,6,15,2,13,10,24,5,0
1712,Mads Pedersen,Augsburg,1.8,5,4,3,1,1,3,3,100.0,0,3,0,3,1,6,5,0
1713,Marcus Pedersen,Torino,4.5,5,3,2,2,1,4,6,66.7,2,4,2,2,0,5,7,0
1714,Pedri,Barcelona,10.3,18,10,5,12,1,7,22,31.8,15,16,2,14,8,26,8,1
1716,Pedro,Lazio,2.9,5,4,0,3,2,1,3,33.3,2,2,0,2,0,5,1,0
1717,Kevin Pedro,Saint-Étienne,0.1,3,0,2,1,0,3,3,100.0,0,1,0,1,2,5,1,0
1718,Adria Pedrosa,Sevilla,9.6,28,18,21,3,4,17,29,58.6,12,18,3,15,9,37,31,0
1719,Jordan Pefok,Union Berlin,5.3,5,4,4,0,1,0,2,0.0,2,4,1,3,3,8,6,0
1720,Pejino,Las Palmas,0.2,1,1,0,1,0,1,1,100.0,0,0,0,0,0,1,0,0
1721,Pietro Pellegri,Empoli,2.9,6,1,0,5,1,2,4,50.0,2,1,0,1,0,6,3,0
1722,Lorenzo Pellegrini,Roma,9.1,10,6,2,5,3,3,8,37.5,5,1,0,1,0,10,9,0
1723,Luca Pellegrini,Lazio,1.9,4,3,1,3,0,2,2,100.0,0,4,0,4,1,5,6,0
1724,Theo Pellenard,Auxerre,0.5,3,2,2,1,0,1,3,33.3,2,1,0,1,0,3,3,0
1725,Andy Pelmard,Lecce,1.4,6,6,5,1,0,4,4,100.0,0,1,0,1,0,6,5,0
1726,Timothee Pembele,Le Havre,2.5,3,2,2,0,1,1,3,33.3,2,3,2,1,0,3,9,0
1727,Faris Pemi Moumbagna,Marseille,0.1,0,0,0,0,0,0,0,0.0,0,0,0,0,0,0,0,0
1728,Inaki Pena,Barcelona,7.5,0,0,0,0,0,0,2,0.0,2,0,0,0,0,0,11,1
1729,Ruben Pena,Osasuna,4.3,6,0,1,1,4,1,10,10.0,9,7,0,7,3,9,6,0
1730,Nicolas Pepe,Villarreal,6.3,4,1,1,1,2,0,3,0.0,3,3,1,2,3,7,3,0
1731,Peque,Sevilla,5.6,6,2,1,5,0,2,8,25.0,6,7,0,7,4,10,1,0
1732,Andreas Pereira,Fulham,9.3,7,2,2,3,2,2,14,14.3,12,5,1,4,3,10,2,0
1733,Mathias Pereira Lage,Brest,3.8,8,5,3,3,2,2,3,66.7,1,4,0,4,4,12,6,0
1734,Pedro Pereira,Monza,8.8,13,6,7,6,0,6,15,40.0,9,8,3,5,6,19,22,2
1735,Ricardo Pereira,Leicester City,1.6,3,2,0,1,2,1,4,25.0,3,3,1,2,1,4,0,0
1736,Gaston Pereiro,Genoa,0.3,1,0,0,1,0,1,1,100.0,0,0,0,0,0,1,1,0
1737,Ayoze Perez,Villarreal,5.7,6,4,2,3,1,2,7,28.6,5,5,0,5,2,8,5,0
1738,Carles Perez,Getafe,9.9,21,15,5,10,6,15,29,51.7,14,12,1,11,4,25,12,0
1739,Francisco Perez,Valencia,0.4,1,1,0,1,0,0,1,0.0,1,1,0,1,0,1,1,0
1740,Kike Perez,Valladolid,7.3,24,16,9,13,2,11,19,57.9,8,9,3,6,5,29,6,0
1742,Luis Perez,Valladolid,12.6,21,14,12,4,5,14,22,63.6,8,17,4,13,15,36,36,0
1743,Nehuen Perez,Udinese,2.0,1,1,0,0,1,0,1,0.0,1,2,2,0,1,2,7,0
1744,Simone Perilli,Hellas Verona,1.0,0,0,0,0,0,0,0,0.0,0,0,0,0,0,0,1,0
1745,Mattia Perin,Juventus,3.0,0,0,0,0,0,0,0,0.0,0,0,0,0,0,0,0,0
1746,Romain Perraud,Betis,9.3,17,8,6,7,4,11,25,44.0,14,7,1,6,11,28,26,0
1747,Lucas Perri,Lyon,11.0,0,0,0,0,0,0,2,0.0,2,1,0,1,0,0,6,1
1748,Gaetan Perrin,Auxerre,7.6,25,11,12,6,7,13,22,59.1,9,4,0,4,4,29,1,0
1749,Maximo Perrone,Como,7.3,14,9,8,5,1,4,19,21.1,15,4,0,4,6,20,16,0
1750,Matteo Pessina,Monza,9.5,15,4,3,11,1,9,14,64.3,5,6,0,6,12,27,7,0
1751,Andrea Petagna,Monza,2.0,0,0,0,0,0,0,0,0.0,0,0,0,0,1,1,1,0
1752,Leo Petrot,Saint-Étienne,6.7,23,15,14,8,1,12,14,85.7,2,11,4,7,14,37,22,0
1753,Dorde Petrovic,Strasbourg,8.0,0,0,0,0,0,0,0,0.0,0,0,0,0,0,0,6,0
1754,Giuseppe Pezzella,Empoli,9.3,19,13,14,5,0,15,25,60.0,10,8,4,4,4,23,27,0
1755,Kalvin Phillips,Ipswich Town,6.0,14,6,4,9,1,8,18,44.4,10,16,3,13,7,21,11,1
1756,Jaden Philogene Bidace,Aston Villa,2.2,6,4,2,4,0,3,4,75.0,1,1,0,1,0,6,2,0
1757,Pica,Alavés,4.5,7,6,6,1,0,3,8,37.5,5,6,5,1,7,14,19,0
1758,Roberto Piccoli,Cagliari,11.0,2,0,1,0,1,1,2,50.0,1,3,2,1,1,3,9,0
1759,Benedikt Pichler,Holstein Kiel,6.7,3,2,1,0,2,1,3,33.3,2,4,2,2,1,4,8,0
1760,Jordan Pickford,Everton,11.0,0,0,0,0,0,0,0,0.0,0,0,0,0,1,1,12,1
1761,Amos Pieper,Werder Bremen,3.4,7,2,5,1,1,3,6,50.0,3,7,3,4,9,16,14,0
1762,Marvin Pieringer,Heidenheim,8.4,7,2,3,3,1,2,4,50.0,2,9,0,9,3,10,12,0
1763,Nicholas Pierini,Venezia,0.9,0,0,0,0,0,0,1,0.0,1,2,0,2,0,0,0,0
1764,Santiago Pierotti,Lecce,4.8,12,9,7,4,1,8,13,61.5,5,6,2,4,5,17,5,0
1765,Balthazar Pierret,Lecce,5.8,16,8,10,6,0,3,8,37.5,5,6,1,5,3,19,7,0
1766,Andrea Pinamonti,Genoa,9.9,5,3,0,4,1,0,2,0.0,2,5,1,4,1,6,11,1
1768,Ethan Pinnock,Brentford,11.0,24,13,12,9,3,9,12,75.0,3,16,10,6,15,39,66,2
1769,Yeremi Pino,Villarreal,4.4,11,7,3,6,2,7,13,53.8,6,7,1,6,2,13,4,0
1770,Niccolo Pisilli,Roma,5.5,9,7,5,3,1,4,5,80.0,1,7,1,6,4,13,3,0
1771,Semuel Pizzignacco,Monza,3.0,0,0,0,0,0,0,0,0.0,0,0,0,0,0,0,1,0
1772,Alassane Plea,Gladbach,7.0,3,1,0,1,2,2,4,50.0,2,3,0,3,2,5,1,1
1773,Tommaso Pobega,Bologna,2.3,5,3,3,0,2,2,4,50.0,2,5,2,3,3,8,1,0
1774,Daniel Podence,Wolves,0.5,0,0,0,0,0,0,1,0.0,1,0,0,0,0,0,0,0
1775,Joel Pohjanpalo,Venezia,9.1,2,2,1,1,0,0,1,0.0,1,2,2,0,3,5,11,0
1776,Matteo Politano,Napoli,9.9,8,4,5,3,0,6,15,40.0,9,5,1,4,4,12,17,0
1777,Marin Pongracic,Fiorentina,1.0,1,1,1,0,0,1,3,33.3,2,0,0,0,2,3,4,0
1778,Nick Pope,Newcastle Utd,11.0,0,0,0,0,0,0,0,0.0,0,1,0,1,1,1,11,3
1779,Finn Porath,Holstein Kiel,7.2,18,11,12,4,2,11,17,64.7,6,10,4,6,9,27,17,0
1780,Pedro Porro,Tottenham,11.0,25,17,11,8,6,17,26,65.4,9,15,5,10,15,40,23,0
1781,Portu,Girona,1.8,3,2,1,1,1,2,2,100.0,0,3,0,3,0,3,1,0
1782,Stefan Posch,Bologna,6.9,22,14,11,7,4,13,22,59.1,9,18,4,14,4,26,18,0
1783,Tom Pouilly,Lens,0.5,2,2,1,1,0,1,1,100.0,0,1,0,1,1,3,3,0
1784,Yussuf Poulsen,RB Leipzig,2.2,5,3,1,4,0,3,6,50.0,3,4,2,2,0,5,4,0
1785,Benat Prados,Athletic Club,6.5,12,10,4,7,1,4,14,28.6,10,11,1,10,14,26,11,0
1786,Alexander Prass,Hoffenheim,7.4,13,8,10,1,2,7,22,31.8,15,11,3,8,2,15,14,2
1787,Matteo Prati,Cagliari,2.6,5,2,1,3,1,2,6,33.3,4,0,0,0,2,7,3,1
1788,Abdon Prats,Mallorca,2.0,1,1,1,0,0,0,0,0.0,0,1,0,1,0,1,2,0
1789,Grischa Promel,Hoffenheim,1.9,0,0,0,0,0,0,1,0.0,1,1,1,0,2,2,4,0
1790,Ivan Provedel,Lazio,12.0,0,0,0,0,0,0,0,0.0,0,1,0,1,0,0,6,3
1791,Javi Puado,Espanyol,9.2,7,6,3,2,2,1,1,100.0,0,5,0,5,3,10,8,0
1792,Tymoteusz Puchacz,Holstein Kiel,3.8,7,4,5,2,0,4,6,66.7,2,4,1,3,1,8,10,0
1794,Christian Pulisic,Milan,9.3,16,9,5,6,5,6,13,46.2,7,5,1,4,0,16,5,1
1795,Jarell Quansah,Liverpool,0.5,2,2,1,1,0,0,0,0.0,0,1,1,0,1,3,3,0
1796,Leopold Querfeld,Union Berlin,2.4,3,1,3,0,0,2,5,40.0,3,3,1,2,4,7,15,0
1797,Dani Raba,Leganés,3.1,8,4,3,4,1,4,9,44.4,5,3,0,3,5,13,3,0
1798,Adrien Rabiot,Marseille,4.6,9,6,5,3,1,4,7,57.1,3,5,0,5,4,13,4,0
1799,Hamza Rafia,Lecce,5.8,19,12,9,9,1,5,14,35.7,9,4,2,2,4,23,7,0
1800,Antonio Raillo,Mallorca,13.0,12,7,5,4,3,4,5,80.0,1,17,15,2,18,30,65,0
1801,Antonio Raimondo,Venezia,0.9,2,1,1,1,0,0,0,0.0,0,0,0,0,0,2,0,1
1802,Ylber Ramadani,Lecce,11.0,27,15,13,14,0,16,20,80.0,4,18,6,12,8,35,17,3
1803,Benito Ramirez,Las Palmas,2.7,3,2,2,1,0,3,9,33.3,6,6,3,3,1,4,11,0
1804,Sandro Ramirez,Las Palmas,6.2,13,10,4,8,1,8,14,57.1,6,3,0,3,8,21,8,0
1805,Goncalo Ramos,Paris S-G,0.2,0,0,0,0,0,0,0,0.0,0,0,0,0,0,0,0,0
1806,Aaron Ramsdale,Southampton,9.0,0,0,0,0,0,0,1,0.0,1,0,0,0,2,2,6,2
1807,Jacob Ramsey,Aston Villa,7.0,7,3,3,3,1,3,5,60.0,2,8,2,6,5,12,2,0
1808,Luca Ranieri,Fiorentina,10.4,9,5,8,0,1,4,7,57.1,3,17,13,4,6,15,38,0
1809,Grant Ranos,Gladbach,0.1,1,0,0,1,0,0,1,0.0,1,1,0,1,0,1,0,0
1810,Lilian Raolisoa,Angers,1.4,4,2,2,1,1,1,4,25.0,3,1,1,0,2,6,3,0
1811,Raphinha,Barcelona,12.0,18,11,6,9,3,6,12,50.0,6,7,0,7,3,21,13,0
1812,Marcus Rashford,Manchester Utd,8.4,5,3,1,1,3,3,8,37.5,5,8,0,8,3,8,5,0
1813,Giacomo Raspadori,Napoli,2.7,3,1,2,1,0,2,4,50.0,2,5,1,4,2,5,0,0
1814,Andrei Ratiu,Rayo Vallecano,9.9,20,13,13,2,5,14,17,82.4,3,9,2,7,7,27,21,0
1815,Raul,Osasuna,3.4,2,2,0,1,1,0,1,0.0,1,2,0,2,0,2,2,0
1816,David Raum,RB Leipzig,5.4,11,8,5,4,2,2,6,33.3,4,5,1,4,2,13,10,0
1817,Federico Ravaglia,Bologna,4.0,0,0,0,0,0,0,0,0.0,0,0,0,0,0,0,1,0
1818,Rayan Raveloson,Auxerre,7.0,5,4,2,3,0,4,14,28.6,10,8,7,1,4,9,21,0
1820,David Raya,Arsenal,11.0,0,0,0,0,0,0,0,0.0,0,0,0,0,1,1,7,3
1821,Abderrahman Rebbach,Alavés,4.0,3,2,3,0,0,0,5,0.0,5,4,0,4,0,3,5,0
1822,Ante Rebic,Lecce,3.8,5,4,3,1,1,2,6,33.3,4,1,1,0,0,5,3,0
1823,Harrison Reed,Fulham,0.7,5,2,2,2,1,0,2,0.0,2,1,0,1,1,6,2,0
1824,Bobby Reid,Leicester City,1.8,1,1,0,1,0,0,3,0.0,3,4,1,3,0,1,3,0
1825,Tijjani Reijnders,Milan,8.1,2,1,0,2,0,1,9,11.1,8,0,0,0,7,9,6,0
1826,Pepe Reina,Como,5.0,0,0,0,0,0,0,1,0.0,1,0,0,0,0,0,1,1
1827,Rocco Reitz,Gladbach,6.2,22,12,10,11,1,10,15,66.7,5,8,3,5,27,49,14,1
1828,Nicolai Remberg,Holstein Kiel,5.2,13,9,5,7,1,5,10,50.0,5,10,1,9,4,17,13,0
1829,Alex Remiro,Real Sociedad,13.0,0,0,0,0,0,0,1,0.0,1,0,0,0,0,0,6,3
1830,Guillaume Restes,Toulouse,11.0,0,0,0,0,0,0,0,0.0,0,0,0,0,0,0,5,0
1831,Mateo Retegui,Atalanta,8.6,6,4,0,2,4,2,6,33.3,4,1,0,1,1,7,5,0
1832,Elvis Rexhbecaj,Augsburg,8.3,11,9,3,6,2,7,20,35.0,13,18,2,16,7,18,9,0
1833,Gio Reyna,Dortmund,0.1,1,0,0,0,1,1,1,100.0,0,0,0,0,0,1,0,0
1834,Chadi Riad,Crystal Palace,1.0,5,2,2,2,1,2,3,66.7,1,0,0,0,2,7,0,0
1835,Alexsandro Ribeiro,Lille,9.0,11,9,5,5,1,9,13,69.2,4,5,2,3,12,23,42,1
1836,Samuele Ricci,Torino,11.1,12,7,3,6,3,7,10,70.0,3,8,4,4,8,20,15,2
1837,Declan Rice,Arsenal,9.2,14,5,3,9,2,6,11,54.5,5,10,7,3,9,23,14,0
1838,Chris Richards,Crystal Palace,3.8,10,5,5,4,1,6,11,54.5,5,7,1,6,3,13,17,0
1839,Amir Richardson,Fiorentina,3.7,11,4,7,4,0,2,6,33.3,4,3,0,3,1,12,11,1
1840,Richarlison,Tottenham,1.0,1,1,0,0,1,0,0,0.0,0,0,0,0,0,1,2,0
1841,Diego Rico,Getafe,12.0,34,15,20,11,3,18,33,54.5,15,9,0,9,11,45,21,1
1842,Fabian Rieder,Stuttgart,5.7,10,9,3,4,3,6,18,33.3,12,6,0,6,6,16,1,0
1843,Luis Rioja,Alavés,0.3,2,1,0,1,1,1,2,50.0,1,2,0,2,0,2,0,0
1844,Luis Rioja,Valencia,8.7,10,7,1,5,4,4,12,33.3,8,9,0,9,11,21,10,0
1846,Rodrigo Riquelme,Atlético Madrid,4.3,8,3,3,5,0,4,9,44.4,5,1,0,1,1,9,3,0
1847,Alberto Risco,Getafe,0.8,4,4,2,0,2,1,6,16.7,5,2,0,2,0,4,0,0
1848,Mihailo Ristic,Celta Vigo,1.2,2,2,1,1,0,0,1,0.0,1,0,0,0,0,2,4,0
1849,Lars Ritzka,St. Pauli,3.8,25,15,14,8,3,14,23,60.9,9,8,0,8,2,27,13,0
1850,Gorka Rivera Alonso,Getafe,0.2,2,0,0,2,0,2,2,100.0,0,0,0,0,0,2,0,0
1851,Sergi Roberto,Como,5.9,10,6,3,3,4,4,5,80.0,1,4,1,3,9,19,8,0
1852,Andrew Robertson,Liverpool,8.4,10,7,7,2,1,8,14,57.1,6,2,1,1,5,15,11,0
1853,Antonee Robinson,Fulham,11.0,33,22,18,14,1,17,30,56.7,13,9,1,8,20,53,39,0
1854,Marc Roca,Betis,8.1,14,8,8,6,0,8,15,53.3,7,16,5,11,8,22,9,1
1855,Rodri,Manchester City,0.7,2,1,1,1,0,0,0,0.0,0,1,0,1,1,3,0,0
1856,Rodri,Betis,1.3,2,1,1,1,0,1,2,50.0,1,2,1,1,1,3,1,1
1857,Alvaro Rodriguez,Getafe,2.2,1,0,0,1,0,1,1,100.0,0,7,0,7,1,2,2,0
1858,Oscar Rodriguez Arnaiz,Leganés,3.8,7,2,3,3,1,3,7,42.9,4,1,0,1,3,10,1,0
1859,Damian Rodriguez,Celta Vigo,6.2,8,5,2,5,1,2,7,28.6,5,4,1,3,4,12,8,0
1860,Dani Rodriguez,Mallorca,7.6,17,13,7,6,4,6,7,85.7,1,3,0,3,3,20,9,0
1861,Guido Rodriguez,West Ham,8.9,25,13,16,9,0,11,26,42.3,15,15,7,8,10,35,22,1
1862,James Rodriguez,Rayo Vallecano,1.6,3,2,1,2,0,0,2,0.0,2,2,0,2,1,4,0,0
1863,Javi Rodriguez,Celta Vigo,7.7,10,6,9,1,0,7,11,63.6,4,6,1,5,5,15,23,0
1864,Kirian Rodriguez,Las Palmas,11.2,16,9,6,9,1,10,26,38.5,16,14,2,12,4,20,10,0
1865,Ricardo Rodriguez,Betis,3.7,9,7,6,1,2,5,9,55.6,4,2,0,2,3,12,12,0
1866,Rodrygo,Real Madrid,7.4,6,4,4,2,0,3,9,33.3,6,9,1,8,0,6,3,0
1867,Mads Roerslev,Brentford,5.0,5,3,4,1,0,1,8,12.5,7,5,1,4,2,7,14,0
1868,Morgan Rogers,Aston Villa,10.0,8,3,2,4,2,3,9,33.3,6,9,2,7,3,11,6,0
1869,Merlin Rohl,Freiburg,1.8,3,3,1,2,0,1,1,100.0,0,1,0,1,1,4,0,0
1870,Alessio Romagnoli,Lazio,8.3,14,10,6,8,0,6,8,75.0,2,5,4,1,9,23,25,0
1872,Leo Roman,Mallorca,4.0,0,0,0,0,0,0,0,0.0,0,0,0,0,0,0,0,0
1873,Carlos Romero,Espanyol,9.6,27,18,19,7,1,16,26,61.5,10,9,1,8,6,33,23,0
1874,Cristian Romero,Tottenham,10.7,25,22,20,5,0,14,20,70.0,6,13,3,10,13,38,32,0
1875,Isaac Romero,Sevilla,8.9,3,1,0,2,1,0,6,0.0,6,7,1,6,1,4,10,0
1876,Luka Romero,Alavés,2.1,4,4,1,1,2,2,3,66.7,1,1,0,1,1,5,0,0
1877,Oriol Romeu,Girona,4.7,14,9,5,9,0,6,8,75.0,2,8,3,5,2,16,7,0
1878,Valentin Rongier,Marseille,2.0,7,4,4,3,0,2,6,33.3,4,5,2,3,2,9,7,0
1879,Marten de Roon,Atalanta,12.0,33,19,13,19,1,15,25,60.0,10,20,2,18,15,48,22,1
1880,Vitor Roque,Betis,6.7,2,2,0,1,1,0,1,0.0,1,1,0,1,3,5,1,0
1881,Pablo Rosario,Nice,8.8,8,6,2,6,0,4,9,44.4,5,10,5,5,17,25,18,2
1882,Lasse Rosenboom,Holstein Kiel,2.2,4,3,4,0,0,2,4,50.0,2,5,1,4,4,8,8,0
1883,Max Rosenfelder,Freiburg,4.9,11,6,7,4,0,7,8,87.5,1,6,2,4,3,14,31,0
1884,Valentin Rosier,Leganés,9.5,32,26,23,8,1,20,32,62.5,12,12,1,11,14,46,48,1
1885,Tom Rothe,Union Berlin,5.9,19,10,14,5,0,11,19,57.9,8,13,3,10,5,24,14,1
1886,Anthony Rouault,Stuttgart,5.9,6,5,4,1,1,5,6,83.3,1,8,4,4,8,14,24,1
1887,Jonas Rouhi,Juventus,1.0,0,0,0,0,0,0,0,0.0,0,1,0,1,1,1,2,0
1888,Jerome Roussillon,Union Berlin,0.1,0,0,0,0,0,0,0,0.0,0,0,0,0,0,0,1,0
1889,Nicolo Rovella,Lazio,8.9,33,22,10,19,4,12,20,60.0,8,6,2,4,12,45,13,1
1890,Jon Rowe,Marseille,4.1,6,6,0,2,4,4,6,66.7,2,1,1,0,1,7,0,0
1891,Amir Rrahmani,Napoli,12.0,7,5,4,3,0,3,7,42.9,4,11,7,4,4,11,48,0
1892,Tommaso Rubino,Fiorentina,0.1,0,0,0,0,0,0,1,0.0,1,0,0,0,0,0,0,0
1893,Antonio Rudiger,Real Madrid,11.1,8,4,5,3,0,5,7,71.4,2,13,9,4,4,12,40,0
1894,Matteo Ruggeri,Atalanta,8.8,13,9,5,6,2,7,8,87.5,1,11,1,10,8,21,14,1
1895,Aitor Ruibal,Betis,5.6,11,7,6,2,3,7,11,63.6,4,8,2,6,6,17,9,0
1896,Abel Ruiz,Girona,7.3,2,0,1,0,1,2,5,40.0,3,4,1,3,2,4,3,0
1898,Ferran Ruiz,Girona,0.2,0,0,0,0,0,0,0,0.0,0,2,1,1,1,1,0,0
1899,Fabian Ruiz Pena,Paris S-G,5.7,16,9,8,5,3,8,21,38.1,13,5,0,5,7,23,7,1
1900,Geronimo Rulli,Marseille,11.0,0,0,0,0,0,0,3,0.0,3,0,0,0,0,0,8,1
1901,Georginio Rutter,Brighton,6.7,11,3,6,4,1,4,13,30.8,9,7,0,7,4,15,7,1
1902,Julian Ryerson,Dortmund,7.8,13,8,10,2,1,12,16,75.0,4,8,1,7,10,23,6,1
1903,Frederik Ronnow,Union Berlin,10.0,0,0,0,0,0,0,0,0.0,0,0,0,0,0,0,5,0
1904,Jose Sa,Wolves,6.0,0,0,0,0,0,0,0,0.0,0,0,0,0,0,0,3,1
1905,Elias Saad,St. Pauli,3.8,12,7,4,5,3,6,11,54.5,5,6,0,6,1,13,1,0
1906,Youssouf Sabaly,Betis,5.2,11,7,6,4,1,7,9,77.8,2,5,0,5,5,16,17,0
1907,Emmanuel Sabbi,Le Havre,3.3,6,4,3,1,2,2,3,66.7,1,2,0,2,2,8,2,0
1908,Stefano Sabelli,Genoa,6.7,16,9,8,5,3,5,18,27.8,13,10,1,9,5,21,17,0
1909,Marcel Sabitzer,Dortmund,6.6,10,5,0,8,2,5,10,50.0,5,7,4,3,2,12,8,0
1910,Falaye Sacko,Montpellier,9.4,13,7,9,3,1,8,15,53.3,7,14,5,9,11,24,9,0
1911,Umar Sadiq,Real Sociedad,2.3,2,1,1,1,0,1,2,50.0,1,2,1,1,1,3,2,0
1912,Alexis Saelemaekers,Roma,1.2,4,2,3,1,0,2,2,100.0,0,1,0,1,0,4,1,0
1913,Alexis Saelemaekers,Milan,1.0,1,1,0,0,1,1,1,100.0,0,0,0,0,1,2,0,0
1914,Jorge Saenz,Leganés,5.8,14,11,6,7,1,4,6,66.7,2,5,3,2,9,23,37,0
1915,Matvei Safonov,Paris S-G,3.0,0,0,0,0,0,0,0,0.0,0,0,0,0,0,0,0,0
1916,Modibo Sagnan,Montpellier,9.7,20,9,11,7,2,11,19,57.9,8,9,5,4,15,35,40,2
1917,Richie Sagrado,Venezia,1.3,2,2,1,1,0,1,1,100.0,0,1,0,1,1,3,2,0
1918,Osame Sahraoui,Lille,7.1,4,3,2,1,1,1,4,25.0,3,9,1,8,4,8,5,1
1919,Wesley Said,Lens,3.9,3,2,1,2,0,1,2,50.0,1,0,0,0,0,3,1,0
1920,Bukayo Saka,Arsenal,9.1,16,10,5,5,6,7,15,46.7,8,12,0,12,2,18,6,0
1921,Marco Sala,Como,1.4,7,4,5,1,1,3,3,100.0,0,1,0,1,1,8,6,0
1922,Ibrahim Salah,Brest,3.4,2,1,1,0,1,1,4,25.0,3,2,0,2,1,3,0,0
1924,Mohamed Salah,Liverpool,10.7,7,5,2,3,2,2,3,66.7,1,1,0,1,2,9,4,0
1925,Amine Salama,Reims,2.3,2,2,0,1,1,0,2,0.0,2,2,1,1,0,2,0,0
1926,Kike Salas,Sevilla,4.2,5,5,2,1,2,2,4,50.0,2,7,3,4,7,12,17,0
1927,Manolis Saliakas,St. Pauli,7.1,16,6,7,7,2,8,15,53.3,7,13,1,12,8,24,22,0
1928,William Saliba,Arsenal,9.3,26,17,18,8,0,12,13,92.3,1,7,2,5,7,33,29,1
1929,Mohammed Salisu,Monaco,4.1,14,7,9,5,0,7,7,100.0,0,5,4,1,2,16,15,1
1930,Roland Sallai,Freiburg,0.5,2,1,1,1,0,0,0,0.0,0,0,0,0,1,3,0,0
1931,Yoann Salmier,Le Havre,6.6,6,2,4,2,0,5,6,83.3,1,8,6,2,4,10,43,0
1932,Lazar Samardzic,Atalanta,4.5,3,3,0,1,2,2,3,66.7,1,4,1,3,0,3,1,0
1933,Diadie Samassekou,Hoffenheim,0.1,0,0,0,0,0,0,0,0.0,0,1,0,1,1,1,0,0
1934,Mama Samba Balde,Lyon,0.4,2,2,0,2,0,0,0,0.0,0,0,0,0,1,3,1,0
1935,Mama Samba Balde,Brest,4.7,5,4,1,1,3,2,4,50.0,2,2,0,2,2,7,5,0
1936,Brice Samba,Lens,11.0,0,0,0,0,0,0,0,0.0,0,0,0,0,0,0,3,1
1937,Albert Sambi Lokonga,Sevilla,5.3,7,6,5,2,0,3,4,75.0,1,4,1,3,1,8,11,1
1938,Junior Sambia,Empoli,0.3,1,1,1,0,0,1,1,100.0,0,0,0,0,0,1,0,0
1939,Chuky san jose,Valladolid,1.0,1,0,0,0,1,1,1,100.0,0,2,0,2,0,1,0,0
1940,Antonio Sanabria,Torino,6.8,2,2,1,0,1,1,3,33.3,2,3,0,3,0,2,3,0
1941,Oihan Sancet,Athletic Club,7.3,5,2,3,1,1,3,8,37.5,5,4,0,4,2,7,3,0
1942,Antonio Sanchez,Mallorca,5.7,13,8,10,2,1,8,12,66.7,4,8,2,6,7,20,17,0
1943,Ivan Sanchez,Valladolid,4.8,12,7,8,2,2,5,14,35.7,9,6,2,4,6,18,3,0
1944,Javi Sanchez,Valladolid,6.5,6,4,5,1,0,5,7,71.4,2,12,9,3,6,12,33,1
1945,Juanlu Sanchez,Sevilla,5.1,7,6,3,2,2,5,6,83.3,1,0,0,0,6,13,6,0
1946,Manu Sanchez,Alavés,10.5,19,14,7,7,5,10,17,58.8,7,18,2,16,10,29,21,0
1947,Robert Sanchez,Chelsea,11.0,0,0,0,0,0,0,1,0.0,1,0,0,0,0,0,10,3
1948,Jadon Sancho,Chelsea,3.4,1,1,1,0,0,1,3,33.3,2,0,0,0,0,1,0,0
1950,Philipp Sander,Gladbach,3.9,13,7,6,6,1,6,9,66.7,3,7,1,6,5,18,11,0
1951,Leroy Sane,Bayern Munich,2.1,4,1,0,2,2,1,1,100.0,0,1,0,1,1,5,0,0
1952,Arouna Sangante,Le Havre,5.8,9,7,4,5,0,5,8,62.5,3,7,4,3,14,23,21,1
1953,Ibrahim Sangare,Nott'ham Forest,2.4,15,9,5,10,0,4,8,50.0,4,4,0,4,2,17,2,0
1954,Nhoa Sangui,Reims,5.5,6,4,0,3,3,3,6,50.0,3,5,2,3,2,8,12,0
1955,Kaishu Sano,Mainz 05,9.8,21,16,8,12,1,6,15,40.0,9,22,4,18,17,38,11,0
1956,Nicola Sansone,Lecce,0.6,0,0,0,0,0,0,0,0.0,0,0,0,0,0,0,0,0
1957,Baptiste Santamaria,Rennes,5.3,11,4,7,3,1,6,11,54.5,5,10,4,6,12,23,7,0
1958,Jesus Santiago,Getafe,2.4,6,3,4,2,0,2,4,50.0,2,4,1,3,0,6,2,0
1959,Andrey Santos,Strasbourg,9.7,37,24,21,14,2,19,33,57.6,14,13,3,10,10,47,12,0
1960,Kaua Santos,Eint Frankfurt,3.5,0,0,0,0,0,0,0,0.0,0,0,0,0,0,0,2,0
1961,Tiago Santos,Lille,4.5,12,7,4,5,3,6,9,66.7,3,2,0,2,2,14,4,0
1962,Pablo Sarabia,Wolves,2.0,5,3,2,2,1,3,5,60.0,2,3,0,3,2,7,2,1
1963,Jeremy Sarmiento,Brighton,0.1,0,0,0,0,0,0,0,0.0,0,0,0,0,0,0,0,0
1964,Amin Sarr,Hellas Verona,2.0,4,2,2,1,1,1,1,100.0,0,1,1,0,0,4,4,0
1965,Ismaila Sarr,Crystal Palace,5.4,2,1,0,1,1,0,6,0.0,6,6,0,6,3,5,4,0
1966,Malang Sarr,Lens,1.5,0,0,0,0,0,0,0,0.0,0,2,1,1,4,4,1,0
1967,Mamadou Sarr,Strasbourg,4.5,10,5,4,6,0,5,10,50.0,5,4,3,1,6,16,14,0
1968,Martin Satriano,Lens,0.5,3,1,1,1,1,3,3,100.0,0,0,0,0,0,3,2,0
1969,Teji Savanier,Montpellier,8.4,12,11,4,5,3,10,21,47.6,11,3,0,3,5,17,6,2
1970,Savio,Manchester City,5.8,13,9,3,5,5,3,6,50.0,3,4,0,4,1,14,1,1
1971,Nicolo Savona,Juventus,7.4,14,7,7,6,1,6,9,66.7,3,2,0,2,5,19,3,0
1972,Saba Sazonov,Torino,0.0,0,0,0,0,0,0,0,0.0,0,1,1,0,0,0,0,0
1973,Joe Scally,Gladbach,9.8,18,13,12,6,0,11,19,57.9,8,11,4,7,5,23,19,1
1974,Kevin Schade,Brentford,5.4,12,10,3,4,5,6,7,85.7,1,2,1,1,0,12,4,0
1976,Andras Schafer,Union Berlin,5.0,15,8,7,7,1,11,17,64.7,6,8,1,7,7,22,10,0
1977,Fabian Schar,Newcastle Utd,8.3,9,5,2,7,0,2,7,28.6,5,7,4,3,10,19,31,0
1978,Patrik Schick,Leverkusen,2.4,2,2,0,1,1,0,0,0.0,0,1,0,1,0,2,2,0
1979,Stefan Schimmer,Heidenheim,0.9,1,0,0,1,0,1,1,100.0,0,0,0,0,0,1,0,0
1980,Joel Schingtienne,Venezia,1.0,4,4,3,1,0,1,1,100.0,0,1,0,1,1,5,1,0
1981,Keven Schlotterbeck,Augsburg,8.4,10,9,4,6,0,6,6,100.0,0,8,4,4,9,19,35,1
1982,Nico Schlotterbeck,Dortmund,8.8,23,16,14,8,1,19,27,70.4,8,16,7,9,11,34,25,0
1983,Jeffrey Schlupp,Crystal Palace,0.8,2,0,1,0,1,0,1,0.0,1,3,0,3,0,2,2,0
1984,Romano Schmid,Werder Bremen,9.8,15,5,4,8,3,8,20,40.0,12,11,0,11,7,22,5,0
1985,Niklas Schmidt,Toulouse,1.7,4,3,1,3,0,2,4,50.0,2,0,0,0,0,4,2,0
1986,Jan Schoppner,Heidenheim,9.2,18,8,5,9,4,10,25,40.0,15,11,2,9,16,34,32,0
1987,Marvin Schulz,Holstein Kiel,1.4,2,2,2,0,0,1,4,25.0,3,4,1,3,0,2,6,0
1988,Leo Scienza,Heidenheim,6.6,11,7,7,3,1,3,7,42.9,4,5,1,4,3,14,7,0
1989,Alex Scott,Bournemouth,2.9,16,7,8,4,4,12,16,75.0,4,9,1,8,6,22,5,0
1990,Simone Scuffet,Cagliari,11.0,0,0,0,0,0,0,1,0.0,1,0,0,0,0,0,7,2
1991,Jeremy Sebas,Strasbourg,0.2,2,1,1,1,0,2,3,66.7,1,0,0,0,0,2,0,0
1992,Aleksandar Sedlar,Alavés,4.5,15,9,5,10,0,7,9,77.8,2,2,1,1,7,22,7,1
1993,Alidu Seidu,Rennes,8.7,21,17,13,6,2,11,14,78.6,3,13,6,7,13,34,16,0
1994,Nicolas Seiwald,RB Leipzig,3.8,12,8,3,9,0,6,11,54.5,5,4,1,3,9,21,9,0
1995,Matz Sels,Nott'ham Forest,11.0,1,1,1,0,0,1,1,100.0,0,0,0,0,0,1,6,0
1996,Nelson Semedo,Wolves,8.7,19,10,13,3,3,8,19,42.1,11,9,3,6,4,23,48,1
1997,Antoine Semenyo,Bournemouth,10.7,17,11,5,8,4,5,15,33.3,10,16,3,13,3,20,8,0
1998,Marvin Senaya,Strasbourg,1.7,6,3,3,2,1,5,9,55.6,4,5,2,3,6,12,7,0
1999,Marcos Senesi,Bournemouth,8.6,29,18,19,8,2,11,20,55.0,9,13,5,8,10,39,38,0
2000,Suat Serdar,Hellas Verona,3.8,9,6,5,4,0,3,9,33.3,6,2,1,1,3,12,3,0
2002,Sergi,Leganés,12.5,16,13,8,7,1,7,10,70.0,3,13,9,4,19,35,67,1
2003,Nicolas Serrano,Athletic Club,1.1,1,1,0,1,0,1,3,33.3,2,4,0,4,0,1,1,0
2004,Benjamin Sesko,RB Leipzig,7.4,4,2,0,2,2,1,3,33.3,2,5,3,2,2,6,6,0
2005,Stephan El Shaarawy,Roma,4.2,6,4,2,1,3,1,2,50.0,1,1,0,1,4,10,3,0
2006,Alen Sherri,Cagliari,1.0,0,0,0,0,0,0,1,0.0,1,0,0,0,0,0,0,0
2007,Eldor Shomurodov,Roma,0.9,1,0,0,1,0,0,1,0.0,1,1,0,1,0,1,0,0
2008,Djibril Sidibe,Toulouse,8.1,26,13,14,8,4,11,18,61.1,7,3,1,2,13,39,22,0
2009,Armindo Sieb,Mainz 05,4.1,3,2,1,2,0,1,4,25.0,3,1,0,1,1,4,4,0
2010,Vincent Sierro,Toulouse,10.1,19,11,8,9,2,10,22,45.5,12,14,2,12,7,26,20,1
2011,Tim Siersleben,Heidenheim,0.6,0,0,0,0,0,0,0,0.0,0,0,0,0,1,1,7,0
2012,Kiliann Sildillia,Freiburg,0.3,1,0,0,0,1,0,0,0.0,0,0,0,0,0,1,0,0
2013,Andre Silva,RB Leipzig,0.5,1,1,1,0,0,0,1,0.0,1,0,0,0,0,1,0,0
2014,Bernardo Silva,Manchester City,9.3,8,6,0,3,5,3,12,25.0,9,7,1,6,5,13,4,1
2015,Caio Henrique Oliveira Silva,Monaco,6.5,12,9,7,4,1,6,9,66.7,3,6,1,5,4,16,13,0
2016,Fabio Silva,Las Palmas,7.2,5,1,1,2,2,1,7,14.3,6,6,0,6,3,8,14,0
2017,Jota Silva,Nott'ham Forest,2.4,8,2,4,4,0,1,6,16.7,5,3,0,3,7,15,4,0
2018,Eric da Silva Moreira,Nott'ham Forest,0.0,0,0,0,0,0,0,0,0.0,0,0,0,0,0,0,0,0
2019,Rui Silva,Betis,13.0,0,0,0,0,0,0,1,0.0,1,1,0,1,0,0,6,0
2020,Abdallah Sima,Brest,2.9,2,2,0,2,0,2,3,66.7,1,1,0,1,1,3,3,0
2021,Mohamed Simakan,RB Leipzig,0.6,0,0,0,0,0,0,0,0.0,0,0,0,0,2,2,0,0
2022,Giovanni Simeone,Napoli,2.4,0,0,0,0,0,0,3,0.0,3,2,0,2,1,1,1,0
2023,Giuliano Simeone,Atlético Madrid,3.2,5,3,0,3,2,4,5,80.0,1,5,1,4,2,7,3,0
2024,Moses Simon,Nantes,9.3,8,7,2,3,3,4,8,50.0,4,3,0,3,6,14,2,0
2025,Xavi Simons,RB Leipzig,6.8,8,7,2,5,1,3,5,60.0,2,3,1,2,2,10,6,0
2026,Jahmai Simpson-Pusey,Manchester City,1.0,1,0,1,0,0,0,0,0.0,0,1,1,0,0,1,2,0
2028,Danel Sinani,St. Pauli,1.1,3,3,0,2,1,0,1,0.0,1,0,0,0,1,4,0,0
2029,Lassine Sinayoko,Auxerre,8.3,10,5,5,1,4,4,8,50.0,4,7,1,6,7,17,18,0
2030,Wilfried Singo,Monaco,8.1,12,9,6,5,1,4,7,57.1,3,3,1,2,18,30,32,0
2031,Luis Sinisterra,Bournemouth,2.3,5,1,1,2,2,0,4,0.0,4,3,0,3,0,5,5,0
2032,Daley Sinkgraven,Las Palmas,1.0,5,1,3,2,0,1,3,33.3,2,1,0,1,1,6,2,0
2033,Jailson Siqueira,Celta Vigo,5.0,7,7,5,2,0,5,6,83.3,1,5,3,2,8,15,18,1
2034,Ibrahim Sissoko,Saint-Étienne,6.8,9,7,4,3,2,2,5,40.0,3,5,0,5,1,10,10,0
2035,Ibrahima Sissoko,Bochum,9.2,22,16,10,11,1,8,15,53.3,7,8,3,5,12,34,14,0
2036,Niama Sissoko,Reims,0.2,0,0,0,0,0,0,0,0.0,0,0,0,0,0,0,0,0
2037,Antonio Sivera,Alavés,13.0,1,0,1,0,0,1,1,100.0,0,0,0,0,0,1,5,0
2038,Tim Skarke,Union Berlin,2.9,2,2,1,1,0,2,5,40.0,3,2,0,2,0,2,4,0
2039,Ellyes Skhiri,Eint Frankfurt,7.5,8,4,3,4,1,2,11,18.2,9,16,3,13,7,15,13,1
2040,Oliver Skipp,Leicester City,4.5,4,2,1,2,1,3,4,75.0,1,7,3,4,4,8,6,0
2041,Leo Skiri Ostigard,Rennes,5.9,15,13,12,3,0,12,19,63.2,7,5,5,0,5,20,37,0
2042,Lukasz Skorupski,Bologna,7.0,0,0,0,0,0,0,0,0.0,0,0,0,0,0,0,3,0
2043,Robert Skov,Union Berlin,1.2,2,1,0,2,0,1,2,50.0,1,1,0,1,0,2,0,0
2044,Milan Skriniar,Paris S-G,3.2,6,4,2,4,0,2,2,100.0,0,6,5,1,2,8,6,0
2045,Steven Skrzybski,Holstein Kiel,3.8,5,0,0,3,2,3,6,50.0,3,9,0,9,5,10,2,0
2046,Naatan Skytta,Toulouse,0.1,1,0,0,0,1,0,0,0.0,0,0,0,0,0,1,0,0
2047,William Smallbone,Southampton,2.7,7,3,3,3,1,3,5,60.0,2,3,0,3,0,7,2,1
2048,Adam Smith,Bournemouth,6.7,9,6,5,2,2,4,8,50.0,4,4,1,3,7,16,25,0
2049,Eric Smith,St. Pauli,9.4,11,8,9,2,0,5,6,83.3,1,13,4,9,15,26,40,2
2050,Justin Smith,Espanyol,0.3,0,0,0,0,0,0,0,0.0,0,0,0,0,1,1,0,0
2051,Emile Smith Rowe,Fulham,8.8,17,11,5,5,7,4,10,40.0,6,7,0,7,7,24,5,0
2052,Eduard Sobol,Strasbourg,0.0,0,0,0,0,0,0,0,0.0,0,0,0,0,0,0,0,0
2054,Simon Sohm,Parma,9.8,6,3,3,2,1,4,8,50.0,4,3,1,2,6,12,14,0
2055,Alex Sola,Getafe,9.5,16,10,8,8,0,8,23,34.8,15,8,0,8,3,19,7,0
2056,Dominic Solanke,Tottenham,8.9,9,6,1,6,2,2,3,66.7,1,6,2,4,0,9,9,0
2057,Ola Solbakken,Empoli,5.7,3,3,0,3,0,0,1,0.0,1,0,0,0,1,4,8,0
2058,Carlos Soler,West Ham,3.0,3,3,2,1,0,1,8,12.5,7,5,1,4,2,5,4,0
2059,Jhon Solis,Girona,3.2,4,4,2,2,0,3,9,33.3,6,10,1,9,3,7,4,0
2060,Yann Sommer,Inter,12.0,0,0,0,0,0,0,0,0.0,0,0,0,0,0,0,4,1
2061,David Soria,Getafe,13.0,3,3,3,0,0,3,3,100.0,0,0,0,0,0,3,7,1
2062,Juan Soriano,Leganés,6.0,1,1,1,0,0,1,1,100.0,0,0,0,0,0,1,2,0
2063,Borna Sosa,Torino,3.7,4,3,2,2,0,3,6,50.0,3,1,0,1,4,8,7,0
2064,Ramon Sosa,Nott'ham Forest,1.1,3,2,2,0,1,1,2,50.0,1,1,0,1,1,4,2,0
2065,Hugo Sotelo,Celta Vigo,6.2,12,8,5,4,3,4,11,36.4,7,5,0,5,1,13,4,0
2066,Florian Sotoca,Lens,6.9,8,6,1,1,6,5,7,71.4,2,5,1,4,2,10,12,0
2067,Riccardo Sottil,Fiorentina,3.9,0,0,0,0,0,0,1,0.0,1,1,0,1,3,3,3,0
2068,Tomas Soucek,West Ham,7.3,14,8,5,7,2,9,17,52.9,8,8,3,5,8,22,23,0
2069,Matias Soule,Roma,5.8,4,3,0,2,2,1,6,16.7,5,8,1,7,2,6,4,0
2070,Boubakary Soumare,Leicester City,1.6,3,2,3,0,0,1,2,50.0,1,2,1,1,2,5,0,0
2071,Issa Soumare,Le Havre,4.9,3,1,0,2,1,2,6,33.3,4,4,1,3,2,5,3,0
2072,Djibril Sow,Sevilla,5.6,5,3,2,3,0,0,3,0.0,3,3,1,2,4,9,4,0
2073,Saidou Sow,Strasbourg,10.3,9,5,6,3,0,6,12,50.0,6,13,7,6,15,24,31,2
2074,Djed Spence,Tottenham,0.7,2,2,2,0,0,2,2,100.0,0,0,0,0,2,4,1,0
2075,Leonardo Spinazzola,Napoli,2.8,3,3,0,2,1,1,2,50.0,1,4,1,3,0,3,6,1
2076,Anton Stach,Hoffenheim,9.4,24,20,11,12,1,11,15,73.3,4,9,5,4,14,38,45,0
2077,Jens Stage,Werder Bremen,6.2,7,6,4,3,0,3,10,30.0,7,14,3,11,8,15,7,0
2078,Filip Stankovic,Venezia,5.0,0,0,0,0,0,0,0,0.0,0,0,0,0,0,0,3,0
2080,Jay Stansfield,Fulham,0.0,0,0,0,0,0,0,0,0.0,0,0,0,0,0,0,0,0
2081,Carl Starfelt,Celta Vigo,10.2,10,6,8,2,0,5,9,55.6,4,16,13,3,12,22,55,1
2082,Niklas Stark,Werder Bremen,4.3,9,6,4,4,1,4,5,80.0,1,11,9,2,4,13,26,0
2083,Lucas Stassin,Saint-Étienne,4.0,4,2,0,2,2,3,4,75.0,1,4,0,4,0,4,3,0
2084,Jason Steele,Brighton,2.0,0,0,0,0,0,0,0,0.0,0,0,0,0,0,0,1,0
2085,Orri Steinn Oskarsson,Real Sociedad,3.6,4,4,1,1,2,1,6,16.7,5,6,0,6,0,4,4,0
2086,Pascal Stenzel,Stuttgart,1.3,1,0,1,0,0,0,1,0.0,1,3,1,2,0,1,4,0
2087,Jack Stephens,Southampton,6.4,10,7,7,3,0,4,12,33.3,8,4,2,2,3,13,14,2
2088,Raheem Sterling,Arsenal,1.4,0,0,0,0,0,0,1,0.0,1,1,0,1,0,0,0,0
2089,Enzo Sternal,Marseille,0.3,0,0,0,0,0,0,0,0.0,0,0,0,0,0,0,0,0
2090,Ross Stewart,Southampton,1.5,0,0,0,0,0,0,3,0.0,3,3,0,3,0,0,4,0
2091,Angelo Stiller,Stuttgart,9.9,14,6,7,6,1,3,9,33.3,6,7,3,4,5,19,16,1
2092,Kevin Stoger,Gladbach,6.4,12,6,7,3,2,6,14,42.9,8,12,1,11,3,15,12,1
2093,Stoichkov,Alavés,6.3,13,8,6,6,1,6,11,54.5,5,2,0,2,1,14,5,0
2094,Petar Stojanovic,Empoli,0.0,0,0,0,0,0,0,0,0.0,0,0,0,0,0,0,0,0
2095,John Stones,Manchester City,2.7,3,2,1,2,0,2,2,100.0,0,2,0,2,1,4,7,1
2096,Jorgen Strand Larsen,Wolves,9.9,4,4,1,2,1,1,12,8.3,11,8,2,6,3,7,12,0
2097,Gabriel Strefezza,Como,10.6,22,15,8,9,5,10,24,41.7,14,7,1,6,2,24,7,0
2098,Cristhian Stuani,Girona,2.0,1,1,0,1,0,1,1,100.0,0,1,0,1,0,1,1,0
2099,Alex Suarez,Las Palmas,9.9,14,8,11,2,1,7,10,70.0,3,17,10,7,4,18,43,1
2100,Denis Suarez,Villarreal,0.9,1,1,1,0,0,1,2,50.0,1,1,1,0,0,1,1,0
2101,Gabriel Suazo,Toulouse,4.9,17,10,7,5,5,11,19,57.9,8,4,0,4,8,25,4,0
2102,Luka Sucic,Real Sociedad,7.8,13,9,3,8,2,6,13,46.2,7,13,2,11,5,18,4,0
2103,Yukinari Sugawara,Southampton,7.4,17,10,10,6,1,9,14,64.3,5,8,3,5,4,21,21,1
2104,Niklas Sule,Dortmund,3.7,5,4,4,1,0,4,5,80.0,1,1,1,0,1,6,19,0
2106,Ibrahim Sulemana,Atalanta,0.3,2,1,1,1,0,1,1,100.0,0,0,0,0,0,2,0,0
2107,Kamaldeen Sulemana,Southampton,0.2,3,3,2,0,1,3,3,100.0,0,0,0,0,0,3,1,0
2108,Crysencio Summerville,West Ham,3.8,5,2,1,2,2,1,3,33.3,2,5,2,3,0,5,5,0
2109,Tomas Suslov,Hellas Verona,6.2,18,13,4,10,4,6,14,42.9,8,15,1,14,3,21,5,0
2110,Suso,Sevilla,1.1,1,0,1,0,0,1,4,25.0,3,0,0,0,0,1,0,0
2111,Zion Suzuki,Parma,10.8,1,0,1,0,0,1,1,100.0,0,0,0,0,0,1,8,3
2112,Mattias Svanberg,Wolfsburg,4.2,6,3,0,5,1,1,3,33.3,2,1,0,1,4,10,4,0
2113,Marin Sverko,Venezia,4.5,5,3,3,2,0,3,3,100.0,0,4,1,3,8,13,20,1
2114,Mile Svilar,Roma,12.0,0,0,0,0,0,0,0,0.0,0,0,0,0,0,0,3,1
2115,Michael Svoboda,Venezia,11.3,21,10,16,4,1,8,17,47.1,9,16,11,5,14,35,51,2
2116,Williot Swedberg,Celta Vigo,5.4,6,5,1,4,1,5,6,83.3,1,7,1,6,1,7,4,1
2117,Abakar Sylla,Strasbourg,6.5,17,8,9,6,2,10,11,90.9,1,10,6,4,6,23,25,0
2118,Issiaga Sylla,Montpellier,3.8,11,2,7,4,0,6,10,60.0,4,1,1,0,4,15,14,0
2119,Mamadou Sylla,Valladolid,5.8,2,0,0,0,2,1,2,50.0,1,1,0,1,0,2,3,1
2120,Sammie Szmodics,Ipswich Town,6.0,6,4,2,3,1,2,5,40.0,3,7,1,6,4,10,6,0
2121,Dominik Szoboszlai,Liverpool,8.3,5,0,1,3,1,2,8,25.0,6,16,2,14,4,9,5,0
2122,Alexander Sorloth,Atlético Madrid,6.9,3,1,0,2,1,1,2,50.0,1,2,1,1,0,3,9,0
2123,Musa Al-Taamari,Montpellier,3.4,4,1,1,1,2,2,2,100.0,0,0,0,0,3,7,0,1
2124,Haris Tabakovic,Hoffenheim,1.6,1,1,0,0,1,0,0,0.0,0,1,1,0,0,1,5,0
2125,Nicolas Tagliafico,Lyon,5.0,17,10,8,5,4,10,14,71.4,4,5,3,2,9,26,10,0
2126,Jonathan Tah,Leverkusen,10.0,5,4,4,1,0,2,3,66.7,1,8,6,2,13,18,30,1
2127,Adrien Tameze,Torino,3.6,2,1,0,2,0,0,6,0.0,6,3,3,0,10,12,3,1
2128,Renato Tapia,Leganés,7.0,18,10,8,8,2,5,15,33.3,10,17,9,8,6,24,27,0
2129,Edmond Tapsoba,Leverkusen,9.9,24,16,12,10,2,11,20,55.0,9,6,4,2,7,31,29,0
2130,Florian Tardieu,Saint-Étienne,1.8,1,1,1,0,0,0,2,0.0,2,3,1,2,3,4,2,0
2132,Mehdi Taremi,Inter,2.7,2,1,0,1,1,0,0,0.0,0,5,0,5,0,2,3,0
2133,Oussama Targhalline,Le Havre,7.3,14,10,8,2,4,3,8,37.5,5,12,6,6,11,25,7,1
2134,James Tarkowski,Everton,11.0,27,16,14,11,2,13,22,59.1,9,17,13,4,11,38,64,1
2135,Cesar Tarrega,Valencia,9.0,9,7,5,3,1,4,8,50.0,4,7,5,2,5,14,40,1
2136,Nuno Tavares,Lazio,8.1,13,11,8,3,2,4,10,40.0,6,4,0,4,7,20,23,0
2137,Marcus Tavernier,Bournemouth,8.9,19,11,5,10,4,4,10,40.0,6,4,0,4,3,22,5,0
2138,Charlie Taylor,Southampton,2.3,7,5,4,3,0,5,6,83.3,1,5,3,2,3,10,20,1
2139,Jack Taylor,Ipswich Town,1.5,1,0,0,1,0,1,5,20.0,4,1,0,1,2,3,7,0
2140,Loum Tchaouna,Lazio,1.9,3,1,1,1,1,1,3,33.3,2,1,0,1,1,4,1,0
2141,Jackson Tchatchoua,Hellas Verona,10.4,19,9,15,2,2,14,18,77.8,4,10,5,5,7,26,25,0
2142,Enzo Tchato,Montpellier,7.1,15,7,8,6,1,9,19,47.4,10,13,3,10,8,23,25,0
2143,Aurelien Tchouameni,Real Madrid,9.4,20,10,9,10,1,7,16,43.8,9,8,7,1,23,43,13,0
2144,Alvaro Tejero,Espanyol,6.7,5,3,1,3,1,2,11,18.2,9,7,0,7,4,9,11,1
2145,Martin Tejon,Valencia,0.5,2,0,0,2,0,1,2,50.0,1,0,0,0,0,2,0,0
2146,Mathys Tel,Bayern Munich,1.3,1,1,0,1,0,0,0,0.0,0,0,0,0,1,2,0,0
2147,Nathan Tella,Leverkusen,1.4,1,0,1,0,0,1,2,50.0,1,1,0,1,0,1,1,0
2148,Nahuel Tenaglia,Alavés,10.5,25,13,19,3,3,13,23,56.5,10,5,2,3,10,35,30,0
2149,Casper Tengstedt,Hellas Verona,8.4,2,1,0,1,1,1,3,33.3,2,3,1,2,3,5,16,0
2150,Marc-Andre ter Stegen,Barcelona,5.5,0,0,0,0,0,0,1,0.0,1,0,0,0,0,0,2,2
2151,Filippo Terracciano,Milan,4.0,6,3,1,3,2,3,6,50.0,3,0,0,0,2,8,4,0
2152,Pietro Terracciano,Fiorentina,3.0,0,0,0,0,0,0,0,0.0,0,0,0,0,0,0,0,0
2153,Ramon Terrats,Villarreal,0.9,3,3,1,2,0,2,3,66.7,1,2,1,1,1,4,3,0
2154,Martin Terrier,Leverkusen,4.9,2,1,0,0,2,1,2,50.0,1,2,0,2,1,3,1,0
2155,Tanner Tessmann,Lyon,2.3,7,4,4,2,1,3,5,60.0,2,1,1,0,6,13,9,0
2156,Kenny Tete,Fulham,10.6,30,18,12,10,8,11,20,55.0,9,16,6,10,21,51,28,0
2158,Teddy Teuma,Reims,2.3,4,3,1,2,1,2,7,28.6,5,4,1,3,3,7,3,0
2159,Jordan Teze,Monaco,2.5,10,5,6,3,1,3,4,75.0,1,7,1,6,2,12,1,0
2160,Florian Thauvin,Udinese,6.6,7,6,4,1,2,6,11,54.5,5,3,0,3,3,10,2,0
2161,Arthur Theate,Eint Frankfurt,8.6,10,6,4,5,1,4,14,28.6,10,12,8,4,13,23,35,1
2162,Malick Thiaw,Milan,5.0,7,5,2,4,1,0,1,0.0,1,3,2,1,5,12,18,0
2163,Denis Thomalla,Heidenheim,0.0,0,0,0,0,0,0,0,0.0,0,0,0,0,0,0,0,0
2164,Sorba Thomas,Nantes,6.9,8,4,3,4,1,5,9,55.6,4,8,0,8,2,10,8,1
2165,Adrien Thomasson,Lens,9.8,28,17,14,8,6,16,31,51.6,15,14,0,14,9,37,15,0
2166,Morten Thorsby,Genoa,6.8,10,7,3,5,2,3,10,30.0,7,7,0,7,3,13,8,0
2167,Khephren Thuram,Juventus,5.6,5,3,1,4,0,3,5,60.0,2,3,0,3,4,9,11,0
2168,Marcus Thuram,Inter,10.8,10,7,3,3,4,2,6,33.3,4,10,3,7,1,11,4,0
2169,Youri Tielemans,Aston Villa,10.8,26,18,12,13,1,14,22,63.6,8,9,4,5,12,38,12,0
2170,Phillip Tietz,Augsburg,7.0,5,3,1,3,1,3,3,100.0,0,4,1,3,3,8,10,0
2171,Jurrien Timber,Arsenal,7.6,15,8,5,7,3,4,11,36.4,7,10,4,6,4,19,18,1
2172,Jean-Clair Todibo,West Ham,5.6,12,7,11,1,0,7,8,87.5,1,9,4,5,6,18,31,2
2173,Harry Toffolo,Nott'ham Forest,0.4,2,0,1,0,1,0,0,0.0,0,0,0,0,0,2,3,0
2174,Umut Tohumcu,Hoffenheim,3.1,9,5,3,5,1,5,7,71.4,2,2,0,2,4,13,6,0
2175,Corentin Tolisso,Lyon,6.7,16,7,8,5,3,6,16,37.5,10,13,2,11,6,22,13,0
2176,Rafael Toloi,Atalanta,0.4,1,1,1,0,0,1,1,100.0,0,0,0,0,0,1,0,0
2177,Tiago Tomas,Wolfsburg,8.0,10,6,5,1,4,5,16,31.3,11,5,1,4,4,14,6,0
2178,Takehiro Tomiyasu,Arsenal,0.1,0,0,0,0,0,0,0,0.0,0,0,0,0,0,0,1,0
2179,Fikayo Tomori,Milan,6.1,8,7,5,2,1,3,6,50.0,3,7,5,2,7,15,18,0
2180,Sandro Tonali,Newcastle Utd,4.6,11,7,2,9,0,4,8,50.0,4,6,3,3,10,21,5,1
2181,Pablo Torre,Barcelona,2.2,5,4,1,3,1,2,2,100.0,0,0,0,0,1,6,3,0
2182,David Torres,Valladolid,7.7,4,3,4,0,0,1,3,33.3,2,10,9,1,2,6,33,0
2184,Ferran Torres,Barcelona,3.6,3,1,1,1,1,1,2,50.0,1,2,0,2,0,3,1,0
2185,Pau Torres,Aston Villa,11.0,10,8,6,4,0,4,5,80.0,1,8,4,4,4,14,27,2
2186,Lucas Torro,Osasuna,12.5,28,17,8,20,0,15,27,55.6,12,20,4,16,18,46,28,2
2187,Abdoulaye Toure,Le Havre,10.0,25,12,13,8,4,15,21,71.4,6,12,7,5,13,38,19,0
2188,Birama Toure,Montpellier,3.3,8,5,5,2,1,4,6,66.7,2,3,2,1,5,13,7,0
2189,Ousmane Toure,Lille,0.1,0,0,0,0,0,0,0,0.0,0,0,0,0,1,1,2,0
2190,Souleymane Toure,Udinese,5.8,5,5,4,1,0,3,4,75.0,1,12,5,7,8,13,12,1
2191,Lucas Tousart,Union Berlin,1.4,1,1,0,1,0,0,2,0.0,2,3,1,2,1,2,2,0
2192,Conor Townsend,Ipswich Town,0.0,1,1,1,0,0,0,0,0.0,0,0,0,0,0,1,0,0
2193,Adama Traore,Fulham,8.0,7,5,4,2,1,2,5,40.0,3,4,0,4,1,8,4,1
2194,Hamari Traore,Real Sociedad,3.5,11,7,7,3,1,9,12,75.0,3,1,1,0,3,14,11,0
2195,Omar Traore,Heidenheim,8.5,12,6,10,2,0,8,9,88.9,1,10,2,8,6,18,18,0
2196,Kevin Trapp,Eint Frankfurt,6.5,0,0,0,0,0,0,0,0.0,0,0,0,0,0,0,2,1
2197,Mark Travers,Bournemouth,3.0,0,0,0,0,0,0,0,0.0,0,0,0,0,0,0,4,0
2198,Oscar Trejo,Rayo Vallecano,1.7,3,3,0,3,0,3,4,75.0,1,1,0,1,1,4,1,0
2199,Philipp Treu,St. Pauli,8.5,15,11,10,4,1,8,17,47.1,9,14,1,13,6,21,14,0
2200,Ryan Trevitt,Brentford,0.0,1,1,1,0,0,0,0,0.0,0,0,0,0,0,1,0,0
2201,Christopher Trimmel,Union Berlin,6.2,17,12,9,7,1,14,21,66.7,7,3,0,3,5,22,19,0
2202,Kieran Trippier,Newcastle Utd,3.1,9,4,4,4,1,5,13,38.5,8,2,1,1,2,11,6,0
2203,Leandro Trossard,Arsenal,6.4,11,8,2,6,3,5,14,35.7,9,9,0,9,5,16,6,0
2204,Adrien Truffert,Rennes,9.3,22,9,9,8,5,14,20,70.0,6,13,0,13,8,30,15,0
2205,Kostas Tsimikas,Liverpool,2.6,12,7,8,2,2,6,8,75.0,2,3,1,2,3,15,6,0
2206,Viktor Tsyhankov,Girona,4.9,4,3,0,2,2,2,5,40.0,3,0,0,0,0,4,2,0
2207,Axel Tuanzebe,Ipswich Town,6.7,15,9,11,1,3,8,12,66.7,4,7,3,4,10,25,21,0
2208,Stefano Turati,Monza,9.0,0,0,0,0,0,0,0,0.0,0,0,0,0,0,0,7,1
2210,Benat Turrientes,Real Sociedad,5.1,10,3,4,5,1,3,7,42.9,4,9,2,7,1,11,5,0
2211,Tuta,Eint Frankfurt,9.7,23,14,13,8,2,15,21,71.4,6,21,12,9,18,41,61,0
2212,Chrisantus Uche,Getafe,11.0,8,5,2,3,3,1,1,100.0,0,6,1,5,1,9,4,0
2213,Destiny Udogie,Tottenham,10.2,29,17,16,7,6,13,22,59.1,9,18,2,16,13,42,17,1
2214,Manuel Ugarte Ribeiro,Manchester Utd,3.1,17,11,5,10,2,6,12,50.0,6,0,0,0,4,21,4,1
2215,Lesley Ugochukwu,Southampton,1.9,4,2,0,4,0,0,4,0.0,4,5,1,4,2,6,1,0
2216,Lukas Ullrich,Gladbach,1.8,2,1,1,0,1,1,3,33.3,2,4,1,3,4,6,6,0
2217,Sven Ulreich,Bayern Munich,1.0,0,0,0,0,0,0,0,0.0,0,0,0,0,0,0,0,0
2218,Enes Unal,Bournemouth,1.7,1,0,0,0,1,0,1,0.0,1,1,0,1,0,1,3,0
2219,Deniz Undav,Stuttgart,7.1,4,4,1,1,2,0,5,0.0,5,3,0,3,3,7,3,0
2220,Naci Unuvar,Espanyol,0.3,2,2,1,1,0,1,2,50.0,1,0,0,0,0,2,0,0
2221,Dayot Upamecano,Bayern Munich,9.9,15,10,4,9,2,8,17,47.1,9,7,4,3,15,30,27,0
2222,Kacper Urbanski,Bologna,2.2,5,2,4,0,1,4,6,66.7,2,4,0,4,2,7,5,0
2223,Can Uzun,Eint Frankfurt,1.1,2,1,1,0,1,1,2,50.0,1,2,0,2,0,2,1,0
2224,Josha Vagnoman,Stuttgart,7.4,7,3,5,2,0,4,8,50.0,4,7,2,5,5,12,20,0
2225,Oscar Valentin,Rayo Vallecano,9.3,22,17,7,10,5,13,20,65.0,7,12,2,10,10,32,21,0
2226,German Valera,Valencia,0.5,0,0,0,0,0,0,0,0.0,0,0,0,0,3,3,1,0
2227,Emanuele Valeri,Parma,7.6,13,6,8,3,2,10,14,71.4,4,8,2,6,9,22,18,0
2228,Martin Valjent,Mallorca,8.8,9,7,9,0,0,4,4,100.0,0,7,3,4,4,13,44,0
2229,Jesus Vallejo,Real Madrid,0.1,0,0,0,0,0,0,0,0.0,0,0,0,0,0,0,2,0
2230,Mattia Valoti,Monza,0.3,2,2,2,0,0,0,0,0.0,0,1,0,1,0,2,2,0
2231,Federico Valverde,Real Madrid,11.4,18,11,8,9,1,13,19,68.4,6,19,3,16,22,40,11,0
2232,Ignace Van Der Brempt,Como,4.4,16,11,12,4,0,9,12,75.0,3,4,2,2,6,22,8,0
2233,Virgil van Dijk,Liverpool,11.0,7,3,5,1,1,2,4,50.0,2,6,1,5,20,27,53,1
2234,Vanderson,Monaco,6.5,23,15,10,9,4,13,17,76.5,4,9,3,6,13,36,13,1
2236,Maarten Vandevoordt,RB Leipzig,0.5,0,0,0,0,0,0,0,0.0,0,0,0,0,0,0,0,0
2237,Jamie Vardy,Leicester City,9.4,3,3,2,1,0,0,2,0.0,2,1,0,1,1,4,11,0
2238,Ruben Vargas,Augsburg,2.6,2,1,1,1,0,1,4,25.0,3,1,0,1,1,3,0,1
2239,Nikola Vasilj,St. Pauli,10.0,0,0,0,0,0,0,0,0.0,0,0,0,0,0,0,2,1
2240,Devis Vasquez,Empoli,12.0,0,0,0,0,0,0,0,0.0,0,0,0,0,0,0,7,1
2241,Johan Vasquez,Genoa,11.3,14,7,5,7,2,4,10,40.0,6,18,11,7,17,31,46,1
2242,Denis Vavro,Wolfsburg,5.0,2,2,2,0,0,2,3,66.7,1,7,4,3,5,7,39,1
2243,Jose Luis Garcia Vaya,Valencia,9.5,17,11,7,7,3,4,12,33.3,8,10,3,7,3,20,15,0
2244,Jesus Vazquez,Valencia,6.2,16,13,8,6,2,5,12,41.7,7,11,5,6,5,21,19,0
2245,Lucas Vazquez,Real Madrid,5.0,11,9,7,4,0,7,13,53.8,6,4,0,4,3,14,2,0
2246,Matias Vecino,Lazio,4.7,7,6,1,5,1,3,12,25.0,9,5,2,3,3,10,6,0
2247,Renato Veiga,Chelsea,1.9,8,5,5,3,0,4,8,50.0,4,3,1,2,1,9,2,0
2248,Alejo Veliz,Espanyol,7.2,1,1,0,1,0,1,5,20.0,4,10,2,8,1,2,14,0
2249,Milos Veljkovic,Werder Bremen,2.5,1,0,0,0,1,0,2,0.0,2,4,3,1,1,2,6,0
2250,Joel Veltman,Brighton,9.6,19,12,12,5,2,12,30,40.0,18,11,5,6,10,29,27,0
2251,Micky van de Ven,Tottenham,7.9,7,4,3,3,1,5,10,50.0,5,6,4,2,9,16,24,1
2252,Nikolas Veratschnig,Mainz 05,0.1,0,0,0,0,0,0,0,0.0,0,0,0,0,0,0,0,0
2253,Bart Verbruggen,Brighton,9.0,0,0,0,0,0,0,2,0.0,2,0,0,0,0,0,9,2
2254,Simone Verdi,Como,0.7,0,0,0,0,0,0,1,0.0,1,0,0,0,0,0,1,0
2255,Jordan Veretout,Lyon,6.2,6,2,3,2,1,3,10,30.0,7,9,2,7,1,7,7,0
2256,Arthur Vermeeren,RB Leipzig,4.5,13,10,4,9,0,4,16,25.0,12,10,5,5,7,20,6,0
2257,Yorbe Vertessen,Union Berlin,5.6,5,2,3,1,1,1,4,25.0,3,3,0,3,3,8,3,0
2258,Mikel Vesga,Athletic Club,4.0,6,3,2,4,0,3,11,27.3,8,5,0,5,6,12,5,0
2259,Jannik Vestergaard,Leicester City,4.0,6,1,3,3,0,0,1,0.0,1,3,1,2,3,9,25,1
2260,Ben Viadere,Auxerre,0.1,0,0,0,0,0,0,0,0.0,0,0,0,0,0,0,0,0
2262,Guglielmo Vicario,Tottenham,11.0,0,0,0,0,0,0,0,0.0,0,0,0,0,1,1,7,2
2263,Carlos Vicente,Alavés,11.7,11,8,7,2,2,5,7,71.4,2,9,1,8,4,15,7,0
2264,Pau Victor Delgado,Barcelona,1.6,1,1,0,1,0,0,3,0.0,3,5,1,4,2,3,4,0
2265,Nacho Vidal,Osasuna,1.3,2,0,0,1,1,1,3,33.3,2,1,0,1,0,2,3,0
2266,Gabriel Vidovic,Mainz 05,0.0,0,0,0,0,0,0,0,0.0,0,0,0,0,0,0,0,0
2267,Samuele Vignato,Monza,2.3,4,2,0,2,2,3,5,60.0,2,0,0,0,0,4,1,0
2268,Asier Villalibre,Alavés,2.4,0,0,0,0,0,0,0,0.0,0,1,0,1,1,1,4,0
2269,Ivan Villar,Celta Vigo,4.0,0,0,0,0,0,0,0,0.0,0,0,0,0,0,0,3,0
2270,Nicolas Viola,Cagliari,4.3,5,5,1,4,0,0,4,0.0,4,1,0,1,2,7,2,0
2271,Viti,Las Palmas,7.6,26,18,14,10,2,9,12,75.0,3,11,2,9,14,40,23,0
2272,Mattia Viti,Empoli,12.0,31,22,23,7,1,17,22,77.3,5,21,10,11,20,51,48,1
2273,Vitinha,Genoa,5.5,10,4,4,3,3,4,15,26.7,11,5,1,4,4,14,5,0
2274,Vitinha,Paris S-G,7.0,15,7,6,8,1,11,18,61.1,7,6,2,4,2,17,5,1
2275,Daniel Vivian,Athletic Club,9.6,12,9,7,5,0,9,11,81.8,2,9,3,6,11,23,48,0
2276,Dusan Vlahovic,Juventus,10.8,1,1,0,0,1,0,0,0.0,0,4,3,1,1,2,7,1
2277,Vanja Vlahovic,Atalanta,0.3,0,0,0,0,0,0,0,0.0,0,0,0,0,0,0,0,0
2278,Nikola Vlasic,Torino,4.3,13,8,6,6,1,5,9,55.6,4,6,2,4,3,16,3,0
2279,Alessandro Vogliacco,Genoa,7.2,11,3,4,7,0,6,7,85.7,1,11,7,4,8,19,19,0
2280,Kevin Vogt,Union Berlin,9.4,4,3,2,2,0,3,6,50.0,3,8,5,3,5,9,39,0
2281,Mergim Vojvoda,Torino,6.9,11,6,4,5,2,5,12,41.7,7,9,3,6,4,15,16,1
2282,Aster Vranckx,Wolfsburg,1.4,3,2,1,2,0,1,1,100.0,0,2,1,1,3,6,4,0
2283,Stefan de Vrij,Inter,4.9,6,4,3,2,1,3,5,60.0,2,4,2,2,3,9,16,0
2284,Ibrahima Wadji,Saint-Étienne,0.7,1,1,0,1,0,1,3,33.3,2,0,0,0,0,1,0,0
2285,Robert Wagner,St. Pauli,4.0,7,2,1,6,0,3,10,30.0,7,6,0,6,1,8,9,0
2286,Elye Wahi,Marseille,5.6,0,0,0,0,0,0,3,0.0,3,1,0,1,1,1,0,0
2288,Hauke Wahl,St. Pauli,10.0,15,10,9,5,1,8,10,80.0,2,8,4,4,7,22,39,1
2289,Kyle Walker,Manchester City,5.2,9,4,3,4,2,7,13,53.8,6,5,2,3,3,12,4,0
2290,Kyle Walker-Peters,Southampton,8.9,13,10,6,5,2,6,14,42.9,8,10,5,5,8,21,18,0
2291,Christian Walton,Ipswich Town,1.0,0,0,0,0,0,0,1,0.0,1,0,0,0,0,0,0,0
2292,Sebastian Walukiewicz,Torino,5.9,7,3,4,2,1,4,7,57.1,3,7,2,5,9,16,24,0
2293,Sebastian Walukiewicz,Empoli,2.0,1,0,1,0,0,0,1,0.0,1,3,3,0,1,2,15,0
2294,Aaron Wan-Bissaka,West Ham,9.1,16,11,7,7,2,8,10,80.0,2,6,2,4,17,33,30,0
2295,Paul Wanner,Heidenheim,8.3,18,10,7,11,0,7,16,43.8,9,5,0,5,1,19,7,0
2296,James Ward-Prowse,West Ham,0.2,1,0,1,0,0,1,1,100.0,0,1,0,1,0,1,0,0
2297,James Ward-Prowse,Nott'ham Forest,3.2,3,1,1,2,0,1,1,100.0,0,3,2,1,5,8,3,0
2298,Kjell-Arik Watjen,Dortmund,0.0,0,0,0,0,0,0,0,0.0,0,0,0,0,0,0,2,0
2299,Ollie Watkins,Aston Villa,9.3,3,2,0,2,1,0,4,0.0,4,5,0,5,2,5,2,0
2300,Timothy Weah,Juventus,5.0,6,3,1,3,2,1,3,33.3,2,6,0,6,4,10,4,0
2301,Adam Webster,Brighton,0.9,0,0,0,0,0,0,2,0.0,2,4,3,1,1,1,3,1
2302,Julian Weigl,Gladbach,9.6,20,5,14,4,2,11,13,84.6,2,12,5,7,18,38,21,0
2303,Timon Weiner,Holstein Kiel,10.0,0,0,0,0,0,0,0,0.0,0,0,0,0,0,0,4,2
2304,Nelson Weiper,Mainz 05,0.5,1,1,1,0,0,0,0,0.0,0,1,0,1,0,1,0,0
2305,Mitchell Weiser,Werder Bremen,8.9,15,10,3,10,2,6,12,50.0,6,6,0,6,3,18,17,1
2306,Noah Weisshaupt,Freiburg,0.9,0,0,0,0,0,0,1,0.0,1,0,0,0,0,0,1,0
2307,Danny Welbeck,Brighton,10.3,9,5,3,5,1,2,9,22.2,7,11,1,10,3,12,5,0
2308,Timo Werner,Tottenham,3.0,2,2,1,1,0,1,4,25.0,3,9,1,8,1,3,2,0
2309,Adam Wharton,Crystal Palace,6.9,18,10,9,9,0,9,26,34.6,17,5,0,5,10,28,13,0
2310,Ben White,Arsenal,7.7,10,6,8,1,1,9,21,42.9,12,6,5,1,11,21,23,0
2311,Silvan Widmer,Mainz 05,1.4,2,2,1,1,0,2,3,66.7,1,1,0,1,1,3,7,0
2312,Mats Wieffer,Brighton,2.6,10,5,1,7,2,3,8,37.5,5,7,1,6,2,12,6,2
2314,Mateusz Wieteska,Cagliari,1.2,1,0,0,1,0,1,1,100.0,0,2,1,1,6,7,4,0
2315,Caleb Wiley,Strasbourg,2.5,0,0,0,0,0,0,0,0.0,0,3,1,2,1,1,3,0
2316,Inaki Williams,Athletic Club,10.8,6,1,2,3,1,4,10,40.0,6,9,1,8,7,13,11,0
2317,Neco Williams,Nott'ham Forest,4.2,13,9,11,2,0,5,11,45.5,6,9,1,8,4,17,19,0
2318,Nico Williams,Athletic Club,8.6,15,9,3,8,4,6,13,46.2,7,4,0,4,2,17,4,0
2319,Joe Willock,Newcastle Utd,3.7,8,5,3,4,1,5,8,62.5,3,9,1,8,2,10,2,0
2320,Harry Wilson,Fulham,0.9,1,1,1,0,0,0,1,0.0,1,1,0,1,0,1,1,0
2321,Patrick Wimmer,Wolfsburg,4.4,5,4,2,3,0,2,7,28.6,5,5,0,5,5,10,2,0
2322,Jonas Wind,Wolfsburg,5.0,1,1,0,1,0,1,1,100.0,0,3,1,2,1,2,4,0
2323,Harry Winks,Leicester City,9.5,12,7,6,4,2,5,13,38.5,8,10,4,6,3,15,14,0
2324,Florian Wirtz,Leverkusen,9.3,13,8,5,6,2,5,11,45.5,6,9,1,8,6,19,1,0
2325,Yoane Wissa,Brentford,6.3,2,1,0,0,2,0,3,0.0,3,2,0,2,3,5,3,0
2326,Dani de Wit,Bochum,7.0,14,9,6,7,1,8,15,53.3,7,8,2,6,6,20,13,1
2327,Axel Witsel,Atlético Madrid,5.9,7,6,2,5,0,5,7,71.4,2,5,3,2,4,11,24,1
2328,Maximilian Wittek,Bochum,9.4,15,11,6,7,2,12,19,63.2,7,19,4,15,11,26,27,1
2329,Marius Wolf,Augsburg,6.7,10,6,3,4,3,5,13,38.5,8,10,2,8,5,15,19,0
2330,Nick Woltemade,Stuttgart,0.7,1,1,0,1,0,0,0,0.0,0,1,0,1,0,1,0,0
2331,Jeong Woo-yeong,Union Berlin,5.4,2,1,1,1,0,0,1,0.0,1,3,1,2,5,7,1,0
2332,Chris Wood,Nott'ham Forest,9.9,1,1,0,0,1,1,4,25.0,3,2,2,0,2,3,6,0
2333,Christopher Wooh,Rennes,9.5,26,12,15,9,2,14,19,73.7,5,17,7,10,11,37,34,0
2334,Luke Woolfenden,Ipswich Town,4.2,1,1,1,0,0,0,2,0.0,2,8,3,5,8,9,22,0
2335,Granit Xhaka,Leverkusen,10.0,12,6,3,8,1,4,8,50.0,4,10,4,6,2,14,11,0
2336,Lamine Yamal,Barcelona,10.8,20,14,2,9,9,5,9,55.6,4,6,0,6,8,28,1,0
2337,Yehor Yarmoliuk,Brentford,1.6,3,2,1,2,0,1,4,25.0,3,6,3,3,4,7,4,0
2338,Ryan Yates,Nott'ham Forest,9.0,18,9,12,5,1,5,11,45.5,6,9,1,8,10,28,26,1
2340,John Yeboah,Venezia,2.1,2,2,0,1,1,0,6,0.0,6,2,0,2,0,2,0,0
2341,Bertug Yildirim,Getafe,7.5,5,2,0,4,1,0,4,0.0,4,4,1,3,0,5,11,0
2342,Kenan Yildiz,Juventus,9.3,25,15,6,12,7,8,12,66.7,4,10,0,10,2,27,4,0
2343,Ashley Young,Everton,8.7,22,11,11,9,2,13,21,61.9,8,3,1,2,10,32,24,0
2344,Etienne Youte Kinkoue,Le Havre,6.5,5,1,3,2,0,3,5,60.0,2,13,7,6,9,14,32,0
2345,Illia Zabarnyi,Bournemouth,11.0,13,7,6,7,0,5,10,50.0,5,14,5,9,12,25,53,0
2346,Mattia Zaccagni,Lazio,8.4,8,6,1,6,1,3,5,60.0,2,4,0,4,7,15,4,0
2347,Dan-Axel Zagadou,Stuttgart,0.3,0,0,0,0,0,0,0,0.0,0,0,0,0,1,1,1,0
2348,Yoram Zague,Paris S-G,1.3,3,2,1,1,1,2,3,66.7,1,1,0,1,1,4,1,0
2349,Wilfried Zaha,Lyon,0.8,1,1,1,0,0,1,2,50.0,1,3,0,3,0,1,0,0
2350,Warren Zaire-Emery,Paris S-G,8.3,21,10,3,10,8,12,18,66.7,6,14,0,14,5,26,10,0
2351,Miha Zajc,Toulouse,1.5,1,1,0,0,1,1,2,50.0,1,0,0,0,1,2,2,0
2352,Denis Zakaria,Monaco,7.3,11,8,4,5,2,6,9,66.7,3,6,4,2,8,19,17,0
2353,Nicola Zalewski,Roma,5.4,6,5,1,2,3,1,5,20.0,4,5,1,4,3,9,6,2
2354,Andre-Frank Zambo Anguissa,Napoli,12.0,19,12,3,13,3,6,14,42.9,8,8,2,6,19,38,9,0
2355,Francesco Zampano,Venezia,10.2,18,12,10,6,2,8,15,53.3,7,8,0,8,5,23,15,2
2356,Nicolo Zaniolo,Atalanta,1.7,0,0,0,0,0,0,0,0.0,0,0,0,0,0,0,0,0
2357,Alessandro Zanoli,Genoa,5.4,7,4,4,2,1,4,5,80.0,1,3,2,1,1,8,14,0
2358,Duvan Zapata,Torino,6.5,7,5,2,0,5,0,3,0.0,3,2,1,1,2,9,7,0
2359,Gabriele Zappa,Cagliari,11.5,16,9,8,8,0,8,12,66.7,4,13,8,5,8,24,31,0
2360,Davide Zappacosta,Atalanta,7.8,6,4,3,2,1,6,13,46.2,7,8,1,7,2,8,7,0
2361,Bryan Zaragoza,Osasuna,10.0,9,6,6,2,1,4,15,26.7,11,6,0,6,0,9,8,0
2362,Anass Zaroury,Lens,4.1,5,4,0,4,1,2,7,28.6,5,2,0,2,0,5,1,0
2363,Oier Zarraga,Udinese,4.4,7,3,3,4,0,4,13,30.8,9,2,1,1,1,8,3,0
2364,Jordan Zemura,Udinese,5.8,9,3,3,4,2,4,9,44.4,5,9,2,7,7,16,11,0
2366,Robin Zentner,Mainz 05,10.0,0,0,0,0,0,0,0,0.0,0,0,0,0,0,0,15,2
2367,Alessio Zerbin,Napoli,0.0,1,1,1,0,0,1,1,100.0,0,0,0,0,0,1,0,0
2368,Kevin Zeroli,Milan,0.1,1,1,0,1,0,0,0,0.0,0,0,0,0,0,1,0,0
2369,Cedric Zesiger,Wolfsburg,5.8,13,8,6,5,2,6,12,50.0,6,6,5,1,3,16,27,0
2370,Michael Zetterer,Werder Bremen,10.0,0,0,0,0,0,0,0,0.0,0,0,0,0,0,0,3,4
2371,Nathan Zeze,Nantes,7.0,21,11,10,11,0,13,16,81.3,3,16,7,9,12,33,51,0
2372,Edon Zhegrova,Lille,8.5,4,2,3,0,1,2,7,28.6,5,6,0,6,3,7,0,0
2373,Piotr Zielinski,Inter,2.8,5,5,2,2,1,2,7,28.6,5,1,0,1,0,5,1,0
2374,Oleksandr Zinchenko,Arsenal,1.2,0,0,0,0,0,0,1,0.0,1,3,0,3,2,2,3,0
2375,Joshua Zirkzee,Manchester Utd,4.8,2,0,2,0,0,2,2,100.0,0,6,2,4,2,4,1,0
2376,Luc Zogbe,Brest,2.4,9,7,4,3,2,5,7,71.4,2,2,0,2,2,11,6,0
2377,Nadir Zortea,Cagliari,6.8,11,4,5,5,1,6,10,60.0,4,1,0,1,4,15,15,0
2378,Aristide Zossou,Auxerre,0.1,0,0,0,0,0,0,0,0.0,0,0,0,0,0,0,0,0
2379,Yanis Zouaoui,Le Havre,1.8,2,2,1,1,0,1,1,100.0,0,1,0,1,2,4,3,0
2380,Igor Zubeldia,Real Sociedad,10.4,10,8,6,3,1,6,13,46.2,7,15,10,5,9,19,36,1
2381,Martin Zubimendi,Real Sociedad,12.5,32,18,12,14,6,10,15,66.7,5,17,5,12,14,46,27,1
2382,Martin Odegaard,Arsenal,3.8,7,4,1,5,1,1,4,25.0,3,1,0,1,1,8,0,0
2383,Milan Duric,Monza,9.2,1,1,0,1,0,0,1,0.0,1,4,0,4,1,2,9,0
