,Player,Squad,90s,Tackles - Tkl,Tackles - TklW,Tackles - Def 3rd,Tackles - Mid 3rd,Tackles - Att 3rd,Challenges - Tkl,Challenges - Att,Challenges - Tkl%,Challenges - Lost,Blocks - Blocks,Blocks - Sh,Blocks - Pass,Int,Tkl+Int,Clr,Err
0,James Abankwah,Udinese,0.0,0,0,0,0,0,0,0,0.0,0,0,0,0,0,0,0,0
1,Keyliane Abdallah,Marseille,0.0,1,1,1,0,0,1,1,100.0,0,0,0,0,0,1,0,0
2,Yunis Abdelhamid,Saint-Étienne,5.0,5,2,5,0,0,4,7,57.1,3,9,8,1,3,8,24,0
3,Himad Abdelli,Angers,6.9,13,9,2,5,6,5,12,41.7,7,6,0,6,6,19,6,0
4,Mohamed Abdelmoneim,Nice,1.8,9,6,6,2,1,6,11,54.5,5,1,1,0,0,9,4,1
5,Ali Abdi,Nice,2.5,11,7,5,2,4,10,15,66.7,5,7,3,4,1,12,7,0
6,Abel,Osasuna,6.8,19,13,10,6,3,12,19,63.2,7,12,2,10,6,25,23,0
7,Nabil Aberdin,Getafe,2.6,5,4,3,2,0,1,1,100.0,0,2,0,2,0,5,5,0
8,Oliver Abildgaard,Como,0.1,0,0,0,0,0,0,0,0.0,0,1,0,1,0,0,0,0
9,Matthis Abline,Nantes,6.2,0,0,0,0,0,0,1,0.0,1,1,0,1,0,0,12,0
10,Abner,Lyon,5.2,13,8,5,6,2,10,14,71.4,4,8,1,7,5,18,12,0
11,Zakaria Aboukhlal,Toulouse,5.3,3,1,0,1,2,2,4,50.0,2,3,0,3,2,5,1,0
12,Abdel Abqar,Alavés,7.5,8,5,3,5,0,2,6,33.3,4,6,3,3,18,26,33,0
13,Tammy Abraham,Roma,0.0,0,0,0,0,0,0,1,0.0,1,0,0,0,0,0,0,0
14,Tammy Abraham,Milan,3.9,4,1,0,4,0,0,0,0.0,0,3,0,3,1,5,3,0
15,Federico Accornero,Genoa,0.1,0,0,0,0,0,0,0,0.0,0,0,0,0,0,0,0,0
16,Francesco Acerbi,Inter,6.0,6,4,5,1,0,2,3,66.7,1,6,6,0,10,16,23,0
17,Akor Adams,Montpellier,6.1,1,1,0,1,0,0,1,0.0,1,2,1,1,0,1,3,0
18,Che Adams,Torino,4.3,3,2,1,1,1,0,1,0.0,1,2,2,0,0,3,1,0
19,Junior Adamu,Freiburg,5.5,0,0,0,0,0,0,2,0.0,2,5,0,5,3,3,5,0
20,Tosin Adarabioyo,Chelsea,1.3,2,2,2,0,0,1,1,100.0,0,2,2,0,1,3,6,0
21,Martin Adeline,Reims,0.3,1,1,0,1,0,1,2,50.0,1,0,0,0,0,1,2,0
22,Karim Adeyemi,Dortmund,3.4,7,5,3,1,3,2,2,100.0,0,6,0,6,1,8,0,0
23,Simon Adingra,Brighton,1.5,4,2,2,2,0,3,5,60.0,2,3,0,3,2,6,0,0
24,Amine Adli,Leverkusen,1.6,4,2,0,1,3,1,2,50.0,1,2,0,2,0,4,2,0
26,Yacine Adli,Fiorentina,1.6,5,3,2,2,1,1,3,33.3,2,0,0,0,2,7,3,0
27,Adryelson,Lyon,0.0,0,0,0,0,0,0,0,0.0,0,0,0,0,1,1,1,0
28,Michel Aebischer,Bologna,4.2,7,4,1,4,2,4,8,50.0,4,3,1,2,5,12,2,0
29,Oladapo Afolayan,St. Pauli,3.8,6,3,1,2,3,2,4,50.0,2,2,0,2,2,8,3,0
30,Emmanuel Agbadou,Reims,7.0,20,13,15,3,2,15,19,78.9,4,16,11,5,8,28,35,1
31,Julen Agirrezabala,Athletic Club,5.4,0,0,0,0,0,0,1,0.0,1,0,0,0,0,0,1,0
32,Lucien Agoume,Sevilla,6.0,12,4,7,3,2,6,9,66.7,3,12,5,7,7,19,8,0
33,Felix Agu,Werder Bremen,5.6,8,4,5,2,1,4,7,57.1,3,4,1,3,5,13,16,0
34,Alvaro Aguado,Espanyol,2.5,4,2,2,2,0,2,4,50.0,2,5,0,5,1,5,5,1
35,Nayef Aguerd,Real Sociedad,4.7,8,6,4,4,0,3,5,60.0,2,6,2,4,6,14,14,0
36,Ruben Aguilar,Lens,3.0,9,6,5,4,0,7,9,77.8,2,5,1,4,5,14,2,0
37,Honest Ahanor,Genoa,0.8,1,0,0,1,0,1,3,33.3,2,0,0,0,0,1,2,0
38,Jean-Eudes Aholou,Angers,5.1,13,10,6,4,3,6,13,46.2,7,5,2,3,8,21,6,0
39,Joseph Aidoo,Celta Vigo,0.0,1,0,1,0,0,0,0,0.0,0,0,0,0,0,1,0,0
40,Ayman Aiki,Saint-Étienne,1.0,3,3,1,2,0,1,1,100.0,0,1,0,1,1,4,0,0
41,Ola Aina,Nott'ham Forest,6.6,11,6,7,4,0,8,14,57.1,6,8,4,4,10,21,22,1
42,Rayan Ait-Nouri,Wolves,6.3,11,6,9,2,0,4,7,57.1,3,6,0,6,6,17,15,1
43,Kristoffer Ajer,Brentford,6.1,5,4,5,0,0,1,6,16.7,5,8,1,7,6,11,17,0
44,Ludovic Ajorque,Brest,5.5,4,2,0,2,2,2,5,40.0,3,3,1,2,1,5,5,0
45,Manuel Akanji,Manchester City,6.7,5,3,2,1,2,3,6,50.0,3,4,2,2,3,8,20,0
46,Umit Akdag,Toulouse,0.9,3,2,1,2,0,3,5,60.0,2,1,1,0,5,8,0,0
47,Nathan Ake,Manchester City,0.0,1,1,1,0,0,1,1,100.0,0,0,0,0,1,2,0,0
48,Ilias Akhomach,Villarreal,4.3,12,7,4,4,4,6,11,54.5,5,6,0,6,3,15,9,0
49,Sergio Akieme,Reims,4.0,5,4,4,1,0,3,6,50.0,3,4,2,2,1,6,12,0
50,Maghnes Akliouche,Monaco,4.2,8,6,5,2,1,2,7,28.6,5,2,0,2,0,8,2,0
52,Clement Akpa,Auxerre,4.8,7,4,3,1,3,4,9,44.4,5,7,2,5,7,14,17,1
53,David Akpan Ankeye,Genoa,0.3,0,0,0,0,0,0,1,0.0,1,0,0,0,0,0,0,0
54,Kevin Akpoguma,Hoffenheim,6.0,9,2,7,1,1,3,6,50.0,3,19,13,6,3,12,27,0
55,Andreas Albers,St. Pauli,0.3,0,0,0,0,0,0,1,0.0,1,0,0,0,0,0,1,0
56,Raul Albiol,Villarreal,5.2,2,2,2,0,0,1,2,50.0,1,6,6,0,2,4,39,0
57,Carlos Alcaraz,Southampton,0.1,0,0,0,0,0,0,0,0.0,0,0,0,0,1,1,0,0
58,Omar Alderete,Getafe,8.0,12,8,10,1,1,6,7,85.7,1,8,6,2,6,18,46,1
59,Carles Alena,Getafe,3.4,6,3,2,3,1,4,8,50.0,4,7,1,6,0,6,2,0
60,Trent Alexander-Arnold,Liverpool,6.5,17,11,9,6,2,11,18,61.1,7,5,1,4,5,22,5,0
61,Alfon,Celta Vigo,2.1,1,0,0,1,0,0,1,0.0,1,2,0,2,1,2,1,0
62,Mohamed Ali Cho,Nice,4.8,3,2,0,1,2,0,3,0.0,3,3,0,3,1,4,2,0
63,Faride Alidou,Hellas Verona,0.7,0,0,0,0,0,0,0,0.0,0,1,0,1,0,0,2,1
64,Alisson,Liverpool,5.9,0,0,0,0,0,0,0,0.0,0,0,0,0,0,0,2,0
65,Jim Allevinah,Angers,2.5,2,1,1,0,1,0,2,0.0,2,1,0,1,1,3,3,0
66,Domingos Andre Ribeiro Almeida,Valencia,4.6,11,7,5,4,2,4,6,66.7,2,5,1,4,2,13,2,0
67,Iker Almena,Girona,0.5,0,0,0,0,0,0,1,0.0,1,1,0,1,0,0,2,0
68,Miguel Almiron,Newcastle Utd,0.4,1,1,1,0,0,1,1,100.0,0,0,0,0,0,1,0,0
69,Pontus Almqvist,Parma,1.9,5,3,3,1,1,3,5,60.0,2,1,0,1,5,10,1,0
70,Marcos Alonso,Celta Vigo,4.1,3,1,2,1,0,2,5,40.0,3,4,2,2,6,9,12,0
71,Giorgio Altare,Venezia,2.2,5,4,4,1,0,1,4,25.0,3,3,2,1,4,9,9,0
72,Adria Altimira,Leganés,3.0,7,3,2,4,1,4,9,44.4,5,1,1,0,5,12,4,0
73,Sergi Altimira,Betis,3.9,6,4,3,2,1,4,9,44.4,5,3,0,3,2,8,4,0
74,Edson Alvarez,West Ham,2.7,10,6,6,3,1,5,6,83.3,1,4,1,3,4,14,4,0
75,Hugo Alvarez,Celta Vigo,7.5,14,5,8,5,1,6,10,60.0,4,8,1,7,4,18,13,1
76,Julian Alvarez,Atlético Madrid,5.7,2,1,1,0,1,1,4,25.0,3,6,0,6,0,2,3,0
78,Yeray Alvarez,Athletic Club,4.0,6,4,3,2,1,3,5,60.0,2,3,1,2,9,15,15,1
79,Skelly Alvero,Werder Bremen,1.1,3,3,3,0,0,1,1,100.0,0,4,0,4,2,5,5,0
80,Selim Amallah,Valladolid,5.1,10,6,4,5,1,0,5,0.0,5,12,0,12,5,15,1,0
81,Amath,Valladolid,3.3,1,0,1,0,0,1,5,20.0,4,5,1,4,2,3,2,0
82,Jordan Amavi,Brest,3.8,14,10,5,6,3,9,13,69.2,4,5,2,3,6,20,8,0
83,Aurele Amenda,Eint Frankfurt,0.6,0,0,0,0,0,0,0,0.0,0,2,2,0,1,1,4,0
84,Kelvin Amian,Nantes,5.2,21,12,19,2,0,11,13,84.6,2,6,2,4,1,22,11,0
85,Michael Amir Murillo,Marseille,7.0,17,10,8,6,3,10,17,58.8,7,4,3,1,5,22,17,0
86,Nadiem Amiri,Mainz 05,4.2,6,1,3,3,0,1,7,14.3,6,5,2,3,2,8,8,0
87,Samuel Amo-Ameyaw,Southampton,0.1,0,0,0,0,0,0,0,0.0,0,0,0,0,0,0,0,0
88,Mathis Amougou,Saint-Étienne,6.0,8,5,6,2,0,4,7,57.1,3,4,0,4,10,18,2,0
89,Mohamed Amoura,Wolfsburg,3.4,3,1,1,0,2,0,0,0.0,0,4,0,4,0,3,1,0
90,Sofyan Amrabat,Fiorentina,2.0,3,2,1,2,0,2,2,100.0,0,1,1,0,0,3,2,0
91,Joachim Andersen,Crystal Palace,1.0,1,1,1,0,0,1,2,50.0,1,0,0,0,0,1,7,0
92,Joachim Andersen,Fulham,4.0,4,2,4,0,0,3,6,50.0,3,6,4,2,6,10,31,0
93,Elliot Anderson,Nott'ham Forest,4.7,15,12,9,4,2,10,15,66.7,5,14,3,11,4,19,13,0
94,Andre,Wolves,3.5,8,4,4,2,2,5,6,83.3,1,5,2,3,2,10,2,0
95,Benjamin Andre,Lille,5.9,19,7,9,9,1,11,19,57.9,8,7,0,7,8,27,6,0
96,Marcos Andre,Valladolid,2.8,0,0,0,0,0,0,2,0.0,2,3,1,2,1,1,2,0
97,Robert Andrich,Leverkusen,3.5,8,4,2,6,0,3,4,75.0,1,3,1,2,6,14,6,0
98,Angelino,Roma,6.8,13,3,3,8,2,3,4,75.0,1,4,3,1,6,19,23,0
99,Lorenzo Anghele,Juventus,0.1,0,0,0,0,0,0,0,0.0,0,0,0,0,0,0,0,0
100,Faustino Anjorin,Empoli,2.4,6,1,3,3,0,1,4,25.0,3,5,1,4,0,6,5,0
101,Waldemar Anton,Dortmund,6.0,12,9,7,4,1,4,5,80.0,1,11,8,3,6,18,25,1
102,Michail Antonio,West Ham,4.8,0,0,0,0,0,0,1,0.0,1,2,0,2,0,0,1,0
104,Antoniu,Espanyol,0.4,3,0,1,1,1,1,1,100.0,0,0,0,0,1,4,2,1
105,Antony,Manchester Utd,0.3,2,0,2,0,0,1,3,33.3,2,1,0,1,1,3,0,0
106,Anuar,Valladolid,0.3,0,0,0,0,0,0,0,0.0,0,0,0,0,1,1,0,0
107,Dennis Appiah,Saint-Étienne,4.9,14,12,9,5,0,10,22,45.5,12,7,4,3,4,18,18,0
108,Aritz Arambarri,Leganés,2.0,1,1,1,0,0,1,1,100.0,0,2,2,0,3,4,8,0
109,Mauro Arambarri,Getafe,5.2,8,4,1,5,2,3,8,37.5,5,6,1,5,2,10,11,0
110,Jon Aramburu,Real Sociedad,4.8,24,18,14,6,4,15,19,78.9,4,9,2,7,1,25,19,0
111,Julian Araujo,Bournemouth,3.0,5,2,3,2,0,3,9,33.3,6,1,0,1,3,8,9,0
112,Cameron Archer,Southampton,3.2,4,2,1,1,2,1,2,50.0,1,1,0,1,1,5,0,0
113,Carlens Arcus,Angers,5.3,14,6,8,5,1,8,18,44.4,10,8,1,7,10,24,8,1
114,Alphonse Areola,West Ham,6.5,1,1,1,0,0,1,2,50.0,1,0,0,0,0,1,3,0
115,Adu Ares,Athletic Club,0.2,0,0,0,0,0,0,1,0.0,1,0,0,0,0,0,0,0
116,Jesus Areso,Osasuna,7.8,9,7,6,2,1,8,13,61.5,5,9,2,7,3,12,19,0
117,Joe Aribo,Southampton,4.0,6,4,1,3,2,2,3,66.7,1,3,3,0,4,10,4,0
118,Adam Armstrong,Southampton,2.6,3,1,1,1,1,1,4,25.0,3,1,0,1,2,5,1,0
119,Harrison Armstrong,Everton,0.0,0,0,0,0,0,0,1,0.0,1,0,0,0,0,0,0,0
120,Jose Arnaiz,Osasuna,0.2,1,1,1,0,0,0,0,0.0,0,0,0,0,0,1,0,0
121,Hakon Arnar Haraldsson,Lille,1.9,5,2,2,2,1,3,7,42.9,4,0,0,0,1,6,0,0
122,Marko Arnautovic,Inter,0.4,2,2,1,1,0,1,1,100.0,0,0,0,0,0,2,1,0
123,Maximilian Arnold,Wolfsburg,5.9,11,8,3,6,2,4,9,44.4,5,5,4,1,2,13,17,0
124,Jann-Fiete Arp,Holstein Kiel,2.0,5,4,3,1,1,1,3,33.3,2,1,0,1,0,5,0,0
125,Kepa Arrizabalaga,Bournemouth,4.0,0,0,0,0,0,0,1,0.0,1,0,0,0,0,0,3,1
126,Arthur,Leverkusen,0.1,0,0,0,0,0,0,0,0.0,0,0,0,0,1,1,1,0
127,Takuma Asano,Mallorca,3.5,5,3,1,3,1,2,3,66.7,1,3,0,3,2,7,4,0
128,Marco Asensio,Paris S-G,3.1,1,1,0,1,0,0,3,0.0,3,1,0,1,0,1,0,0
130,Kristjan Asllani,Inter,1.6,4,0,3,1,0,2,6,33.3,4,3,1,2,1,5,3,0
131,Iago Aspas,Celta Vigo,7.0,6,3,2,2,2,5,10,50.0,5,5,0,5,1,7,4,0
132,Yaser Asprilla,Girona,3.8,8,4,4,3,1,3,7,42.9,4,0,0,0,3,11,4,0
133,Lorenz Assignon,Rennes,4.5,6,4,2,4,0,4,7,57.1,3,6,3,3,7,13,21,0
134,Dehmaine Assoumani,Nantes,0.4,4,1,0,2,2,2,2,100.0,0,0,0,0,0,4,1,0
135,Valentin Atangana Edoa,Reims,6.6,14,9,7,6,1,5,8,62.5,3,6,3,3,9,23,10,0
136,Arthur Atta,Udinese,0.3,2,2,0,1,1,0,0,0.0,0,0,0,0,0,2,0,0
137,Noah Atubolu,Freiburg,4.0,0,0,0,0,0,0,0,0.0,0,0,0,0,0,0,2,1
138,Emil Audero,Como,4.0,0,0,0,0,0,0,0,0.0,0,0,0,0,0,0,2,0
139,Tommaso Augello,Cagliari,5.5,10,5,5,3,2,7,9,77.8,2,8,3,5,5,15,26,0
140,Carlos Augusto,Inter,2.1,3,2,2,1,0,2,4,50.0,2,1,1,0,1,4,6,0
141,Yann Aurel Bisseck,Inter,2.5,1,1,1,0,0,1,2,50.0,1,0,0,0,3,4,9,1
142,Ezequiel Avila,Betis,2.3,3,1,1,1,1,1,3,33.3,2,2,0,2,1,4,1,0
143,Taiwo Awoniyi,Nott'ham Forest,0.9,1,0,0,1,0,1,1,100.0,0,1,0,1,0,1,2,0
144,Yasin Ayari,Brighton,2.2,9,5,1,7,1,3,6,50.0,3,2,1,1,2,11,0,0
145,Florian Aye,Auxerre,1.7,0,0,0,0,0,0,1,0.0,1,3,0,3,1,1,3,0
146,Jordan Ayew,Crystal Palace,0.2,1,0,0,0,1,0,0,0.0,0,0,0,0,0,1,0,0
147,Jordan Ayew,Leicester City,4.0,8,4,3,4,1,1,4,25.0,3,4,0,4,3,11,1,0
148,Neil El Aynaoui,Lens,0.1,0,0,0,0,0,0,0,0.0,0,0,0,0,0,0,0,0
149,Cesar Azpilicueta,Atlético Madrid,4.3,8,3,4,4,0,8,12,66.7,4,2,1,1,1,9,11,0
150,Paulo Azzi,Cagliari,3.7,8,7,1,6,1,3,5,60.0,2,4,2,2,4,12,8,0
151,Shavy Babicka,Toulouse,3.0,7,6,3,3,1,4,5,80.0,1,1,0,1,0,7,0,1
152,Aliou Badara Balde,Bochum,1.0,1,1,1,0,0,0,0,0.0,0,2,0,2,0,1,0,0
153,Loic Bade,Sevilla,6.2,12,8,10,2,0,5,6,83.3,1,2,1,1,5,17,33,1
154,Milan Badelj,Genoa,4.4,5,3,2,3,0,3,6,50.0,3,5,3,2,3,8,5,0
156,Alex Baena,Villarreal,6.4,2,1,0,1,1,1,5,20.0,4,10,1,9,7,9,2,0
157,Leon Bailey,Aston Villa,3.9,2,0,0,1,1,0,0,0.0,0,1,0,1,0,2,4,0
158,Eric Bailly,Villarreal,5.4,9,2,5,4,0,2,3,66.7,1,8,3,5,5,14,19,0
159,Theo Bair,Auxerre,2.4,1,0,0,1,0,0,0,0.0,0,2,1,1,0,1,2,0
160,Cedric Bakambu,Betis,1.5,0,0,0,0,0,0,0,0.0,0,2,0,2,0,0,0,0
161,Mitchel Bakker,Atalanta,0.2,1,0,1,0,0,1,1,100.0,0,0,0,0,0,1,0,0
162,Mitchel Bakker,Lille,0.8,5,4,1,2,2,2,2,100.0,0,0,0,0,5,10,2,0
163,Ridle Baku,Wolfsburg,4.4,7,5,1,4,2,3,9,33.3,6,10,0,10,5,12,5,0
164,Dilane Bakwa,Strasbourg,6.8,8,5,5,1,2,4,7,57.1,3,5,0,5,3,11,8,0
165,Tommaso Baldanzi,Roma,1.7,5,1,3,1,1,0,1,0.0,1,2,0,2,1,6,2,0
166,Alejandro Balde,Barcelona,6.1,5,4,2,2,1,3,4,75.0,1,3,2,1,2,7,9,0
167,Carlos Baleba,Brighton,4.7,15,8,1,8,6,8,13,61.5,5,6,1,5,10,25,1,0
168,Leonardo Balerdi,Marseille,3.0,4,4,3,1,0,2,3,66.7,1,4,4,0,3,7,8,1
169,Ivan Balliu,Rayo Vallecano,5.5,9,7,2,4,3,3,8,37.5,5,2,1,1,5,14,15,0
170,Botond Balogh,Parma,6.4,13,4,9,4,0,10,11,90.9,1,14,10,4,8,21,46,1
171,Folarin Balogun,Monaco,4.5,0,0,0,0,0,0,2,0.0,2,0,0,0,0,0,0,0
172,Abdoulaye Bamba,Angers,2.7,5,2,4,1,0,2,3,66.7,1,1,1,0,4,9,12,0
173,Jonathan Bamba,Celta Vigo,2.8,4,1,1,2,1,2,4,50.0,2,2,0,2,3,7,3,0
174,Samuel Bamba,Bochum,0.1,0,0,0,0,0,0,0,0.0,0,0,0,0,0,0,0,0
175,Lameck Banda,Lecce,2.7,2,2,2,0,0,1,3,33.3,2,4,0,4,1,3,3,0
176,Daniel Bandeira,Hellas Verona,2.7,4,0,1,3,0,3,5,60.0,2,2,1,1,6,10,6,0
177,Mattia Bani,Genoa,4.0,2,1,2,0,0,1,1,100.0,0,3,2,1,8,10,12,0
178,Scott Banks,St. Pauli,0.3,0,0,0,0,0,0,0,0.0,0,0,0,0,1,1,1,0
179,Antonin Barak,Fiorentina,0.6,2,0,0,2,0,0,2,0.0,2,1,1,0,0,2,0,0
180,Federico Barba,Como,2.0,0,0,0,0,0,0,1,0.0,1,1,1,0,3,3,9,0
182,Valentin Barco,Sevilla,2.8,14,8,7,3,4,11,14,78.6,3,0,0,0,2,16,5,0
183,Bradley Barcola,Paris S-G,5.2,8,4,5,2,1,1,6,16.7,5,6,0,6,2,10,1,0
184,Melvin Bard,Nice,3.7,8,4,4,4,0,3,6,50.0,3,7,2,5,2,10,4,1
185,Nicolo Barella,Inter,3.5,3,3,2,0,1,1,10,10.0,9,5,0,5,1,4,0,0
186,Gabriel Bares,Montpellier,0.3,1,1,1,0,0,1,2,50.0,1,0,0,0,1,2,1,0
187,Ross Barkley,Aston Villa,2.4,5,2,3,2,0,4,6,66.7,2,3,1,2,1,6,2,0
188,Aymen Barkok,Mainz 05,0.8,2,1,1,1,0,1,1,100.0,0,1,1,0,2,4,0,0
189,Harvey Barnes,Newcastle Utd,4.3,5,3,2,2,1,2,2,100.0,0,1,0,1,3,8,4,0
190,Enzo Barrenechea,Valencia,2.3,5,1,3,2,0,3,6,50.0,3,3,0,3,2,7,7,0
191,Ander Barrenetxea,Real Sociedad,3.1,5,4,0,4,1,0,4,0.0,4,4,0,4,4,9,7,0
192,Pablo Barrios,Atlético Madrid,4.5,9,5,4,5,0,4,11,36.4,7,1,1,0,7,16,5,2
193,Thierno Barry,Villarreal,6.0,1,0,0,1,0,1,3,33.3,2,3,0,3,0,1,4,0
194,Davide Bartesaghi,Milan,0.1,0,0,0,0,0,0,0,0.0,0,0,0,0,0,0,0,0
195,Marc Bartra,Betis,1.9,2,2,2,0,0,2,2,100.0,0,4,3,1,2,4,5,0
196,Federico Baschirotto,Lecce,7.0,8,6,7,1,0,5,6,83.3,1,12,9,3,8,16,25,0
197,Daniele Baselli,Como,0.2,0,0,0,0,0,0,0,0.0,0,0,0,0,1,1,1,0
198,Calvin Bassey,Fulham,7.0,7,5,5,2,0,1,2,50.0,1,14,9,5,2,9,28,1
199,Aboubacar Bassinga,Las Palmas,0.0,0,0,0,0,0,0,0,0.0,0,0,0,0,0,0,0,0
200,Alessandro Bastoni,Inter,5.3,7,4,4,2,1,5,8,62.5,3,2,0,2,6,13,10,0
201,Augusto Batalla,Rayo Vallecano,5.0,0,0,0,0,0,0,1,0.0,1,0,0,0,0,0,2,1
202,Dylan Batubinsika,Saint-Étienne,7.0,11,6,9,2,0,5,7,71.4,2,7,3,4,15,26,38,0
203,Maximilian Bauer,Augsburg,3.8,9,4,4,4,1,5,9,55.6,4,5,1,4,4,13,23,1
204,Oliver Baumann,Hoffenheim,6.0,0,0,0,0,0,0,1,0.0,1,0,0,0,0,0,4,0
205,Christoph Baumgartner,RB Leipzig,1.3,2,2,1,1,0,2,7,28.6,5,3,1,2,0,2,2,0
206,Adrian Beck,Heidenheim,2.6,3,2,1,2,0,0,5,0.0,5,9,0,9,4,7,5,0
208,Sheraldo Becker,Real Sociedad,5.5,1,1,0,1,0,0,2,0.0,2,3,0,3,1,2,7,0
209,Timo Becker,Holstein Kiel,6.0,11,5,7,4,0,6,10,60.0,4,8,6,2,4,15,17,0
210,Jan Bednarek,Southampton,6.9,7,3,5,2,0,3,7,42.9,4,13,11,2,11,18,39,1
211,Donny van de Beek,Girona,2.3,3,1,2,1,0,1,2,50.0,1,5,0,5,0,3,4,0
212,Kevin Behrens,Wolfsburg,0.5,1,1,0,1,0,0,1,0.0,1,0,0,0,0,1,0,0
213,Maximilian Beier,Dortmund,2.5,3,1,0,2,1,2,4,50.0,2,2,0,2,0,3,2,0
214,Reda Belahyane,Hellas Verona,6.8,13,9,5,5,3,5,5,100.0,0,6,4,2,3,16,6,0
215,Haris Belkebla,Angers,3.9,8,6,6,2,0,3,8,37.5,5,5,1,4,2,10,4,1
216,Yassin Belkhdim,Angers,3.2,11,5,3,5,3,3,5,60.0,2,5,1,4,6,17,4,0
217,Stefan Bell,Mainz 05,1.8,4,2,3,1,0,0,2,0.0,2,1,1,0,5,9,12,0
218,Raoul Bellanova,Torino,1.0,0,0,0,0,0,0,1,0.0,1,0,0,0,0,0,4,0
219,Raoul Bellanova,Atalanta,4.2,4,2,0,3,1,1,1,100.0,0,2,0,2,3,7,5,0
220,Jean-Ricner Bellegarde,Wolves,4.5,6,4,2,2,2,2,3,66.7,1,5,0,5,4,10,1,0
221,Hector Bellerin,Betis,4.3,11,6,6,3,2,8,12,66.7,4,2,1,1,2,13,14,0
222,Jude Bellingham,Real Madrid,4.9,14,9,7,4,3,7,9,77.8,2,9,0,9,6,20,3,0
223,Jeanuel Belocian,Leverkusen,0.5,1,1,1,0,0,1,1,100.0,0,0,0,0,0,1,2,0
224,Andrea Belotti,Como,2.3,4,3,1,2,1,0,2,0.0,2,1,0,1,1,5,2,0
225,Fran Beltran,Celta Vigo,5.6,11,6,6,4,1,5,9,55.6,4,7,3,4,4,15,7,0
226,Lucas Beltran,Fiorentina,1.0,0,0,0,0,0,0,0,0.0,0,1,0,1,0,0,0,0
227,Eliesse Ben Seghir,Monaco,5.1,15,12,4,7,4,9,12,75.0,3,7,0,7,0,15,1,0
228,Carlos Benavidez,Alavés,2.4,5,3,2,2,1,0,3,0.0,3,1,1,0,5,10,3,1
229,Laszlo Benes,Union Berlin,1.5,0,0,0,0,0,0,1,0.0,1,1,1,0,0,0,1,0
230,Iker Benito,Osasuna,0.4,0,0,0,0,0,0,1,0.0,1,0,0,0,1,1,2,0
231,Ismael Bennacer,Milan,0.6,1,1,0,1,0,0,0,0.0,0,0,0,0,0,1,0,0
232,Said Benrahma,Lyon,3.8,3,2,1,1,1,2,5,40.0,3,4,0,4,1,4,0,0
234,Ramy Bensebaini,Dortmund,2.0,1,0,1,0,0,0,3,0.0,3,7,0,7,3,4,5,1
235,Rodrigo Bentancur,Tottenham,4.3,8,6,4,4,0,5,7,71.4,2,4,0,4,11,19,4,0
236,Lucas Beraldo,Paris S-G,4.9,10,9,9,1,0,7,13,53.8,6,4,0,4,3,13,8,0
237,Yuri Berchiche,Athletic Club,5.4,8,5,6,1,1,4,9,44.4,5,7,2,5,5,13,14,0
238,Alex Berenguer,Athletic Club,5.6,6,2,2,2,2,4,7,57.1,3,5,2,3,4,10,3,0
239,Sander Berge,Fulham,1.9,5,2,2,3,0,0,0,0.0,0,4,1,3,4,9,4,0
240,Lucas Bergvall,Tottenham,0.6,5,2,0,3,2,5,7,71.4,2,0,0,0,0,5,0,0
241,Medon Berisha,Lecce,0.9,2,1,1,1,0,1,1,100.0,0,0,0,0,0,2,0,0
242,Mergim Berisha,Hoffenheim,2.4,1,1,1,0,0,0,2,0.0,2,0,0,0,0,1,2,0
243,Adrian Bernabe,Parma,6.9,14,10,11,3,0,9,18,50.0,9,16,9,7,5,19,11,0
244,Marc Bernal,Barcelona,2.7,8,6,2,5,1,7,8,87.5,1,5,1,4,1,9,4,0
245,Juan Bernat,Villarreal,0.3,2,1,1,0,1,1,2,50.0,1,1,0,1,0,2,0,0
246,Alexander Bernhardsson,Holstein Kiel,1.7,1,1,0,0,1,1,1,100.0,0,2,0,2,0,1,2,0
247,Victor Bernth Kristiansen,Leicester City,6.9,19,13,13,6,0,8,16,50.0,8,14,6,8,10,29,23,0
248,Matus Bero,Bochum,5.7,11,6,5,2,4,5,16,31.3,11,12,2,10,2,13,6,1
249,Juan Berrocal,Getafe,4.9,8,3,6,2,0,6,8,75.0,2,0,0,0,6,14,25,0
250,Dimitry Bertaud,Montpellier,3.0,0,0,0,0,0,0,0,0.0,0,0,0,0,0,0,2,0
251,Beto,Everton,0.5,1,0,0,0,1,0,0,0.0,0,1,0,1,0,1,0,0
252,Sam Beukema,Bologna,6.5,10,4,4,5,1,3,9,33.3,6,6,4,2,6,16,14,0
253,Alessandro Bianco,Monza,2.8,7,6,4,3,0,3,3,100.0,0,2,0,2,1,8,4,1
254,Alessandro Bianco,Fiorentina,0.2,0,0,0,0,0,0,1,0.0,1,0,0,0,0,0,0,0
255,Jaka Bijol,Udinese,7.0,16,9,12,4,0,10,14,71.4,4,12,7,5,10,26,33,1
256,El Bilal Toure,Stuttgart,1.4,2,1,0,1,1,2,2,100.0,0,1,0,1,0,2,0,0
257,Philip Billing,Bournemouth,0.3,1,0,1,0,0,0,0,0.0,0,0,0,0,1,2,0,0
258,Cristiano Biraghi,Fiorentina,4.7,4,4,1,3,0,2,7,28.6,5,2,0,2,4,8,9,0
260,Samuele Birindelli,Monza,1.9,4,4,2,2,0,1,1,100.0,0,2,1,1,0,4,2,0
261,Tom Bischof,Hoffenheim,2.8,13,6,5,8,0,4,6,66.7,2,5,3,2,3,16,8,0
262,Yves Bissouma,Tottenham,2.1,5,4,2,3,0,4,7,57.1,3,2,0,2,2,7,3,0
263,Leonardo Bittencourt,Werder Bremen,0.4,0,0,0,0,0,0,0,0.0,0,1,0,1,0,0,0,0
264,Emmanuel Biumla,Angers,4.1,10,5,6,4,0,8,10,80.0,2,5,1,4,4,14,12,0
265,Marco Bizot,Brest,7.0,0,0,0,0,0,0,0,0.0,0,0,0,0,0,0,5,0
266,Antonio Blanco,Alavés,5.8,11,7,4,7,0,8,14,57.1,6,8,2,6,7,18,4,0
267,Ludovic Blas,Rennes,6.6,7,6,2,3,2,6,12,50.0,6,7,2,5,3,10,2,0
268,Daley Blind,Girona,7.6,15,8,7,7,1,9,9,100.0,0,12,4,8,10,25,22,0
269,Myron Boadu,Bochum,3.9,0,0,0,0,0,0,1,0.0,1,1,0,1,0,0,3,0
270,Augustine Boakye,Saint-Étienne,0.6,3,1,1,2,0,2,4,50.0,2,0,0,0,0,3,0,0
271,Sacha Boey,Bayern Munich,1.4,3,0,2,0,1,2,3,66.7,1,1,0,1,0,3,4,0
272,Jeremie Boga,Nice,2.7,1,1,0,1,0,0,1,0.0,1,2,0,2,0,1,0,0
273,Lamare Bogarde,Aston Villa,1.9,8,4,2,5,1,5,9,55.6,4,1,0,1,1,9,4,0
274,Emil Bohinen,Genoa,1.8,4,4,3,0,1,2,5,40.0,3,2,0,2,1,5,6,0
275,Adama Boiro,Athletic Club,2.4,7,4,3,4,0,2,3,66.7,1,4,3,1,3,10,6,0
276,Willy Boly,Nott'ham Forest,1.0,4,0,3,1,0,3,3,100.0,0,3,1,2,1,5,8,0
277,Moise Bombito,Nice,4.7,7,6,4,3,0,4,6,66.7,2,5,5,0,5,12,26,1
278,Warren Bondo,Monza,6.1,11,6,9,1,1,4,7,57.1,3,6,2,4,2,13,2,1
279,Victor Boniface,Leverkusen,4.6,2,2,0,2,0,1,1,100.0,0,1,0,1,0,2,3,0
280,Ange-Yoan Bonny,Parma,5.9,6,4,1,5,0,1,4,25.0,3,1,0,1,0,6,2,0
281,Sebastiaan Bornauw,Wolfsburg,6.0,5,3,2,2,1,1,4,25.0,3,11,11,0,8,13,25,0
282,Ayyoub Bouaddi,Lille,1.5,11,7,7,3,1,4,7,57.1,3,2,0,2,0,11,0,0
283,Badredine Bouanani,Nice,2.9,0,0,0,0,0,0,2,0.0,2,3,0,3,3,3,0,0
284,Benjamin Bouchouari,Saint-Étienne,0.5,2,1,1,1,0,1,5,20.0,4,0,0,0,0,2,1,0
286,Hicham Boudaoui,Nice,5.0,18,9,12,3,3,9,16,56.3,7,7,2,5,4,22,4,0
287,Carlo Boukhalfa,St. Pauli,2.6,6,1,0,5,1,0,2,0.0,2,3,0,3,3,9,2,0
288,Benjamin Bourigeaud,Rennes,0.9,1,0,0,1,0,0,2,0.0,2,2,1,1,2,3,1,0
289,Edoardo Bove,Fiorentina,4.2,10,7,5,5,0,6,14,42.9,8,4,0,4,3,13,4,0
290,Jarrod Bowen,West Ham,6.7,8,4,2,3,3,1,8,12.5,7,6,1,5,2,10,9,0
291,Enzo Boyomo,Osasuna,6.0,14,11,10,3,1,6,7,85.7,1,10,6,4,5,19,31,0
292,Enzo Boyomo,Valladolid,3.0,6,2,4,2,0,3,3,100.0,0,4,3,1,1,7,7,0
293,Domagoj Bradaric,Hellas Verona,1.0,0,0,0,0,0,0,2,0.0,2,0,0,0,0,0,1,0
294,Conor Bradley,Liverpool,0.9,0,0,0,0,0,0,1,0.0,1,0,0,0,2,2,5,0
295,Bilal Brahimi,Nice,0.8,0,0,0,0,0,0,0,0.0,0,1,0,1,0,0,2,0
296,Julian Brandt,Dortmund,5.2,3,0,2,1,0,1,2,50.0,1,2,0,2,1,4,3,0
297,Jarrad Branthwaite,Everton,1.0,2,2,1,1,0,0,0,0.0,0,1,0,1,3,5,5,0
298,Darko Brasanac,Leganés,5.6,8,2,2,4,2,2,3,66.7,1,6,5,1,3,11,16,0
299,Lilian Brassier,Marseille,5.0,5,4,5,0,0,3,4,75.0,1,6,2,4,4,9,20,0
300,Matthias Braunoder,Como,1.5,5,2,3,1,1,5,7,71.4,2,0,0,0,0,5,3,0
301,Iker Bravo,Udinese,0.6,1,1,0,1,0,0,1,0.0,1,0,0,0,0,1,1,0
302,Tim Breithaupt,Augsburg,1.3,1,1,0,1,0,0,4,0.0,4,1,0,1,2,3,0,0
303,Gleison Bremer,Juventus,6.0,15,7,9,5,1,4,5,80.0,1,15,11,4,6,21,16,0
304,Brenner,Udinese,4.1,5,3,1,3,1,2,7,28.6,5,4,0,4,1,6,5,0
305,Ben Brereton,Southampton,4.3,2,2,0,1,1,1,8,12.5,7,2,1,1,0,2,3,0
306,Marco Brescianini,Atalanta,4.1,2,1,1,1,0,1,2,50.0,1,5,1,4,0,2,2,0
307,Maximilian Breunig,Heidenheim,2.5,4,3,1,2,1,3,4,75.0,1,4,2,2,1,5,3,0
308,David Brooks,Bournemouth,0.1,0,0,0,0,0,0,0,0.0,0,0,0,0,0,0,0,0
309,Moritz Broschinski,Bochum,3.1,3,2,1,2,0,0,3,0.0,3,3,0,3,0,3,4,0
310,Jacob Bruun Larsen,Hoffenheim,1.0,1,0,1,0,0,1,2,50.0,1,3,0,3,1,2,1,0
312,Ante Budimir,Osasuna,6.6,6,2,1,5,0,1,3,33.3,2,6,1,5,1,7,5,0
313,Emi Buendia,Aston Villa,0.2,1,1,1,0,0,0,1,0.0,1,2,0,2,0,1,0,0
314,Santiago Bueno,Wolves,0.9,3,2,2,1,0,2,2,100.0,0,2,0,2,1,4,6,0
315,Marius Bulter,Hoffenheim,4.8,5,5,1,3,1,5,7,71.4,2,2,1,1,1,6,2,0
316,Facundo Buonanotte,Leicester City,4.1,12,4,4,5,3,6,17,35.3,11,8,1,7,2,14,6,0
317,Alessandro Buongiorno,Napoli,6.0,10,7,8,2,0,6,7,85.7,1,13,9,4,2,12,17,0
318,Jonathan Burkardt,Mainz 05,6.0,0,0,0,0,0,0,2,0.0,2,2,1,1,0,0,7,0
319,Oliver Burke,Werder Bremen,0.1,0,0,0,0,0,0,0,0.0,0,0,0,0,0,0,0,0
320,Dan Burn,Newcastle Utd,7.0,8,4,6,2,0,5,9,55.6,4,7,5,2,5,13,35,1
321,Wes Burns,Ipswich Town,3.1,2,2,0,1,1,0,1,0.0,1,3,0,3,0,2,2,1
322,Marnon Busch,Heidenheim,2.7,4,2,3,1,0,4,7,57.1,3,4,3,1,1,5,12,0
323,Gianluca Busio,Venezia,3.8,5,3,4,1,0,4,6,66.7,2,5,2,3,1,6,9,0
324,Aurelio Buta,Reims,4.7,12,7,10,1,1,9,14,64.3,5,1,0,1,5,17,14,0
325,Marcin Bulka,Nice,7.0,0,0,0,0,0,0,0,0.0,0,0,0,0,0,0,2,2
326,Pau Cabanes,Villarreal,0.2,0,0,0,0,0,0,0,0.0,0,0,0,0,0,0,1,0
327,Remy Cabella,Lille,3.0,9,5,1,6,2,6,10,60.0,4,2,0,2,3,12,0,0
328,Leandro Cabrera,Espanyol,4.5,6,3,4,2,0,2,4,50.0,2,7,6,1,4,10,30,1
329,Liberato Cacace,Empoli,1.2,1,1,1,0,0,1,2,50.0,1,4,2,2,0,1,6,0
330,Anthony Caci,Mainz 05,5.2,7,4,2,3,2,3,5,60.0,2,7,2,5,6,13,17,1
331,Mathieu Cafaro,Saint-Étienne,4.6,4,3,2,1,1,1,7,14.3,6,3,1,2,5,9,2,0
332,Moises Caicedo,Chelsea,6.8,27,16,14,11,2,19,27,70.4,8,11,3,8,10,37,11,0
333,Tom Cairney,Fulham,1.1,3,1,1,0,2,1,2,50.0,1,1,0,1,2,5,0,0
334,Jens Cajuste,Ipswich Town,0.9,2,1,0,2,0,0,0,0.0,0,0,0,0,0,2,3,0
335,Davide Calabria,Milan,1.6,4,2,4,0,0,3,5,60.0,2,0,0,0,3,7,4,0
336,Riccardo Calafiori,Arsenal,3.3,9,6,5,3,1,7,11,63.6,4,6,2,4,4,13,7,0
338,Luca Caldirola,Monza,2.1,0,0,0,0,0,0,1,0.0,1,1,1,0,0,0,7,0
339,Fernando Calero,Espanyol,2.1,4,2,4,0,0,1,2,50.0,1,3,3,0,5,9,20,0
340,Duje Caleta-Car,Lyon,7.0,8,3,5,3,0,2,4,50.0,2,9,8,1,11,19,36,0
341,Hakan Calhanoglu,Inter,5.1,13,7,1,5,7,5,8,62.5,3,1,1,0,3,16,5,0
342,Dominic Calvert-Lewin,Everton,6.6,3,2,1,1,1,0,0,0.0,0,3,1,2,3,6,9,0
343,Drissa Camara,Parma,0.3,0,0,0,0,0,0,2,0.0,2,0,0,0,0,0,1,0
344,Issiaga Camara,Nice,0.0,0,0,0,0,0,0,0,0.0,0,0,0,0,1,1,0,0
345,Lamine Camara,Monaco,4.7,20,14,8,9,3,8,14,57.1,6,6,3,3,9,29,4,0
346,Mahdi Camara,Brest,5.8,17,8,2,11,4,6,9,66.7,3,11,1,10,9,26,8,0
347,Eduardo Camavinga,Real Madrid,0.8,4,3,1,3,0,3,3,100.0,0,0,0,0,1,5,1,0
348,Nicolo Cambiaghi,Bologna,0.2,1,0,0,1,0,0,0,0.0,0,1,0,1,0,1,0,0
349,Andrea Cambiaso,Juventus,6.1,9,5,6,2,1,6,11,54.5,5,2,0,2,2,11,10,0
350,Axel Camblan,Brest,0.3,1,1,0,0,1,1,2,50.0,1,1,0,1,0,1,0,0
351,Sergio Camello,Rayo Vallecano,5.5,3,0,1,2,0,0,0,0.0,0,4,1,3,3,6,9,0
352,Jose Campana,Las Palmas,2.3,3,3,1,2,0,2,4,50.0,2,2,0,2,7,10,4,0
353,Emre Can,Dortmund,4.1,7,3,2,4,1,3,6,50.0,3,5,3,2,2,9,9,1
354,Peio Canales,Athletic Club,0.2,1,1,0,0,1,0,0,0.0,0,0,0,0,1,2,1,0
355,Matteo Cancellieri,Parma,2.3,4,3,4,0,0,1,4,25.0,3,1,0,1,1,5,4,0
356,Antonio Candela,Venezia,5.9,10,7,6,3,1,6,8,75.0,2,4,3,1,2,12,8,0
357,Sergi Canos,Valencia,1.4,5,4,0,3,2,2,5,40.0,3,2,0,2,2,7,1,0
358,Jaydee Canvot,Toulouse,0.1,1,1,1,0,0,1,1,100.0,0,0,0,0,0,1,0,0
359,Pierrick Capelle,Angers,2.0,6,3,3,2,1,3,6,50.0,3,1,1,0,3,9,0,1
360,Gianluca Caprari,Monza,2.3,2,1,0,2,0,0,0,0.0,0,2,0,2,1,3,0,0
361,Elia Caprile,Napoli,2.6,0,0,0,0,0,0,0,0.0,0,0,0,0,0,0,1,0
362,Francesco Caputo,Empoli,0.1,0,0,0,0,0,0,0,0.0,0,0,0,0,0,0,0,0
364,Maxence Caqueret,Lyon,5.3,18,9,5,9,4,3,18,16.7,15,11,2,9,6,24,1,0
365,Andrea Carboni,Monza,4.9,12,7,8,4,0,7,14,50.0,7,6,1,5,6,18,21,0
366,Franco Carboni,Venezia,0.0,0,0,0,0,0,0,0,0.0,0,0,0,0,0,0,1,0
367,Valentin Carboni,Marseille,1.1,2,2,0,1,1,0,1,0.0,1,1,0,1,1,3,1,0
368,Cardenas,Rayo Vallecano,4.0,0,0,0,0,0,0,0,0.0,0,0,0,0,0,0,3,0
369,Irvin Cardona,Espanyol,3.1,5,4,2,3,0,4,12,33.3,8,4,1,3,3,8,5,0
370,Marc Cardona,Las Palmas,0.5,0,0,0,0,0,0,0,0.0,0,0,0,0,0,0,0,0
371,Sergi Cardona,Villarreal,8.8,20,13,13,6,1,12,23,52.2,11,19,2,17,8,28,32,0
372,Johnny Cardoso,Betis,2.7,8,5,2,6,0,4,11,36.4,7,4,1,3,4,12,5,0
373,Diego Carlos,Aston Villa,2.9,1,0,1,0,0,0,1,0.0,1,3,2,1,2,3,13,1
374,Carmona,Sevilla,8.8,27,19,17,8,2,12,18,66.7,6,7,3,4,17,44,16,0
375,Marco Carnesecchi,Atalanta,6.0,0,0,0,0,0,0,0,0.0,0,0,0,0,0,0,4,1
376,Sergio Carreira,Celta Vigo,2.6,6,4,3,2,1,2,4,50.0,2,2,0,2,1,7,9,0
377,Dani Carvajal,Real Madrid,6.8,12,8,7,3,2,9,12,75.0,3,8,3,5,10,22,19,1
378,Fabio Carvalho,Brentford,2.7,9,6,3,2,4,3,5,60.0,2,5,1,4,2,11,1,0
379,William Carvalho,Betis,2.7,3,2,0,3,0,2,4,50.0,2,4,1,3,3,6,4,0
380,Marc Casado,Barcelona,5.3,14,9,2,8,4,7,13,53.8,6,3,1,2,2,16,8,0
381,Nicolo Casale,Bologna,1.8,2,1,1,1,0,1,2,50.0,1,4,3,1,1,3,3,1
382,Nicolo Casale,Lazio,1.5,5,3,4,1,0,0,0,0.0,0,4,3,1,1,6,2,0
383,Casemiro,Manchester Utd,3.1,13,9,6,4,3,6,10,60.0,4,8,2,6,1,14,6,2
384,Matty Cash,Aston Villa,2.1,3,1,0,3,0,0,3,0.0,3,2,1,1,2,5,7,0
385,Josue Casimir,Le Havre,4.5,7,4,2,3,2,1,4,25.0,3,2,0,2,1,8,7,0
386,Federico Cassa,Atalanta,0.2,0,0,0,0,0,0,0,0.0,0,1,0,1,0,0,0,0
387,Cristian Casseres Jr.,Toulouse,5.7,26,17,14,10,2,9,17,52.9,8,9,2,7,8,34,7,0
388,Timothy Castagne,Fulham,0.2,4,2,2,2,0,3,4,75.0,1,0,0,0,0,4,0,0
390,Valentin Castellanos,Lazio,5.6,4,2,0,1,3,1,7,14.3,6,4,1,3,1,5,2,0
391,Jean-Charles Castelletto,Nantes,5.0,2,1,2,0,0,1,3,33.3,2,5,4,1,0,2,36,0
392,Santiago Castro,Bologna,6.0,5,2,2,3,0,0,2,0.0,2,4,0,4,1,6,8,0
393,Gaetano Castrovilli,Lazio,1.0,3,1,2,0,1,0,1,0.0,1,1,0,1,2,5,1,0
394,Danilo Cataldi,Fiorentina,4.0,7,6,1,4,2,3,4,75.0,1,3,2,1,3,10,5,0
395,Catena,Osasuna,8.0,10,4,4,6,0,6,12,50.0,6,7,3,4,6,16,57,0
396,Dani Ceballos,Real Madrid,0.8,4,3,1,3,0,1,3,33.3,2,1,0,1,0,4,0,0
397,Zeki Celik,Roma,5.8,15,11,5,6,4,7,12,58.3,5,4,2,2,2,17,14,0
398,Alberto Cerri,Como,0.7,0,0,0,0,0,0,0,0.0,0,1,0,1,0,0,1,0
399,Franco Cervi,Celta Vigo,0.1,0,0,0,0,0,0,2,0.0,2,0,0,0,1,1,0,0
400,Julian Chabot,Stuttgart,5.8,12,7,9,2,1,6,9,66.7,3,3,1,2,11,23,30,0
401,El Chadaille Bitshiabu,RB Leipzig,1.1,5,3,1,4,0,3,4,75.0,1,1,1,0,3,8,5,1
402,Fares Chaibi,Eint Frankfurt,4.0,6,4,2,2,2,3,6,50.0,3,6,0,6,5,11,15,0
403,Trevoh Chalobah,Crystal Palace,1.0,1,0,1,0,0,0,0,0.0,0,0,0,0,2,3,1,0
404,Conor Chaplin,Ipswich Town,1.1,3,3,3,0,0,1,3,33.3,2,2,0,2,0,3,1,0
405,Brendan Chardonnet,Brest,6.0,12,9,5,5,2,8,13,61.5,5,6,5,1,6,18,35,1
406,Gabriel Charpentier,Parma,0.6,1,1,1,0,0,1,1,100.0,0,1,0,1,0,1,5,0
407,Raul Chasco,Valladolid,0.4,1,1,1,0,0,0,1,0.0,1,1,0,1,1,2,2,0
408,Anrie Chase,Stuttgart,3.5,5,2,2,3,0,2,3,66.7,1,5,3,2,6,11,12,0
409,Pep Chavarria,Rayo Vallecano,3.4,5,5,3,2,0,2,7,28.6,5,5,1,4,5,10,10,0
410,Arthur Chaves,Hoffenheim,0.8,2,2,1,1,0,1,2,50.0,1,0,0,0,1,3,4,0
411,Jhoanner Chavez,Lens,4.4,4,2,2,1,1,1,3,33.3,2,7,1,6,4,8,6,0
412,Walid Cheddira,Napoli,0.1,0,0,0,0,0,0,0,0.0,0,0,0,0,0,0,0,0
413,Walid Cheddira,Espanyol,2.5,0,0,0,0,0,0,0,0.0,0,1,0,1,1,1,2,0
414,Theo Chennahi,Montpellier,0.0,0,0,0,0,0,0,0,0.0,0,1,0,1,0,0,0,0
416,Sidiki Cherif,Angers,3.1,4,4,0,3,1,3,4,75.0,1,2,0,2,0,4,0,1
417,Rayan Cherki,Lyon,1.2,0,0,0,0,0,0,1,0.0,1,1,0,1,0,0,1,0
418,Lucas Chevalier,Lille,7.0,1,1,1,0,0,1,1,100.0,0,0,0,0,0,1,0,0
419,Fabio Chiarodia,Gladbach,0.0,1,1,1,0,0,1,1,100.0,0,0,0,0,0,1,0,0
420,Julian Chicco,Leganés,1.3,6,4,0,6,0,3,5,60.0,2,0,0,0,2,8,1,0
421,Leandro Chichizola,Parma,1.0,0,0,0,0,0,0,0,0.0,0,0,0,0,0,0,2,0
422,Federico Chiesa,Liverpool,0.2,0,0,0,0,0,0,0,0.0,0,0,0,0,0,0,0,0
423,Chiquinho,Wolves,0.1,0,0,0,0,0,0,0,0.0,0,0,0,0,0,0,0,0
424,Chiquinho,Mallorca,0.7,1,0,0,1,0,0,5,0.0,5,1,0,1,0,1,0,0
425,Pedro Chirivella,Nantes,6.7,9,9,5,3,1,6,9,66.7,3,2,0,2,1,10,14,0
426,Joris Chotard,Montpellier,3.4,7,4,2,5,0,4,7,57.1,3,3,0,3,2,9,4,0
427,Hamza Choudhury,Leicester City,0.2,0,0,0,0,0,0,0,0.0,0,0,0,0,1,1,1,0
428,Andreas Christensen,Barcelona,0.3,0,0,0,0,0,0,0,0.0,0,0,0,0,0,0,2,0
429,Ryan Christie,Bournemouth,5.1,7,3,2,4,1,2,7,28.6,5,13,3,10,4,11,8,1
430,Samuel Chukwueze,Milan,2.1,3,2,1,1,1,1,3,33.3,2,0,0,0,0,3,0,0
431,Aaron Ciammaglichella,Torino,0.0,0,0,0,0,0,0,0,0.0,0,0,0,0,0,0,0,0
432,Jasper Cillessen,Las Palmas,7.0,0,0,0,0,0,0,0,0.0,0,0,0,0,0,0,6,0
433,Alessandro Circati,Parma,4.0,4,2,3,1,0,1,1,100.0,0,5,4,1,2,6,29,1
434,Pathe Ciss,Rayo Vallecano,3.3,6,3,4,2,0,1,6,16.7,5,6,3,3,5,11,16,0
435,Alphadjo Cisse,Hellas Verona,0.0,0,0,0,0,0,0,0,0.0,0,0,0,0,0,0,0,0
436,Seydouba Cisse,Leganés,6.8,13,10,6,6,1,4,9,44.4,5,7,0,7,4,17,9,0
437,Jack Clarke,Ipswich Town,2.6,5,3,0,5,0,2,8,25.0,6,0,0,0,0,5,4,0
438,Alexis Claude-Maurice,Augsburg,0.4,1,1,1,0,0,0,0,0.0,0,0,0,0,0,1,0,0
439,Jonathan Clauss,Nice,6.0,20,14,10,9,1,10,17,58.8,7,7,2,5,9,29,18,0
440,Nathaniel Clyne,Crystal Palace,2.5,9,6,6,2,1,5,6,83.3,1,0,0,0,1,10,10,1
442,Conor Coady,Leicester City,0.1,0,0,0,0,0,0,0,0.0,0,2,1,1,1,1,2,0
443,Marcus Coco,Nantes,3.1,11,11,5,4,2,6,11,54.5,5,5,2,3,2,13,8,0
444,Saul Coco,Torino,6.0,8,5,5,3,0,1,4,25.0,3,10,5,5,11,19,33,2
445,Seamus Coleman,Everton,1.0,1,0,0,1,0,1,2,50.0,1,2,1,1,0,1,2,0
446,Nathan Collins,Brentford,7.0,11,6,7,3,1,8,10,80.0,2,22,17,5,6,17,28,0
447,Nnamdi Collins,Eint Frankfurt,0.0,0,0,0,0,0,0,0,0.0,0,0,0,0,0,0,0,0
448,Toby Collyer,Manchester Utd,0.5,4,3,1,3,0,2,2,100.0,0,0,0,0,0,4,1,0
449,Lorenzo Colombo,Empoli,4.8,5,3,0,3,2,1,4,25.0,3,4,0,4,0,5,0,0
450,Andrea Colpani,Fiorentina,5.1,5,2,3,2,0,0,5,0.0,5,2,0,2,1,6,4,0
451,Levi Colwill,Chelsea,7.0,4,2,4,0,0,1,3,33.3,2,11,8,3,10,14,27,0
452,Kingsley Coman,Bayern Munich,2.5,8,4,3,2,3,3,4,75.0,1,4,0,4,2,10,5,0
453,Eray Comert,Valladolid,6.2,8,3,4,4,0,5,9,55.6,4,10,7,3,6,14,21,1
454,Santi Comesana,Villarreal,7.5,16,11,9,7,0,4,13,30.8,9,13,5,8,8,24,8,0
455,Pietro Comuzzo,Fiorentina,5.5,12,5,7,3,2,6,9,66.7,3,7,5,2,3,15,13,0
456,Francisco Conceicao,Juventus,1.8,4,3,3,1,0,2,3,66.7,1,1,0,1,1,5,0,0
457,Diego Conde,Villarreal,9.0,2,2,2,0,0,2,4,50.0,2,0,0,0,1,3,4,1
458,Tomas Conechny,Alavés,4.3,4,2,2,2,0,2,10,20.0,8,7,1,6,3,7,3,0
459,Sirlord Conteh,Heidenheim,1.7,5,3,2,3,0,1,1,100.0,0,0,0,0,0,5,1,0
460,Lewis Cook,Bournemouth,6.9,20,10,10,9,1,7,18,38.9,11,10,2,8,12,32,10,0
461,Copete,Mallorca,3.4,7,5,7,0,0,3,3,100.0,0,3,1,2,2,9,27,0
462,Diego Coppola,Hellas Verona,6.0,8,4,5,2,1,6,9,66.7,3,10,5,5,13,21,25,1
463,Derek Cornelius,Marseille,4.5,7,5,5,2,0,6,8,75.0,2,4,1,3,3,10,19,0
464,Maxwel Cornet,Southampton,0.8,5,5,1,4,0,0,4,0.0,4,0,0,0,0,5,2,0
465,Pierre Cornud,Saint-Étienne,2.3,3,3,2,0,1,3,4,75.0,1,3,1,2,3,6,10,1
466,Angel Correa,Atlético Madrid,2.1,1,0,1,0,0,1,3,33.3,2,2,0,2,1,2,1,0
468,Joaquin Correa,Inter,0.2,1,0,0,1,0,0,0,0.0,0,0,0,0,0,1,0,0
469,Thierry Correia,Valencia,7.1,21,14,17,2,2,11,17,64.7,6,9,1,8,4,25,14,0
470,David Costa,Lens,1.6,1,0,0,1,0,1,2,50.0,1,4,1,3,1,2,0,0
471,Logan Costa,Villarreal,6.2,4,3,3,1,0,3,3,100.0,0,4,4,0,4,8,26,0
472,Logan Costa,Toulouse,1.0,2,1,0,2,0,1,1,100.0,0,2,2,0,2,4,4,0
473,Samu Costa,Mallorca,9.0,27,14,16,10,1,11,22,50.0,11,10,3,7,8,35,31,0
474,Vladimir Coufal,West Ham,2.2,0,0,0,0,0,0,3,0.0,3,2,2,0,2,2,4,0
475,Lassana Coulibaly,Lecce,3.8,6,4,3,3,0,3,6,50.0,3,7,1,6,3,9,4,0
476,Lasso Coulibaly,Auxerre,0.4,0,0,0,0,0,0,0,0.0,0,0,0,0,0,0,0,0
477,Soumaila Coulibaly,Brest,1.6,1,1,0,1,0,0,0,0.0,0,3,1,2,4,5,9,0
478,Tanguy Coulibaly,Montpellier,3.2,5,4,2,3,0,2,7,28.6,5,3,0,3,2,7,0,0
479,Woyo Coulibaly,Parma,6.1,8,5,5,1,2,4,8,50.0,4,13,1,12,3,11,11,0
480,Thibaut Courtois,Real Madrid,8.0,0,0,0,0,0,0,0,0.0,0,0,0,0,1,1,2,0
481,Yan Couto,Dortmund,2.6,5,3,4,1,0,4,7,57.1,3,6,0,6,2,7,6,1
482,Nicolas Cozza,Nantes,2.3,8,7,3,3,2,5,7,71.4,2,0,0,0,1,9,9,0
483,Aaron Cresswell,West Ham,0.3,1,0,0,1,0,1,1,100.0,0,1,0,1,0,1,1,0
484,Charlie Cresswell,Toulouse,3.8,8,2,2,6,0,7,12,58.3,5,3,2,1,5,13,16,1
485,Bryan Cristante,Roma,6.6,11,8,5,6,0,2,5,40.0,3,6,5,1,9,20,17,0
486,Domen Crnigoj,Venezia,0.4,3,1,0,0,3,1,1,100.0,0,2,1,1,1,4,3,0
487,Juan Cruz Armada,Osasuna,2.3,2,0,1,1,0,0,1,0.0,1,1,0,1,0,2,7,0
488,Juan Cruz,Leganés,5.7,6,4,2,4,0,3,6,50.0,3,5,1,4,4,10,6,0
489,Juan Cuadrado,Atalanta,0.7,1,0,0,0,1,1,2,50.0,1,0,0,0,0,1,2,0
490,Pau Cubarsi,Barcelona,7.4,5,4,4,1,0,2,5,40.0,3,2,1,1,3,8,22,0
491,Marc Cucurella,Chelsea,6.6,9,6,6,3,0,4,11,36.4,7,10,4,6,6,15,24,0
492,Matheus Cunha,Wolves,6.1,8,7,3,3,2,0,6,0.0,6,4,0,4,4,12,10,0
494,Patrick Cutrone,Como,6.2,6,5,0,3,3,2,3,66.7,1,2,0,2,1,7,4,0
495,Tomas Cvancara,Gladbach,1.6,1,1,0,1,0,1,1,100.0,0,2,1,1,0,1,2,0
496,Wylan Cyprien,Parma,0.3,0,0,0,0,0,0,1,0.0,1,1,0,1,1,1,0,0
497,Danilo D'Ambrosio,Monza,0.5,2,0,1,0,1,0,0,0.0,0,1,0,1,0,2,0,0
498,Lucas Da Cunha,Como,2.2,5,2,3,1,1,2,3,66.7,1,5,0,5,0,5,1,0
499,Mahmoud Dahoud,Eint Frankfurt,1.1,3,0,3,0,0,1,1,100.0,0,2,1,1,1,4,1,0
500,Thijs Dallinga,Bologna,1.3,3,2,0,1,2,1,1,100.0,0,1,1,0,0,3,4,0
501,Diogo Dalot,Manchester Utd,7.0,15,12,6,7,2,7,9,77.8,2,6,4,2,15,30,14,0
502,Mikkel Damsgaard,Brentford,5.1,19,10,9,5,5,7,12,58.3,5,13,1,12,9,28,7,1
503,Flavius Daniliuc,Hellas Verona,2.8,3,3,1,2,0,1,6,16.7,5,4,1,3,3,6,8,0
504,Danilo,Nott'ham Forest,0.2,0,0,0,0,0,0,0,0.0,0,0,0,0,0,0,0,0
505,Danilo,Juventus,1.3,1,0,0,0,1,0,0,0.0,0,1,1,0,2,3,2,0
506,Arnaut Danjuma,Villarreal,2.2,2,1,0,1,1,0,1,0.0,1,1,0,1,0,2,0,0
507,Arnaut Danjuma,Girona,3.7,5,3,2,2,1,1,3,33.3,2,2,0,2,1,6,0,0
508,Kevin Danois,Auxerre,3.5,12,10,5,6,1,5,11,45.5,6,0,0,0,7,19,3,0
509,Kevin Danso,Lens,2.0,3,0,2,1,0,1,2,50.0,1,2,2,0,2,5,12,0
510,Dante,Nice,6.3,13,6,5,6,2,9,12,75.0,3,5,1,4,8,21,16,0
511,Pape Daouda Diongue,Strasbourg,0.5,1,0,0,1,0,0,0,0.0,0,0,0,0,1,2,0,0
512,Mohammed Daramy,Reims,0.2,0,0,0,0,0,0,0,0.0,0,0,0,0,0,0,1,0
513,Bence Dardai,Wolfsburg,0.1,0,0,0,0,0,0,0,0.0,0,0,0,0,1,1,0,0
514,Sergi Darder,Mallorca,6.6,11,6,5,2,4,1,9,11.1,8,1,0,1,2,13,5,1
515,Matteo Darmian,Inter,5.2,13,7,5,5,3,5,10,50.0,5,2,2,0,1,14,11,0
516,Lukas Daschner,Bochum,2.3,1,1,0,0,1,0,6,0.0,6,3,0,3,0,1,3,0
517,Juan David Cabal,Juventus,2.3,3,1,3,0,0,2,6,33.3,4,1,0,1,1,4,7,1
518,Jonathan David,Lille,5.1,5,1,0,3,2,2,4,50.0,2,3,0,3,1,6,0,0
520,Alphonso Davies,Bayern Munich,4.3,8,4,2,4,2,5,6,83.3,1,3,0,3,3,11,5,0
521,Keinan Davis,Udinese,2.3,1,1,0,1,0,0,1,0.0,1,0,0,0,1,2,0,0
522,Leif Davis,Ipswich Town,7.0,14,9,13,0,1,9,14,64.3,5,6,1,5,5,19,18,0
523,Zuriko Davitashvili,Saint-Étienne,6.7,8,4,2,5,1,6,16,37.5,10,3,0,3,5,13,3,0
524,Pawel Dawidowicz,Hellas Verona,4.2,8,6,2,6,0,3,4,75.0,1,2,1,1,3,11,11,0
525,Craig Dawson,Wolves,4.3,5,3,3,1,1,5,6,83.3,1,5,4,1,4,9,18,0
526,Kevin De Bruyne,Manchester City,4.0,2,1,2,0,0,0,3,0.0,3,2,0,2,2,4,0,0
527,Charles De Ketelaere,Atalanta,5.2,2,2,0,1,1,0,1,0.0,1,2,2,0,0,2,1,0
528,Rodrigo De Paul,Atlético Madrid,4.1,4,3,1,3,0,4,7,57.1,3,2,0,2,1,5,5,1
529,Mattia De Sciglio,Empoli,0.1,0,0,0,0,0,0,0,0.0,0,0,0,0,0,0,2,0
530,Lorenzo De Silvestri,Bologna,1.0,2,1,1,0,1,1,3,33.3,2,2,0,2,0,2,1,0
531,Thibault De Smet,Reims,0.1,0,0,0,0,0,0,0,0.0,0,1,1,0,1,1,2,0
532,Koni De Winter,Genoa,7.0,12,9,6,5,1,4,6,66.7,2,2,1,1,8,20,34,0
533,Alessandro Deiola,Cagliari,4.4,9,4,3,6,0,3,8,37.5,5,4,2,2,2,11,8,0
534,Romain Del Castillo,Brest,4.7,8,5,3,1,4,4,5,80.0,1,9,0,9,1,9,0,0
535,Enrico Del Prato,Parma,5.2,2,1,1,1,0,2,4,50.0,2,11,4,7,4,6,21,0
536,Liam Delap,Ipswich Town,6.0,3,1,1,1,1,0,4,0.0,4,2,0,2,1,4,8,0
537,Fisayo Dele-Bashiru,Lazio,1.8,2,2,0,1,1,0,0,0.0,0,2,0,2,0,2,0,0
538,Olivier Deman,Werder Bremen,0.3,3,1,0,3,0,1,5,20.0,4,0,0,0,0,3,2,0
539,Ali Dembele,Torino,0.6,2,1,1,1,0,2,2,100.0,0,0,0,0,0,2,2,0
540,Ousmane Dembele,Paris S-G,4.8,4,2,0,2,2,2,2,100.0,0,1,0,1,3,7,0,0
541,Ermedin Demirovic,Stuttgart,3.9,1,1,0,1,0,0,1,0.0,1,3,0,3,0,1,0,0
542,Sepp van den Berg,Brentford,4.2,10,7,7,1,2,3,5,60.0,2,10,5,5,1,11,12,1
543,Arthur Desmas,Le Havre,7.0,0,0,0,0,0,0,0,0.0,0,0,0,0,0,0,0,0
544,Kiernan Dewsbury-Hall,Chelsea,0.5,0,0,0,0,0,0,0,0.0,0,1,0,1,1,1,1,1
546,Michele Di Gregorio,Juventus,5.0,0,0,0,0,0,0,0,0.0,0,0,0,0,0,0,0,0
547,Giovanni Di Lorenzo,Napoli,7.0,18,11,9,8,1,12,15,80.0,3,2,1,1,5,23,19,0
548,Boulaye Dia,Lazio,4.7,4,2,1,1,2,2,3,66.7,1,1,0,1,0,4,0,1
549,Mamadou Diakhon,Reims,0.6,3,3,2,0,1,3,4,75.0,1,0,0,0,0,3,1,0
550,Bafode Diakite,Lille,7.0,8,4,5,2,1,6,10,60.0,4,5,2,3,7,15,16,1
551,Oumar Diakite,Reims,5.5,7,5,4,3,0,4,9,44.4,5,4,0,4,2,9,3,0
552,Amad Diallo,Manchester Utd,3.8,12,8,4,5,3,7,8,87.5,1,2,0,2,2,14,1,0
553,Assane Diao,Betis,1.9,3,1,0,2,1,2,4,50.0,2,1,0,1,0,3,1,0
554,Habib Diarra,Strasbourg,6.3,4,2,0,3,1,2,5,40.0,3,5,0,5,1,5,9,0
555,Moussa Diarra,Alavés,4.2,10,7,5,5,0,6,10,60.0,4,2,0,2,4,14,2,0
556,Ruben Dias,Manchester City,6.1,5,3,1,3,1,2,3,66.7,1,4,3,1,9,14,18,1
557,Krepin Diatta,Monaco,0.4,3,0,3,0,0,2,2,100.0,0,0,0,0,1,4,3,0
558,Kandet Diawara,Le Havre,0.0,0,0,0,0,0,0,0,0.0,0,1,0,1,0,0,1,0
559,Mahamadou Diawara,Lyon,0.2,1,0,0,1,0,1,3,33.3,2,2,0,2,0,1,0,0
560,Brahim Diaz,Real Madrid,1.3,2,2,2,0,0,0,3,0.0,3,0,0,0,1,3,0,0
561,Luis Diaz,Liverpool,5.0,7,5,4,3,0,4,9,44.4,5,5,0,5,2,9,3,0
562,Pedro Diaz,Rayo Vallecano,0.6,1,1,0,1,0,1,1,100.0,0,2,0,2,1,2,0,0
563,Tyler Dibling,Southampton,4.1,6,5,3,2,1,4,7,57.1,3,4,1,3,1,7,2,0
564,Diego,Leganés,1.3,0,0,0,0,0,0,0,0.0,0,0,0,0,0,0,3,0
565,Justin Diehl,Stuttgart,0.3,0,0,0,0,0,0,0,0.0,0,2,0,2,0,0,0,0
566,Bamba Dieng,Angers,2.3,2,0,0,1,1,0,0,0.0,0,1,0,1,0,2,2,0
567,Eric Dier,Bayern Munich,0.1,0,0,0,0,0,0,0,0.0,0,0,0,0,0,0,1,0
568,Lucas Digne,Aston Villa,5.8,20,14,11,6,3,12,19,63.2,7,7,2,5,9,29,14,0
569,Federico Dimarco,Inter,6.3,4,2,2,2,0,2,4,50.0,2,6,2,4,2,6,8,0
570,Junior Dina Ebimbe,Eint Frankfurt,1.3,1,0,0,1,0,0,1,0.0,1,2,0,2,2,3,4,0
572,Eren Dinkci,Freiburg,2.8,7,4,3,3,1,2,6,33.3,4,6,1,5,2,9,0,0
573,Sinaly Diomande,Auxerre,4.3,6,4,1,5,0,5,7,71.4,2,4,3,1,5,11,13,0
574,Lois Diony,Angers,0.2,0,0,0,0,0,0,0,0.0,0,0,0,0,0,0,0,0
575,Issa Diop,Fulham,3.1,8,5,5,3,0,3,5,60.0,2,3,2,1,0,8,12,0
576,Sofiane Diop,Nice,0.5,1,1,0,0,1,0,0,0.0,0,0,0,0,0,1,1,0
577,Andy Diouf,Lens,6.0,12,8,3,7,2,9,14,64.3,5,11,1,10,4,16,6,0
578,Yehvann Diouf,Reims,7.0,0,0,0,0,0,0,0,0.0,0,0,0,0,0,0,3,1
579,Assane Diousse,Auxerre,0.1,0,0,0,0,0,0,0,0.0,0,0,0,0,0,0,0,0
580,Axel Disasi,Chelsea,1.0,1,1,1,0,0,1,3,33.3,2,1,0,1,1,2,3,0
581,Roman Dixon,Everton,1.0,5,5,3,2,0,4,4,100.0,0,1,0,1,1,6,3,0
582,Alvaro djalo,Athletic Club,2.1,1,0,0,1,0,0,1,0.0,1,1,0,1,0,1,1,0
583,Djene,Getafe,8.2,4,1,2,2,0,1,8,12.5,7,7,4,3,9,13,31,0
584,Berat Djimsiti,Atalanta,6.0,13,7,5,8,0,6,8,75.0,2,9,7,2,12,25,21,1
585,Marko Dmitrovic,Leganés,3.0,0,0,0,0,0,0,0,0.0,0,0,0,0,0,0,3,0
586,Ritsu Doan,Freiburg,5.6,13,11,9,3,1,8,11,72.7,3,11,0,11,3,16,5,0
587,Dodo,Fiorentina,7.0,9,7,4,3,2,5,9,55.6,4,7,2,5,10,19,9,0
588,Danilho Doekhi,Union Berlin,6.0,6,4,3,1,2,3,5,60.0,2,9,2,7,3,9,19,0
589,Matt Doherty,Wolves,2.3,8,6,6,2,0,4,5,80.0,1,4,1,3,2,10,8,0
590,Jeremy Doku,Manchester City,3.7,5,2,2,1,2,1,3,33.3,2,3,0,3,0,5,1,0
591,Marc Domenech,Mallorca,1.3,0,0,0,0,0,0,2,0.0,2,2,0,2,0,0,0,0
592,Carlos Dominguez,Celta Vigo,3.8,7,4,4,3,0,4,7,57.1,3,4,4,0,4,11,22,0
593,Nicolas Dominguez,Nott'ham Forest,2.0,8,4,1,4,3,4,8,50.0,4,4,1,3,2,10,4,0
594,Sergi Dominguez,Barcelona,1.9,1,1,1,0,0,0,0,0.0,0,0,0,0,3,4,7,0
595,Gianluigi Donnarumma,Paris S-G,5.0,0,0,0,0,0,0,0,0.0,0,0,0,0,0,0,0,0
596,Patrick Dorgu,Lecce,5.5,13,6,4,6,3,8,14,57.1,6,6,1,5,5,18,9,0
598,Niklas Dorsch,Augsburg,0.4,0,0,0,0,0,0,0,0.0,0,1,0,1,0,0,0,0
599,Niklas Dorsch,Heidenheim,1.4,0,0,0,0,0,0,1,0.0,1,3,0,3,0,0,2,0
600,Alberto Dossena,Como,5.7,12,7,9,3,0,5,8,62.5,3,3,1,2,8,20,26,1
601,Abdoulaye Doucoure,Everton,4.4,9,5,5,4,0,3,3,100.0,0,6,2,4,2,11,3,0
602,Cheick Doucoure,Crystal Palace,1.0,6,3,1,4,1,1,2,50.0,1,2,0,2,2,8,1,0
603,Desire Doue,Paris S-G,1.6,2,1,1,1,0,0,4,0.0,4,1,0,1,0,2,1,0
604,Guela Doue,Strasbourg,7.0,13,10,7,2,4,8,11,72.7,3,8,0,8,12,25,37,0
605,Douglas,Nantes,5.6,15,9,5,6,4,4,9,44.4,5,7,1,6,3,18,11,0
606,Ismael Doukoure,Strasbourg,6.5,14,6,5,9,0,8,8,100.0,0,7,2,5,6,20,16,2
607,Issa Doumbia,Venezia,1.6,3,1,1,2,0,3,4,75.0,1,3,1,2,1,4,2,0
608,Kamory Doumbia,Brest,2.1,7,6,1,5,1,4,5,80.0,1,1,0,1,3,10,2,0
609,Anastasios Douvikas,Celta Vigo,3.9,5,1,1,4,0,1,3,33.3,2,4,2,2,3,8,5,0
610,Artem Dovbyk,Roma,6.8,1,1,0,0,1,0,0,0.0,0,3,0,3,0,1,3,0
611,Flynn Downes,Southampton,7.0,14,7,6,6,2,4,13,30.8,9,13,2,11,12,26,8,1
612,Tommy Doyle,Wolves,0.8,1,0,0,1,0,1,2,50.0,1,1,0,1,0,1,1,0
613,Radu Dragusin,Tottenham,1.1,1,0,1,0,0,1,1,100.0,0,2,1,1,1,2,3,0
614,Patrick Drewes,Bochum,6.0,0,0,0,0,0,0,1,0.0,1,0,0,0,0,0,6,1
615,Tim Drexler,Hoffenheim,3.7,17,7,11,6,0,9,12,75.0,3,6,4,2,1,18,8,0
616,Marvin Ducksch,Werder Bremen,5.1,3,2,0,2,1,0,5,0.0,5,2,0,2,0,3,8,0
617,Ondrej Duda,Hellas Verona,4.3,4,2,2,2,0,2,8,25.0,6,3,1,2,5,9,4,1
618,Denzel Dumfries,Inter,1.8,3,3,1,0,2,2,4,50.0,2,1,0,1,0,3,1,0
619,Alfred Duncan,Venezia,3.7,9,3,3,6,0,2,7,28.6,5,1,0,1,5,14,2,0
620,Lewis Dunk,Brighton,6.8,1,0,1,0,0,1,1,100.0,0,7,4,3,7,8,15,0
621,Jhon Duran,Aston Villa,2.1,3,3,1,0,2,1,3,33.3,2,2,0,2,0,3,4,0
622,Pablo Duran,Celta Vigo,1.9,3,2,0,2,1,2,4,50.0,2,1,1,0,2,5,2,0
624,Julien Duranville,Dortmund,0.3,0,0,0,0,0,0,0,0.0,0,0,0,0,0,0,0,0
625,Hugo Duro,Valencia,5.8,4,4,2,2,0,0,0,0.0,0,3,0,3,4,8,5,0
626,Jean-Kevin Duverne,Nantes,3.6,12,9,6,3,3,10,20,50.0,10,6,0,6,4,16,15,0
627,Paulo Dybala,Roma,3.2,3,1,0,1,2,0,1,0.0,1,2,0,2,1,4,0,0
628,Stefan Dzodic,Montpellier,1.8,5,2,3,2,0,3,5,60.0,2,2,1,1,4,9,7,0
629,Adam Dzwigala,St. Pauli,1.0,4,1,3,1,0,2,3,66.7,1,0,0,0,0,4,3,0
630,Aron Donnum,Toulouse,5.1,7,4,2,5,0,2,9,22.2,7,2,0,2,2,9,8,0
631,Ederson,Manchester City,7.0,0,0,0,0,0,0,0,0.0,0,0,0,0,1,1,2,1
632,Ederson,Atalanta,6.6,3,2,1,2,0,1,2,50.0,1,2,0,2,9,12,7,0
633,George Edmundson,Ipswich Town,0.0,0,0,0,0,0,0,0,0.0,0,0,0,0,0,0,0,0
634,Odsonne Edouard,Crystal Palace,1.3,1,0,0,1,0,0,2,0.0,2,1,0,1,0,1,1,0
635,Odsonne Edouard,Leicester City,0.3,0,0,0,0,0,0,0,0.0,0,0,0,0,0,0,1,0
636,Samuel Edozie,Southampton,0.7,3,1,0,1,2,2,2,100.0,0,0,0,0,0,3,0,0
637,Johannes Eggestein,St. Pauli,5.3,0,0,0,0,0,0,0,0.0,0,1,0,1,0,0,2,0
638,Maximilian Eggestein,Freiburg,5.7,7,5,1,5,1,2,6,33.3,4,6,0,6,11,18,6,0
639,Kingsley Ehizibue,Udinese,6.7,11,7,7,4,0,6,15,40.0,9,9,4,5,7,18,20,1
640,Chidera Ejuke,Sevilla,5.5,5,3,0,3,2,3,8,37.5,5,6,0,6,1,6,2,0
641,Jeff Ekhator,Genoa,0.7,0,0,0,0,0,0,0,0.0,0,1,0,1,0,0,0,0
642,Hugo Ekitike,Eint Frankfurt,3.9,4,1,2,1,1,2,2,100.0,0,2,0,2,4,8,4,0
643,Jurgen Ekkelenkamp,Udinese,3.2,6,4,1,5,0,4,5,80.0,1,5,0,5,3,9,4,0
644,Jacques Ekomie,Angers,2.5,5,5,2,2,1,2,4,50.0,2,6,0,6,2,7,6,0
645,Emmanuel Ekong,Empoli,0.7,3,2,0,2,1,2,2,100.0,0,1,0,1,1,4,1,0
646,Caleb Ekuban,Genoa,2.3,1,1,0,1,0,0,0,0.0,0,2,0,2,0,1,3,0
647,Pierre Ekwah Elimby,Saint-Étienne,4.0,8,6,4,4,0,5,6,83.3,1,7,4,3,5,13,12,0
648,Anthony Elanga,Nott'ham Forest,4.0,2,1,0,1,1,1,4,25.0,3,2,0,2,3,5,5,0
650,Mikael Ellertsson,Venezia,4.8,5,1,0,3,2,1,3,33.3,2,7,2,5,0,5,12,0
651,Harvey Elliott,Liverpool,0.1,0,0,0,0,0,0,0,0.0,0,0,0,0,0,0,0,0
652,Aritz Elustondo,Real Sociedad,2.7,4,2,2,1,1,1,1,100.0,0,6,5,1,1,5,8,0
653,Nico Elvedi,Gladbach,5.5,10,5,5,2,3,6,6,100.0,0,10,8,2,8,18,19,0
654,Adri Embarba,Rayo Vallecano,6.0,12,5,6,5,1,7,12,58.3,5,3,0,3,4,16,4,0
655,Breel Embolo,Monaco,3.7,0,0,0,0,0,0,2,0.0,2,1,0,1,1,1,2,0
656,Emanuel Emegha,Strasbourg,6.6,4,4,0,2,2,1,1,100.0,0,6,4,2,0,4,8,0
657,Emerson,Milan,5.0,9,7,5,2,2,6,10,60.0,4,5,2,3,5,14,12,0
658,Yunus Emre Konak,Brentford,0.2,1,1,0,1,0,0,1,0.0,1,0,0,0,0,1,0,0
659,Julio Enciso,Brighton,0.9,0,0,0,0,0,0,1,0.0,1,0,0,0,0,0,0,0
660,Wataru Endo,Liverpool,0.0,0,0,0,0,0,0,0,0.0,0,1,0,1,0,0,0,0
661,Endrick,Real Madrid,0.5,0,0,0,0,0,0,1,0.0,1,0,0,0,1,1,0,0
662,Yannik Engelhardt,Como,0.9,1,0,1,0,0,1,3,33.3,2,0,0,0,0,1,0,0
663,Arne Engels,Augsburg,0.9,0,0,0,0,0,0,0,0.0,0,1,1,0,0,0,0,0
664,Christian Eriksen,Manchester Utd,2.9,4,0,0,3,1,4,7,57.1,3,2,1,1,1,5,1,0
665,Martin Erlic,Bologna,2.5,2,0,0,2,0,1,2,50.0,1,5,4,1,1,3,5,0
666,Patrick Erras,Holstein Kiel,3.5,4,3,3,1,0,1,7,14.3,6,6,5,1,3,7,32,0
667,Alfonso Espino,Rayo Vallecano,3.4,16,9,10,5,1,9,20,45.0,11,6,2,4,7,23,7,0
668,Sebastiano Esposito,Empoli,5.0,14,8,5,7,2,6,13,46.2,7,4,1,3,5,19,2,0
669,Samuel Essende,Augsburg,3.6,0,0,0,0,0,0,0,0.0,0,3,1,2,0,0,1,0
670,Dario Essugo,Las Palmas,3.6,8,6,5,2,1,2,4,50.0,2,1,1,0,5,13,6,1
671,Nahuel Estevez,Parma,1.8,3,1,3,0,0,1,6,16.7,5,2,2,0,2,5,6,0
672,Pervis Estupinan,Brighton,2.6,6,3,3,3,0,2,3,66.7,1,0,0,0,3,9,4,0
673,Evanilson,Bournemouth,4.8,4,2,0,1,3,2,3,66.7,1,4,1,3,0,4,4,0
674,Jonny Evans,Manchester Utd,1.3,5,4,3,2,0,1,1,100.0,0,2,1,1,1,6,4,0
676,Eberechi Eze,Crystal Palace,7.0,10,7,4,5,1,4,10,40.0,6,4,0,4,3,13,2,1
677,Abde Ezzalzouli,Betis,7.1,13,8,8,5,0,3,6,50.0,3,4,0,4,4,17,3,0
678,Giovanni Fabbian,Bologna,3.3,6,5,1,2,3,3,5,60.0,2,0,0,0,1,7,1,0
679,Lukasz Fabianski,West Ham,0.5,0,0,0,0,0,0,0,0.0,0,0,0,0,0,0,0,0
680,Alieu Fadera,Como,3.5,15,12,7,5,3,8,19,42.1,11,5,1,4,0,15,0,0
681,Wout Faes,Leicester City,7.0,6,4,6,0,0,4,10,40.0,6,20,15,5,5,11,50,1
682,Nicolo Fagioli,Juventus,3.8,8,5,4,3,1,3,3,100.0,0,1,0,1,2,10,3,0
683,Romain Faivre,Brest,2.9,6,6,2,3,1,2,5,40.0,3,1,0,1,3,9,0,0
684,Wladimiro Falcone,Lecce,7.0,0,0,0,0,0,0,0,0.0,0,0,0,0,0,0,4,0
685,Davide Faraoni,Hellas Verona,0.3,1,1,0,1,0,0,2,0.0,2,0,0,0,0,1,1,0
686,Abdul Fatawu Issahaku,Leicester City,3.1,15,12,10,0,5,7,11,63.6,4,3,0,3,3,18,6,0
687,Ansu Fati,Barcelona,0.3,0,0,0,0,0,0,0,0.0,0,0,0,0,0,0,0,1
688,Khalil Fayad,Montpellier,2.8,14,7,5,9,0,5,8,62.5,3,4,0,4,1,15,4,0
689,Jacopo Fazzini,Empoli,3.3,8,4,4,4,0,3,4,75.0,1,4,0,4,1,9,8,0
690,Peter Federico,Getafe,1.5,2,1,0,1,1,0,0,0.0,0,2,0,2,0,2,1,0
691,Nabil Fekir,Betis,2.0,3,2,1,1,1,1,2,50.0,1,2,0,2,0,3,0,0
692,Mattia Felici,Cagliari,0.3,0,0,0,0,0,0,0,0.0,0,0,0,0,2,2,0,0
693,Joao Felix,Chelsea,1.4,2,0,1,0,1,1,2,50.0,1,1,0,1,1,3,2,0
694,Kiko Femenia,Villarreal,9.0,18,11,13,4,1,12,23,52.2,11,13,6,7,14,32,16,0
695,Evan Ferguson,Brighton,0.3,0,0,0,0,0,0,0,0.0,0,0,0,0,0,0,0,0
696,Zinedine Ferhat,Angers,2.3,1,0,0,1,0,0,2,0.0,2,1,0,1,2,3,2,0
697,Bruno Fernandes,Manchester Utd,6.3,15,10,1,11,3,5,13,38.5,8,8,1,7,6,21,5,0
698,Edimilson Fernandes,Brest,1.6,2,2,1,1,0,2,3,66.7,1,5,2,3,3,5,4,0
699,Mateus Fernandes,Southampton,4.1,13,8,3,7,3,3,6,50.0,3,3,0,3,2,15,7,0
700,Enzo Fernandez,Chelsea,5.7,14,6,3,6,5,9,22,40.9,13,6,1,5,2,16,5,2
702,Valery Fernandez,Mallorca,1.2,3,3,1,0,2,2,4,50.0,2,2,1,1,0,3,1,0
703,Matias Fernandez-Pardo,Lille,0.5,2,1,1,1,0,2,2,100.0,0,2,0,2,0,2,1,0
704,Jordan Ferri,Montpellier,3.0,6,6,2,4,0,5,6,83.3,1,2,0,2,1,7,2,0
705,Karol Fila,Strasbourg,0.1,0,0,0,0,0,0,0,0.0,0,0,0,0,0,0,0,0
706,Kilian Fischer,Wolfsburg,5.2,17,13,12,3,2,13,27,48.1,14,10,0,10,5,22,18,1
707,Mark Flekken,Brentford,7.0,1,1,1,0,0,1,2,50.0,1,0,0,0,0,1,8,0
708,Phil Foden,Manchester City,1.9,0,0,0,0,0,0,1,0.0,1,2,1,1,2,2,2,0
709,Malick Fofana,Lyon,2.9,5,3,2,3,0,3,3,100.0,0,0,0,0,1,6,3,0
710,Wesley Fofana,Chelsea,6.6,7,6,2,5,0,2,7,28.6,5,8,5,3,9,16,27,1
711,Yahia Fofana,Angers,7.0,0,0,0,0,0,0,0,0.0,0,0,0,0,0,0,8,0
712,Youssouf Fofana,Milan,4.8,6,3,2,3,1,3,8,37.5,5,4,1,3,3,9,5,1
713,Jonas Fohrenbach,Heidenheim,6.0,11,9,5,6,0,5,8,62.5,3,6,2,4,6,17,16,0
714,Michael Folorunsho,Napoli,0.2,1,0,0,1,0,1,3,33.3,2,0,0,0,0,1,0,1
715,Lamine Fomba,Saint-Étienne,0.8,2,1,1,1,0,1,2,50.0,1,4,1,3,2,4,3,1
716,Carlos Forbs,Wolves,1.2,5,5,2,2,1,3,4,75.0,1,1,0,1,0,5,1,0
717,Pablo Fornals,Betis,6.8,10,7,5,5,0,3,11,27.3,8,13,0,13,7,17,3,1
718,Omari Forson,Monza,0.2,0,0,0,0,0,0,0,0.0,0,1,0,1,0,0,0,0
719,Hector Fort,Barcelona,1.3,3,2,1,2,0,3,4,75.0,1,2,0,2,0,3,2,0
720,Dimitri Foulquier,Valencia,4.8,13,8,4,6,3,7,11,63.6,4,4,0,4,0,13,7,1
721,Alejandro Frances,Girona,4.9,12,7,7,4,1,12,17,70.6,5,6,2,4,8,20,16,0
722,Przemyslaw Frankowski,Lens,4.0,9,7,6,3,0,6,11,54.5,5,4,0,4,0,9,10,0
723,Enric Franquesa,Leganés,4.0,12,6,8,3,1,7,8,87.5,1,5,1,4,1,13,10,0
724,Ryan Fraser,Southampton,1.4,5,2,1,4,0,4,5,80.0,1,0,0,0,0,5,3,0
725,Davide Frattesi,Inter,3.9,6,3,2,4,0,4,7,57.1,3,2,1,1,2,8,1,1
726,Morten Frendrup,Genoa,5.8,17,9,5,5,7,6,14,42.9,8,8,2,6,11,28,6,0
728,Martin Frese,Hellas Verona,3.7,13,7,6,7,0,5,8,62.5,3,2,1,1,6,19,14,1
729,Remo Freuler,Bologna,7.0,20,10,14,4,2,10,17,58.8,7,9,1,8,4,24,14,1
730,Marco Friedl,Werder Bremen,3.7,7,6,3,4,0,2,6,33.3,4,7,5,2,5,12,20,0
731,Marvin Friedrich,Gladbach,0.5,0,0,0,0,0,0,0,0.0,0,0,0,0,0,0,3,0
732,Jeremie Frimpong,Leverkusen,4.6,7,6,4,1,2,4,10,40.0,6,6,0,6,5,12,2,0
733,Jorge de Frutos,Rayo Vallecano,6.7,13,8,6,3,4,7,20,35.0,13,4,0,4,5,18,8,0
734,Chris Fuhrich,Stuttgart,2.4,3,2,1,1,1,3,4,75.0,1,0,0,0,0,3,4,0
735,Angelo Fulgini,Lens,2.7,3,3,1,0,2,2,3,66.7,1,5,1,4,0,3,1,0
736,Niclas Fullkrug,West Ham,0.7,0,0,0,0,0,0,0,0.0,0,0,0,0,0,0,2,0
737,Manuel Fuster,Las Palmas,1.6,1,0,0,1,0,1,3,33.3,2,1,0,1,0,1,1,0
738,Matteo Gabbia,Milan,4.0,2,0,0,1,1,0,1,0.0,1,4,2,2,2,4,11,1
739,Alessandro Gabrielloni,Como,0.6,0,0,0,0,0,0,1,0.0,1,0,0,0,0,0,0,0
740,Gianluca Gaetano,Cagliari,1.5,3,2,1,2,0,2,3,66.7,1,2,0,2,1,4,1,0
741,Roberto Gagliardini,Monza,1.0,1,0,0,1,0,0,2,0.0,2,0,0,0,1,2,4,0
742,Cody Gakpo,Liverpool,2.4,6,4,4,2,0,3,4,75.0,1,2,0,2,3,9,4,0
743,Javi Galan,Atlético Madrid,1.1,4,3,3,1,0,3,8,37.5,5,1,0,1,3,7,1,0
744,Inigo Ruiz de Galarreta,Athletic Club,2.6,2,1,0,2,0,1,4,25.0,3,2,0,2,3,5,1,0
745,Conor Gallagher,Atlético Madrid,5.6,18,12,6,10,2,7,14,50.0,7,7,1,6,7,25,8,0
746,Antonino Gallo,Lecce,6.9,12,7,9,3,0,4,10,40.0,6,8,1,7,7,19,26,0
747,Idrissa Gana Gueye,Everton,4.2,15,9,7,6,2,3,6,50.0,3,8,2,6,7,22,5,0
748,Ignatius Ganago,Nantes,0.5,1,1,0,1,0,1,1,100.0,0,0,0,0,0,1,0,0
749,Aleix Garcia,Leverkusen,2.3,3,0,1,1,1,2,3,66.7,1,2,0,2,1,4,2,0
750,Alvaro Garcia,Rayo Vallecano,4.1,10,7,6,3,1,4,9,44.4,5,2,0,2,6,16,10,0
751,Eric Garcia,Barcelona,4.9,10,4,2,6,2,4,6,66.7,2,8,3,5,4,14,9,0
752,Fran Garcia,Real Madrid,2.8,5,4,2,1,2,2,4,50.0,2,2,1,1,2,7,2,0
754,Joan Garcia,Espanyol,9.0,0,0,0,0,0,0,0,0.0,0,0,0,0,0,0,3,3
755,Ruben Garcia,Osasuna,6.0,11,9,5,4,2,8,14,57.1,6,11,1,10,5,16,9,0
756,Ulisses Garcia,Marseille,1.4,4,3,3,0,1,2,5,40.0,3,1,0,1,0,4,6,0
757,Alejandro Garnacho,Manchester Utd,4.6,7,6,3,2,2,2,3,66.7,1,2,0,2,3,10,4,0
758,James Garner,Everton,2.8,10,8,6,4,0,7,10,70.0,3,2,2,0,4,14,9,0
759,Yarek Gasiorowski,Valencia,3.0,7,5,6,1,0,4,7,57.1,3,6,3,3,3,10,13,0
760,Gaspar,Lecce,7.0,11,4,10,1,0,4,4,100.0,0,17,11,6,12,23,34,0
761,Federico Gatti,Juventus,4.9,7,4,6,1,0,5,6,83.3,1,8,5,3,5,12,12,0
762,Paulo Gazzaniga,Girona,9.0,1,1,1,0,0,1,1,100.0,0,0,0,0,0,1,3,0
763,Jean-Philippe Gbamin,Nantes,0.9,0,0,0,0,0,0,1,0.0,1,2,1,1,2,2,2,0
764,Yann Gboho,Toulouse,6.8,8,3,0,6,2,3,8,37.5,5,4,0,4,0,8,0,0
765,David de Gea,Fiorentina,4.0,0,0,0,0,0,0,0,0.0,0,0,0,0,0,0,0,0
766,Lutsharel Geertruida,RB Leipzig,3.2,6,4,1,5,0,2,8,25.0,6,2,0,2,3,9,9,0
767,Dennis Geiger,Hoffenheim,1.9,6,5,2,3,1,3,5,60.0,2,1,0,1,1,7,0,0
768,Valentin Gendrey,Lecce,2.0,2,2,1,0,1,1,1,100.0,0,3,1,2,2,4,1,0
769,Valentin Gendrey,Hoffenheim,2.3,5,2,4,1,0,1,1,100.0,0,0,0,0,2,7,11,0
770,Denis Genreau,Toulouse,0.0,0,0,0,0,0,0,0,0.0,0,0,0,0,0,0,0,0
771,Yannick Gerhardt,Wolfsburg,0.6,1,1,1,0,0,1,1,100.0,0,2,0,2,3,4,2,0
772,Max Geschwill,Holstein Kiel,3.9,6,5,2,4,0,4,5,80.0,1,2,2,0,6,12,12,0
773,Daniele Ghilardi,Hellas Verona,1.0,2,1,1,1,0,2,2,100.0,0,1,0,1,1,3,7,0
774,Lautaro Gianetti,Udinese,3.3,6,4,5,0,1,1,6,16.7,5,7,3,4,8,14,12,0
775,Dimitris Giannoulis,Augsburg,5.8,11,8,5,5,1,10,15,66.7,5,10,1,9,11,22,10,0
776,Morgan Gibbs-White,Nott'ham Forest,5.6,9,2,1,6,2,0,2,0.0,2,1,1,0,3,12,5,0
777,Armin Gigovic,Holstein Kiel,2.8,5,2,3,1,1,1,4,25.0,3,2,0,2,5,10,7,0
778,Bryan Gil,Girona,5.8,14,9,6,5,3,7,12,58.3,5,8,0,8,3,17,3,1
780,Mario Gila,Lazio,4.0,10,8,8,2,0,7,12,58.3,5,2,1,1,4,14,13,0
781,Billy Gilmour,Brighton,1.1,3,3,2,1,0,3,4,75.0,1,1,0,1,0,3,1,0
782,Billy Gilmour,Napoli,0.3,3,1,1,0,2,1,2,50.0,1,0,0,0,0,3,0,0
783,Benedikt Gimber,Heidenheim,6.0,16,10,11,5,0,8,10,80.0,2,15,4,11,7,23,34,0
784,Gvidas Gineitis,Torino,1.1,4,1,2,1,1,1,2,50.0,1,1,1,0,1,5,7,0
785,Matthias Ginter,Freiburg,3.7,4,2,1,2,1,3,3,100.0,0,4,3,1,1,5,10,0
786,Jamie Gittens,Dortmund,3.2,6,2,1,3,2,0,1,0.0,1,3,0,3,2,8,0,0
787,Serge Gnabry,Bayern Munich,4.3,6,5,3,1,2,3,6,50.0,3,3,0,3,4,10,2,0
788,Ben Godfrey,Atalanta,0.3,0,0,0,0,0,0,1,0.0,1,1,1,0,0,0,0,0
789,Saba Goglichidze,Empoli,5.0,13,9,7,6,0,7,11,63.6,4,4,2,2,6,19,17,0
790,Edoardo Goldaniga,Como,1.4,2,1,2,0,0,0,0,0.0,0,1,1,0,2,4,5,0
791,Pierluigi Gollini,Genoa,7.0,0,0,0,0,0,0,0,0.0,0,1,0,1,0,0,2,1
792,Aleksandr Golovin,Monaco,3.0,6,4,0,4,2,2,9,22.2,7,4,2,2,3,9,4,0
793,Andre Gomes,Lille,2.2,3,3,1,1,1,1,5,20.0,4,0,0,0,1,4,0,0
794,Angel Gomes,Lille,4.2,3,2,0,2,1,1,5,20.0,4,0,0,0,0,3,0,0
795,Joao Gomes,Wolves,6.3,24,15,12,11,1,5,18,27.8,13,5,1,4,5,29,4,0
796,Rodrigo Gomes,Wolves,1.3,4,1,2,2,0,1,3,33.3,2,2,0,2,0,4,1,0
797,Toti Gomes,Wolves,5.0,7,6,5,2,0,4,4,100.0,0,3,2,1,1,8,18,0
798,Carlos Gomez,Rennes,0.5,1,1,0,1,0,0,2,0.0,2,1,0,1,0,1,0,0
799,Dani Gomez,Valencia,3.6,2,1,0,0,2,0,0,0.0,0,1,0,1,2,4,3,0
800,Joe Gomez,Liverpool,0.0,1,1,0,1,0,1,2,50.0,1,1,0,1,0,1,1,0
801,Moi Gomez,Osasuna,3.4,7,3,3,3,1,1,3,33.3,2,1,0,1,5,12,3,1
802,Sergi Gomez,Espanyol,4.0,3,2,3,0,0,2,2,100.0,0,7,6,1,5,8,20,0
803,Sergio Gomez,Real Sociedad,7.6,18,11,8,8,2,9,17,52.9,8,6,1,5,5,23,7,0
804,Unai Gomez,Athletic Club,3.2,1,1,0,1,0,1,1,100.0,0,1,0,1,0,1,4,0
806,Fabio Gonzalez,Las Palmas,0.5,0,0,0,0,0,0,1,0.0,1,0,0,0,0,0,0,0
807,Nicolas Gonzalez,Juventus,2.5,3,1,1,0,2,1,2,50.0,1,4,1,3,0,3,0,0
808,Urko Gonzalez,Real Sociedad,0.5,0,0,0,0,0,0,0,0.0,0,1,1,0,0,0,0,0
809,Anthony Gordon,Newcastle Utd,6.6,7,4,4,3,0,5,8,62.5,3,9,0,9,2,9,0,1
810,Leon Goretzka,Bayern Munich,0.0,0,0,0,0,0,0,0,0.0,0,0,0,0,0,0,2,0
811,Andoni Gorosabel,Athletic Club,2.0,2,0,1,1,0,0,3,0.0,3,2,0,2,0,2,10,0
812,Robin Gosens,Fiorentina,5.0,11,5,5,2,4,4,4,100.0,0,1,0,1,2,13,16,0
813,Robin Gosens,Union Berlin,1.0,0,0,0,0,0,0,3,0.0,3,1,0,1,1,1,2,0
814,Mario Gotze,Eint Frankfurt,2.6,5,4,1,3,1,1,5,20.0,4,2,0,2,1,6,3,0
815,Amine Gouiri,Rennes,4.8,5,2,2,2,1,1,5,20.0,4,4,0,4,0,5,1,0
816,Jeffrey Gouweleeuw,Augsburg,6.0,8,4,3,2,3,5,9,55.6,4,5,1,4,7,15,22,0
817,Kamil Grabara,Wolfsburg,6.0,0,0,0,0,0,0,1,0.0,1,1,0,1,0,0,3,0
818,Jonathan Gradit,Lens,5.8,11,6,5,5,1,6,10,60.0,4,8,3,5,8,19,23,0
819,Jose Gragera,Espanyol,5.8,24,15,11,13,0,9,16,56.3,7,9,1,8,4,28,12,0
820,Samuel Grandsir,Le Havre,0.6,3,3,0,2,1,2,2,100.0,0,2,0,2,0,3,0,0
821,Alberto Grassi,Empoli,4.3,8,4,2,4,2,3,3,100.0,0,4,3,1,6,14,6,0
822,Ryan Gravenberch,Liverpool,7.0,15,12,4,6,5,8,12,66.7,4,9,1,8,12,27,5,0
823,Archie Gray,Tottenham,0.4,2,1,0,0,2,1,3,33.3,2,1,0,1,0,2,1,0
824,Jack Grealish,Manchester City,3.6,5,2,3,0,2,1,3,33.3,2,5,1,4,0,5,3,0
825,Jacob Greaves,Ipswich Town,7.0,14,6,6,8,0,7,11,63.6,4,8,6,2,8,22,41,1
826,Mason Greenwood,Marseille,6.9,6,3,3,2,1,4,9,44.4,5,1,0,1,1,7,5,0
827,Michael Gregoritsch,Freiburg,0.2,0,0,0,0,0,0,0,0.0,0,0,0,0,0,0,0,0
828,Dominik Greif,Mallorca,6.0,0,0,0,0,0,0,0,0.0,0,0,0,0,0,0,1,1
829,Antoine Griezmann,Atlético Madrid,7.4,5,3,5,0,0,1,7,14.3,6,8,0,8,3,8,7,0
830,Vincenzo Grifo,Freiburg,5.3,3,3,1,2,0,0,4,0.0,4,4,1,3,0,3,1,0
832,Florian Grillitsch,Hoffenheim,3.3,8,5,4,3,1,5,7,71.4,2,4,2,2,2,10,15,0
833,Alex Grimaldo,Leverkusen,6.0,7,4,4,1,2,5,11,45.5,6,4,1,3,6,13,5,1
834,Pascal Gross,Dortmund,5.2,8,4,1,6,1,1,8,12.5,7,4,1,3,2,10,4,1
835,Brajan Gruda,Brighton,0.0,0,0,0,0,0,0,0,0.0,0,0,0,0,0,0,0,0
836,Marco Grull,Werder Bremen,1.6,2,2,0,1,1,0,2,0.0,2,4,1,3,1,3,1,0
837,Albert Gronbaek,Rennes,4.9,11,5,4,6,1,6,14,42.9,8,4,0,4,3,14,2,0
838,Vicente Guaita,Celta Vigo,5.0,0,0,0,0,0,0,0,0.0,0,0,0,0,0,0,1,0
839,Sergi Guardiola,Rayo Vallecano,0.3,2,1,0,2,0,0,0,0.0,0,0,0,0,0,2,1,0
840,Nemanja Gudelj,Sevilla,6.0,11,6,4,5,2,2,2,100.0,0,5,3,2,8,19,18,0
841,Gabriel Gudmundsson,Lille,5.3,11,8,2,8,1,8,13,61.5,5,6,1,5,2,13,6,1
842,Goncalo Guedes,Wolves,0.8,1,1,0,0,1,0,3,0.0,3,3,0,3,2,3,1,0
843,Axel Gueguin,Montpellier,0.3,1,1,0,1,0,1,1,100.0,0,0,0,0,0,1,0,0
844,Marc Guehi,Crystal Palace,7.0,6,3,6,0,0,4,5,80.0,1,13,9,4,5,11,46,1
845,Matteo Guendouzi,Lazio,7.0,9,5,3,5,1,5,13,38.5,8,5,1,4,9,18,11,0
846,Javier Guerra,Valencia,4.6,9,5,4,3,2,6,10,60.0,4,1,0,1,0,9,7,1
847,Raphael Guerreiro,Bayern Munich,3.9,7,5,5,1,1,5,6,83.3,1,1,0,1,3,10,4,0
848,Evann Guessand,Nice,6.4,6,4,1,4,1,0,0,0.0,0,3,0,3,5,11,3,0
849,Ander Guevara,Alavés,5.4,9,5,4,4,1,5,13,38.5,8,6,0,6,2,11,10,0
850,Pape Gueye,Villarreal,5.3,12,6,6,4,2,7,8,87.5,1,3,0,3,7,19,11,0
851,Morgan Guilavogui,St. Pauli,2.4,2,0,1,1,0,0,0,0.0,0,2,0,2,1,3,1,0
852,Frederic Guilbert,Lecce,3.2,9,4,6,2,1,2,5,40.0,3,3,1,2,7,16,11,0
853,Luis Guilherme,West Ham,0.1,0,0,0,0,0,0,0,0.0,0,0,0,0,0,0,0,0
854,Hugo Guillamon,Valencia,3.4,6,4,0,5,1,4,5,80.0,1,2,1,1,5,11,6,0
855,Bruno Guimaraes,Newcastle Utd,7.0,19,10,12,5,2,9,16,56.3,7,8,3,5,11,30,8,1
856,Bahereba Guirassy,Nantes,0.1,0,0,0,0,0,0,0,0.0,0,1,0,1,0,0,1,0
858,Serhou Guirassy,Dortmund,3.8,0,0,0,0,0,0,0,0.0,0,0,0,0,0,0,4,0
859,Marc Guiu,Chelsea,0.3,0,0,0,0,0,0,0,0.0,0,0,0,0,0,0,0,0
860,Peter Gulacsi,RB Leipzig,6.0,0,0,0,0,0,0,0,0.0,0,0,0,0,0,0,3,1
861,Arda Guler,Real Madrid,2.8,8,3,3,2,3,4,6,66.7,2,6,0,6,1,9,3,0
862,Gerard Gumbau,Rayo Vallecano,2.3,8,6,5,3,0,2,4,50.0,2,2,1,1,0,8,2,0
863,Ilkay Gundogan,Manchester City,4.2,4,2,1,2,1,2,6,33.3,4,0,0,0,2,6,7,0
864,Christian Gunter,Freiburg,5.7,5,3,2,3,0,4,8,50.0,4,4,2,2,2,7,9,0
865,Jon Guridi,Alavés,4.2,6,3,3,2,1,3,8,37.5,5,1,0,1,4,10,4,0
866,Gorka Guruzeta,Athletic Club,5.6,3,2,0,3,0,2,7,28.6,5,7,1,6,2,5,8,0
867,Malo Gusto,Chelsea,4.8,13,8,9,3,1,7,18,38.9,11,10,3,7,3,16,11,1
868,Miguel Gutierrez,Girona,8.0,17,11,7,9,1,6,10,60.0,4,2,1,1,8,25,11,1
869,Albert Gudmundsson,Fiorentina,2.1,0,0,0,0,0,0,2,0.0,2,1,0,1,2,2,2,0
870,Josko Gvardiol,Manchester City,6.5,14,9,8,4,2,8,10,80.0,2,7,2,5,10,24,17,0
871,Emmanuel Gyasi,Empoli,7.0,11,5,7,4,0,7,9,77.8,2,10,4,6,0,11,18,0
872,Christian Gytkjaer,Venezia,1.9,1,1,1,0,0,1,2,50.0,1,1,1,0,0,1,3,0
873,Erling Haaland,Manchester City,7.0,2,2,0,1,1,1,1,100.0,0,2,0,2,1,3,6,0
874,Nicolas Haas,Empoli,1.1,4,2,3,1,0,2,2,100.0,0,0,0,0,1,5,4,0
875,Janik Haberer,Union Berlin,4.0,7,5,3,3,1,7,12,58.3,5,1,0,1,1,8,7,0
876,Robin Hack,Gladbach,1.8,6,6,3,1,2,4,5,80.0,1,0,0,0,0,6,2,0
877,Saad El Haddad,Venezia,0.2,0,0,0,0,0,0,0,0.0,0,0,0,0,0,0,0,0
878,Munir El Haddadi,Leganés,1.7,3,2,0,1,2,0,2,0.0,2,2,0,2,0,3,0,0
879,Amadou Haidara,RB Leipzig,4.1,8,6,4,4,0,4,7,57.1,3,11,4,7,5,13,16,0
880,Massadio Haidara,Brest,2.7,3,2,1,2,0,1,3,33.3,2,2,0,2,3,6,13,0
881,Antoine Hainaut,Parma,1.9,4,2,3,1,0,2,2,100.0,0,3,1,2,2,6,5,0
882,Mohamed Haj,Parma,0.4,0,0,0,0,0,0,0,0.0,0,0,0,0,1,1,0,0
884,Achraf Hakimi,Paris S-G,5.9,13,10,6,5,2,6,8,75.0,2,5,0,5,8,21,5,1
885,Lewis Hall,Newcastle Utd,4.8,5,3,3,0,2,4,15,26.7,11,13,7,6,5,10,15,0
886,Sebastien Haller,Leganés,3.6,1,0,1,0,0,1,2,50.0,1,1,0,1,0,1,7,0
887,Ali Al Hamadi,Ipswich Town,0.4,1,0,0,0,1,0,1,0.0,1,0,0,0,0,1,2,0
888,Andreas Hanche-Olsen,Mainz 05,3.3,4,1,1,2,1,0,0,0.0,0,7,6,1,3,7,20,1
889,Florent Hanin,Angers,4.4,14,11,8,4,2,6,10,60.0,4,1,0,1,6,20,12,1
890,Ridgeciano Haps,Venezia,3.0,7,5,6,0,1,4,5,80.0,1,0,0,0,0,7,10,0
891,Amine Harit,Marseille,4.2,3,3,0,3,0,0,1,0.0,1,5,0,5,3,6,1,1
892,Marcus Harness,Ipswich Town,0.5,1,0,0,0,1,0,3,0.0,3,2,1,1,0,1,1,0
893,Jack Harrison,Everton,4.8,7,4,3,2,2,3,9,33.3,6,2,0,2,4,11,7,1
894,Abdou Harroui,Hellas Verona,1.9,2,2,1,1,0,2,2,100.0,0,0,0,0,0,2,4,0
895,Taylor Harwood-Bellis,Southampton,5.6,1,1,1,0,0,0,1,0.0,1,12,7,5,7,8,18,1
896,Hans Hateboer,Rennes,4.7,9,4,4,3,2,5,7,71.4,2,3,1,2,5,14,9,0
897,Kai Havertz,Arsenal,7.0,7,5,2,2,3,3,9,33.3,6,9,2,7,4,11,15,1
898,Jan Paul van Hecke,Brighton,5.0,9,5,6,3,0,5,8,62.5,3,2,1,1,5,14,12,0
899,Hwang Hee-chan,Wolves,2.8,1,0,0,0,1,0,1,0.0,1,5,0,5,1,2,3,0
900,Dean Henderson,Crystal Palace,7.0,1,0,1,0,0,1,2,50.0,1,0,0,0,0,1,6,0
901,Liam Henderson,Empoli,6.1,4,1,2,2,0,2,7,28.6,5,7,4,3,5,9,11,0
902,Ramon Hendriks,Stuttgart,0.0,0,0,0,0,0,0,0,0.0,0,0,0,0,2,2,0,0
903,Benjamin Henrichs,RB Leipzig,2.7,15,4,7,6,2,8,10,80.0,2,3,0,3,8,23,6,0
904,Luis Henrique,Marseille,5.9,2,2,1,1,0,2,2,100.0,0,4,2,2,1,3,4,0
905,Mads Hermansen,Leicester City,7.0,1,1,1,0,0,1,1,100.0,0,0,0,0,0,1,4,1
906,Mario Hermoso,Roma,0.8,1,0,1,0,0,0,0,0.0,0,1,1,0,2,3,7,0
907,Javi Hernandez,Leganés,6.7,12,6,5,5,2,5,13,38.5,8,6,1,5,8,20,27,0
908,Theo Hernandez,Milan,5.4,7,5,7,0,0,2,4,50.0,2,4,1,3,8,15,13,0
910,Hernani,Parma,2.8,7,4,0,5,2,2,7,28.6,5,4,1,3,1,8,2,1
911,Jorge Herrando,Osasuna,4.1,2,1,1,1,0,1,2,50.0,1,6,5,1,1,3,16,0
912,Ander Herrera,Athletic Club,2.4,6,4,0,6,0,2,5,40.0,3,0,0,0,2,8,8,0
913,Sergio Herrera,Osasuna,9.0,1,0,1,0,0,1,1,100.0,0,0,0,0,0,1,10,1
914,Yangel Herrera,Girona,6.1,24,15,11,11,2,9,17,52.9,8,6,1,5,9,33,8,0
915,Juan Herzog,Las Palmas,4.0,2,2,2,0,0,2,4,50.0,2,4,3,1,4,6,18,0
916,Son Heung-min,Tottenham,5.0,2,2,0,1,1,0,4,0.0,4,3,0,3,2,4,4,0
917,Isak Hien,Atalanta,3.3,3,3,2,1,0,1,4,25.0,3,6,5,1,7,10,9,1
918,Omar El Hilali,Espanyol,9.0,25,17,19,4,2,11,20,55.0,9,12,2,10,9,34,40,0
919,Piero Hincapie,Leverkusen,4.7,9,8,4,4,1,6,9,66.7,3,13,6,7,6,15,11,0
920,Jack Hinshelwood,Brighton,6.7,7,4,2,3,2,4,9,44.4,5,1,0,1,3,10,9,1
921,George Hirst,Ipswich Town,0.7,1,1,1,0,0,0,1,0.0,1,0,0,0,0,1,0,0
922,Adam Hlozek,Hoffenheim,3.3,5,2,3,0,2,2,6,33.3,4,3,1,2,0,5,6,0
923,Ki-Jana Hoever,Auxerre,3.9,6,5,4,1,1,2,4,50.0,2,6,0,6,2,8,14,0
924,Nicolas Hofler,Freiburg,0.8,2,2,1,1,0,1,2,50.0,1,0,0,0,1,3,6,0
925,Jonas Hofmann,Leverkusen,1.4,0,0,0,0,0,0,0,0.0,0,1,0,1,0,0,1,0
926,Philipp Hofmann,Bochum,4.5,3,2,2,0,1,1,3,33.3,2,1,0,1,0,3,7,0
927,Lucas Holer,Freiburg,1.3,4,4,1,3,0,1,3,33.3,2,3,1,2,1,5,4,0
928,Mason Holgate,Everton,0.1,0,0,0,0,0,0,0,0.0,0,0,0,0,0,0,0,0
929,Benedict Hollerbach,Union Berlin,4.7,10,4,3,5,2,5,5,100.0,0,7,0,7,1,11,0,0
930,Emil Holm,Bologna,1.1,4,4,2,2,0,3,5,60.0,2,1,1,0,0,4,2,0
931,Lewis Holtby,Holstein Kiel,5.3,14,6,9,4,1,4,9,44.4,5,4,0,4,10,24,6,1
932,Franck Honorat,Gladbach,2.6,2,1,1,0,1,0,1,0.0,1,3,1,2,0,2,3,0
933,Mathias Honsak,Heidenheim,0.9,2,2,1,1,0,1,2,50.0,1,0,0,0,0,2,3,0
934,Dinko Horkas,Las Palmas,2.0,0,0,0,0,0,0,0,0.0,0,0,0,0,0,0,2,0
936,Cedric Hountondji,Angers,3.0,6,4,4,2,0,3,7,42.9,4,3,3,0,4,10,14,0
937,Ilyes Housni,Le Havre,0.8,5,4,0,3,2,2,3,66.7,1,2,0,2,0,5,0,0
938,Lukas Hradecky,Leverkusen,5.0,0,0,0,0,0,0,0,0.0,0,0,0,0,0,0,1,1
939,Robin Hranac,Hoffenheim,1.0,0,0,0,0,0,0,1,0.0,1,1,0,1,2,2,3,1
940,Callum Hudson-Odoi,Nott'ham Forest,5.3,5,4,0,4,1,2,3,66.7,1,3,0,3,3,8,4,0
941,Will Hughes,Crystal Palace,2.6,10,4,1,4,5,3,5,60.0,2,1,0,1,2,12,1,0
942,Dean Huijsen,Bournemouth,2.2,2,1,2,0,0,0,0,0.0,0,2,1,1,3,5,7,0
943,Omari Hutchinson,Ipswich Town,6.8,5,3,2,3,0,4,13,30.8,9,8,1,7,3,8,4,0
944,Elseid Hysaj,Lazio,0.1,1,1,0,1,0,0,0,0.0,0,0,0,0,0,1,1,0
945,Hong Hyunseok,Mainz 05,2.5,4,1,2,1,1,0,1,0.0,1,2,1,1,3,7,5,0
946,Pierre Hojbjerg,Marseille,6.9,17,12,14,3,0,15,26,57.7,11,11,3,8,15,32,15,1
947,Oscar Hojlund,Eint Frankfurt,0.2,2,1,2,0,0,0,0,0.0,0,1,0,1,1,3,0,0
948,Rasmus Hojlund,Manchester Utd,1.1,0,0,0,0,0,0,0,0.0,0,2,0,2,0,0,0,0
949,Pablo Ibanez,Osasuna,3.3,7,3,4,2,1,3,10,30.0,7,6,3,3,8,15,7,0
950,Stanis Idumbo,Sevilla,0.1,1,1,0,1,0,0,0,0.0,0,0,0,0,1,2,0,0
951,Jay Idzes,Venezia,5.7,5,3,3,2,0,1,2,50.0,1,7,4,3,2,7,18,0
952,Iglesias,Getafe,7.7,26,15,12,12,2,9,26,34.6,17,6,1,5,13,39,31,0
953,Borja Iglesias,Celta Vigo,5.1,3,3,1,1,1,0,1,0.0,1,3,1,2,3,6,4,0
954,Igor,Brighton,1.3,1,1,0,0,1,1,2,50.0,1,4,1,3,0,1,0,0
955,Kelechi Iheanacho,Sevilla,3.0,1,0,0,1,0,1,2,50.0,1,0,0,0,0,1,1,0
956,Jonathan Ikone,Fiorentina,1.2,2,1,2,0,0,0,1,0.0,1,1,0,1,0,2,0,0
957,George Ilenikhena,Monaco,2.5,0,0,0,0,0,0,0,0.0,0,0,0,0,1,1,0,0
958,Ivan Ilic,Torino,5.6,2,1,0,1,1,0,4,0.0,4,0,0,0,4,6,3,0
959,Samuel Iling-Junior,Bologna,1.0,2,1,1,1,0,0,0,0.0,0,0,0,0,2,4,0,0
960,Danny Ings,West Ham,0.3,0,0,0,0,0,0,0,0.0,0,0,0,0,0,0,0,0
962,Alessio Iovine,Como,2.5,1,0,0,1,0,1,3,33.3,2,4,1,3,2,3,17,0
963,Tim Iroegbunam,Everton,4.3,18,9,9,4,5,7,12,58.3,5,6,0,6,8,26,5,1
964,Jackson Irvine,St. Pauli,6.0,14,6,7,5,2,5,12,41.7,7,6,0,6,10,24,16,0
965,Andy Irving,West Ham,0.2,2,1,0,1,1,0,3,0.0,3,0,0,0,0,2,0,0
966,Alexander Isak,Newcastle Utd,4.5,2,2,0,1,1,1,3,33.3,2,6,1,5,1,3,5,0
967,Gustav Isaksen,Lazio,3.9,3,2,0,3,0,0,4,0.0,4,1,0,1,1,4,1,0
968,Ismaily,Lille,0.9,2,0,0,1,1,0,1,0.0,1,4,0,4,0,2,2,0
969,Ardian Ismajli,Empoli,7.0,5,4,3,2,0,2,3,66.7,1,9,6,3,12,17,73,0
970,Yanis Issoufou,Montpellier,0.8,5,3,4,1,0,3,5,60.0,2,1,0,1,0,5,1,0
971,Ko Itakura,Gladbach,6.0,14,10,7,6,1,8,10,80.0,2,3,3,0,5,19,33,0
972,Junya Ito,Reims,6.7,10,9,3,6,1,3,14,21.4,11,10,0,10,1,11,1,1
973,Marko Ivezic,Holstein Kiel,2.0,5,3,4,1,0,2,5,40.0,3,4,3,1,6,11,15,0
974,Alex Iwobi,Fulham,6.5,10,7,5,4,1,3,5,60.0,2,3,0,3,3,13,11,0
975,Armando Izzo,Monza,6.6,10,5,8,2,0,3,6,50.0,3,13,10,3,14,24,21,0
976,Nicolas Jackson,Chelsea,5.8,1,1,0,0,1,0,2,0.0,2,6,0,6,1,2,6,0
977,Lee Jae-sung,Mainz 05,4.8,10,7,3,5,2,2,4,50.0,2,6,1,5,3,13,8,0
978,Kristijan Jakic,Augsburg,3.9,6,1,1,4,1,0,4,0.0,4,10,0,10,4,10,2,0
979,Karl Jakob Hein,Valladolid,9.0,0,0,0,0,0,0,1,0.0,1,0,0,0,0,0,4,0
980,Ismail Jakobs,Monaco,2.0,5,5,3,0,2,3,5,60.0,2,0,0,0,2,7,6,0
981,Jordan James,Rennes,0.3,2,0,1,0,1,1,3,33.3,2,0,0,0,0,2,1,0
982,Vitaly Janelt,Brentford,6.2,9,7,4,3,2,6,10,60.0,4,9,1,8,6,15,16,0
983,Adnan Januzaj,Las Palmas,2.1,2,1,0,2,0,1,2,50.0,1,1,0,1,0,2,1,0
984,Vitezslav Jaros,Liverpool,0.1,0,0,0,0,0,0,0,0.0,0,0,0,0,0,0,0,0
985,Ali Jasim,Como,0.0,0,0,0,0,0,0,0,0.0,0,0,0,0,0,0,0,0
986,Mikel Jauregizar,Athletic Club,4.3,18,9,5,9,4,11,18,61.1,7,3,1,2,5,23,2,1
988,Dominik Javorcek,Holstein Kiel,0.5,1,0,1,0,0,1,1,100.0,0,1,1,0,1,2,4,1
989,Gaby Jean,Lecce,0.2,0,0,0,0,0,0,1,0.0,1,1,1,0,0,0,2,0
990,Daniel Jebbison,Bournemouth,0.3,0,0,0,0,0,0,1,0.0,1,0,0,0,0,0,1,0
991,Fredrik Jensen,Augsburg,1.3,1,1,0,0,1,1,1,100.0,0,2,0,2,0,1,1,0
992,Mathias Jensen,Brentford,2.6,1,1,1,0,0,0,3,0.0,3,3,1,2,2,3,2,0
993,Moritz Jenz,Mainz 05,4.0,6,1,4,2,0,0,3,0.0,3,6,6,0,3,9,32,0
994,Gabriel Jesus,Arsenal,0.9,3,2,3,0,0,2,3,66.7,1,3,1,2,2,5,0,0
995,Juan Jesus,Napoli,0.9,0,0,0,0,0,0,0,0.0,0,0,0,0,0,0,3,0
996,Raul Jimenez,Fulham,3.8,5,2,1,3,1,0,4,0.0,4,1,0,1,1,6,4,0
997,Joao Pedro,Brighton,3.1,5,3,1,3,1,1,3,33.3,2,2,0,2,1,6,2,0
998,John Joe,Getafe,0.1,0,0,0,0,0,0,0,0.0,0,1,1,0,0,0,1,0
999,Joelinton,Newcastle Utd,6.3,19,11,8,6,5,9,18,50.0,9,12,3,9,2,21,14,1
1000,Jofre,Espanyol,6.1,3,3,2,1,0,1,5,20.0,4,1,0,1,2,5,7,0
1001,Carl Johansson,Holstein Kiel,3.9,4,2,4,0,0,3,6,50.0,3,7,6,1,6,10,23,1
1002,Ben Johnson,Ipswich Town,2.5,11,8,9,2,0,7,11,63.6,4,4,1,3,3,14,3,0
1003,Brennan Johnson,Tottenham,5.7,14,9,2,8,4,7,10,70.0,3,6,1,5,1,15,7,0
1004,Karl-Johan Johnsson,Strasbourg,3.0,0,0,0,0,0,0,1,0.0,1,0,0,0,0,0,3,0
1005,Sam Johnstone,Wolves,5.0,0,0,0,0,0,0,0,0.0,0,0,0,0,0,0,5,0
1006,Paul Joly,Auxerre,4.4,16,11,11,5,0,8,15,53.3,7,5,0,5,11,27,14,3
1007,Curtis Jones,Liverpool,1.7,3,0,1,2,0,3,3,100.0,0,3,2,1,0,3,3,0
1008,Frenkie de Jong,Barcelona,0.1,0,0,0,0,0,0,0,0.0,0,0,0,0,0,0,0,0
1009,Joan Jordan,Alavés,2.4,8,6,2,4,2,4,8,50.0,4,2,0,2,0,8,4,0
1010,Jorginho,Arsenal,1.7,2,1,0,1,1,2,4,50.0,2,0,0,0,0,2,0,1
1011,Jesse Joronen,Venezia,7.0,0,0,0,0,0,0,0,0.0,0,0,0,0,0,0,3,0
1012,Jota,Rennes,0.4,0,0,0,0,0,0,0,0.0,0,0,0,0,0,0,1,0
1014,Diogo Jota,Liverpool,5.1,3,1,0,2,1,2,6,33.3,4,1,0,1,3,6,3,0
1015,Antoine Joujou,Le Havre,3.4,6,5,4,1,1,2,4,50.0,2,8,2,6,3,9,3,0
1016,Luka Jovic,Milan,0.9,0,0,0,0,0,0,0,0.0,0,0,0,0,1,1,0,0
1017,Juanmi,Betis,1.6,6,3,3,2,1,3,5,60.0,2,4,0,4,1,7,4,0
1018,Juanpe,Girona,1.0,1,1,1,0,0,0,0,0.0,0,4,2,2,0,1,4,0
1019,Jubal,Auxerre,5.4,8,6,7,1,0,5,11,45.5,6,9,3,6,4,12,28,0
1020,Abdulai Juma Bah,Valladolid,2.9,4,3,2,2,0,0,2,0.0,2,4,2,2,4,8,14,0
1021,Anthony Jung,Werder Bremen,5.4,7,5,5,2,0,3,5,60.0,2,3,1,2,6,13,25,0
1022,Hamed Junior Traore,Auxerre,4.6,9,5,2,4,3,2,9,22.2,7,3,0,3,3,12,6,0
1023,Vinicius Junior,Real Madrid,8.1,8,4,1,2,5,1,4,25.0,3,1,0,1,0,8,1,1
1024,David Jurasek,Hoffenheim,0.2,1,0,1,0,0,0,0,0.0,0,1,0,1,0,1,0,0
1025,Stanko Juric,Valladolid,6.1,19,10,12,6,1,11,23,47.8,12,10,4,6,8,27,19,0
1026,James Justin,Leicester City,7.0,13,8,7,4,2,7,14,50.0,7,9,1,8,11,24,34,0
1027,Yusuf Kabadayi,Augsburg,0.4,1,0,0,1,0,0,0,0.0,0,1,0,1,0,1,0,0
1028,Christian Kabasele,Udinese,4.4,7,5,4,3,0,3,3,100.0,0,3,0,3,6,13,16,1
1029,Yaya Kader Fofana,Reims,4.8,13,8,7,5,1,3,9,33.3,6,5,0,5,2,15,2,0
1030,Pavel Kaderabek,Hoffenheim,4.8,7,4,4,1,2,5,12,41.7,7,5,2,3,6,13,13,0
1031,Tino Kadewere,Nantes,3.5,11,5,4,3,4,6,9,66.7,3,1,0,1,3,14,7,0
1032,Ferdi Kadioglu,Brighton,1.5,3,1,1,2,0,2,7,28.6,5,0,0,0,5,8,6,0
1033,Arnaud Kalimuendo,Rennes,4.4,3,2,0,1,2,1,1,100.0,0,1,0,1,0,3,0,0
1034,Pierre Kalulu,Juventus,4.0,4,2,4,0,0,2,2,100.0,0,6,2,4,3,7,4,0
1035,Daichi Kamada,Crystal Palace,4.1,12,6,3,7,2,4,10,40.0,6,6,1,5,3,15,4,0
1036,Waren Kamanzi,Toulouse,4.3,16,8,7,7,2,7,15,46.7,8,1,0,1,1,17,9,0
1037,Glen Kamara,Rennes,4.0,13,6,4,7,2,7,10,70.0,3,6,0,6,4,17,4,0
1038,Hassane Kamara,Udinese,3.6,9,5,4,4,1,1,2,50.0,1,4,1,3,6,15,10,0
1040,Willy Kambwala,Villarreal,1.0,4,2,3,0,1,2,2,100.0,0,1,1,0,0,4,6,0
1041,Jakub Kaminski,Wolfsburg,5.9,10,4,4,2,4,5,16,31.3,11,11,6,5,6,16,7,0
1042,Kevin Kampl,RB Leipzig,2.9,6,4,2,2,2,3,4,75.0,1,6,1,5,3,9,3,0
1043,Nordine Kandil,Strasbourg,0.1,0,0,0,0,0,0,0,0.0,0,0,0,0,0,0,1,0
1044,Harry Kane,Bayern Munich,5.6,2,2,0,1,1,0,1,0.0,1,3,0,3,0,2,2,0
1045,Lee Kang-in,Paris S-G,4.7,9,6,3,2,4,8,12,66.7,4,1,0,1,1,10,2,0
1046,Yann Karamoh,Torino,0.5,0,0,0,0,0,0,1,0.0,1,1,1,0,0,0,0,0
1047,Atakan Karazor,Stuttgart,4.9,14,4,1,8,5,7,8,87.5,1,2,0,2,4,18,6,0
1048,Jesper Karlsson,Bologna,1.0,0,0,0,0,0,0,1,0.0,1,0,0,0,0,0,0,0
1049,Jesper Karlstrom,Udinese,6.2,11,5,6,4,1,1,6,16.7,5,6,3,3,10,21,16,0
1050,Lior Kasa,Genoa,0.2,0,0,0,0,0,0,0,0.0,0,0,0,0,1,1,0,0
1051,Grigoris Kastanos,Hellas Verona,3.1,3,1,1,1,1,2,3,66.7,1,7,1,6,2,5,2,0
1052,Mikkel Kaufmann,Heidenheim,1.6,3,2,1,1,1,1,2,50.0,1,2,1,1,0,3,4,0
1053,Michael Kayode,Fiorentina,0.2,1,1,1,0,0,0,0,0.0,0,2,1,1,0,1,3,0
1054,Moise Kean,Fiorentina,6.9,2,2,0,0,2,1,2,50.0,1,3,0,3,0,2,7,0
1055,Michael Keane,Everton,6.0,5,3,5,0,0,3,5,60.0,2,4,3,1,9,14,35,0
1056,Yassine Kechta,Le Havre,5.5,14,9,5,7,2,7,19,36.8,12,7,0,7,5,19,1,0
1057,Thilo Kehrer,Monaco,5.0,14,12,9,5,0,6,9,66.7,3,1,1,0,4,18,27,1
1058,Abdoulaye Keita,Getafe,0.3,0,0,0,0,0,0,0,0.0,0,1,0,1,0,0,0,0
1059,Mandela Keita,Parma,0.2,0,0,0,0,0,0,0,0.0,0,0,0,0,0,0,1,0
1060,Andu Kelati,Holstein Kiel,1.1,1,1,1,0,0,0,1,0.0,1,1,0,1,2,3,1,0
1061,Caoimhin Kelleher,Liverpool,1.0,0,0,0,0,0,0,0,0.0,0,0,0,0,0,0,0,1
1062,Lloyd Kelly,Newcastle Utd,2.3,2,2,2,0,0,0,0,0.0,0,4,2,2,1,3,14,0
1063,Aljoscha Kemlein,Union Berlin,0.8,2,1,1,1,0,0,1,0.0,1,0,0,0,1,3,1,0
1064,Marc-Oliver Kempf,Como,5.0,3,3,0,3,0,1,2,50.0,1,4,2,2,10,13,23,0
1066,Kenedy,Valladolid,0.1,0,0,0,0,0,0,0,0.0,0,1,0,1,0,0,0,0
1067,Luca Kerber,Heidenheim,0.9,2,2,1,1,0,2,3,66.7,1,1,0,1,0,2,5,0
1068,Milos Kerkez,Bournemouth,6.4,10,4,3,5,2,4,8,50.0,4,7,3,4,7,17,15,0
1069,Reda Khadra,Reims,0.9,1,1,1,0,0,0,1,0.0,1,0,0,0,0,1,1,0
1070,Bilal El Khannouss,Leicester City,0.9,1,1,0,0,1,0,0,0.0,0,0,0,0,0,1,0,0
1071,Wahbi Khazri,Montpellier,2.1,3,2,0,2,1,1,2,50.0,1,1,1,0,2,5,1,0
1072,Rani Khedira,Union Berlin,6.0,10,6,3,6,1,4,6,66.7,2,4,2,2,9,19,9,0
1073,Abdukodir Khusanov,Lens,5.2,7,5,6,1,0,3,4,75.0,1,12,9,3,16,23,34,0
1074,Kike,Alavés,4.7,2,2,0,2,0,1,2,50.0,1,0,0,0,0,2,3,0
1075,Max Kilman,West Ham,7.0,4,2,2,2,0,2,4,50.0,2,9,5,4,10,14,33,0
1076,Joshua Kimmich,Bayern Munich,6.0,7,4,2,3,2,6,9,66.7,3,2,0,2,5,12,7,2
1077,Joshua King,Toulouse,2.1,1,1,0,0,1,0,0,0.0,0,0,0,0,0,1,5,0
1078,Cedric Kipre,Reims,4.1,8,6,7,1,0,8,10,80.0,2,8,3,5,2,10,25,0
1079,Jakub Kiwior,Arsenal,0.2,0,0,0,0,0,0,0,0.0,0,1,1,0,0,0,1,0
1080,Tim Kleindienst,Gladbach,5.9,5,2,1,3,1,1,6,16.7,5,8,0,8,1,6,14,0
1081,Lukas Klostermann,RB Leipzig,4.2,7,4,5,1,1,4,6,66.7,2,7,3,4,4,11,18,1
1082,Justin Kluivert,Bournemouth,4.3,7,4,3,2,2,1,3,33.3,2,4,0,4,4,11,8,0
1083,Ansgar Knauff,Eint Frankfurt,2.3,9,4,6,2,1,3,4,75.0,1,4,0,4,0,9,4,0
1084,Magnus Knudsen,Holstein Kiel,5.7,16,7,9,3,4,9,15,60.0,6,7,4,3,6,22,11,0
1085,Gregor Kobel,Dortmund,6.0,0,0,0,0,0,0,0,0.0,0,0,0,0,0,0,3,1
1086,Robin Koch,Eint Frankfurt,6.0,1,1,1,0,0,0,2,0.0,2,15,9,6,3,4,36,1
1087,Magnus Kofod Andersen,Venezia,3.0,5,0,1,4,0,0,2,0.0,2,1,0,1,3,8,2,0
1088,Derrick Kohn,Werder Bremen,2.5,2,1,1,0,1,0,0,0.0,0,2,2,0,2,4,5,0
1089,Philipp Kohn,Monaco,7.0,0,0,0,0,0,0,1,0.0,1,0,0,0,0,0,4,0
1090,Dominik Kohr,Mainz 05,5.8,19,14,12,4,3,12,17,70.6,5,14,8,6,5,24,34,0
1092,Koke,Atlético Madrid,7.1,14,9,7,4,3,7,14,50.0,7,9,0,9,7,21,8,0
1093,Sead Kolasinac,Atalanta,3.9,7,5,2,5,0,2,4,50.0,2,1,0,1,6,13,8,0
1094,Randal Kolo Muani,Paris S-G,3.3,4,4,1,1,2,0,0,0.0,0,0,0,0,0,4,3,0
1095,Marco Komenda,Holstein Kiel,1.1,3,2,2,1,0,3,3,100.0,0,1,0,1,0,3,6,0
1096,Mert Komur,Augsburg,0.3,0,0,0,0,0,0,0,0.0,0,1,1,0,0,0,0,1
1097,Ibrahima Konate,Liverpool,6.3,8,5,5,2,1,6,6,100.0,0,10,5,5,3,11,28,1
1098,Geoffrey Kondogbia,Marseille,5.9,18,10,11,7,0,12,12,100.0,0,2,0,2,7,25,17,0
1099,Abdoul Kone,Reims,0.7,4,2,3,1,0,2,4,50.0,2,1,1,0,1,5,1,0
1100,Amadou Kone,Reims,0.2,2,1,1,1,0,2,2,100.0,0,0,0,0,1,3,0,0
1101,Ismael Kone,Marseille,1.6,3,1,2,1,0,1,2,50.0,1,4,1,3,2,5,1,0
1102,Manu Kone,Roma,2.9,3,2,1,2,0,2,5,40.0,3,2,0,2,3,6,2,0
1103,Ezri Konsa,Aston Villa,6.1,7,5,4,2,1,4,6,66.7,2,3,0,3,3,10,23,0
1104,Teun Koopmeiners,Juventus,4.0,6,4,0,5,1,2,4,50.0,2,1,1,0,0,6,2,0
1105,Odilon Kossounou,Atalanta,1.7,3,3,1,2,0,1,2,50.0,1,2,1,1,1,4,0,0
1106,Christian Kouame,Fiorentina,3.3,8,5,3,3,2,0,3,0.0,3,1,0,1,2,10,5,0
1107,Henri Koudossou,Augsburg,0.7,1,1,0,1,0,1,3,33.3,2,1,1,0,0,1,5,0
1108,Konstantinos Koulierakis,Wolfsburg,2.6,5,2,4,1,0,2,5,40.0,3,7,3,4,1,6,17,0
1109,Jules Kounde,Barcelona,8.3,17,11,9,6,2,13,16,81.3,3,10,2,8,4,21,23,1
1110,Boubakar Kouyate,Montpellier,1.2,4,1,3,1,0,3,5,60.0,2,0,0,0,3,7,5,0
1111,Mateo Kovacic,Manchester City,5.8,15,11,5,8,2,5,14,35.7,9,6,0,6,2,17,5,0
1112,Matej Kovar,Leverkusen,1.0,0,0,0,0,0,0,0,0.0,0,0,0,0,0,0,0,0
1113,Mateusz Kowalski,Parma,0.6,0,0,0,0,0,0,0,0.0,0,1,0,1,0,0,1,0
1114,Emil Krafth,Newcastle Utd,2.7,2,1,0,1,1,1,2,50.0,1,5,4,1,2,4,10,0
1115,Alex Kral,Espanyol,8.4,22,15,14,8,0,6,9,66.7,3,14,8,6,10,32,19,0
1116,Andrej Kramaric,Hoffenheim,4.7,1,1,0,1,0,1,3,33.3,2,3,1,2,0,1,1,0
1118,Frans Kratzig,Stuttgart,0.6,2,1,1,0,1,1,3,33.3,2,2,1,1,0,2,1,0
1119,Ladislav Krejci,Girona,3.1,2,0,2,0,0,1,2,50.0,1,4,2,2,5,7,11,0
1120,Rasmus Kristensen,Eint Frankfurt,6.0,16,8,12,2,2,12,21,57.1,9,7,3,4,3,19,22,0
1121,Thomas Kristensen,Udinese,2.1,2,1,1,1,0,1,2,50.0,1,1,1,0,0,2,7,0
1122,Nikola Krstovic,Lecce,6.7,8,3,3,2,3,3,6,50.0,3,1,0,1,1,9,3,0
1123,Lukas Kubler,Freiburg,5.2,10,6,6,3,1,6,8,75.0,2,11,3,8,17,27,10,1
1124,Takefusa Kubo,Real Sociedad,7.0,7,3,3,2,2,5,9,55.6,4,14,1,13,3,10,3,0
1125,Mohammed Kudus,West Ham,6.4,7,5,1,3,3,3,10,30.0,7,9,1,8,1,8,1,0
1126,Dejan Kulusevski,Tottenham,5.9,5,2,1,0,4,0,7,0.0,7,10,2,8,5,10,7,0
1127,Sael Kumbedi,Lyon,1.0,4,2,1,2,1,3,4,75.0,1,0,0,0,2,6,3,0
1128,Marash Kumbulla,Espanyol,7.7,10,6,8,1,1,3,7,42.9,4,18,13,5,8,18,50,0
1129,Daler Kuzyaev,Le Havre,3.5,6,5,3,3,0,1,4,25.0,3,5,3,2,4,10,3,0
1130,Khvicha Kvaratskhelia,Napoli,5.8,10,8,3,6,1,4,8,50.0,4,6,0,6,1,11,4,0
1131,Moritz-Broni Kwarteng,Bochum,0.7,0,0,0,0,0,0,1,0.0,1,0,0,0,0,0,0,0
1132,Giorgos Kyriakopoulos,Monza,7.0,17,12,8,8,1,10,17,58.8,7,10,2,8,7,24,17,0
1133,Remy Labeau Lascary,Lens,2.7,1,0,0,1,0,0,3,0.0,3,2,0,2,0,1,2,0
1134,Gaetan Laborde,Nice,0.9,0,0,0,0,0,0,2,0.0,2,0,0,0,1,1,1,0
1135,Nediljko Labrovic,Augsburg,6.0,0,0,0,0,0,0,0,0.0,0,0,0,0,0,0,7,0
1136,Alexandre Lacazette,Lyon,4.9,2,1,1,1,0,2,5,40.0,3,1,0,1,0,2,1,0
1137,Maxence Lacroix,Crystal Palace,4.0,7,4,5,1,1,2,6,33.3,4,6,2,4,7,14,15,0
1138,Alban Lafont,Nantes,7.0,1,1,1,0,0,1,1,100.0,0,0,0,0,0,1,5,1
1139,Konrad Laimer,Bayern Munich,1.3,4,4,0,4,0,2,4,50.0,2,1,0,1,1,5,1,0
1140,Stefan Lainer,Gladbach,0.2,1,0,0,1,0,0,0,0.0,0,0,0,0,2,3,0,0
1141,Kenny Lala,Brest,6.0,17,12,10,7,0,13,18,72.2,5,11,6,5,6,23,13,0
1142,Adam Lallana,Southampton,1.3,3,3,2,1,0,2,4,50.0,2,0,0,0,3,6,2,0
1144,Mathis Lambourde,Hellas Verona,0.1,1,0,1,0,0,0,0,0.0,0,0,0,0,0,1,0,0
1145,Mohamed Lamine Bayo,Lille,2.1,0,0,0,0,0,0,0,0.0,0,0,0,0,0,0,0,0
1146,Gianluca Lapadula,Cagliari,1.0,1,0,0,0,1,0,0,0.0,0,0,0,0,0,1,1,0
1147,Cyle Larin,Mallorca,4.6,2,2,1,1,0,0,2,0.0,2,4,0,4,1,3,3,0
1148,Gautier Larsonneur,Saint-Étienne,7.0,0,0,0,0,0,0,0,0.0,0,0,0,0,0,0,5,0
1149,Hugo Larsson,Eint Frankfurt,5.6,4,1,2,2,0,3,9,33.3,6,11,5,6,6,10,12,0
1150,Juanmi Latasa,Valladolid,4.6,1,0,0,1,0,0,2,0.0,2,1,0,1,0,1,4,0
1151,Toni Lato,Mallorca,1.9,5,4,1,0,4,1,3,33.3,2,2,0,2,2,7,7,0
1152,Romeo Lavia,Chelsea,0.9,3,1,0,2,1,0,1,0.0,1,0,0,0,3,6,1,0
1153,Valentino Lazaro,Torino,6.3,9,2,4,4,1,7,11,63.6,4,6,2,4,0,9,13,1
1154,Darko Lazovic,Hellas Verona,5.7,10,3,1,7,2,5,9,55.6,4,5,0,5,4,14,10,0
1155,Manuel Lazzari,Lazio,5.5,7,6,3,3,1,4,7,57.1,3,1,1,0,1,8,6,0
1156,Julien Le Cardinal,Brest,4.8,6,3,3,3,0,3,6,50.0,3,7,6,1,9,15,27,0
1157,Jeremy Le Douaron,Brest,1.1,1,0,0,0,1,0,1,0.0,1,1,0,1,0,1,0,0
1158,Enzo Le Fee,Roma,1.0,2,2,0,2,0,0,2,0.0,2,3,1,2,1,3,0,0
1159,Robin Le Normand,Atlético Madrid,7.0,11,8,11,0,0,3,5,60.0,2,3,2,1,2,13,25,0
1160,Rafael Leao,Milan,5.7,3,3,0,2,1,1,2,50.0,1,5,0,5,4,7,0,0
1161,Benjamin Lecomte,Montpellier,4.0,0,0,0,0,0,0,0,0.0,0,0,0,0,0,0,3,0
1162,Pierre Lees-Melou,Brest,0.5,2,1,0,1,1,0,0,0.0,0,0,0,0,1,3,1,0
1163,Jordan Lefort,Angers,7.0,16,13,13,3,0,10,14,71.4,4,12,4,8,9,25,28,1
1164,Diogo Leite,Union Berlin,6.0,20,11,14,5,1,9,16,56.3,7,14,6,8,12,32,21,0
1165,Maxim Leitsch,Mainz 05,3.1,5,1,2,2,1,3,3,100.0,0,5,2,3,4,9,20,0
1166,Florian Lejeune,Rayo Vallecano,9.0,12,8,7,3,2,5,9,55.6,4,10,9,1,3,15,40,0
1167,Inigo Lekue,Athletic Club,3.5,4,3,3,1,0,3,6,50.0,3,2,1,1,3,7,13,2
1168,Nunzio Lella,Venezia,0.1,0,0,0,0,0,0,0,0.0,0,0,0,0,0,0,0,0
1170,Felix Lemarechal,Strasbourg,0.9,0,0,0,0,0,0,0,0.0,0,3,0,3,0,0,2,0
1171,Mario Lemina,Wolves,7.0,22,12,12,8,2,11,14,78.6,3,6,4,2,15,37,14,1
1172,Clement Lenglet,Atlético Madrid,1.0,0,0,0,0,0,0,1,0.0,1,1,0,1,1,1,10,0
1173,Bernd Leno,Fulham,7.0,0,0,0,0,0,0,0,0.0,0,1,0,1,0,0,1,3
1174,Donovan Leon,Auxerre,7.0,0,0,0,0,0,0,0,0.0,0,0,0,0,0,0,5,1
1175,Esteban Lepaul,Angers,1.3,1,1,0,0,1,0,3,0.0,3,0,0,0,0,1,2,0
1176,Johann Lepenant,Nantes,4.9,11,5,5,4,2,3,10,30.0,7,5,2,3,6,17,3,0
1177,Jefferson Lerma,Crystal Palace,3.4,3,2,1,1,1,2,4,50.0,2,3,1,2,5,8,7,0
1178,Louis Leroux,Nantes,0.2,1,1,1,0,0,1,1,100.0,0,0,0,0,0,1,0,0
1179,Robert Lewandowski,Barcelona,8.2,4,1,0,3,1,1,2,50.0,1,2,0,2,1,5,5,0
1180,Jamie Leweling,Stuttgart,5.5,4,2,2,0,2,2,5,40.0,3,9,0,9,2,6,5,0
1181,Rico Lewis,Manchester City,5.4,13,5,6,6,1,5,6,83.3,1,8,2,6,4,17,14,1
1182,Keane Lewis-Potter,Brentford,5.1,11,5,4,5,2,6,10,60.0,4,6,2,4,3,14,7,0
1183,Myles Lewis-Skelly,Arsenal,0.0,0,0,0,0,0,0,0,0.0,0,0,0,0,0,0,1,0
1184,Philipp Lienhart,Freiburg,5.5,5,4,3,2,0,3,6,50.0,3,3,3,0,9,14,14,1
1185,Matthijs de Ligt,Manchester Utd,4.5,8,3,6,2,0,5,7,71.4,2,7,5,2,7,15,15,0
1186,Victor Lindelof,Manchester Utd,0.5,3,0,3,0,0,1,1,100.0,0,1,0,1,1,4,3,0
1187,Jesper Lindstrom,Everton,1.7,8,5,2,6,0,2,3,66.7,1,4,1,3,1,9,0,0
1188,Karol Linetty,Torino,4.9,14,8,6,8,0,6,11,54.5,5,6,2,4,4,18,11,0
1189,Samuel Lino,Atlético Madrid,4.6,9,3,6,2,1,6,17,35.3,11,7,1,6,4,13,3,0
1190,Pol Lirola,Marseille,1.5,3,2,1,2,0,1,3,33.3,2,0,0,0,0,3,2,0
1191,Dailon Livramento,Hellas Verona,2.7,6,5,1,3,2,2,5,40.0,3,3,0,3,2,8,1,0
1192,Valentino Livramento,Newcastle Utd,3.9,10,5,6,4,0,6,8,75.0,2,11,3,8,3,13,16,0
1193,Diego Llorente,Betis,9.0,12,5,7,5,0,4,10,40.0,6,10,10,0,14,26,39,1
1194,Marcos Llorente,Atlético Madrid,7.0,16,12,10,4,2,9,13,69.2,4,6,1,5,5,21,13,1
1196,Gautier Lloris,Le Havre,7.0,14,8,8,6,0,9,16,56.3,7,4,3,1,4,18,30,0
1197,Giovani Lo Celso,Betis,5.1,10,6,3,2,5,6,9,66.7,3,3,0,3,1,11,1,0
1198,Stanislav Lobotka,Napoli,6.7,15,9,2,8,5,5,7,71.4,2,6,2,4,4,19,8,0
1199,Manuel Locatelli,Juventus,5.0,11,9,6,4,1,3,7,42.9,4,8,1,7,2,13,11,0
1200,Ruben Loftus-Cheek,Milan,4.5,7,3,2,2,3,1,3,33.3,2,1,0,1,1,8,4,0
1201,Enzo Loiodice,Las Palmas,2.6,2,2,1,1,0,1,3,33.3,2,3,0,3,2,4,2,0
1202,Sean Longstaff,Newcastle Utd,3.4,11,9,3,6,2,8,13,61.5,5,8,1,7,4,15,3,0
1203,Ademola Lookman,Atalanta,3.1,5,3,4,1,0,2,3,66.7,1,6,0,6,1,6,0,0
1204,David Lopez,Girona,7.4,4,1,2,0,2,2,6,33.3,4,12,6,6,7,11,28,1
1205,Diego Lopez,Valencia,7.3,5,4,1,2,2,4,14,28.6,10,5,0,5,2,7,1,0
1206,Fermin Lopez,Barcelona,0.7,2,2,1,0,1,1,3,33.3,2,1,0,1,1,3,0,0
1207,Javi Lopez,Real Sociedad,5.7,12,6,7,4,1,6,10,60.0,4,4,1,3,1,13,16,1
1208,Roberto Lopez,Leganés,3.7,6,4,3,3,0,4,12,33.3,8,4,0,4,1,7,6,1
1209,Unai Lopez,Rayo Vallecano,5.5,5,3,2,1,2,3,9,33.3,6,5,1,4,10,15,6,0
1210,Iker Losada,Betis,1.0,5,4,1,1,3,2,4,50.0,2,1,0,1,1,6,1,0
1211,Anthony Losilla,Bochum,3.8,7,7,3,4,0,3,8,37.5,5,9,3,6,8,15,5,0
1212,Jordan Lotomba,Nice,0.4,0,0,0,0,0,0,0,0.0,0,0,0,0,0,0,1,0
1213,Tom Louchet,Nice,0.4,0,0,0,0,0,0,0,0.0,0,0,0,0,0,0,0,0
1214,Sandi Lovric,Udinese,3.5,7,5,4,2,1,4,8,50.0,4,4,0,4,5,12,1,0
1215,Pol Lozano,Espanyol,4.2,13,9,6,6,1,6,11,54.5,5,3,2,1,1,14,4,0
1216,Lorenzo Lucca,Udinese,5.1,7,4,1,2,4,3,5,60.0,2,2,0,2,1,8,2,0
1217,Jhon Lucumi,Bologna,3.4,5,3,4,1,0,3,6,50.0,3,6,3,3,3,8,11,0
1218,Jose Luis Palomino,Cagliari,1.0,1,1,0,0,1,0,1,0.0,1,1,1,0,0,1,3,0
1219,Douglas Luiz,Juventus,2.0,4,2,2,2,0,3,4,75.0,1,2,0,2,1,5,0,0
1220,Romelu Lukaku,Napoli,3.8,0,0,0,0,0,0,2,0.0,2,0,0,0,0,0,4,0
1222,Castello Lukeba,RB Leipzig,4.9,8,3,2,5,1,2,5,40.0,3,8,4,4,3,11,14,0
1223,Dodi Lukebakio,Sevilla,7.3,5,4,2,2,1,1,4,25.0,3,5,0,5,1,6,3,0
1224,Sasa Lukic,Fulham,6.1,12,6,6,5,1,3,15,20.0,12,6,3,3,8,20,6,0
1225,Andriy Lunin,Real Madrid,1.0,0,0,0,0,0,0,0,0.0,0,0,0,0,0,0,0,0
1226,Massimo Luongo,Ipswich Town,1.6,5,3,5,0,0,4,6,66.7,2,3,2,1,2,7,2,0
1227,Sebastiano Luperto,Cagliari,7.0,9,6,7,1,1,3,6,50.0,3,7,5,2,8,17,29,0
1228,Zito Luvumbo,Cagliari,5.3,1,0,1,0,0,0,4,0.0,4,1,0,1,0,1,1,0
1229,Charalambos Lykogiannis,Bologna,4.5,5,2,3,2,0,3,7,42.9,4,1,1,0,3,8,13,0
1230,Senne Lynen,Werder Bremen,4.8,11,5,5,3,3,6,7,85.7,1,8,1,7,4,15,10,0
1231,Othmane Maamma,Montpellier,0.1,0,0,0,0,0,0,0,0.0,0,0,0,0,0,0,0,0
1232,Ian Maatsen,Aston Villa,1.4,5,3,1,4,0,1,2,50.0,1,1,0,1,0,5,3,1
1233,Alexis Mac Allister,Liverpool,6.2,18,13,6,11,1,11,24,45.8,13,17,0,17,3,21,7,0
1234,Deiver Machado,Lens,2.6,2,1,2,0,0,2,2,100.0,0,2,0,2,1,3,4,0
1235,Shuto Machino,Holstein Kiel,4.2,2,2,1,0,1,2,4,50.0,2,0,0,0,2,4,2,0
1236,Darwin Machis,Valladolid,3.0,0,0,0,0,0,0,4,0.0,4,2,0,2,1,1,3,0
1237,Yvann Macon,Saint-Étienne,1.6,2,1,0,2,0,1,1,100.0,0,1,1,0,0,2,4,1
1238,James Maddison,Tottenham,6.3,9,5,1,6,2,4,11,36.4,7,3,2,1,5,14,7,0
1239,Eros Maddy,Auxerre,0.1,0,0,0,0,0,0,0,0.0,0,0,0,0,0,0,0,0
1240,Noni Madueke,Chelsea,5.3,8,6,2,5,1,4,10,40.0,6,2,0,2,3,11,4,0
1241,Pablo Maffeo,Mallorca,5.4,13,7,7,5,1,7,10,70.0,3,8,2,6,4,17,16,0
1242,Gabriel Magalhaes,Arsenal,7.0,6,3,4,2,0,4,7,57.1,3,17,12,5,4,10,27,1
1243,Soungoutou Magassa,Monaco,1.9,12,8,3,8,1,7,9,77.8,2,1,0,1,4,16,1,1
1244,Giangiacomo Magnani,Hellas Verona,3.3,5,5,3,2,0,1,1,100.0,0,6,4,2,4,9,12,0
1245,Hugo Magnetti,Brest,5.3,5,1,3,2,0,4,9,44.4,5,5,1,4,5,10,9,0
1246,Frank Magri,Toulouse,3.1,1,0,0,0,1,1,4,25.0,3,7,0,7,1,2,3,0
1248,Harry Maguire,Manchester Utd,2.7,2,1,2,0,0,2,2,100.0,0,2,2,0,6,8,10,0
1249,Jon Magunacelaya,Real Sociedad,0.1,1,1,1,0,0,0,0,0.0,0,0,0,0,0,1,0,0
1250,Arne Maier,Augsburg,1.9,1,0,0,1,0,1,1,100.0,0,3,0,3,0,1,0,0
1251,Mike Maignan,Milan,7.0,0,0,0,0,0,0,0,0.0,0,0,0,0,0,0,4,1
1252,Patrick Mainka,Heidenheim,6.0,6,4,6,0,0,3,4,75.0,1,10,5,5,10,16,28,0
1253,Kobbie Mainoo,Manchester Utd,6.3,16,13,12,3,1,10,15,66.7,5,5,1,4,14,30,2,1
1254,Ainsley Maitland-Niles,Lyon,5.1,23,15,8,9,6,16,20,80.0,4,6,1,5,11,34,10,2
1255,Lovro Majer,Wolfsburg,1.3,0,0,0,0,0,0,1,0.0,1,1,0,1,0,0,1,0
1256,Jordy Makengo,Freiburg,0.3,3,2,3,0,0,2,2,100.0,0,0,0,0,0,3,4,0
1257,Antoine Makoumbou,Cagliari,2.4,3,2,2,1,0,1,2,50.0,1,7,1,6,3,6,3,0
1258,Julian Malatini,Werder Bremen,2.4,6,6,3,2,1,3,5,60.0,2,2,2,0,3,9,9,0
1259,Daniel Maldini,Monza,5.6,9,4,1,8,0,3,5,60.0,2,3,2,1,2,11,3,1
1260,Youssef Maleh,Empoli,3.0,4,3,2,2,0,1,3,33.3,2,5,2,3,3,7,3,0
1261,Donyell Malen,Dortmund,2.1,0,0,0,0,0,0,0,0.0,0,2,0,2,1,1,1,0
1262,Ruslan Malinovskyi,Genoa,2.5,8,6,2,5,1,2,3,66.7,1,1,0,1,1,9,3,0
1263,Lennard Maloney,Heidenheim,3.9,8,3,5,2,1,6,8,75.0,2,5,1,4,5,13,16,0
1264,Giorgi Mamardashvili,Valencia,9.0,0,0,0,0,0,0,0,0.0,0,0,0,0,0,0,2,0
1265,Dennis Man,Parma,6.3,2,2,1,0,1,2,4,50.0,2,1,1,0,2,4,2,0
1266,Hianga Mananga Mbock,Brest,0.2,0,0,0,0,0,0,0,0.0,0,0,0,0,1,1,0,0
1267,Gianluca Mancini,Roma,6.6,8,4,3,3,2,4,5,80.0,1,8,6,2,6,14,9,0
1268,Steve Mandanda,Rennes,7.0,0,0,0,0,0,0,1,0.0,1,0,0,0,0,0,0,0
1269,Reinildo Mandava,Atlético Madrid,5.1,9,5,4,4,1,4,7,57.1,3,6,3,3,8,17,18,0
1270,Aissa Mandi,Lille,3.5,6,4,1,5,0,3,4,75.0,1,2,2,0,3,9,5,0
1271,Rolando Mandragora,Fiorentina,3.0,1,0,0,0,1,0,1,0.0,1,3,1,2,5,6,4,1
1272,Orel Mangala,Everton,2.8,6,2,0,6,0,1,2,50.0,1,0,0,0,9,15,0,0
1274,Orel Mangala,Lyon,0.7,1,0,0,0,1,0,1,0.0,1,2,0,2,0,1,1,0
1275,Ryan Manning,Southampton,0.8,3,2,1,2,0,1,1,100.0,0,2,2,0,0,3,3,0
1276,Javier Manquillo,Celta Vigo,2.7,3,2,2,1,0,1,3,33.3,2,3,2,1,3,6,9,0
1277,Johan Manzambi,Freiburg,0.1,0,0,0,0,0,0,0,0.0,0,0,0,0,0,0,0,0
1278,Alberto Manzoni,Atalanta,0.1,0,0,0,0,0,0,0,0.0,0,0,0,0,0,0,0,0
1279,Sekou Mara,Strasbourg,1.3,1,1,0,0,1,0,2,0.0,2,1,0,1,2,3,1,0
1280,Marcao,Sevilla,3.3,7,5,4,3,0,1,1,100.0,0,4,3,1,3,10,14,1
1281,Filip Marchwinski,Lecce,0.2,0,0,0,0,0,0,0,0.0,0,0,0,0,0,0,0,0
1282,Oscar de Marcos,Athletic Club,4.6,13,6,7,6,0,8,12,66.7,4,6,0,6,10,23,10,0
1283,Alberto Mari,Valencia,0.1,0,0,0,0,0,0,0,0.0,0,0,0,0,0,0,0,0
1284,Pablo Mari,Monza,7.0,7,5,5,2,0,3,7,42.9,4,8,8,0,17,24,41,0
1285,Jose Maria Gimenez,Atlético Madrid,7.0,7,4,5,2,0,6,9,66.7,3,7,5,2,7,14,33,0
1286,Mirko Maric,Monza,0.1,0,0,0,0,0,0,0,0.0,0,1,1,0,0,0,0,0
1287,Pablo Marin,Real Sociedad,0.5,1,1,0,1,0,1,1,100.0,0,0,0,0,0,1,0,0
1288,Razvan Marin,Cagliari,5.1,9,5,2,6,1,6,11,54.5,5,3,0,3,1,10,8,1
1289,Guillermo Maripan,Torino,1.4,2,0,1,1,0,1,1,100.0,0,2,0,2,1,3,6,0
1290,Mika Marmol,Las Palmas,5.5,12,4,8,3,1,4,6,66.7,2,7,2,5,8,20,16,0
1291,Omar Marmoush,Eint Frankfurt,5.6,5,3,0,3,2,0,2,0.0,2,5,1,4,1,6,1,0
1292,Mario Maroto,Valladolid,0.2,0,0,0,0,0,0,1,0.0,1,0,0,0,2,2,1,0
1293,Marquinhos,Paris S-G,5.0,7,5,2,4,1,4,4,100.0,0,8,3,5,2,9,10,0
1294,Aaron Martin,Genoa,5.9,16,12,8,7,1,8,10,80.0,2,2,0,2,4,20,13,1
1295,Carlos Martin,Alavés,2.0,5,2,1,3,1,2,6,33.3,4,5,1,4,0,5,3,0
1296,Gerard Martin,Barcelona,2.9,5,2,3,2,0,4,6,66.7,2,5,1,4,2,7,9,0
1297,Ivan Martin,Girona,7.3,12,7,7,4,1,5,14,35.7,9,10,1,9,5,17,3,0
1298,Jon Martin,Real Sociedad,1.0,0,0,0,0,0,0,0,0.0,0,1,1,0,1,1,6,0
1300,Jonas Martin,Brest,3.0,5,3,4,1,0,2,4,50.0,2,3,0,3,6,11,4,0
1301,Mario Martin,Valladolid,4.1,15,8,7,7,1,8,16,50.0,8,2,1,1,2,17,5,1
1302,Gabriel Martinelli,Arsenal,4.9,6,5,0,1,5,3,6,50.0,3,2,0,2,0,6,8,0
1303,Arnau Martinez,Girona,4.1,9,6,5,2,2,5,7,71.4,2,0,0,0,0,9,11,1
1304,Emiliano Martinez,Aston Villa,7.0,0,0,0,0,0,0,0,0.0,0,0,0,0,0,0,6,2
1305,Inigo Martinez,Barcelona,7.8,7,4,5,2,0,3,3,100.0,0,3,3,0,3,10,27,0
1306,Javi Martinez,Osasuna,0.1,0,0,0,0,0,0,0,0.0,0,0,0,0,0,0,0,0
1307,Lautaro Martinez,Inter,5.4,6,3,2,2,2,2,4,50.0,2,1,0,1,1,7,1,0
1308,Lisandro Martinez,Manchester Utd,5.8,9,6,8,0,1,5,11,45.5,6,5,2,3,17,26,14,1
1309,Lucas Martinez Quarta,Fiorentina,2.4,10,5,8,2,0,7,12,58.3,5,4,2,2,1,11,17,0
1310,Toni Martinez,Alavés,3.0,3,2,0,1,2,0,1,0.0,1,3,1,2,0,3,4,0
1311,Kevin Martins,Monza,0.0,0,0,0,0,0,0,0,0.0,0,0,0,0,0,0,0,0
1312,Javi Marton,Athletic Club,0.2,0,0,0,0,0,0,0,0.0,0,0,0,0,0,0,0,0
1313,Adam Marusic,Lazio,3.4,5,2,2,3,0,3,6,50.0,3,1,0,1,4,9,8,0
1314,Marvin,Las Palmas,4.5,10,5,5,3,2,5,16,31.3,11,4,1,3,5,15,13,0
1315,Omar Mascarell,Mallorca,5.1,10,4,6,4,0,5,10,50.0,5,8,5,3,8,18,19,1
1316,Adam Masina,Torino,6.7,9,7,8,1,0,6,12,50.0,6,9,7,2,4,13,28,1
1317,Erhan Masovic,Bochum,3.2,3,3,2,1,0,2,4,50.0,2,6,5,1,4,7,14,0
1318,Clinton Mata,Lyon,6.0,11,6,5,5,1,8,8,100.0,0,6,3,3,11,22,11,2
1319,Jaime Mata,Las Palmas,2.3,1,0,1,0,0,1,5,20.0,4,2,0,2,1,2,0,0
1320,Igor Matanovic,Eint Frankfurt,1.6,1,0,0,1,0,0,0,0.0,0,1,0,1,0,1,3,0
1321,Pape Matar Sarr,Tottenham,2.4,10,6,3,6,1,0,1,0.0,1,5,0,5,1,11,0,0
1322,Eliot Matazo,Monaco,0.0,0,0,0,0,0,0,0,0.0,0,0,0,0,0,0,0,0
1323,Jean-Philippe Mateta,Crystal Palace,5.1,1,0,0,1,0,0,2,0.0,2,3,0,3,0,1,2,0
1324,Nemanja Matic,Lyon,4.0,8,7,2,5,1,3,8,37.5,5,4,1,3,2,10,4,0
1326,Chrislain Matsima,Augsburg,0.6,0,0,0,0,0,0,0,0.0,0,3,3,0,3,3,5,0
1327,Jean Matteo Bahoya,Eint Frankfurt,0.3,2,2,1,1,0,2,3,66.7,1,0,0,0,0,2,0,0
1328,Alan Matturro,Genoa,0.2,0,0,0,0,0,0,0,0.0,0,0,0,0,0,0,0,0
1329,Azor Matusiwa,Rennes,6.8,24,13,11,12,1,14,17,82.4,3,11,3,8,11,35,13,0
1330,Neal Maupay,Marseille,1.7,1,0,1,0,0,0,0,0.0,0,1,0,1,0,1,0,0
1331,Stephy Mavididi,Leicester City,4.3,11,7,5,4,2,5,12,41.7,7,9,1,8,1,12,2,0
1332,Konstantinos Mavropanos,West Ham,5.5,10,7,8,2,0,5,8,62.5,3,10,8,2,12,22,34,0
1333,Christian Mawissa,Monaco,1.8,9,5,3,5,1,9,11,81.8,2,4,1,3,7,16,2,0
1334,Keke Maximilian Topp,Werder Bremen,1.3,1,0,0,0,1,0,0,0.0,0,0,0,0,1,2,0,0
1335,Borja Mayoral,Getafe,1.4,1,1,1,0,0,0,0,0.0,0,1,0,1,0,1,1,0
1336,Senny Mayulu,Paris S-G,0.5,3,2,1,2,0,0,1,0.0,1,4,2,2,1,4,0,0
1337,Noussair Mazraoui,Manchester Utd,6.2,21,10,12,5,4,12,16,75.0,4,5,0,5,8,29,16,0
1338,Luca Mazzitelli,Como,1.9,6,3,3,3,0,3,5,60.0,2,5,2,3,2,8,6,0
1339,Pasquale Mazzocchi,Napoli,4.0,4,2,2,1,1,1,4,25.0,3,1,1,0,3,7,10,0
1340,Samuel Mbangula,Juventus,3.4,9,7,7,1,1,5,7,71.4,2,4,0,4,0,9,2,0
1341,Ethan Mbappe,Lille,0.9,1,0,0,1,0,0,2,0.0,2,4,0,4,0,1,0,0
1342,Kylian Mbappe,Real Madrid,7.5,1,1,0,1,0,0,0,0.0,0,0,0,0,0,1,0,0
1343,Ibrahim Mbaye,Paris S-G,0.9,0,0,0,0,0,0,2,0.0,2,0,0,0,0,0,0,0
1344,Bryan Mbeumo,Brentford,7.0,8,6,5,1,2,3,4,75.0,1,3,1,2,2,10,4,0
1345,James Mcatee,Manchester City,0.0,0,0,0,0,0,0,0,0.0,0,1,0,1,0,0,0,0
1346,Kasey McAteer,Leicester City,0.1,2,1,2,0,0,1,2,50.0,1,4,0,4,0,2,3,0
1347,Oliver McBurnie,Las Palmas,7.1,5,4,2,2,1,2,4,50.0,2,3,1,2,3,8,6,0
1348,Alex McCarthy,Southampton,2.0,0,0,0,0,0,0,0,0.0,0,0,0,0,0,0,0,1
1349,John McGinn,Aston Villa,3.9,4,3,1,3,0,2,3,66.7,1,3,0,3,1,5,1,0
1350,Scott McKenna,Las Palmas,4.1,4,3,3,1,0,3,4,75.0,1,6,5,1,0,4,18,0
1352,Weston McKennie,Juventus,2.1,3,2,1,2,0,1,2,50.0,1,3,0,3,0,3,0,0
1353,Mark McKenzie,Toulouse,4.7,9,6,3,6,0,6,9,66.7,3,8,5,3,3,12,18,0
1354,Dwight McNeil,Everton,6.9,6,4,3,3,0,3,7,42.9,4,4,0,4,4,10,1,0
1355,Scott McTominay,Manchester Utd,0.2,0,0,0,0,0,0,1,0.0,1,0,0,0,0,0,1,0
1356,Scott McTominay,Napoli,3.2,5,5,0,4,1,2,4,50.0,2,5,0,5,4,9,2,0
1357,Jakov Medic,Bochum,5.8,4,3,2,2,0,2,6,33.3,4,13,11,2,6,10,33,1
1358,Facundo Medina,Lens,7.0,11,7,6,4,1,5,8,62.5,3,6,0,6,8,19,23,0
1359,Ben Mee,Brentford,0.0,0,0,0,0,0,0,0,0.0,0,0,0,0,0,0,0,0
1360,Henrik Meister,Rennes,0.7,2,0,0,2,0,0,0,0.0,0,4,0,4,1,3,0,0
1361,Bamo Meite,Marseille,0.3,0,0,0,0,0,0,0,0.0,0,0,0,0,0,0,1,0
1362,Mateo Mejia,Sevilla,0.1,0,0,0,0,0,0,0,0.0,0,0,0,0,0,0,0,0
1363,Farid El Melali,Angers,4.3,6,1,1,2,3,3,10,30.0,7,4,1,3,3,9,3,1
1364,Filippo Melegoni,Genoa,0.3,0,0,0,0,0,0,2,0.0,2,0,0,0,0,0,0,0
1365,Nuno Mendes,Paris S-G,2.8,4,3,1,3,0,3,6,50.0,3,3,1,2,0,4,2,0
1366,Brais Mendez,Real Sociedad,3.6,4,2,1,1,2,2,7,28.6,5,2,0,2,2,6,1,0
1367,Antoine Mendy,Nice,3.2,10,6,6,4,0,6,10,60.0,4,3,1,2,2,12,9,0
1368,Ferland Mendy,Real Madrid,6.2,14,11,5,5,4,7,8,87.5,1,7,2,5,6,20,5,1
1369,Nampalys Mendy,Lens,1.0,4,2,3,1,0,2,4,50.0,2,0,0,0,1,5,0,0
1370,Gideon Mensah,Auxerre,1.3,4,2,3,0,1,1,4,25.0,3,1,0,1,2,6,3,0
1371,Alex Meret,Napoli,4.4,0,0,0,0,0,0,0,0.0,0,0,0,0,0,0,0,0
1372,Mikel Merino,Arsenal,0.3,3,2,0,2,1,2,2,100.0,0,2,2,0,2,5,0,0
1373,Quentin Merlin,Marseille,3.0,2,1,1,0,1,1,3,33.3,2,1,1,0,2,4,3,0
1374,Victor Meseguer,Valladolid,2.9,7,5,4,2,1,1,6,16.7,5,3,0,3,0,7,3,1
1375,Junior Messias,Genoa,2.9,4,1,3,1,0,1,1,100.0,0,1,1,0,3,7,5,0
1376,Connor Metcalfe,St. Pauli,2.5,1,0,0,1,0,0,3,0.0,3,3,0,3,2,3,4,0
1378,Karol Mets,St. Pauli,6.0,6,3,3,3,0,1,3,33.3,2,4,1,3,5,11,36,0
1379,Thomas Meunier,Lille,3.7,9,6,5,3,1,5,6,83.3,1,5,2,3,4,13,10,0
1380,Florian Micheler,Hoffenheim,0.4,0,0,0,0,0,0,2,0.0,2,0,0,0,0,0,0,0
1381,Miguel,Leganés,5.4,2,1,1,1,0,1,4,25.0,3,7,0,7,1,3,2,0
1382,Valentin Mihaila,Parma,4.7,12,3,3,6,3,2,6,33.3,4,5,0,5,0,12,1,0
1383,Georges Mikautadze,Lyon,3.9,3,2,1,1,1,1,1,100.0,0,2,0,2,1,4,0,0
1384,Nikola Milenkovic,Nott'ham Forest,6.0,4,4,2,2,0,1,1,100.0,0,7,6,1,6,10,24,0
1385,Vanja Milinkovic-Savic,Torino,6.0,0,0,0,0,0,0,2,0.0,2,0,0,0,0,0,2,0
1386,Eder Militao,Real Madrid,8.1,13,12,10,3,0,7,12,58.3,5,11,8,3,9,22,29,0
1387,Luis Milla,Getafe,8.8,16,12,9,6,1,10,21,47.6,11,13,0,13,6,22,8,0
1388,Pere Milla,Espanyol,1.6,3,1,2,0,1,0,8,0.0,8,5,2,3,1,4,2,0
1389,Enzo Millot,Stuttgart,4.7,5,5,0,3,2,2,9,22.2,7,8,0,8,3,8,2,0
1390,James Milner,Brighton,1.9,5,2,1,3,1,3,3,100.0,0,4,2,2,2,7,2,1
1391,Kim Min-jae,Bayern Munich,5.9,8,5,2,6,0,2,3,66.7,1,6,2,4,11,19,11,1
1392,Yerry Mina,Cagliari,5.5,12,4,5,6,1,9,12,75.0,3,12,6,6,6,18,24,1
1393,Takumi Minamino,Monaco,4.9,3,3,2,1,0,1,6,16.7,5,5,0,5,3,6,4,0
1394,Lucas Mincarelli,Montpellier,2.4,3,3,0,2,1,1,4,25.0,3,1,1,0,1,4,6,0
1395,Oscar Mingueza,Celta Vigo,6.5,10,5,4,6,0,7,13,53.8,6,11,3,8,1,11,12,1
1396,Yankuba Minteh,Brighton,4.5,5,3,1,1,3,3,11,27.3,8,7,0,7,3,8,4,0
1397,Bojan Miovski,Girona,1.9,2,2,0,0,2,1,5,20.0,4,3,0,3,0,2,1,0
1398,Rafa Mir,Valencia,2.7,6,3,4,2,0,1,3,33.3,2,1,0,1,0,6,5,0
1399,Juan Miranda,Bologna,2.5,9,5,3,4,2,4,6,66.7,2,2,0,2,2,11,1,0
1400,Fabio Miretti,Genoa,1.5,4,3,2,2,0,3,3,100.0,0,2,0,2,1,5,1,0
1401,Tyrick Mitchell,Crystal Palace,6.6,23,17,13,9,1,3,6,50.0,3,12,3,9,4,27,17,1
1402,Kaoru Mitoma,Brighton,6.9,12,6,4,4,4,8,14,57.1,6,11,0,11,3,15,1,0
1404,Maximilian Mittelstadt,Stuttgart,5.1,16,10,10,6,0,10,15,66.7,5,12,5,7,7,23,14,1
1405,Koji Miyoshi,Bochum,0.9,2,2,0,1,1,0,2,0.0,2,2,1,1,0,2,1,0
1406,Henrikh Mkhitaryan,Inter,5.9,8,4,1,4,3,4,8,50.0,4,5,0,5,2,10,10,0
1407,Luka Modric,Real Madrid,5.5,4,1,3,0,1,3,8,37.5,5,3,0,3,5,9,6,0
1408,Max Moerstedt,Hoffenheim,0.6,0,0,0,0,0,0,0,0.0,0,0,0,0,0,0,2,0
1409,Mostafa Mohamed,Nantes,1.3,1,1,1,0,0,0,1,0.0,1,1,0,1,1,2,4,0
1410,Johan Mojica,Mallorca,7.1,10,6,8,1,1,6,10,60.0,4,3,1,2,7,17,21,0
1411,Alberto Moleiro,Las Palmas,7.6,7,3,4,3,0,6,13,46.2,7,5,0,5,2,9,2,0
1412,Nahuel Molina,Atlético Madrid,4.3,11,4,7,4,0,8,12,66.7,4,7,0,7,4,15,16,0
1413,Florent Mollet,Nantes,0.3,0,0,0,0,0,0,0,0.0,0,0,0,0,0,0,0,0
1414,Jon Moncayola,Osasuna,5.8,22,10,3,16,3,5,12,41.7,7,10,1,9,5,27,6,0
1415,Gonzalo Montiel,Sevilla,0.0,0,0,0,0,0,0,0,0.0,0,0,0,0,0,0,0,0
1416,Lorenzo Montipo,Hellas Verona,7.0,0,0,0,0,0,0,0,0.0,0,0,0,0,0,0,2,2
1417,Mikey Moore,Tottenham,0.3,0,0,0,0,0,0,0,0.0,0,0,0,0,0,0,0,0
1418,Alvaro Morata,Milan,3.1,2,1,0,2,0,0,1,0.0,1,4,1,3,2,4,1,0
1419,Morato,Nott'ham Forest,0.4,1,1,1,0,0,0,0,0.0,0,1,1,0,0,1,10,0
1420,Diego Moreira,Strasbourg,5.2,9,5,1,4,4,5,8,62.5,3,3,0,3,7,16,12,0
1421,Alberto Moreno,Como,7.0,10,4,6,4,0,3,8,37.5,5,7,1,6,6,16,11,1
1422,Alex Moreno,Nott'ham Forest,3.2,10,8,10,0,0,7,16,43.8,9,3,1,2,6,16,9,0
1423,Gerard Moreno,Villarreal,1.3,2,2,0,0,2,1,1,100.0,0,0,0,0,0,2,1,0
1424,Tete Morente,Lecce,3.6,5,3,2,3,0,2,9,22.2,7,6,0,6,3,8,3,0
1425,Ilaix Moriba,Celta Vigo,3.4,7,5,2,5,0,6,15,40.0,9,3,1,2,4,11,3,0
1426,Manu Morlanes,Mallorca,3.9,5,4,2,3,0,3,5,60.0,2,6,3,3,10,15,5,0
1427,Nikola Moro,Bologna,3.2,7,7,3,4,0,4,7,57.1,3,6,3,3,2,9,3,0
1428,Raul Moro,Valladolid,6.5,8,6,5,2,1,4,11,36.4,7,3,0,3,6,14,2,0
1430,Sam Morsy,Ipswich Town,6.9,20,11,10,8,2,8,14,57.1,6,8,3,5,3,23,11,1
1431,Cristhian Mosquera,Valencia,9.0,6,3,5,1,0,1,3,33.3,2,11,7,4,10,16,26,0
1432,Daniel Mosquera,Hellas Verona,2.9,2,1,1,1,0,0,2,0.0,2,2,1,1,0,2,2,0
1433,Yerson Mosquera,Wolves,4.9,11,7,9,2,0,9,14,64.3,5,13,10,3,10,21,14,0
1434,Dany Mota,Monza,2.6,2,0,1,0,1,0,0,0.0,0,3,0,3,2,4,2,0
1435,Aimen Moueffek,Saint-Étienne,3.4,5,1,0,4,1,1,5,20.0,4,5,3,2,2,7,12,0
1436,Youssoufa Moukoko,Nice,1.2,1,0,1,0,0,0,1,0.0,1,0,0,0,0,1,0,0
1437,Steve Mounie,Augsburg,2.0,2,2,0,0,2,0,1,0.0,1,1,1,0,0,2,1,0
1438,Mason Mount,Manchester Utd,1.6,5,1,2,3,0,4,5,80.0,1,3,0,3,0,5,0,0
1439,Santiago Mourino,Alavés,2.7,11,8,10,1,0,6,12,50.0,6,1,0,1,4,15,9,0
1440,Louis Mouton,Saint-Étienne,0.6,5,2,2,1,2,1,3,33.3,2,0,0,0,0,5,2,0
1441,Mykhailo Mudryk,Chelsea,0.9,0,0,0,0,0,0,0,0.0,0,1,1,0,0,0,0,0
1442,Ngal'Ayel Mukau,Lille,1.4,7,5,2,4,1,5,9,55.6,4,2,0,2,2,9,1,0
1443,Nordi Mukiele,Leverkusen,0.6,2,2,0,1,1,2,2,100.0,0,1,0,1,1,3,2,1
1444,Florian Muller,Freiburg,2.0,0,0,0,0,0,0,0,0.0,0,0,0,0,0,0,0,0
1445,Kevin Muller,Heidenheim,6.0,0,0,0,0,0,0,0,0.0,0,0,0,0,0,0,2,0
1446,Thomas Muller,Bayern Munich,2.4,3,1,0,2,1,2,4,50.0,2,2,0,2,0,3,2,0
1447,Abdul Mumin,Rayo Vallecano,9.0,8,7,5,3,0,1,6,16.7,5,15,10,5,12,20,50,0
1448,Marshall Munetsi,Reims,6.9,12,8,8,2,2,7,12,58.3,5,10,3,7,5,17,9,0
1449,Rodrigo Muniz,Fulham,3.2,0,0,0,0,0,0,0,0.0,0,1,1,0,1,1,4,0
1450,Aihen Munoz,Real Sociedad,1.4,1,1,1,0,0,1,2,50.0,1,0,0,0,1,2,7,0
1451,Alex Munoz,Las Palmas,5.7,17,14,8,8,1,11,14,78.6,3,11,4,7,7,24,23,0
1452,Daniel Munoz,Crystal Palace,6.1,20,14,10,9,1,7,13,53.8,6,6,1,5,5,25,16,0
1453,Iker Munoz,Osasuna,0.5,0,0,0,0,0,0,0,0.0,0,0,0,0,0,0,1,0
1454,Javier Munoz,Las Palmas,6.8,10,9,3,5,2,4,10,40.0,6,7,0,7,6,16,5,1
1456,Arijanet Muric,Ipswich Town,6.0,0,0,0,0,0,0,2,0.0,2,0,0,0,0,0,2,3
1457,Murillo,Nott'ham Forest,7.0,7,4,4,3,0,5,13,38.5,8,12,9,3,3,10,40,1
1458,Vedat Muriqi,Mallorca,5.2,0,0,0,0,0,0,0,0.0,0,0,0,0,3,3,12,0
1459,Jacob Murphy,Newcastle Utd,4.5,8,6,4,3,1,5,8,62.5,3,6,0,6,1,9,2,0
1460,Yunus Musah,Milan,1.7,6,5,2,2,2,1,1,100.0,0,2,0,2,1,7,1,0
1461,Jamal Musiala,Bayern Munich,4.3,7,5,2,3,2,1,6,16.7,5,4,0,4,3,10,2,0
1462,Florent Muslija,Freiburg,0.9,4,3,3,0,1,2,2,100.0,0,0,0,0,1,5,0,0
1463,Juan Musso,Atalanta,1.0,0,0,0,0,0,0,0,0.0,0,0,0,0,0,0,0,0
1464,Juan Musso,Atlético Madrid,1.0,0,0,0,0,0,0,0,0.0,0,0,0,0,0,0,0,0
1465,Kingstone Mutandwa,Cagliari,0.5,0,0,0,0,0,0,0,0.0,0,0,0,0,0,0,0,0
1466,Junior Mwanga,Strasbourg,1.7,8,3,7,1,0,4,6,66.7,2,0,0,0,0,8,1,0
1467,Phillipp Mwene,Mainz 05,5.9,13,7,5,7,1,3,6,50.0,3,6,1,5,7,20,15,0
1468,Vitaliy Mykolenko,Everton,4.3,4,2,3,1,0,2,6,33.3,4,3,1,2,4,8,19,0
1469,Joakim Maehle,Wolfsburg,0.0,0,0,0,0,0,0,0,0.0,0,0,0,0,0,0,0,0
1470,Obite N'Dicka,Roma,7.0,8,7,4,4,0,4,4,100.0,0,8,6,2,7,15,27,1
1471,Nathan N'Goumou,Gladbach,2.4,5,5,3,1,1,2,4,50.0,2,5,0,5,2,7,3,0
1472,Stanley N'Soki,Hoffenheim,0.2,1,0,1,0,0,0,0,0.0,0,1,0,1,0,1,3,0
1473,Mickael Nade,Saint-Étienne,2.6,9,6,5,4,0,3,3,100.0,0,9,3,6,3,12,8,1
1474,Mahamadou Nagida,Rennes,0.4,1,1,0,0,1,1,1,100.0,0,1,0,1,2,3,0,0
1475,Keito Nakamura,Reims,5.4,7,7,1,3,3,3,6,50.0,3,5,0,5,5,12,2,0
1476,Sebastian Nanasi,Strasbourg,4.5,3,2,0,3,0,1,4,25.0,3,4,1,3,0,3,3,0
1477,Matija Nastasic,Leganés,3.5,3,3,2,1,0,0,2,0.0,2,11,8,3,5,8,17,0
1478,Natan,Betis,7.1,8,6,6,1,1,6,6,100.0,0,9,5,4,9,17,32,0
1479,Pau Navarro,Villarreal,0.2,0,0,0,0,0,0,0,0.0,0,0,0,0,0,0,4,0
1480,Roberto Navarro,Mallorca,3.9,6,5,3,1,2,1,5,20.0,4,7,0,7,6,12,3,0
1482,Jesus Navas,Sevilla,2.4,3,1,2,0,1,0,1,0.0,1,0,0,0,2,5,3,0
1483,Michel Ndary Adopo,Cagliari,2.9,7,3,3,4,0,1,4,25.0,3,0,0,0,4,11,1,0
1484,Youssouf Ndayishimiye,Nice,4.6,12,5,9,3,0,4,6,66.7,2,5,3,2,6,18,25,1
1485,Iliman Ndiaye,Everton,5.4,12,7,5,3,4,7,11,63.6,4,7,3,4,7,19,4,0
1486,Rassoul Ndiaye,Le Havre,3.3,12,8,7,5,0,1,8,12.5,7,4,0,4,3,15,0,0
1487,Wilfred Ndidi,Leicester City,6.8,28,18,16,10,2,7,14,50.0,7,17,5,12,4,32,20,0
1488,Tanguy Ndombele,Nice,5.7,20,13,5,14,1,7,10,70.0,3,6,0,6,6,26,2,0
1489,Dan Ndoye,Bologna,4.6,1,1,1,0,0,0,4,0.0,4,4,0,4,0,1,0,0
1490,Paul Nebel,Mainz 05,0.7,3,1,2,0,1,2,2,100.0,0,3,0,3,2,5,3,0
1491,Kosta Nedeljkovic,Aston Villa,1.1,7,5,1,3,3,2,3,66.7,1,1,0,1,0,7,3,0
1492,Loic Nego,Le Havre,5.8,15,10,10,4,1,11,16,68.8,5,4,0,4,9,24,11,0
1493,Reiss Nelson,Arsenal,0.0,1,0,0,1,0,0,1,0.0,1,0,0,0,0,1,1,0
1494,Reiss Nelson,Fulham,0.9,4,2,2,1,1,2,4,50.0,2,3,0,3,0,4,0,0
1495,David Neres,Napoli,0.8,1,1,0,1,0,0,0,0.0,0,0,0,0,0,1,0,0
1496,Neto,Bournemouth,2.0,0,0,0,0,0,0,0,0.0,0,0,0,0,0,0,1,1
1497,Pedro Neto,Chelsea,2.7,4,2,1,3,0,2,2,100.0,0,2,0,2,1,5,2,0
1498,Luca Netz,Gladbach,5.9,13,6,9,3,1,5,10,50.0,5,9,2,7,7,20,13,0
1499,Manuel Neuer,Bayern Munich,5.0,0,0,0,0,0,0,0,0.0,0,0,0,0,0,0,3,1
1500,Florian Neuhaus,Gladbach,0.3,1,0,1,0,0,0,4,0.0,4,0,0,0,1,2,0,0
1501,Joao Neves,Paris S-G,5.8,18,9,4,11,3,4,11,36.4,7,6,2,4,5,23,3,0
1502,Yvan Neyou,Leganés,4.9,8,6,3,5,0,6,10,60.0,4,6,0,6,6,14,7,0
1503,Cyril Ngonge,Napoli,0.1,1,1,0,1,0,0,0,0.0,0,0,0,0,0,1,0,0
1504,Mikayil Ngor Faye,Rennes,1.1,2,2,2,0,0,2,2,100.0,0,1,0,1,1,3,4,0
1505,Steve Ngoura,Le Havre,0.7,0,0,0,0,0,0,0,0.0,0,1,0,1,0,0,0,0
1506,Moussa Niakhate,Lyon,5.0,17,10,15,2,0,8,9,88.9,1,6,3,3,2,19,22,1
1508,Abdoulaye Niakhate Ndiaye,Brest,1.6,3,2,1,2,0,2,2,100.0,0,3,0,3,2,5,14,0
1509,Ibrahima Niane,Angers,1.2,1,1,1,0,0,1,1,100.0,0,2,1,1,0,1,3,1
1510,Tanguy Nianzou,Sevilla,4.8,7,5,6,0,1,5,5,100.0,0,1,0,1,8,15,24,0
1511,Rasmus Nicolaisen,Toulouse,6.9,6,3,4,2,0,3,5,60.0,2,10,5,5,10,16,25,0
1512,Moritz Nicolas,Gladbach,3.0,0,0,0,0,0,0,0,0.0,0,0,0,0,0,0,2,1
1513,Hans Nicolussi Caviglia,Venezia,3.6,7,2,0,3,4,4,6,66.7,2,3,2,1,3,10,4,0
1514,Saul Niguez,Sevilla,3.6,9,6,3,3,3,1,4,25.0,3,6,1,5,2,11,4,0
1515,Eybi Nije,Torino,0.3,2,0,2,0,0,0,1,0.0,1,0,0,0,0,2,0,0
1516,Justin Njinmah,Werder Bremen,1.5,1,1,1,0,0,1,1,100.0,0,0,0,0,2,3,0,0
1517,Eddie Nketiah,Crystal Palace,3.5,2,1,2,0,0,0,1,0.0,1,3,0,3,1,3,3,0
1518,Niels Nkounkou,Eint Frankfurt,1.9,1,1,1,0,0,0,1,0.0,1,2,1,1,3,4,2,0
1519,Christopher Nkunku,Chelsea,1.5,3,3,0,1,2,2,2,100.0,0,3,1,2,1,4,1,0
1520,Felix Nmecha,Dortmund,2.1,3,3,0,2,1,2,3,66.7,1,1,0,1,2,5,5,0
1521,Arnaud Nordin,Montpellier,5.5,9,5,2,7,0,5,8,62.5,3,5,0,5,2,11,2,0
1522,Brooke Norton-Cuffy,Genoa,0.1,0,0,0,0,0,0,0,0.0,0,0,0,0,0,0,0,0
1523,Tijjani Noslin,Lazio,2.6,1,1,0,0,1,0,3,0.0,3,5,0,5,0,1,4,0
1524,Hugo Novoa,Alavés,2.5,8,5,4,3,1,5,5,100.0,0,2,1,1,0,8,6,0
1525,Randy Nteka,Rayo Vallecano,3.2,4,2,0,4,0,2,3,66.7,1,3,1,2,1,5,3,0
1526,Ernest Nuamah,Lyon,1.5,2,1,1,0,1,1,2,50.0,1,0,0,0,1,3,2,0
1527,Alexander Nubel,Stuttgart,6.0,0,0,0,0,0,0,0,0.0,0,0,0,0,0,0,1,0
1528,Matheus Nunes,Manchester City,0.3,0,0,0,0,0,0,0,0.0,0,2,1,1,0,0,1,0
1529,Darwin Nunez,Liverpool,1.5,6,4,3,1,2,2,3,66.7,1,0,0,0,0,6,3,0
1530,Unai Nunez,Athletic Club,2.0,1,1,0,1,0,0,1,0.0,1,2,2,0,11,12,9,1
1531,Antonio Nusa,RB Leipzig,3.0,6,3,4,1,1,3,5,60.0,2,6,0,6,2,8,5,0
1532,Ethan Nwaneri,Arsenal,0.1,0,0,0,0,0,0,0,0.0,0,1,1,0,0,0,1,0
1534,Orjan Nyland,Sevilla,9.0,1,1,1,0,0,1,1,100.0,0,0,0,0,0,1,6,1
1535,Rabby Nzingoula,Montpellier,3.3,13,8,6,5,2,4,10,40.0,6,4,0,4,6,19,4,0
1536,M'Bala Nzola,Lens,2.2,1,0,0,0,1,1,1,100.0,0,1,1,0,2,3,2,0
1537,Marwann Nzuzi,Saint-Étienne,1.4,2,2,1,0,1,1,2,50.0,1,0,0,0,2,4,6,0
1538,Christian Norgaard,Brentford,4.8,13,7,6,7,0,9,12,75.0,3,9,1,8,9,22,12,0
1539,Jake O'Brien,Everton,0.3,2,2,1,1,0,2,2,100.0,0,1,0,1,0,2,0,0
1540,Dara O'Shea,Ipswich Town,4.0,6,3,5,1,0,2,2,100.0,0,7,7,0,9,15,17,0
1541,Adam Obert,Cagliari,1.8,2,2,1,1,0,1,4,25.0,3,4,1,3,5,7,10,1
1542,Jan Oblak,Atlético Madrid,8.0,0,0,0,0,0,0,0,0.0,0,0,0,0,0,0,2,1
1543,Lucas Ocampos,Sevilla,1.9,3,2,2,0,1,1,2,50.0,1,2,0,2,0,3,2,0
1544,Jens Odgaard,Bologna,2.4,3,2,0,3,0,1,2,50.0,1,3,1,2,1,4,0,0
1545,Wilson Odobert,Tottenham,1.8,5,2,2,2,1,4,6,66.7,2,1,0,1,0,5,1,1
1546,Alvaro Odriozola,Real Sociedad,0.3,0,0,0,0,0,0,0,0.0,0,0,0,0,0,0,1,0
1547,Tim Oermann,Bochum,1.2,1,1,1,0,0,0,1,0.0,1,2,2,0,3,4,2,0
1548,Chiedozie Ogbene,Ipswich Town,2.3,7,3,1,2,4,2,4,50.0,2,1,0,1,1,8,3,0
1549,Ifechukwu Ogbus,Freiburg,0.2,1,1,0,0,1,0,1,0.0,1,0,0,0,1,2,2,0
1550,Hamzat Ojediran,Lens,1.2,7,4,2,5,0,2,4,50.0,2,1,0,1,4,11,2,0
1551,Noah Okafor,Milan,2.5,1,0,0,0,1,0,0,0.0,0,0,0,0,0,1,1,0
1552,Caleb Okoli,Leicester City,5.0,11,5,5,6,0,5,7,71.4,2,13,8,5,4,15,37,1
1553,Yllan Okou,Hellas Verona,0.0,0,0,0,0,0,0,0,0.0,0,1,0,1,0,0,0,0
1554,Maduka Okoye,Udinese,7.0,0,0,0,0,0,0,0,0.0,0,0,0,0,0,0,3,1
1555,Joseph Okumu,Reims,3.0,4,2,2,2,0,2,4,50.0,2,10,9,1,5,9,11,1
1556,Olasagasti,Real Sociedad,0.7,2,1,1,1,0,0,2,0.0,2,0,0,0,1,3,1,0
1557,Ben Old,Saint-Étienne,4.2,4,4,3,1,0,2,8,25.0,6,5,1,4,1,5,1,0
1558,Michael Olise,Bayern Munich,4.6,7,4,2,4,1,3,6,50.0,3,4,0,4,1,8,2,0
1560,Brian Olivan,Espanyol,1.9,3,3,1,2,0,0,2,0.0,2,1,0,1,3,6,6,0
1561,Lucas Oliveira Rosa,Valladolid,9.0,21,15,16,4,1,13,19,68.4,6,10,6,4,12,33,24,1
1562,Mathias Olivera,Napoli,5.2,12,5,6,3,3,5,10,50.0,5,7,1,6,3,15,12,0
1563,Dani Olmo,Barcelona,2.1,3,1,1,1,1,1,6,16.7,5,0,0,0,1,4,0,0
1564,Becir Omeragic,Montpellier,4.8,11,4,9,2,0,6,10,60.0,4,5,3,2,5,16,14,0
1565,Jonas Omlin,Gladbach,3.0,0,0,0,0,0,0,0,0.0,0,0,0,0,0,0,0,0
1566,Ado Onaiwu,Auxerre,3.6,5,4,0,5,0,2,3,66.7,1,1,0,1,1,6,3,0
1567,Amadou Onana,Aston Villa,4.7,16,10,6,8,2,5,10,50.0,5,6,4,2,8,24,9,1
1568,Andre Onana,Manchester Utd,7.0,1,1,1,0,0,1,1,100.0,0,0,0,0,0,1,4,0
1569,Karim Onisiwo,Mainz 05,1.0,0,0,0,0,0,0,0,0.0,0,0,0,0,0,0,0,0
1570,Paul Onuachu,Southampton,0.2,0,0,0,0,0,0,0,0.0,0,0,0,0,1,1,0,0
1571,Frank Onyeka,Brentford,0.3,0,0,0,0,0,0,0,0.0,0,0,0,0,0,0,0,0
1572,Frank Onyeka,Augsburg,3.9,13,12,5,6,2,4,6,66.7,2,4,2,2,6,19,4,0
1573,Lois Openda,RB Leipzig,5.2,0,0,0,0,0,0,1,0.0,1,4,0,4,0,0,0,0
1574,Christopher Operi,Le Havre,6.0,4,3,1,1,2,1,3,33.3,2,7,2,5,6,10,13,0
1575,Victor Orakpo,Nice,0.3,0,0,0,0,0,0,0,0.0,0,0,0,0,0,0,0,0
1576,Gift Orban,Lyon,2.1,0,0,0,0,0,0,1,0.0,1,0,0,0,0,0,0,0
1577,Willi Orban,RB Leipzig,3.9,8,5,4,4,0,6,7,85.7,1,6,4,2,4,12,17,0
1578,Ivan Ordets,Bochum,1.0,0,0,0,0,0,0,0,0.0,0,1,1,0,1,1,3,0
1579,Gaetano Oristanio,Venezia,5.0,6,4,3,2,1,3,4,75.0,1,6,0,6,2,8,3,0
1580,Aimar Oroz,Osasuna,7.7,13,8,5,5,3,6,13,46.2,7,8,1,7,6,19,1,0
1581,Riccardo Orsolini,Bologna,4.2,2,2,1,0,1,1,2,50.0,1,2,0,2,2,4,1,0
1582,Gabriel Osei Misehouy,Girona,0.7,0,0,0,0,0,0,0,0.0,0,0,0,0,0,0,0,0
1583,Gabriel Osho,Auxerre,6.4,6,5,6,0,0,3,6,50.0,3,16,11,5,4,10,35,0
1584,Yordan Osorio,Parma,1.9,5,3,4,1,0,2,2,100.0,0,3,1,2,4,9,6,1
1586,Patrick Osterhage,Freiburg,4.9,12,8,5,6,1,4,10,40.0,6,4,0,4,9,21,4,0
1587,William Osula,Newcastle Utd,0.1,0,0,0,0,0,0,0,0.0,0,0,0,0,0,0,0,0
1588,Jibril Othman,Saint-Étienne,0.1,0,0,0,0,0,0,0,0.0,0,0,0,0,0,0,0,0
1589,David Otorbi,Valencia,0.2,0,0,0,0,0,0,0,0.0,0,1,0,1,0,0,0,0
1590,Dango Ouattara,Bournemouth,2.9,9,9,2,4,3,5,9,55.6,4,4,0,4,2,11,8,0
1591,Kassoum Ouattara,Monaco,1.8,5,3,2,3,0,3,5,60.0,2,2,0,2,2,7,0,0
1592,Remi Oudin,Lecce,1.1,1,0,1,0,0,1,3,33.3,2,0,0,0,1,2,0,0
1593,Zinedine Ould Khaled,Angers,0.6,1,1,1,0,0,0,1,0.0,1,2,0,2,0,1,1,0
1594,Beres Owusu,Saint-Étienne,1.0,2,2,1,1,0,2,2,100.0,0,2,2,0,0,2,5,0
1595,Elisha Owusu,Auxerre,6.6,25,14,9,16,0,11,17,64.7,6,9,2,7,12,37,10,0
1596,Mikel Oyarzabal,Real Sociedad,4.6,2,0,2,0,0,1,3,33.3,2,2,0,2,0,2,2,0
1597,Salih Ozcan,Wolfsburg,1.4,1,1,0,0,1,0,4,0.0,4,5,1,4,2,3,1,0
1598,Cenk Ozkacar,Valladolid,1.2,2,2,2,0,0,2,5,40.0,3,2,1,1,3,5,7,0
1599,Jon Pacheco,Real Sociedad,3.8,3,2,2,1,0,2,3,66.7,1,5,4,1,3,6,20,1
1600,Willian Pacho,Paris S-G,6.3,11,6,8,3,0,4,6,66.7,2,11,6,5,13,24,25,0
1601,Alex Padilla,Athletic Club,3.6,0,0,0,0,0,0,0,0.0,0,0,0,0,0,0,2,1
1602,Exequiel Palacios,Leverkusen,0.9,0,0,0,0,0,0,0,0.0,0,1,0,1,0,0,0,0
1603,Isaac Palazon Camacho,Rayo Vallecano,5.6,5,4,3,2,0,3,10,30.0,7,4,1,3,3,8,3,0
1604,Alberto Paleari,Torino,1.0,0,0,0,0,0,0,0,0.0,0,0,0,0,0,0,2,0
1605,Marco Palestra,Atalanta,0.5,2,1,1,1,0,1,1,100.0,0,0,0,0,0,2,0,0
1606,Joao Palhinha,Bayern Munich,1.4,1,1,1,0,0,0,2,0.0,2,4,0,4,2,3,2,0
1607,Nicolas Pallois,Nantes,4.0,11,3,9,2,0,8,11,72.7,3,3,2,1,6,17,29,0
1608,Cole Palmer,Chelsea,6.6,7,5,3,4,0,3,6,50.0,3,2,1,1,2,9,5,0
1609,Emerson Palmieri,West Ham,5.6,14,7,8,6,0,4,10,40.0,6,7,1,6,6,20,11,0
1610,Mats Pannewig,Bochum,0.4,0,0,0,0,0,0,0,0.0,0,3,0,3,0,0,2,0
1612,Lucas Paqueta,West Ham,5.8,10,5,5,4,1,5,9,55.6,4,7,1,6,4,14,5,2
1613,Aitor Paredes,Athletic Club,4.9,3,2,1,2,0,2,5,40.0,3,8,6,2,4,7,33,1
1614,Leandro Paredes,Roma,1.2,1,1,0,1,0,0,1,0.0,1,2,1,1,2,3,1,1
1615,Daniel Parejo,Villarreal,6.4,9,7,5,3,1,3,13,23.1,10,4,1,3,4,13,10,1
1616,Fabiano Parisi,Fiorentina,1.4,4,2,1,2,1,0,1,0.0,1,1,0,1,1,5,2,0
1617,Thomas Partey,Arsenal,6.9,20,13,8,6,6,11,17,64.7,6,6,4,2,11,31,14,1
1618,Mario Pasalic,Atalanta,4.9,3,2,0,3,0,1,4,25.0,3,3,1,2,2,5,6,0
1619,Felix Passlack,Bochum,6.0,12,7,8,2,2,7,14,50.0,7,12,5,7,5,17,12,0
1620,Patric,Lazio,2.5,4,2,3,1,0,3,6,50.0,3,0,0,0,2,6,6,0
1621,Benjamin Pavard,Inter,4.5,8,3,4,3,1,4,6,66.7,2,3,2,1,3,11,15,0
1622,Aleksandar Pavlovic,Bayern Munich,4.6,11,6,2,6,3,5,8,62.5,3,6,1,5,0,11,6,0
1623,Strahinja Pavlovic,Milan,3.0,11,7,7,4,0,6,11,54.5,5,3,2,1,3,14,16,0
1624,Leonardo Pavoletti,Cagliari,1.1,0,0,0,0,0,0,0,0.0,0,1,1,0,0,0,1,0
1625,Martin Payero,Udinese,2.4,4,2,1,2,1,1,2,50.0,1,1,1,0,3,7,4,0
1626,Nicolas Paz,Como,4.6,8,7,3,3,2,4,6,66.7,2,9,1,8,4,12,2,0
1627,Mads Pedersen,Augsburg,1.8,5,4,3,1,1,3,3,100.0,0,3,0,3,1,6,5,0
1628,Marcus Pedersen,Torino,2.3,4,2,2,1,1,3,5,60.0,2,2,0,2,0,4,6,0
1629,Pedri,Barcelona,6.5,15,9,5,9,1,5,15,33.3,10,8,1,7,6,21,7,1
1630,Pedro,Lazio,0.5,2,1,0,2,0,1,1,100.0,0,2,0,2,0,2,1,0
1631,Kevin Pedro,Saint-Étienne,0.1,3,0,2,1,0,3,3,100.0,0,1,0,1,2,5,1,0
1632,Adria Pedrosa,Sevilla,5.7,9,3,6,1,2,8,11,72.7,3,12,2,10,4,13,15,0
1633,Jordan Pefok,Union Berlin,4.0,3,2,2,0,1,0,2,0.0,2,2,0,2,3,6,5,0
1634,Pejino,Las Palmas,0.2,1,1,0,1,0,1,1,100.0,0,0,0,0,0,1,0,0
1635,Pietro Pellegri,Empoli,0.8,1,0,0,1,0,0,0,0.0,0,0,0,0,0,1,0,0
1636,Lorenzo Pellegrini,Roma,5.8,7,4,1,4,2,1,3,33.3,2,1,0,1,0,7,7,0
1638,Luca Pellegrini,Lazio,0.3,2,2,0,2,0,1,1,100.0,0,2,0,2,0,2,2,0
1639,Theo Pellenard,Auxerre,0.5,3,2,2,1,0,1,3,33.3,2,1,0,1,0,3,3,0
1640,Andy Pelmard,Lecce,0.1,0,0,0,0,0,0,0,0.0,0,0,0,0,0,0,0,0
1641,Faris Pemi Moumbagna,Marseille,0.1,0,0,0,0,0,0,0,0.0,0,0,0,0,0,0,0,0
1642,Inaki Pena,Barcelona,3.5,0,0,0,0,0,0,2,0.0,2,0,0,0,0,0,6,0
1643,Ruben Pena,Osasuna,2.3,4,0,1,1,2,1,4,25.0,3,6,0,6,1,5,3,0
1644,Nicolas Pepe,Villarreal,4.2,3,0,1,1,1,0,3,0.0,3,2,1,1,3,6,2,0
1645,Peque,Sevilla,4.9,5,2,1,4,0,2,7,28.6,5,7,0,7,3,8,1,0
1646,Andreas Pereira,Fulham,6.0,3,1,1,1,1,1,8,12.5,7,4,1,3,2,5,2,0
1647,Mathias Pereira Lage,Brest,3.0,4,2,1,2,1,0,1,0.0,1,4,0,4,4,8,5,0
1648,Pedro Pereira,Monza,4.6,6,2,3,3,0,2,4,50.0,2,7,3,4,5,11,9,0
1649,Ayoze Perez,Villarreal,4.6,4,2,1,3,0,1,6,16.7,5,4,0,4,2,6,5,0
1650,Carles Perez,Getafe,6.7,14,10,3,6,5,11,23,47.8,12,10,1,9,2,16,7,0
1651,Francisco Perez,Valencia,0.3,1,1,0,1,0,0,1,0.0,1,1,0,1,0,1,1,0
1652,Kike Perez,Valladolid,5.8,18,12,6,12,0,6,14,42.9,8,7,3,4,4,22,3,0
1653,Luis Perez,Valladolid,8.6,16,10,8,4,4,9,13,69.2,4,13,2,11,9,25,21,0
1654,Nehuen Perez,Udinese,2.0,1,1,0,0,1,0,1,0.0,1,2,2,0,1,2,7,0
1655,Mattia Perin,Juventus,2.0,0,0,0,0,0,0,0,0.0,0,0,0,0,0,0,0,0
1656,Romain Perraud,Betis,5.3,9,4,5,1,3,6,17,35.3,11,3,0,3,4,13,14,0
1657,Lucas Perri,Lyon,7.0,0,0,0,0,0,0,1,0.0,1,0,0,0,0,0,5,1
1658,Gaetan Perrin,Auxerre,4.0,11,3,8,1,2,6,11,54.5,5,0,0,0,2,13,1,0
1659,Maximo Perrone,Como,5.3,9,6,6,3,0,3,16,18.8,13,3,0,3,6,15,13,0
1660,Matteo Pessina,Monza,6.5,13,4,2,10,1,8,11,72.7,3,5,0,5,9,22,7,0
1661,Andrea Petagna,Monza,2.0,0,0,0,0,0,0,0,0.0,0,0,0,0,1,1,1,0
1662,Leo Petrot,Saint-Étienne,2.7,5,2,3,2,0,4,4,100.0,0,6,2,4,4,9,16,0
1664,Dorde Petrovic,Strasbourg,4.0,0,0,0,0,0,0,0,0.0,0,0,0,0,0,0,1,0
1665,Giuseppe Pezzella,Empoli,6.0,15,9,10,5,0,11,18,61.1,7,4,2,2,1,16,18,0
1666,Kalvin Phillips,Ipswich Town,3.3,9,3,2,6,1,4,11,36.4,7,8,1,7,6,15,6,0
1667,Jaden Philogene Bidace,Aston Villa,1.5,5,3,1,4,0,2,3,66.7,1,0,0,0,0,5,2,0
1668,Pica,Alavés,1.5,2,2,2,0,0,2,4,50.0,2,4,4,0,2,4,5,0
1669,Roberto Piccoli,Cagliari,6.4,1,0,0,0,1,1,1,100.0,0,2,1,1,1,2,6,0
1670,Benedikt Pichler,Holstein Kiel,5.1,3,2,1,0,2,1,2,50.0,1,4,2,2,1,4,6,0
1671,Jordan Pickford,Everton,7.0,0,0,0,0,0,0,0,0.0,0,0,0,0,0,0,7,1
1672,Amos Pieper,Werder Bremen,1.2,2,1,1,0,1,0,3,0.0,3,2,2,0,5,7,4,0
1673,Marvin Pieringer,Heidenheim,4.7,2,0,0,1,1,1,2,50.0,1,5,0,5,2,4,5,0
1674,Nicholas Pierini,Venezia,0.9,0,0,0,0,0,0,1,0.0,1,2,0,2,0,0,0,0
1675,Santiago Pierotti,Lecce,1.7,5,4,3,2,0,4,6,66.7,2,2,1,1,2,7,1,0
1676,Balthazar Pierret,Lecce,4.5,12,5,8,4,0,2,6,33.3,4,6,1,5,3,15,4,0
1677,Andrea Pinamonti,Genoa,4.9,1,1,0,1,0,0,1,0.0,1,1,0,1,1,2,4,0
1678,Ethan Pinnock,Brentford,7.0,19,10,9,7,3,7,10,70.0,3,9,5,4,10,29,34,2
1679,Yeremi Pino,Villarreal,3.6,9,6,2,5,2,5,11,45.5,6,5,1,4,1,10,3,0
1680,Niccolo Pisilli,Roma,2.7,5,3,2,3,0,2,2,100.0,0,4,0,4,1,6,3,0
1681,Semuel Pizzignacco,Monza,3.0,0,0,0,0,0,0,0,0.0,0,0,0,0,0,0,1,0
1682,Alassane Plea,Gladbach,3.9,1,1,0,1,0,1,1,100.0,0,1,0,1,0,1,1,1
1683,Tommaso Pobega,Bologna,1.0,5,3,3,0,2,2,4,50.0,2,3,1,2,0,5,1,0
1684,Daniel Podence,Wolves,0.5,0,0,0,0,0,0,1,0.0,1,0,0,0,0,0,0,0
1685,Joel Pohjanpalo,Venezia,4.4,1,1,1,0,0,0,0,0.0,0,1,1,0,2,3,3,0
1686,Matteo Politano,Napoli,6.2,4,2,2,2,0,4,5,80.0,1,2,0,2,2,6,10,0
1687,Marin Pongracic,Fiorentina,1.0,1,1,1,0,0,1,3,33.3,2,0,0,0,2,3,4,0
1688,Nick Pope,Newcastle Utd,7.0,0,0,0,0,0,0,0,0.0,0,0,0,0,0,0,7,2
1690,Finn Porath,Holstein Kiel,4.7,13,7,11,1,1,10,15,66.7,5,8,4,4,4,17,10,0
1691,Pedro Porro,Tottenham,7.0,18,12,9,5,4,12,18,66.7,6,12,5,7,10,28,16,0
1692,Portu,Girona,1.8,3,2,1,1,1,2,2,100.0,0,3,0,3,0,3,1,0
1693,Stefan Posch,Bologna,5.1,17,11,7,6,4,9,18,50.0,9,12,3,9,3,20,11,0
1694,Yussuf Poulsen,RB Leipzig,1.2,2,1,1,1,0,2,4,50.0,2,2,2,0,0,2,1,0
1695,Benat Prados,Athletic Club,4.8,8,8,2,6,0,3,13,23.1,10,8,1,7,7,15,5,0
1696,Alexander Prass,Hoffenheim,4.9,8,5,7,1,0,6,15,40.0,9,6,2,4,1,9,11,1
1697,Matteo Prati,Cagliari,1.9,4,2,1,2,1,2,6,33.3,4,0,0,0,2,6,2,1
1698,Abdon Prats,Mallorca,1.5,1,1,1,0,0,0,0,0.0,0,1,0,1,0,1,2,0
1699,Grischa Promel,Hoffenheim,1.9,0,0,0,0,0,0,1,0.0,1,1,1,0,2,2,4,0
1700,Ivan Provedel,Lazio,7.0,0,0,0,0,0,0,0,0.0,0,0,0,0,0,0,5,3
1701,Javi Puado,Espanyol,7.3,6,5,2,2,2,1,1,100.0,0,4,0,4,1,7,8,0
1702,Tymoteusz Puchacz,Holstein Kiel,1.6,3,2,2,1,0,1,2,50.0,1,4,1,3,0,3,5,0
1703,Christian Pulisic,Milan,6.1,12,7,4,5,3,3,7,42.9,4,2,0,2,0,12,2,0
1704,Jarell Quansah,Liverpool,0.5,2,2,1,1,0,0,0,0.0,0,1,1,0,1,3,3,0
1705,Leopold Querfeld,Union Berlin,1.2,2,0,2,0,0,2,3,66.7,1,2,1,1,1,3,13,0
1706,Dani Raba,Leganés,1.6,6,4,3,3,0,3,6,50.0,3,2,0,2,4,10,3,0
1707,Adrien Rabiot,Marseille,0.6,1,0,1,0,0,0,0,0.0,0,0,0,0,1,2,2,0
1708,Hamza Rafia,Lecce,2.5,8,5,4,3,1,2,7,28.6,5,2,1,1,1,9,4,0
1709,Antonio Raillo,Mallorca,9.0,9,5,4,3,2,4,5,80.0,1,11,10,1,13,22,45,0
1710,Antonio Raimondo,Venezia,0.9,2,1,1,1,0,0,0,0.0,0,0,0,0,0,2,0,1
1711,Ylber Ramadani,Lecce,6.5,14,8,6,8,0,7,10,70.0,3,9,3,6,6,20,8,2
1712,Benito Ramirez,Las Palmas,2.4,2,1,2,0,0,2,8,25.0,6,5,2,3,1,3,7,0
1713,Sandro Ramirez,Las Palmas,4.5,6,5,3,3,0,4,8,50.0,4,0,0,0,8,14,4,0
1714,Goncalo Ramos,Paris S-G,0.2,0,0,0,0,0,0,0,0.0,0,0,0,0,0,0,0,0
1716,Aaron Ramsdale,Southampton,5.0,0,0,0,0,0,0,0,0.0,0,0,0,0,1,1,5,1
1717,Jacob Ramsey,Aston Villa,3.7,6,2,2,3,1,2,4,50.0,2,1,0,1,0,6,1,0
1718,Luca Ranieri,Fiorentina,5.4,3,2,2,0,1,0,1,0.0,1,9,6,3,6,9,20,0
1719,Grant Ranos,Gladbach,0.1,1,0,0,1,0,0,1,0.0,1,1,0,1,0,1,0,0
1720,Lilian Raolisoa,Angers,1.1,3,2,1,1,1,1,3,33.3,2,1,1,0,1,4,3,0
1721,Raphinha,Barcelona,8.4,12,6,3,8,1,4,9,44.4,5,5,0,5,2,14,7,0
1722,Marcus Rashford,Manchester Utd,5.3,4,2,1,1,2,2,6,33.3,4,4,0,4,3,7,3,0
1723,Giacomo Raspadori,Napoli,2.2,2,0,1,1,0,1,2,50.0,1,3,1,2,2,4,0,0
1724,Andrei Ratiu,Rayo Vallecano,6.9,12,9,8,1,3,8,9,88.9,1,5,1,4,5,17,16,0
1725,Raul,Osasuna,2.8,2,2,0,1,1,0,1,0.0,1,1,0,1,0,2,2,0
1726,David Raum,RB Leipzig,5.4,11,8,5,4,2,2,6,33.3,4,5,1,4,2,13,10,0
1727,Federico Ravaglia,Bologna,2.0,0,0,0,0,0,0,0,0.0,0,0,0,0,0,0,0,0
1728,Rayan Raveloson,Auxerre,4.4,3,2,1,2,0,2,10,20.0,8,2,1,1,2,5,9,0
1729,David Raya,Arsenal,7.0,0,0,0,0,0,0,0,0.0,0,0,0,0,1,1,2,0
1730,Abderrahman Rebbach,Alavés,2.3,0,0,0,0,0,0,3,0.0,3,2,0,2,0,0,3,0
1731,Ante Rebic,Lecce,2.9,2,2,1,0,1,1,4,25.0,3,1,1,0,0,2,1,0
1732,Harrison Reed,Fulham,0.5,5,2,2,2,1,0,2,0.0,2,1,0,1,1,6,1,0
1733,Bobby Reid,Leicester City,1.8,1,1,0,1,0,0,3,0.0,3,4,1,3,0,1,3,0
1734,Tijjani Reijnders,Milan,5.8,1,1,0,1,0,1,8,12.5,7,0,0,0,7,8,4,0
1735,Pepe Reina,Como,3.0,0,0,0,0,0,0,0,0.0,0,0,0,0,0,0,0,1
1736,Rocco Reitz,Gladbach,2.7,9,3,6,3,0,6,6,100.0,0,4,2,2,8,17,5,0
1737,Nicolai Remberg,Holstein Kiel,1.8,6,3,3,3,0,2,4,50.0,2,3,0,3,0,6,4,0
1738,Alex Remiro,Real Sociedad,9.0,0,0,0,0,0,0,0,0.0,0,0,0,0,0,0,3,3
1739,Guillaume Restes,Toulouse,7.0,0,0,0,0,0,0,0,0.0,0,0,0,0,0,0,3,0
1740,Mateo Retegui,Atalanta,5.3,5,3,0,1,4,2,4,50.0,2,1,0,1,1,6,4,0
1742,Elvis Rexhbecaj,Augsburg,5.6,8,7,1,5,2,5,13,38.5,8,9,1,8,4,12,6,0
1743,Gio Reyna,Dortmund,0.1,1,0,0,0,1,1,1,100.0,0,0,0,0,0,1,0,0
1744,Chadi Riad,Crystal Palace,1.0,5,2,2,2,1,2,3,66.7,1,0,0,0,2,7,0,0
1745,Alexsandro Ribeiro,Lille,6.0,9,8,4,4,1,8,11,72.7,3,1,0,1,6,15,25,0
1746,Samuele Ricci,Torino,6.6,5,3,2,2,1,4,5,80.0,1,6,3,3,3,8,13,1
1747,Declan Rice,Arsenal,5.5,4,2,0,4,0,3,6,50.0,3,6,4,2,5,9,9,0
1748,Chris Richards,Crystal Palace,3.8,10,5,5,4,1,6,11,54.5,5,7,1,6,3,13,17,0
1749,Amir Richardson,Fiorentina,1.4,6,2,5,1,0,2,5,40.0,3,1,0,1,0,6,4,0
1750,Richarlison,Tottenham,0.3,0,0,0,0,0,0,0,0.0,0,0,0,0,0,0,2,0
1751,Diego Rico,Getafe,8.0,28,13,18,7,3,15,23,65.2,8,6,0,6,5,33,13,1
1752,Fabian Rieder,Stuttgart,2.8,5,4,1,2,2,2,6,33.3,4,3,0,3,3,8,0,0
1753,Luis Rioja,Alavés,0.3,2,1,0,1,1,1,2,50.0,1,2,0,2,0,2,0,0
1754,Luis Rioja,Valencia,6.9,6,4,0,3,3,2,10,20.0,8,8,0,8,11,17,7,0
1755,Rodrigo Riquelme,Atlético Madrid,2.7,3,2,3,0,0,2,2,100.0,0,0,0,0,1,4,3,0
1756,Alberto Risco,Getafe,0.8,4,4,2,0,2,1,6,16.7,5,2,0,2,0,4,0,0
1757,Lars Ritzka,St. Pauli,2.3,11,8,3,5,3,5,10,50.0,5,6,0,6,0,11,6,0
1758,Gorka Rivera Alonso,Getafe,0.2,2,0,0,2,0,2,2,100.0,0,0,0,0,0,2,0,0
1759,Sergi Roberto,Como,4.5,9,6,3,3,3,4,5,80.0,1,3,1,2,9,18,6,0
1760,Andrew Robertson,Liverpool,5.7,5,3,3,1,1,3,6,50.0,3,1,0,1,3,8,3,0
1761,Antonee Robinson,Fulham,7.0,25,16,13,11,1,13,20,65.0,7,7,1,6,10,35,25,0
1762,Marc Roca,Betis,8.1,14,8,8,6,0,8,15,53.3,7,16,5,11,8,22,9,1
1763,Rodri,Manchester City,0.7,2,1,1,1,0,0,0,0.0,0,1,0,1,1,3,0,0
1764,Rodri,Betis,1.3,2,1,1,1,0,1,2,50.0,1,2,1,1,1,3,1,1
1765,Alvaro Rodriguez,Getafe,0.2,0,0,0,0,0,0,0,0.0,0,0,0,0,0,0,0,0
1766,Oscar Rodriguez Arnaiz,Leganés,3.5,5,2,1,3,1,1,4,25.0,3,1,0,1,3,8,1,0
1768,Damian Rodriguez,Celta Vigo,5.8,7,4,2,4,1,2,7,28.6,5,3,1,2,4,11,8,0
1769,Dani Rodriguez,Mallorca,6.1,14,12,6,5,3,6,7,85.7,1,3,0,3,2,16,6,0
1770,Guido Rodriguez,West Ham,5.9,16,6,11,5,0,6,15,40.0,9,8,2,6,8,24,11,0
1771,James Rodriguez,Rayo Vallecano,1.1,3,2,1,2,0,0,2,0.0,2,2,0,2,1,4,0,0
1772,Javi Rodriguez,Celta Vigo,5.9,8,5,7,1,0,6,8,75.0,2,4,1,3,4,12,17,0
1773,Kirian Rodriguez,Las Palmas,7.4,12,7,4,8,0,8,20,40.0,12,8,1,7,2,14,6,0
1774,Ricardo Rodriguez,Betis,3.7,9,7,6,1,2,5,9,55.6,4,2,0,2,3,12,11,0
1775,Rodrygo,Real Madrid,6.9,6,4,4,2,0,3,8,37.5,5,7,1,6,0,6,2,0
1776,Mads Roerslev,Brentford,2.9,3,1,3,0,0,1,4,25.0,3,2,0,2,2,5,5,0
1777,Morgan Rogers,Aston Villa,6.7,5,3,2,1,2,2,5,40.0,3,7,2,5,1,6,5,0
1778,Merlin Rohl,Freiburg,1.8,3,3,1,2,0,1,1,100.0,0,1,0,1,1,4,0,0
1779,Alessio Romagnoli,Lazio,6.0,8,5,3,5,0,4,5,80.0,1,4,3,1,8,16,14,0
1780,Leo Roman,Mallorca,3.0,0,0,0,0,0,0,0,0.0,0,0,0,0,0,0,0,0
1781,Carlos Romero,Espanyol,7.8,19,14,12,6,1,10,19,52.6,9,8,1,7,6,25,20,0
1782,Cristian Romero,Tottenham,7.0,14,14,11,3,0,9,12,75.0,3,12,3,9,7,21,21,0
1783,Isaac Romero,Sevilla,5.0,2,0,0,1,1,0,3,0.0,3,6,1,5,0,2,5,0
1784,Luka Romero,Alavés,1.7,4,4,1,1,2,2,3,66.7,1,1,0,1,1,5,0,0
1785,Oriol Romeu,Girona,3.5,12,7,3,9,0,5,6,83.3,1,6,2,4,2,14,0,0
1786,Valentin Rongier,Marseille,1.8,6,3,4,2,0,1,4,25.0,3,4,1,3,2,8,7,0
1787,Marten de Roon,Atalanta,7.0,22,12,11,10,1,9,15,60.0,6,17,2,15,11,33,13,0
1788,Vitor Roque,Betis,3.4,0,0,0,0,0,0,1,0.0,1,1,0,1,1,1,1,0
1789,Pablo Rosario,Nice,4.9,3,2,0,3,0,2,4,50.0,2,6,4,2,6,9,12,1
1790,Lasse Rosenboom,Holstein Kiel,1.7,4,3,4,0,0,2,3,66.7,1,3,1,2,2,6,7,0
1791,Max Rosenfelder,Freiburg,3.3,7,4,6,1,0,5,5,100.0,0,4,1,3,2,9,20,0
1792,Valentin Rosier,Leganés,8.4,27,23,19,8,0,16,24,66.7,8,12,1,11,11,38,37,0
1794,Tom Rothe,Union Berlin,4.2,17,8,12,5,0,9,14,64.3,5,9,3,6,5,22,10,1
1795,Anthony Rouault,Stuttgart,2.8,2,1,1,1,0,2,2,100.0,0,4,1,3,3,5,9,0
1796,Jonas Rouhi,Juventus,1.0,0,0,0,0,0,0,0,0.0,0,1,0,1,1,1,2,0
1797,Nicolo Rovella,Lazio,4.9,21,16,6,12,3,11,14,78.6,3,2,0,2,6,27,7,1
1798,Jon Rowe,Marseille,1.7,6,6,0,2,4,4,6,66.7,2,1,1,0,0,6,0,0
1799,Amir Rrahmani,Napoli,7.0,5,3,4,1,0,2,6,33.3,4,4,1,3,3,8,26,0
1800,Antonio Rudiger,Real Madrid,8.1,6,4,4,2,0,3,5,60.0,2,12,9,3,3,9,28,0
1801,Matteo Ruggeri,Atalanta,4.6,5,2,1,3,1,2,2,100.0,0,4,0,4,5,10,5,1
1802,Aitor Ruibal,Betis,3.8,3,2,0,1,2,2,6,33.3,4,2,1,1,3,6,2,0
1803,Abel Ruiz,Girona,7.3,2,0,1,0,1,2,5,40.0,3,4,1,3,2,4,3,0
1804,Fabian Ruiz Pena,Paris S-G,3.4,13,7,7,3,3,5,11,45.5,6,4,0,4,3,16,1,0
1805,Geronimo Rulli,Marseille,7.0,0,0,0,0,0,0,2,0.0,2,0,0,0,0,0,6,1
1806,Georginio Rutter,Brighton,3.3,2,0,1,1,0,1,8,12.5,7,6,0,6,2,4,1,1
1807,Julian Ryerson,Dortmund,5.3,4,4,1,2,1,4,7,57.1,3,4,1,3,8,12,5,0
1808,Frederik Ronnow,Union Berlin,6.0,0,0,0,0,0,0,0,0.0,0,0,0,0,0,0,5,0
1809,Jose Sa,Wolves,2.0,0,0,0,0,0,0,0,0.0,0,0,0,0,0,0,2,0
1810,Elias Saad,St. Pauli,3.8,12,7,4,5,3,6,11,54.5,5,6,0,6,1,13,1,0
1811,Youssouf Sabaly,Betis,3.7,8,5,5,2,1,5,6,83.3,1,3,0,3,2,10,13,0
1812,Emmanuel Sabbi,Le Havre,1.7,4,2,3,1,0,1,2,50.0,1,2,0,2,1,5,0,0
1813,Stefano Sabelli,Genoa,3.3,5,4,2,1,2,2,11,18.2,9,6,0,6,1,6,4,0
1814,Marcel Sabitzer,Dortmund,3.4,5,3,0,5,0,3,6,50.0,3,6,3,3,1,6,4,0
1815,Falaye Sacko,Montpellier,6.5,10,5,8,1,1,6,13,46.2,7,8,3,5,8,18,6,0
1816,Umar Sadiq,Real Sociedad,2.1,2,1,1,1,0,1,2,50.0,1,2,1,1,1,3,2,0
1817,Alexis Saelemaekers,Roma,1.2,4,2,3,1,0,2,2,100.0,0,1,0,1,0,4,1,0
1818,Alexis Saelemaekers,Milan,1.0,1,1,0,0,1,1,1,100.0,0,0,0,0,1,2,0,0
1820,Jorge Saenz,Leganés,5.3,13,10,5,7,1,3,5,60.0,2,4,2,2,8,21,36,0
1821,Matvei Safonov,Paris S-G,2.0,0,0,0,0,0,0,0,0.0,0,0,0,0,0,0,0,0
1822,Modibo Sagnan,Montpellier,7.0,17,8,8,7,2,10,16,62.5,6,7,4,3,13,30,26,1
1823,Richie Sagrado,Venezia,0.6,1,1,0,1,0,0,0,0.0,0,0,0,0,0,1,1,0
1824,Osame Sahraoui,Lille,4.7,4,3,2,1,1,1,4,25.0,3,6,0,6,3,7,3,1
1825,Wesley Said,Lens,3.9,3,2,1,2,0,1,2,50.0,1,0,0,0,0,3,1,0
1826,Bukayo Saka,Arsenal,6.3,12,8,5,2,5,7,15,46.7,8,10,0,10,1,13,5,0
1827,Marco Sala,Como,1.0,3,2,1,1,1,1,1,100.0,0,1,0,1,1,4,2,0
1828,Ibrahim Salah,Brest,1.4,1,0,0,0,1,1,1,100.0,0,0,0,0,1,2,0,0
1829,Mohamed Salah,Liverpool,6.7,4,4,1,1,2,2,3,66.7,1,1,0,1,1,5,4,0
1830,Amine Salama,Reims,1.1,2,2,0,1,1,0,2,0.0,2,2,1,1,0,2,0,0
1831,Kike Salas,Sevilla,2.2,4,4,1,1,2,2,4,50.0,2,3,2,1,2,6,8,0
1832,Manolis Saliakas,St. Pauli,3.3,6,3,3,1,2,3,6,50.0,3,3,0,3,1,7,9,0
1833,William Saliba,Arsenal,7.0,20,11,12,8,0,8,9,88.9,1,5,2,3,5,25,23,1
1834,Mohammed Salisu,Monaco,4.1,14,7,9,5,0,7,7,100.0,0,5,4,1,2,16,15,1
1835,Roland Sallai,Freiburg,0.5,2,1,1,1,0,0,0,0.0,0,0,0,0,1,3,0,0
1836,Yoann Salmier,Le Havre,2.9,2,1,2,0,0,1,1,100.0,0,2,1,1,3,5,25,0
1837,Lazar Samardzic,Atalanta,2.4,2,2,0,1,1,2,3,66.7,1,2,1,1,0,2,0,0
1838,Mama Samba Balde,Lyon,0.4,2,2,0,2,0,0,0,0.0,0,0,0,0,1,3,1,0
1839,Mama Samba Balde,Brest,1.9,3,3,1,0,2,1,2,50.0,1,2,0,2,1,4,3,0
1840,Brice Samba,Lens,7.0,0,0,0,0,0,0,0,0.0,0,0,0,0,0,0,2,0
1841,Albert Sambi Lokonga,Sevilla,1.9,3,3,3,0,0,1,1,100.0,0,3,1,2,0,3,2,0
1842,Chuky san jose,Valladolid,1.0,1,0,0,0,1,1,1,100.0,0,2,0,2,0,1,0,0
1843,Antonio Sanabria,Torino,2.4,1,1,0,0,1,1,3,33.3,2,1,0,1,0,1,1,0
1844,Oihan Sancet,Athletic Club,6.0,3,1,1,1,1,2,7,28.6,5,3,0,3,2,5,3,0
1846,Antonio Sanchez,Mallorca,4.7,12,8,9,2,1,7,10,70.0,3,5,0,5,5,17,15,0
1847,Ivan Sanchez,Valladolid,4.1,10,7,7,2,1,3,10,30.0,7,4,1,3,6,16,2,0
1848,Javi Sanchez,Valladolid,2.7,2,2,1,1,0,2,3,66.7,1,5,3,2,2,4,13,0
1849,Juanlu Sanchez,Sevilla,3.4,6,5,3,2,1,4,5,80.0,1,0,0,0,6,12,3,0
1850,Manu Sanchez,Alavés,6.5,9,5,3,3,3,5,10,50.0,5,14,2,12,8,17,15,0
1851,Robert Sanchez,Chelsea,7.0,0,0,0,0,0,0,0,0.0,0,0,0,0,0,0,4,2
1852,Jadon Sancho,Chelsea,2.9,1,1,1,0,0,1,3,33.3,2,0,0,0,0,1,0,0
1853,Philipp Sander,Gladbach,3.4,10,6,5,4,1,5,6,83.3,1,7,1,6,5,15,6,0
1854,Leroy Sane,Bayern Munich,0.4,0,0,0,0,0,0,0,0.0,0,0,0,0,0,0,0,0
1855,Arouna Sangante,Le Havre,5.8,9,7,4,5,0,5,8,62.5,3,7,4,3,14,23,21,1
1856,Ibrahim Sangare,Nott'ham Forest,2.4,15,9,5,10,0,4,8,50.0,4,4,0,4,2,17,2,0
1857,Nhoa Sangui,Reims,4.8,3,2,0,2,1,2,5,40.0,3,4,2,2,2,5,9,0
1858,Kaishu Sano,Mainz 05,5.8,11,8,5,5,1,4,11,36.4,7,12,3,9,5,16,8,0
1859,Baptiste Santamaria,Rennes,3.0,6,2,4,1,1,3,5,60.0,2,4,1,3,4,10,6,0
1860,Jesus Santiago,Getafe,1.9,5,3,4,1,0,2,3,66.7,1,2,1,1,0,5,2,0
1861,Andrey Santos,Strasbourg,5.8,23,15,13,8,2,11,24,45.8,13,8,1,7,2,25,9,0
1862,Kaua Santos,Eint Frankfurt,3.5,0,0,0,0,0,0,0,0.0,0,0,0,0,0,0,2,0
1863,Tiago Santos,Lille,4.5,12,7,4,5,3,6,9,66.7,3,2,0,2,2,14,4,0
1864,Pablo Sarabia,Wolves,0.3,2,0,1,0,1,1,2,50.0,1,2,0,2,1,3,0,0
1865,Jeremy Sarmiento,Brighton,0.1,0,0,0,0,0,0,0,0.0,0,0,0,0,0,0,0,0
1866,Amin Sarr,Hellas Verona,0.4,1,1,0,1,0,1,1,100.0,0,1,1,0,0,1,0,0
1867,Ismaila Sarr,Crystal Palace,2.5,0,0,0,0,0,0,3,0.0,3,2,0,2,2,2,1,0
1868,Malang Sarr,Lens,1.0,0,0,0,0,0,0,0,0.0,0,1,0,1,3,3,0,0
1869,Mamadou Sarr,Strasbourg,1.8,4,2,1,3,0,3,5,60.0,2,3,2,1,3,7,4,0
1870,Martin Satriano,Lens,0.5,3,1,1,1,1,3,3,100.0,0,0,0,0,0,3,2,0
1872,Teji Savanier,Montpellier,6.9,7,7,3,2,2,6,16,37.5,10,2,0,2,3,10,5,0
1873,Savio,Manchester City,3.2,8,5,3,1,4,2,3,66.7,1,2,0,2,0,8,1,1
1874,Nicolo Savona,Juventus,4.3,8,5,4,3,1,3,5,60.0,2,1,0,1,4,12,1,0
1875,Saba Sazonov,Torino,0.0,0,0,0,0,0,0,0,0.0,0,1,1,0,0,0,0,0
1876,Joe Scally,Gladbach,5.8,10,6,8,2,0,5,8,62.5,3,6,3,3,1,11,11,1
1877,Kevin Schade,Brentford,4.2,11,9,2,4,5,5,6,83.3,1,1,1,0,0,11,3,0
1878,Andras Schafer,Union Berlin,4.2,13,7,6,6,1,10,15,66.7,5,8,1,7,4,17,8,0
1879,Fabian Schar,Newcastle Utd,4.3,3,0,2,1,0,0,1,0.0,1,1,1,0,5,8,15,0
1880,Patrik Schick,Leverkusen,1.2,1,1,0,1,0,0,0,0.0,0,1,0,1,0,1,1,0
1881,Stefan Schimmer,Heidenheim,0.4,1,0,0,1,0,1,1,100.0,0,0,0,0,0,1,0,0
1882,Joel Schingtienne,Venezia,1.0,4,4,3,1,0,1,1,100.0,0,1,0,1,1,5,1,0
1883,Keven Schlotterbeck,Augsburg,5.4,4,3,1,3,0,2,2,100.0,0,5,3,2,8,12,20,1
1884,Nico Schlotterbeck,Dortmund,4.8,11,7,6,5,0,9,13,69.2,4,5,1,4,8,19,16,0
1885,Jeffrey Schlupp,Crystal Palace,0.4,0,0,0,0,0,0,1,0.0,1,1,0,1,0,0,1,0
1886,Romano Schmid,Werder Bremen,5.8,8,1,3,4,1,5,12,41.7,7,5,0,5,0,8,4,0
1887,Niklas Schmidt,Toulouse,1.6,3,2,1,2,0,1,2,50.0,1,0,0,0,0,3,2,0
1888,Jan Schoppner,Heidenheim,5.2,11,4,2,8,1,6,13,46.2,7,6,1,5,11,22,22,0
1889,Marvin Schulz,Holstein Kiel,0.3,1,1,1,0,0,1,2,50.0,1,1,1,0,0,1,3,0
1890,Leo Scienza,Heidenheim,2.9,3,3,2,1,0,0,4,0.0,4,1,0,1,3,6,4,0
1891,Alex Scott,Bournemouth,2.2,16,7,8,4,4,12,15,80.0,3,6,1,5,4,20,4,0
1892,Simone Scuffet,Cagliari,7.0,0,0,0,0,0,0,1,0.0,1,0,0,0,0,0,6,1
1893,Jeremy Sebas,Strasbourg,0.2,2,1,1,1,0,2,3,66.7,1,0,0,0,0,2,0,0
1894,Aleksandar Sedlar,Alavés,4.5,15,9,5,10,0,7,9,77.8,2,2,1,1,7,22,7,1
1895,Alidu Seidu,Rennes,5.9,14,10,9,4,1,9,10,90.0,1,10,5,5,8,22,12,0
1896,Nicolas Seiwald,RB Leipzig,3.7,12,8,3,9,0,6,11,54.5,5,4,1,3,9,21,9,0
1898,Matz Sels,Nott'ham Forest,7.0,1,1,1,0,0,1,1,100.0,0,0,0,0,0,1,4,0
1899,Nelson Semedo,Wolves,4.7,9,4,5,3,1,4,11,36.4,7,2,1,1,1,10,18,0
1900,Antoine Semenyo,Bournemouth,6.7,11,7,5,2,4,3,9,33.3,6,14,2,12,1,12,4,0
1901,Marvin Senaya,Strasbourg,1.2,3,2,2,1,0,2,4,50.0,2,5,2,3,6,9,7,0
1902,Marcos Senesi,Bournemouth,4.8,17,8,12,4,1,7,15,46.7,8,10,5,5,7,24,24,0
1903,Suat Serdar,Hellas Verona,0.2,0,0,0,0,0,0,0,0.0,0,0,0,0,0,0,0,0
1904,Sergi,Leganés,9.0,13,10,7,5,1,5,6,83.3,1,9,5,4,14,27,46,0
1905,Benjamin Sesko,RB Leipzig,4.8,4,2,0,2,2,1,2,50.0,1,4,2,2,2,6,4,0
1906,Stephan El Shaarawy,Roma,2.8,3,2,1,0,2,0,1,0.0,1,1,0,1,3,6,3,0
1907,Eldor Shomurodov,Roma,0.4,0,0,0,0,0,0,1,0.0,1,0,0,0,0,0,0,0
1908,Djibril Sidibe,Toulouse,4.1,15,7,7,6,2,5,7,71.4,2,2,1,1,6,21,10,0
1909,Armindo Sieb,Mainz 05,2.2,2,1,0,2,0,1,2,50.0,1,1,0,1,1,3,2,0
1910,Vincent Sierro,Toulouse,6.2,13,6,3,9,1,7,12,58.3,5,7,0,7,5,18,13,0
1911,Tim Siersleben,Heidenheim,0.1,0,0,0,0,0,0,0,0.0,0,0,0,0,1,1,2,0
1912,Kiliann Sildillia,Freiburg,0.0,0,0,0,0,0,0,0,0.0,0,0,0,0,0,0,0,0
1913,Andre Silva,RB Leipzig,0.2,0,0,0,0,0,0,0,0.0,0,0,0,0,0,0,0,0
1914,Bernardo Silva,Manchester City,6.1,5,4,0,3,2,1,5,20.0,4,5,1,4,2,7,2,1
1915,Caio Henrique Oliveira Silva,Monaco,3.1,6,4,2,4,0,3,4,75.0,1,5,0,5,2,8,6,0
1916,Fabio Silva,Las Palmas,3.9,5,1,1,2,2,1,6,16.7,5,3,0,3,1,6,1,0
1917,Jota Silva,Nott'ham Forest,1.3,4,1,4,0,0,0,3,0.0,3,1,0,1,5,9,3,0
1918,Rui Silva,Betis,9.0,0,0,0,0,0,0,0,0.0,0,0,0,0,0,0,5,0
1919,Abdallah Sima,Brest,2.6,2,2,0,2,0,2,2,100.0,0,1,0,1,1,3,3,0
1920,Mohamed Simakan,RB Leipzig,0.6,0,0,0,0,0,0,0,0.0,0,0,0,0,2,2,0,0
1921,Giovanni Simeone,Napoli,1.5,0,0,0,0,0,0,2,0.0,2,1,0,1,1,1,1,0
1922,Giuliano Simeone,Atlético Madrid,1.0,2,2,0,1,1,2,3,66.7,1,3,1,2,0,2,2,0
1924,Moses Simon,Nantes,6.4,5,5,2,2,1,4,7,57.1,3,2,0,2,4,9,2,0
1925,Xavi Simons,RB Leipzig,5.8,6,5,1,5,0,3,3,100.0,0,3,1,2,1,7,3,0
1926,Danel Sinani,St. Pauli,0.3,0,0,0,0,0,0,1,0.0,1,0,0,0,1,1,0,0
1927,Lassine Sinayoko,Auxerre,6.6,9,5,4,1,4,3,6,50.0,3,4,0,4,4,13,16,0
1928,Wilfried Singo,Monaco,4.1,7,4,4,3,0,2,4,50.0,2,2,1,1,12,19,15,0
1929,Luis Sinisterra,Bournemouth,2.0,4,1,1,1,2,0,4,0.0,4,3,0,3,0,4,4,0
1930,Daley Sinkgraven,Las Palmas,1.0,5,1,3,2,0,1,3,33.3,2,1,0,1,1,6,2,0
1931,Jailson Siqueira,Celta Vigo,5.0,7,7,5,2,0,5,6,83.3,1,5,3,2,8,15,18,1
1932,Ibrahim Sissoko,Saint-Étienne,5.1,7,6,2,3,2,2,5,40.0,3,5,0,5,1,8,8,0
1933,Ibrahima Sissoko,Bochum,5.8,17,12,9,7,1,6,11,54.5,5,4,2,2,9,26,12,0
1934,Antonio Sivera,Alavés,9.0,0,0,0,0,0,0,0,0.0,0,0,0,0,0,0,4,0
1935,Tim Skarke,Union Berlin,1.9,2,2,1,1,0,2,5,40.0,3,2,0,2,0,2,4,0
1936,Ellyes Skhiri,Eint Frankfurt,4.6,5,3,2,3,0,1,9,11.1,8,12,2,10,5,10,7,0
1937,Oliver Skipp,Leicester City,4.0,4,2,1,2,1,3,4,75.0,1,7,3,4,2,6,6,0
1938,Leo Skiri Ostigard,Rennes,4.7,15,13,12,3,0,12,17,70.6,5,5,5,0,5,20,26,0
1939,Lukasz Skorupski,Bologna,5.0,0,0,0,0,0,0,0,0.0,0,0,0,0,0,0,1,0
1940,Milan Skriniar,Paris S-G,1.2,3,2,2,1,0,1,1,100.0,0,3,2,1,1,4,2,0
1941,Steven Skrzybski,Holstein Kiel,1.1,2,0,0,0,2,1,1,100.0,0,1,0,1,3,5,1,0
1942,Naatan Skytta,Toulouse,0.1,1,0,0,0,1,0,0,0.0,0,0,0,0,0,1,0,0
1943,William Smallbone,Southampton,2.4,7,3,3,3,1,3,4,75.0,1,3,0,3,0,7,1,1
1944,Adam Smith,Bournemouth,3.6,5,2,2,1,2,3,6,50.0,3,2,1,1,4,9,11,0
1945,Eric Smith,St. Pauli,5.4,7,5,6,1,0,5,5,100.0,0,6,3,3,7,14,18,2
1946,Emile Smith Rowe,Fulham,5.2,11,7,3,3,5,3,5,60.0,2,5,0,5,4,15,3,0
1947,Simon Sohm,Parma,5.0,4,2,2,1,1,2,5,40.0,3,2,1,1,5,9,10,0
1948,Alex Sola,Getafe,6.9,13,7,8,5,0,7,17,41.2,10,6,0,6,1,14,6,0
1950,Dominic Solanke,Tottenham,5.0,4,3,1,3,0,0,0,0.0,0,2,0,2,0,4,4,0
1951,Ola Solbakken,Empoli,3.1,2,2,0,2,0,0,0,0.0,0,0,0,0,0,2,4,0
1952,Carlos Soler,West Ham,1.4,2,2,1,1,0,1,5,20.0,4,4,1,3,1,3,2,0
1953,Jhon Solis,Girona,3.2,4,4,2,2,0,3,9,33.3,6,10,1,9,3,7,4,0
1954,Yann Sommer,Inter,7.0,0,0,0,0,0,0,0,0.0,0,0,0,0,0,0,4,1
1955,David Soria,Getafe,9.0,1,1,1,0,0,1,1,100.0,0,0,0,0,0,1,7,1
1956,Juan Soriano,Leganés,6.0,1,1,1,0,0,1,1,100.0,0,0,0,0,0,1,2,0
1957,Borna Sosa,Torino,2.8,4,3,2,2,0,3,6,50.0,3,1,0,1,4,8,7,0
1958,Ramon Sosa,Nott'ham Forest,0.7,2,1,1,0,1,0,0,0.0,0,1,0,1,0,2,2,0
1959,Hugo Sotelo,Celta Vigo,2.8,5,4,3,1,1,0,2,0.0,2,1,0,1,0,5,3,0
1960,Florian Sotoca,Lens,4.6,6,4,0,1,5,3,4,75.0,1,5,1,4,1,7,11,0
1961,Riccardo Sottil,Fiorentina,0.7,0,0,0,0,0,0,0,0.0,0,1,0,1,0,0,0,0
1962,Tomas Soucek,West Ham,5.1,10,6,4,5,1,6,10,60.0,4,7,2,5,5,15,14,0
1963,Matias Soule,Roma,4.3,3,2,0,1,2,1,4,25.0,3,8,1,7,2,5,4,0
1964,Boubakary Soumare,Leicester City,0.2,0,0,0,0,0,0,0,0.0,0,0,0,0,0,0,0,0
1965,Issa Soumare,Le Havre,3.8,2,0,0,1,1,2,6,33.3,4,3,1,2,2,4,2,0
1966,Djibril Sow,Sevilla,4.1,5,3,2,3,0,0,3,0.0,3,1,0,1,3,8,4,0
1967,Saidou Sow,Strasbourg,6.8,7,4,4,3,0,4,7,57.1,3,9,5,4,14,21,26,0
1968,Djed Spence,Tottenham,0.7,2,2,2,0,0,2,2,100.0,0,0,0,0,2,4,1,0
1969,Leonardo Spinazzola,Napoli,2.0,1,1,0,1,0,0,1,0.0,1,3,1,2,0,1,3,1
1970,Anton Stach,Hoffenheim,5.5,13,11,7,5,1,7,10,70.0,3,7,3,4,7,20,34,0
1971,Jens Stage,Werder Bremen,5.7,6,5,4,2,0,3,10,30.0,7,12,3,9,7,13,7,0
1972,Jay Stansfield,Fulham,0.0,0,0,0,0,0,0,0,0.0,0,0,0,0,0,0,0,0
1973,Carl Starfelt,Celta Vigo,6.2,4,3,3,1,0,1,4,25.0,3,10,8,2,11,15,34,0
1974,Niklas Stark,Werder Bremen,4.1,9,6,4,4,1,4,5,80.0,1,10,8,2,4,13,24,0
1976,Lucas Stassin,Saint-Étienne,1.7,2,1,0,1,1,2,3,66.7,1,2,0,2,0,2,2,0
1977,Jason Steele,Brighton,2.0,0,0,0,0,0,0,0,0.0,0,0,0,0,0,0,1,0
1978,Orri Steinn Oskarsson,Real Sociedad,1.9,2,2,0,1,1,0,2,0.0,2,4,0,4,0,2,1,0
1979,Pascal Stenzel,Stuttgart,1.3,1,0,1,0,0,0,1,0.0,1,3,1,2,0,1,4,0
1980,Jack Stephens,Southampton,3.9,8,5,6,2,0,3,7,42.9,4,4,2,2,0,8,5,2
1981,Raheem Sterling,Arsenal,1.0,0,0,0,0,0,0,0,0.0,0,1,0,1,0,0,0,0
1982,Enzo Sternal,Marseille,0.1,0,0,0,0,0,0,0,0.0,0,0,0,0,0,0,0,0
1983,Ross Stewart,Southampton,1.5,0,0,0,0,0,0,3,0.0,3,3,0,3,0,0,4,0
1984,Angelo Stiller,Stuttgart,5.9,8,3,5,2,1,2,6,33.3,4,7,3,4,4,12,13,1
1985,Kevin Stoger,Gladbach,5.6,10,5,5,3,2,4,11,36.4,7,10,0,10,3,13,12,0
1986,Stoichkov,Alavés,5.6,12,7,5,6,1,5,10,50.0,5,1,0,1,1,13,5,0
1987,Petar Stojanovic,Empoli,0.0,0,0,0,0,0,0,0,0.0,0,0,0,0,0,0,0,0
1988,John Stones,Manchester City,1.7,2,2,0,2,0,1,1,100.0,0,1,0,1,1,3,6,1
1989,Jorgen Strand Larsen,Wolves,6.3,2,2,1,0,1,0,5,0.0,5,4,1,3,1,3,6,0
1990,Gabriel Strefezza,Como,6.6,16,12,5,6,5,6,15,40.0,9,5,1,4,2,18,1,0
1991,Cristhian Stuani,Girona,1.1,0,0,0,0,0,0,0,0.0,0,1,0,1,0,0,1,0
1992,Alex Suarez,Las Palmas,6.0,12,8,9,2,1,7,9,77.8,2,9,5,4,4,16,21,0
1993,Denis Suarez,Villarreal,0.9,1,1,1,0,0,1,2,50.0,1,1,1,0,0,1,1,0
1994,Gabriel Suazo,Toulouse,4.0,12,6,4,5,3,8,14,57.1,6,4,0,4,4,16,2,0
1995,Luka Sucic,Real Sociedad,4.4,7,3,1,4,2,2,7,28.6,5,5,2,3,3,10,1,0
1996,Yukinari Sugawara,Southampton,6.3,14,9,8,5,1,6,9,66.7,3,7,3,4,4,18,19,1
1997,Niklas Sule,Dortmund,3.7,5,4,4,1,0,4,5,80.0,1,1,1,0,1,6,19,0
1998,Ibrahim Sulemana,Atalanta,0.2,0,0,0,0,0,0,0,0.0,0,0,0,0,0,0,0,0
1999,Crysencio Summerville,West Ham,1.6,2,0,0,1,1,1,2,50.0,1,4,1,3,0,2,1,0
2000,Tomas Suslov,Hellas Verona,2.7,10,6,3,6,1,2,4,50.0,2,9,0,9,2,12,1,0
2002,Suso,Sevilla,0.8,1,0,1,0,0,1,2,50.0,1,0,0,0,0,1,0,0
2003,Zion Suzuki,Parma,5.8,1,0,1,0,0,1,1,100.0,0,0,0,0,0,1,4,1
2004,Mattias Svanberg,Wolfsburg,4.2,6,3,0,5,1,1,3,33.3,2,1,0,1,4,10,4,0
2005,Marin Sverko,Venezia,3.9,4,3,3,1,0,2,2,100.0,0,4,1,3,7,11,13,1
2006,Mile Svilar,Roma,7.0,0,0,0,0,0,0,0,0.0,0,0,0,0,0,0,2,1
2007,Michael Svoboda,Venezia,6.3,14,7,10,3,1,4,10,40.0,6,14,9,5,7,21,24,2
2008,Williot Swedberg,Celta Vigo,4.2,4,3,1,2,1,3,4,75.0,1,4,0,4,0,4,3,0
2009,Abakar Sylla,Strasbourg,4.4,12,7,8,2,2,6,7,85.7,1,9,6,3,4,16,20,0
2010,Issiaga Sylla,Montpellier,0.2,1,0,1,0,0,1,1,100.0,0,0,0,0,0,1,0,0
2011,Mamadou Sylla,Valladolid,2.4,0,0,0,0,0,0,0,0.0,0,1,0,1,0,0,1,1
2012,Sammie Szmodics,Ipswich Town,3.4,2,1,1,1,0,0,1,0.0,1,2,0,2,3,5,3,0
2013,Dominik Szoboszlai,Liverpool,6.0,4,0,1,2,1,1,2,50.0,1,10,1,9,2,6,4,0
2014,Alexander Sorloth,Atlético Madrid,4.8,1,0,0,0,1,0,0,0.0,0,2,1,1,0,1,7,0
2015,Musa Al-Taamari,Montpellier,1.9,3,1,1,0,2,1,1,100.0,0,0,0,0,1,4,0,0
2016,Haris Tabakovic,Hoffenheim,0.6,1,1,0,0,1,0,0,0.0,0,1,1,0,0,1,2,0
2017,Nicolas Tagliafico,Lyon,2.0,3,1,1,1,1,2,5,40.0,3,3,2,1,4,7,2,0
2018,Jonathan Tah,Leverkusen,6.0,5,4,4,1,0,2,3,66.7,1,3,2,1,7,12,17,1
2019,Adrien Tameze,Torino,2.7,2,1,0,2,0,0,5,0.0,5,2,2,0,8,10,3,1
2020,Renato Tapia,Leganés,3.1,13,6,4,7,2,3,7,42.9,4,6,1,5,2,15,15,0
2021,Edmond Tapsoba,Leverkusen,5.9,14,11,7,6,1,5,9,55.6,4,5,3,2,4,18,15,0
2022,Florian Tardieu,Saint-Étienne,1.8,1,1,1,0,0,0,2,0.0,2,3,1,2,3,4,2,0
2023,Mehdi Taremi,Inter,2.1,2,1,0,1,1,0,0,0.0,0,3,0,3,0,2,3,0
2024,Oussama Targhalline,Le Havre,3.6,6,3,2,1,3,1,3,33.3,2,6,3,3,7,13,2,0
2025,James Tarkowski,Everton,7.0,19,11,10,7,2,11,16,68.8,5,12,9,3,9,28,39,0
2026,Cesar Tarrega,Valencia,7.0,8,7,4,3,1,3,5,60.0,2,6,5,1,4,12,33,1
2028,Nuno Tavares,Lazio,4.7,7,6,6,1,0,2,5,40.0,3,1,0,1,2,9,13,0
2029,Marcus Tavernier,Bournemouth,6.7,13,8,3,6,4,3,6,50.0,3,4,0,4,1,14,4,0
2030,Charlie Taylor,Southampton,2.2,4,2,1,3,0,2,2,100.0,0,5,3,2,3,7,17,1
2031,Jack Taylor,Ipswich Town,1.3,1,0,0,1,0,1,4,25.0,3,1,0,1,2,3,7,0
2032,Loum Tchaouna,Lazio,1.6,3,1,1,1,1,1,3,33.3,2,1,0,1,1,4,1,0
2033,Jackson Tchatchoua,Hellas Verona,7.0,11,4,9,1,1,8,10,80.0,2,9,5,4,6,17,11,0
2034,Enzo Tchato,Montpellier,5.1,9,5,4,4,1,5,12,41.7,7,7,2,5,4,13,16,0
2035,Aurelien Tchouameni,Real Madrid,7.7,15,6,5,9,1,6,14,42.9,8,7,6,1,19,34,11,0
2036,Alvaro Tejero,Espanyol,4.5,5,3,1,3,1,2,10,20.0,8,5,0,5,2,7,10,0
2037,Martin Tejon,Valencia,0.5,2,0,0,2,0,1,2,50.0,1,0,0,0,0,2,0,0
2038,Mathys Tel,Bayern Munich,1.0,0,0,0,0,0,0,0,0.0,0,0,0,0,1,1,0,0
2039,Nathan Tella,Leverkusen,0.9,0,0,0,0,0,0,1,0.0,1,1,0,1,0,0,1,0
2040,Nahuel Tenaglia,Alavés,6.5,19,9,14,3,2,10,15,66.7,5,3,2,1,8,27,23,0
2041,Casper Tengstedt,Hellas Verona,5.4,1,0,0,1,0,0,1,0.0,1,3,1,2,3,4,13,0
2042,Marc-Andre ter Stegen,Barcelona,5.5,0,0,0,0,0,0,1,0.0,1,0,0,0,0,0,2,2
2043,Filippo Terracciano,Milan,1.0,2,2,1,0,1,1,3,33.3,2,0,0,0,2,4,1,0
2044,Pietro Terracciano,Fiorentina,3.0,0,0,0,0,0,0,0,0.0,0,0,0,0,0,0,0,0
2045,Ramon Terrats,Villarreal,0.8,3,3,1,2,0,2,3,66.7,1,2,1,1,1,4,3,0
2046,Martin Terrier,Leverkusen,3.3,2,1,0,0,2,1,2,50.0,1,2,0,2,1,3,1,0
2047,Tanner Tessmann,Lyon,1.0,4,2,3,1,0,0,1,0.0,1,0,0,0,4,8,4,0
2048,Kenny Tete,Fulham,6.8,15,8,7,3,5,7,13,53.8,6,9,2,7,13,28,15,0
2049,Teddy Teuma,Reims,1.5,4,3,1,2,1,2,6,33.3,4,3,1,2,1,5,2,0
2050,Jordan Teze,Monaco,1.8,7,3,4,2,1,1,2,50.0,1,5,1,4,1,8,1,0
2051,Florian Thauvin,Udinese,5.0,5,5,4,0,1,4,7,57.1,3,2,0,2,2,7,2,0
2052,Arthur Theate,Eint Frankfurt,5.8,5,3,2,3,0,2,9,22.2,7,9,8,1,7,12,29,0
2054,Malick Thiaw,Milan,1.0,1,1,0,1,0,0,0,0.0,0,0,0,0,1,2,1,0
2055,Sorba Thomas,Nantes,4.8,6,4,3,3,0,3,6,50.0,3,6,0,6,2,8,5,0
2056,Adrien Thomasson,Lens,6.2,24,13,14,4,6,15,26,57.7,11,11,0,11,7,31,10,0
2057,Morten Thorsby,Genoa,2.5,3,1,2,0,1,0,2,0.0,2,4,0,4,1,4,4,0
2058,Khephren Thuram,Juventus,2.0,1,1,0,1,0,0,1,0.0,1,1,0,1,3,4,4,0
2059,Marcus Thuram,Inter,6.1,5,3,2,1,2,2,4,50.0,2,5,1,4,1,6,2,0
2060,Youri Tielemans,Aston Villa,6.9,19,14,9,9,1,11,15,73.3,4,6,2,4,5,24,6,0
2061,Phillip Tietz,Augsburg,3.8,4,3,1,2,1,2,2,100.0,0,2,0,2,2,6,8,0
2062,Jurrien Timber,Arsenal,5.0,13,8,4,7,2,4,7,57.1,3,5,2,3,3,16,12,1
2063,Jean-Clair Todibo,West Ham,2.1,6,4,6,0,0,4,4,100.0,0,4,2,2,2,8,12,0
2064,Harry Toffolo,Nott'ham Forest,0.4,2,0,1,0,1,0,0,0.0,0,0,0,0,0,2,3,0
2065,Umut Tohumcu,Hoffenheim,1.9,6,4,3,2,1,2,2,100.0,0,2,0,2,2,8,4,0
2066,Corentin Tolisso,Lyon,3.8,5,4,2,1,2,3,7,42.9,4,10,1,9,2,7,7,0
2067,Rafael Toloi,Atalanta,0.4,1,1,1,0,0,1,1,100.0,0,0,0,0,0,1,0,0
2068,Tiago Tomas,Wolfsburg,4.9,7,4,5,1,1,4,13,30.8,9,4,1,3,4,11,6,0
2069,Takehiro Tomiyasu,Arsenal,0.1,0,0,0,0,0,0,0,0.0,0,0,0,0,0,0,1,0
2070,Fikayo Tomori,Milan,6.0,8,7,5,2,1,3,6,50.0,3,6,5,1,7,15,17,0
2071,Sandro Tonali,Newcastle Utd,2.6,3,2,0,3,0,0,4,0.0,4,3,1,2,6,9,3,1
2072,Pablo Torre,Barcelona,2.1,5,4,1,3,1,2,2,100.0,0,0,0,0,1,6,3,0
2073,David Torres,Valladolid,3.7,2,2,2,0,0,1,1,100.0,0,9,8,1,1,3,17,0
2074,Ferran Torres,Barcelona,3.6,3,1,1,1,1,1,2,50.0,1,2,0,2,0,3,1,0
2075,Pau Torres,Aston Villa,7.0,6,5,3,3,0,2,3,66.7,1,5,3,2,3,9,14,0
2076,Lucas Torro,Osasuna,8.6,20,12,7,13,0,11,18,61.1,7,9,2,7,14,34,17,1
2077,Abdoulaye Toure,Le Havre,6.2,14,8,7,5,2,8,13,61.5,5,5,4,1,6,20,11,0
2078,Birama Toure,Montpellier,1.2,3,2,1,2,0,2,3,66.7,1,2,1,1,2,5,1,0
2080,Souleymane Toure,Udinese,2.2,2,2,2,0,0,1,1,100.0,0,4,2,2,3,5,4,0
2081,Lucas Tousart,Union Berlin,1.4,1,1,0,1,0,0,2,0.0,2,3,1,2,1,2,2,0
2082,Adama Traore,Fulham,6.2,7,5,4,2,1,2,5,40.0,3,3,0,3,1,8,2,1
2083,Hamari Traore,Real Sociedad,3.5,11,7,7,3,1,9,12,75.0,3,1,1,0,3,14,11,0
2084,Omar Traore,Heidenheim,5.5,11,6,9,2,0,7,8,87.5,1,4,2,2,1,12,12,0
2085,Kevin Trapp,Eint Frankfurt,2.5,0,0,0,0,0,0,0,0.0,0,0,0,0,0,0,0,0
2086,Mark Travers,Bournemouth,1.0,0,0,0,0,0,0,0,0.0,0,0,0,0,0,0,1,0
2087,Oscar Trejo,Rayo Vallecano,1.4,2,2,0,2,0,2,2,100.0,0,1,0,1,1,3,1,0
2088,Philipp Treu,St. Pauli,5.9,10,6,6,3,1,6,12,50.0,6,13,1,12,3,13,9,0
2089,Ryan Trevitt,Brentford,0.0,1,1,1,0,0,0,0,0.0,0,0,0,0,0,1,0,0
2090,Christopher Trimmel,Union Berlin,2.2,7,6,5,2,0,5,8,62.5,3,2,0,2,1,8,6,0
2091,Kieran Trippier,Newcastle Utd,3.1,9,4,4,4,1,5,13,38.5,8,2,1,1,2,11,6,0
2092,Leandro Trossard,Arsenal,3.8,6,5,2,3,1,4,9,44.4,5,4,0,4,3,9,1,0
2093,Adrien Truffert,Rennes,5.4,15,7,6,5,4,11,15,73.3,4,4,0,4,3,18,9,0
2094,Kostas Tsimikas,Liverpool,1.3,3,2,1,1,1,1,3,33.3,2,2,0,2,2,5,2,0
2095,Viktor Tsyhankov,Girona,4.9,4,3,0,2,2,2,5,40.0,3,0,0,0,0,4,2,0
2096,Axel Tuanzebe,Ipswich Town,5.7,13,8,10,0,3,6,10,60.0,4,5,3,2,8,21,21,0
2097,Stefano Turati,Monza,4.0,0,0,0,0,0,0,0,0.0,0,0,0,0,0,0,2,1
2098,Benat Turrientes,Real Sociedad,4.8,10,3,4,5,1,3,5,60.0,2,8,2,6,1,11,5,0
2099,Tuta,Eint Frankfurt,6.0,15,8,10,3,2,10,13,76.9,3,14,7,7,8,23,43,0
2100,Chrisantus Uche,Getafe,8.3,8,5,2,3,3,1,1,100.0,0,6,1,5,1,9,4,0
2101,Destiny Udogie,Tottenham,6.3,22,14,11,6,5,12,16,75.0,4,9,1,8,7,29,9,1
2102,Manuel Ugarte Ribeiro,Manchester Utd,1.2,8,4,1,5,2,1,1,100.0,0,0,0,0,0,8,3,0
2103,Lesley Ugochukwu,Southampton,1.6,3,1,0,3,0,0,4,0.0,4,4,1,3,1,4,1,0
2104,Sven Ulreich,Bayern Munich,1.0,0,0,0,0,0,0,0,0.0,0,0,0,0,0,0,0,0
2106,Enes Unal,Bournemouth,0.6,0,0,0,0,0,0,0,0.0,0,1,0,1,0,0,0,0
2107,Deniz Undav,Stuttgart,4.6,3,3,0,1,2,0,1,0.0,1,2,0,2,0,3,1,0
2108,Naci Unuvar,Espanyol,0.2,0,0,0,0,0,0,0,0.0,0,0,0,0,0,0,0,0
2109,Dayot Upamecano,Bayern Munich,6.0,10,6,3,6,1,6,11,54.5,5,3,1,2,12,22,10,0
2110,Kacper Urbanski,Bologna,1.8,5,2,4,0,1,4,6,66.7,2,4,0,4,1,6,4,0
2111,Can Uzun,Eint Frankfurt,0.7,2,1,1,0,1,1,2,50.0,1,0,0,0,0,2,1,0
2112,Josha Vagnoman,Stuttgart,3.5,3,1,2,1,0,0,1,0.0,1,3,1,2,3,6,7,0
2113,Oscar Valentin,Rayo Vallecano,7.0,15,12,6,8,1,10,16,62.5,6,6,1,5,10,25,16,0
2114,German Valera,Valencia,0.3,0,0,0,0,0,0,0,0.0,0,0,0,0,3,3,1,0
2115,Emanuele Valeri,Parma,3.6,6,4,3,1,2,6,8,75.0,2,4,1,3,6,12,10,0
2116,Martin Valjent,Mallorca,5.8,4,2,4,0,0,1,1,100.0,0,6,2,4,4,8,32,0
2117,Jesus Vallejo,Real Madrid,0.1,0,0,0,0,0,0,0,0.0,0,0,0,0,0,0,2,0
2118,Federico Valverde,Real Madrid,8.8,16,10,7,9,0,11,15,73.3,4,14,3,11,19,35,11,0
2119,Ignace Van Der Brempt,Como,3.4,14,9,11,3,0,8,11,72.7,3,4,2,2,4,18,6,0
2120,Virgil van Dijk,Liverpool,7.0,3,1,3,0,0,1,2,50.0,1,2,0,2,17,20,39,1
2121,Vanderson,Monaco,5.0,18,13,9,6,3,10,14,71.4,4,7,3,4,10,28,11,1
2122,Jamie Vardy,Leicester City,6.4,3,3,2,1,0,0,2,0.0,2,1,0,1,1,4,7,0
2123,Ruben Vargas,Augsburg,2.6,2,1,1,1,0,1,4,25.0,3,1,0,1,1,3,0,1
2124,Nikola Vasilj,St. Pauli,6.0,0,0,0,0,0,0,0,0.0,0,0,0,0,0,0,1,1
2125,Devis Vasquez,Empoli,7.0,0,0,0,0,0,0,0,0.0,0,0,0,0,0,0,7,0
2126,Johan Vasquez,Genoa,6.3,5,2,2,2,1,2,6,33.3,4,10,6,4,11,16,23,0
2127,Denis Vavro,Wolfsburg,1.0,0,0,0,0,0,0,0,0.0,0,1,0,1,2,2,8,0
2128,Jose Luis Garcia Vaya,Valencia,8.7,15,9,7,6,2,3,11,27.3,8,9,2,7,2,17,13,0
2129,Jesus Vazquez,Valencia,6.2,16,13,8,6,2,5,12,41.7,7,11,5,6,5,21,19,0
2130,Lucas Vazquez,Real Madrid,2.5,4,4,2,2,0,3,7,42.9,4,3,0,3,1,5,0,0
2132,Matias Vecino,Lazio,1.7,2,2,1,1,0,2,7,28.6,5,2,0,2,1,3,2,0
2133,Renato Veiga,Chelsea,1.4,8,5,5,3,0,4,8,50.0,4,3,1,2,1,9,1,0
2134,Alejo Veliz,Espanyol,6.3,1,1,0,1,0,1,4,25.0,3,9,2,7,1,2,13,0
2135,Milos Veljkovic,Werder Bremen,1.0,0,0,0,0,0,0,1,0.0,1,1,1,0,0,0,2,0
2136,Joel Veltman,Brighton,5.8,16,10,9,5,2,11,21,52.4,10,7,2,5,6,22,16,0
2137,Micky van de Ven,Tottenham,5.9,4,1,1,2,1,3,5,60.0,2,4,2,2,6,10,17,0
2138,Nikolas Veratschnig,Mainz 05,0.0,0,0,0,0,0,0,0,0.0,0,0,0,0,0,0,0,0
2139,Bart Verbruggen,Brighton,5.0,0,0,0,0,0,0,1,0.0,1,0,0,0,0,0,3,2
2140,Simone Verdi,Como,0.6,0,0,0,0,0,0,1,0.0,1,0,0,0,0,0,0,0
2141,Jordan Veretout,Lyon,2.6,3,2,0,2,1,1,3,33.3,2,3,1,2,0,3,3,0
2142,Arthur Vermeeren,RB Leipzig,1.6,4,3,2,2,0,2,6,33.3,4,3,2,1,3,7,3,0
2143,Yorbe Vertessen,Union Berlin,2.8,3,1,2,1,0,0,1,0.0,1,3,0,3,0,3,1,0
2144,Mikel Vesga,Athletic Club,3.5,5,3,2,3,0,2,10,20.0,8,4,0,4,6,11,5,0
2145,Jannik Vestergaard,Leicester City,2.0,2,1,0,2,0,0,0,0.0,0,2,0,2,2,4,17,0
2146,Ben Viadere,Auxerre,0.1,0,0,0,0,0,0,0,0.0,0,0,0,0,0,0,0,0
2147,Guglielmo Vicario,Tottenham,7.0,0,0,0,0,0,0,0,0.0,0,0,0,0,0,0,5,1
2148,Carlos Vicente,Alavés,7.9,10,7,6,2,2,4,5,80.0,1,3,0,3,3,13,6,0
2149,Pau Victor Delgado,Barcelona,1.3,1,1,0,1,0,0,3,0.0,3,5,1,4,1,2,4,0
2150,Nacho Vidal,Osasuna,1.2,2,0,0,1,1,1,3,33.3,2,1,0,1,0,2,3,0
2151,Samuele Vignato,Monza,1.2,3,1,0,2,1,2,3,66.7,1,0,0,0,0,3,1,0
2152,Asier Villalibre,Alavés,2.0,0,0,0,0,0,0,0,0.0,0,1,0,1,1,1,4,0
2153,Ivan Villar,Celta Vigo,4.0,0,0,0,0,0,0,0,0.0,0,0,0,0,0,0,3,0
2154,Nicolas Viola,Cagliari,1.9,2,2,1,1,0,0,3,0.0,3,0,0,0,1,3,2,0
2155,Viti,Las Palmas,3.9,11,6,6,4,1,4,6,66.7,2,5,0,5,3,14,10,0
2156,Mattia Viti,Empoli,7.0,26,18,18,7,1,14,18,77.8,4,11,7,4,8,34,30,0
2158,Vitinha,Genoa,5.5,10,4,4,3,3,4,15,26.7,11,5,1,4,4,14,5,0
2159,Vitinha,Paris S-G,4.0,7,2,2,4,1,4,6,66.7,2,3,1,2,1,8,3,1
2160,Daniel Vivian,Athletic Club,7.1,11,8,7,4,0,8,9,88.9,1,6,3,3,10,21,43,0
2161,Dusan Vlahovic,Juventus,6.4,1,1,0,0,1,0,0,0.0,0,3,2,1,0,1,5,1
2162,Vanja Vlahovic,Atalanta,0.3,0,0,0,0,0,0,0,0.0,0,0,0,0,0,0,0,0
2163,Nikola Vlasic,Torino,0.4,0,0,0,0,0,0,1,0.0,1,0,0,0,1,1,0,0
2164,Alessandro Vogliacco,Genoa,3.2,7,2,2,5,0,4,5,80.0,1,3,2,1,5,12,12,0
2165,Kevin Vogt,Union Berlin,5.6,2,2,1,1,0,1,4,25.0,3,4,1,3,2,4,25,0
2166,Mergim Vojvoda,Torino,4.1,7,3,2,3,2,3,9,33.3,6,7,2,5,2,9,9,0
2167,Aster Vranckx,Wolfsburg,1.4,3,2,1,2,0,1,1,100.0,0,2,1,1,3,6,4,0
2168,Stefan de Vrij,Inter,1.3,0,0,0,0,0,0,2,0.0,2,0,0,0,0,0,1,0
2169,Ibrahima Wadji,Saint-Étienne,0.5,1,1,0,1,0,1,2,50.0,1,0,0,0,0,1,0,0
2170,Robert Wagner,St. Pauli,2.7,6,2,1,5,0,2,7,28.6,5,6,0,6,0,6,3,0
2171,Elye Wahi,Marseille,3.8,0,0,0,0,0,0,2,0.0,2,0,0,0,1,1,0,0
2172,Hauke Wahl,St. Pauli,6.0,6,3,1,5,0,3,4,75.0,1,4,1,3,5,11,21,0
2173,Kyle Walker,Manchester City,3.2,4,2,1,2,1,3,6,50.0,3,2,2,0,1,5,4,0
2174,Kyle Walker-Peters,Southampton,4.9,7,5,4,2,1,4,8,50.0,4,6,2,4,3,10,9,0
2175,Christian Walton,Ipswich Town,1.0,0,0,0,0,0,0,1,0.0,1,0,0,0,0,0,0,0
2176,Sebastian Walukiewicz,Torino,2.7,4,1,3,0,1,2,3,66.7,1,3,0,3,6,10,15,0
2177,Sebastian Walukiewicz,Empoli,2.0,1,0,1,0,0,0,1,0.0,1,3,3,0,1,2,15,0
2178,Aaron Wan-Bissaka,West Ham,5.3,11,6,4,5,2,4,4,100.0,0,4,2,2,6,17,9,0
2179,Paul Wanner,Heidenheim,4.9,13,7,3,10,0,5,10,50.0,5,2,0,2,1,14,6,0
2180,James Ward-Prowse,West Ham,0.2,1,0,1,0,0,1,1,100.0,0,1,0,1,0,1,0,0
2181,James Ward-Prowse,Nott'ham Forest,3.2,3,1,1,2,0,1,1,100.0,0,3,2,1,5,8,3,0
2182,Ollie Watkins,Aston Villa,5.9,2,1,0,2,0,0,3,0.0,3,4,0,4,2,4,0,0
2184,Timothy Weah,Juventus,1.3,3,1,0,1,2,1,1,100.0,0,2,0,2,1,4,0,0
2185,Adam Webster,Brighton,0.9,0,0,0,0,0,0,2,0.0,2,4,3,1,1,1,3,1
2186,Julian Weigl,Gladbach,5.6,10,4,7,2,1,7,8,87.5,1,5,2,3,12,22,12,0
2187,Timon Weiner,Holstein Kiel,6.0,0,0,0,0,0,0,0,0.0,0,0,0,0,0,0,3,1
2188,Nelson Weiper,Mainz 05,0.2,0,0,0,0,0,0,0,0.0,0,1,0,1,0,0,0,0
2189,Mitchell Weiser,Werder Bremen,6.0,10,6,3,6,1,4,9,44.4,5,2,0,2,3,13,12,0
2190,Noah Weisshaupt,Freiburg,0.6,0,0,0,0,0,0,1,0.0,1,0,0,0,0,0,1,0
2191,Danny Welbeck,Brighton,6.6,6,4,2,3,1,1,3,33.3,2,6,1,5,2,8,4,0
2192,Timo Werner,Tottenham,2.2,2,2,1,1,0,1,2,50.0,1,7,1,6,1,3,2,0
2193,Adam Wharton,Crystal Palace,5.9,14,8,7,7,0,8,23,34.8,15,3,0,3,7,21,9,0
2194,Ben White,Arsenal,4.5,7,5,5,1,1,6,13,46.2,7,4,3,1,6,13,13,0
2195,Silvan Widmer,Mainz 05,1.2,2,2,1,1,0,2,3,66.7,1,1,0,1,1,3,4,0
2196,Mats Wieffer,Brighton,2.1,6,3,1,3,2,2,5,40.0,3,5,1,4,2,8,4,1
2197,Mateusz Wieteska,Cagliari,1.0,1,0,0,1,0,1,1,100.0,0,2,1,1,6,7,4,0
2198,Caleb Wiley,Strasbourg,2.4,0,0,0,0,0,0,0,0.0,0,3,1,2,1,1,3,0
2199,Inaki Williams,Athletic Club,8.0,3,0,2,0,1,1,5,20.0,4,7,1,6,5,8,10,0
2200,Neco Williams,Nott'ham Forest,3.8,11,7,9,2,0,5,11,45.5,6,8,1,7,4,15,17,0
2201,Nico Williams,Athletic Club,4.8,8,4,2,5,1,4,6,66.7,2,0,0,0,1,9,2,0
2202,Joe Willock,Newcastle Utd,1.6,3,1,1,2,0,2,5,40.0,3,2,0,2,2,5,1,0
2203,Harry Wilson,Fulham,0.4,0,0,0,0,0,0,1,0.0,1,0,0,0,0,0,0,0
2204,Patrick Wimmer,Wolfsburg,3.5,4,4,1,3,0,2,6,33.3,4,4,0,4,4,8,2,0
2205,Jonas Wind,Wolfsburg,2.5,0,0,0,0,0,0,0,0.0,0,1,0,1,0,0,3,0
2206,Harry Winks,Leicester City,6.0,9,4,5,2,2,4,10,40.0,6,7,2,5,3,12,7,0
2207,Florian Wirtz,Leverkusen,6.0,10,6,4,5,1,4,7,57.1,3,8,1,7,4,14,0,0
2208,Yoane Wissa,Brentford,3.2,1,1,0,0,1,0,1,0.0,1,2,0,2,2,3,2,0
2210,Dani de Wit,Bochum,4.6,9,7,5,4,0,4,10,40.0,6,5,1,4,5,14,10,0
2211,Axel Witsel,Atlético Madrid,3.5,2,1,1,1,0,1,2,50.0,1,2,2,0,2,4,20,0
2212,Maximilian Wittek,Bochum,6.0,10,8,4,5,1,8,15,53.3,7,14,3,11,9,19,18,0
2213,Marius Wolf,Augsburg,3.5,4,2,1,2,1,1,6,16.7,5,4,0,4,2,6,8,0
2214,Nick Woltemade,Stuttgart,0.4,0,0,0,0,0,0,0,0.0,0,0,0,0,0,0,0,0
2215,Jeong Woo-yeong,Union Berlin,2.4,1,1,0,1,0,0,1,0.0,1,0,0,0,2,3,0,0
2216,Chris Wood,Nott'ham Forest,6.2,1,1,0,0,1,1,3,33.3,2,0,0,0,2,3,5,0
2217,Christopher Wooh,Rennes,6.0,15,7,7,7,1,4,5,80.0,1,10,6,4,6,21,25,0
2218,Luke Woolfenden,Ipswich Town,3.0,0,0,0,0,0,0,1,0.0,1,8,3,5,6,6,20,0
2219,Granit Xhaka,Leverkusen,6.0,7,3,2,4,1,4,5,80.0,1,7,3,4,1,8,6,0
2220,Lamine Yamal,Barcelona,8.0,16,13,2,7,7,3,6,50.0,3,5,0,5,6,22,0,0
2221,Yehor Yarmoliuk,Brentford,1.3,1,0,1,0,0,0,3,0.0,3,3,2,1,3,4,2,0
2222,Ryan Yates,Nott'ham Forest,5.0,9,4,8,1,0,3,6,50.0,3,7,1,6,3,12,14,1
2223,John Yeboah,Venezia,0.8,2,2,0,1,1,0,1,0.0,1,1,0,1,0,2,0,0
2224,Bertug Yildirim,Getafe,5.0,4,2,0,3,1,0,3,0.0,3,3,1,2,0,4,8,0
2225,Kenan Yildiz,Juventus,5.7,13,8,2,7,4,5,6,83.3,1,9,0,9,1,14,3,0
2226,Ashley Young,Everton,4.7,11,6,5,4,2,5,8,62.5,3,2,1,1,6,17,14,0
2227,Etienne Youte Kinkoue,Le Havre,3.5,2,1,1,1,0,2,3,66.7,1,4,2,2,4,6,10,0
2228,Illia Zabarnyi,Bournemouth,7.0,10,6,4,6,0,4,8,50.0,4,8,2,6,8,18,33,0
2229,Mattia Zaccagni,Lazio,6.7,8,6,1,6,1,3,5,60.0,2,3,0,3,4,12,3,0
2230,Dan-Axel Zagadou,Stuttgart,0.3,0,0,0,0,0,0,0,0.0,0,0,0,0,1,1,1,0
2231,Yoram Zague,Paris S-G,0.8,3,2,1,1,1,2,2,100.0,0,1,0,1,0,3,1,0
2232,Wilfried Zaha,Lyon,0.6,1,1,1,0,0,1,2,50.0,1,2,0,2,0,1,0,0
2233,Warren Zaire-Emery,Paris S-G,5.6,11,3,2,6,3,6,9,66.7,3,7,0,7,3,14,8,0
2234,Miha Zajc,Toulouse,0.5,1,1,0,0,1,1,1,100.0,0,0,0,0,1,2,0,0
2236,Denis Zakaria,Monaco,6.3,10,7,4,5,1,5,7,71.4,2,6,4,2,7,17,17,0
2237,Nicola Zalewski,Roma,2.4,4,3,1,1,2,1,3,33.3,2,2,0,2,0,4,2,0
2238,Andre-Frank Zambo Anguissa,Napoli,7.0,13,8,2,9,2,6,10,60.0,4,4,1,3,16,29,2,0
2239,Francesco Zampano,Venezia,6.3,12,9,7,4,1,4,11,36.4,7,5,0,5,4,16,13,2
2240,Nicolo Zaniolo,Atalanta,0.6,0,0,0,0,0,0,0,0.0,0,0,0,0,0,0,0,0
2241,Alessandro Zanoli,Genoa,3.4,1,0,1,0,0,1,1,100.0,0,3,2,1,1,2,8,0
2242,Duvan Zapata,Torino,6.5,7,5,2,0,5,0,3,0.0,3,2,1,1,2,9,7,0
2243,Gabriele Zappa,Cagliari,6.5,9,6,5,4,0,5,7,71.4,2,11,7,4,5,14,19,0
2244,Davide Zappacosta,Atalanta,4.5,3,3,2,1,0,3,8,37.5,5,3,1,2,1,4,3,0
2245,Bryan Zaragoza,Osasuna,6.3,9,6,6,2,1,4,12,33.3,8,4,0,4,0,9,4,0
2246,Anass Zaroury,Lens,2.2,1,1,0,0,1,0,3,0.0,3,1,0,1,0,1,0,0
2247,Oier Zarraga,Udinese,2.2,3,1,1,2,0,2,5,40.0,3,1,1,0,1,4,0,0
2248,Jordan Zemura,Udinese,3.4,5,2,3,0,2,3,6,50.0,3,8,1,7,4,9,3,0
2249,Robin Zentner,Mainz 05,6.0,0,0,0,0,0,0,0,0.0,0,0,0,0,0,0,10,1
2250,Kevin Zeroli,Milan,0.1,1,1,0,1,0,0,0,0.0,0,0,0,0,0,1,0,0
2251,Cedric Zesiger,Wolfsburg,5.0,10,6,3,5,2,4,9,44.4,5,5,5,0,3,13,24,0
2252,Michael Zetterer,Werder Bremen,6.0,0,0,0,0,0,0,0,0.0,0,0,0,0,0,0,1,1
2253,Nathan Zeze,Nantes,5.0,7,4,1,6,0,5,7,71.4,2,8,3,5,11,18,41,0
2254,Edon Zhegrova,Lille,4.8,2,1,1,0,1,1,2,50.0,1,2,0,2,2,4,0,0
2255,Piotr Zielinski,Inter,0.8,3,3,1,1,1,1,3,33.3,2,0,0,0,0,3,1,0
2256,Oleksandr Zinchenko,Arsenal,0.9,0,0,0,0,0,0,0,0.0,0,1,0,1,2,2,2,0
2257,Joshua Zirkzee,Manchester Utd,4.2,2,0,2,0,0,2,2,100.0,0,6,2,4,2,4,1,0
2258,Luc Zogbe,Brest,1.3,7,5,4,2,1,3,5,60.0,2,2,0,2,2,9,4,0
2259,Nadir Zortea,Cagliari,3.2,6,2,5,1,0,2,3,66.7,1,1,0,1,2,8,5,0
2260,Aristide Zossou,Auxerre,0.1,0,0,0,0,0,0,0,0.0,0,0,0,0,0,0,0,0
2262,Yanis Zouaoui,Le Havre,0.8,0,0,0,0,0,0,0,0.0,0,0,0,0,0,0,1,0
2263,Igor Zubeldia,Real Sociedad,6.4,5,4,3,1,1,3,5,60.0,2,9,6,3,5,10,23,1
2264,Martin Zubimendi,Real Sociedad,8.5,21,11,8,10,3,5,7,71.4,2,11,3,8,11,32,19,0
2265,Martin Odegaard,Arsenal,2.8,5,3,1,3,1,1,4,25.0,3,0,0,0,1,6,0,0
2266,Milan Duric,Monza,4.9,0,0,0,0,0,0,0,0.0,0,2,0,2,1,1,5,0
