,# Pl,90s,Tackles - Tkl,Tackles - TklW,Tackles - Def 3rd,Tackles - Mid 3rd,Tackles - Att 3rd,Challenges - Tkl,Challenges - Att,Challenges - Tkl%,Challenges - Lost,Blocks - Blocks,Blocks - Sh,Blocks - Pass,Int,Tkl+Int,Clr,Err
0,22,9.0,129,81,55,61,13,57,142,40.1,85,85,25,60,62,191,165,1
1,26,9.0,152,95,91,48,13,76,163,46.6,87,88,31,57,75,227,153,3
2,22,8.0,139,80,54,61,24,72,125,57.6,53,106,31,75,64,203,93,3
3,23,8.0,127,73,58,57,12,63,131,48.1,68,88,22,66,55,182,114,1
4,24,8.0,128,70,60,51,17,59,117,50.4,58,100,23,77,71,199,117,1
5,22,9.0,127,80,56,52,19,66,141,46.8,75,93,28,65,62,189,164,0
6,22,8.0,142,82,73,53,16,65,128,50.8,63,99,25,74,60,202,174,1
7,22,7.0,94,54,42,38,14,43,95,45.3,52,82,32,50,57,151,137,2
8,23,9.0,134,85,64,48,22,63,120,52.5,57,80,20,60,55,189,123,3
9,20,7.0,98,59,40,36,22,51,98,52.0,47,72,7,65,55,153,93,3
10,27,9.0,157,96,65,75,17,90,173,52.0,83,108,25,83,84,241,176,1
11,23,7.0,148,89,69,60,19,74,144,51.4,70,86,25,61,65,213,146,2
12,23,8.0,123,66,68,48,7,65,139,46.8,74,94,25,69,57,180,163,2
13,23,8.0,147,70,67,58,22,73,157,46.5,84,111,37,74,72,219,156,7
14,24,8.0,140,91,75,51,14,62,146,42.5,84,96,24,72,71,211,181,4
15,22,8.0,157,105,65,71,21,63,159,39.6,96,89,24,65,71,228,147,1
16,25,8.0,137,83,64,56,17,55,156,35.3,101,92,32,60,72,209,119,3
17,24,8.0,124,71,55,42,27,62,126,49.2,64,92,42,50,55,179,158,6
18,25,9.0,138,81,66,55,17,64,152,42.1,88,92,29,63,61,199,193,3
19,23,8.0,103,61,56,34,13,51,111,45.9,60,83,29,54,57,160,139,3
20,22,9.0,112,70,51,48,13,52,133,39.1,81,86,25,61,71,183,206,1
21,22,8.0,133,77,54,50,29,54,112,48.2,58,86,31,55,51,184,136,2
22,22,7.9,113,77,52,50,11,67,131,51.1,64,70,18,52,71,184,86,6
23,19,8.0,160,83,76,53,31,66,122,54.1,56,90,35,55,65,225,201,1
24,26,7.0,123,80,74,39,10,63,130,48.5,67,82,28,54,81,204,153,3
25,21,7.0,107,77,57,42,8,52,100,52.0,48,86,22,64,51,158,121,2
26,25,7.0,114,75,53,47,14,59,99,59.6,40,90,18,72,55,169,152,2
27,28,8.0,119,71,48,49,22,66,122,54.1,56,117,33,84,51,170,120,3
28,23,8.0,162,97,76,55,31,71,136,52.2,65,112,27,85,63,225,123,3
29,25,8.0,136,82,66,42,28,50,121,41.3,71,109,27,82,55,191,115,1
30,22,7.0,129,74,79,36,14,48,107,44.9,59,102,36,66,58,187,143,1
31,26,8.0,121,77,51,54,16,57,116,49.1,59,94,35,59,47,168,179,2
32,23,8.0,133,74,71,44,18,63,140,45.0,77,77,16,61,61,194,151,3
33,24,8.0,136,74,76,52,8,65,126,51.6,61,103,31,72,76,212,201,3
34,23,9.0,125,68,63,42,20,63,131,48.1,68,69,28,41,80,205,202,5
35,22,9.0,140,88,62,57,21,71,137,51.8,66,96,27,69,50,190,185,0
36,26,9.0,128,67,63,52,13,53,134,39.6,81,79,23,56,42,170,171,9
37,20,7.0,115,61,66,35,14,57,124,46.0,67,84,22,62,72,187,148,2
38,24,8.0,129,80,64,49,16,56,113,49.6,57,72,18,54,60,189,166,3
39,23,7.0,87,53,43,31,13,42,100,42.0,58,88,28,60,66,153,184,2
40,23,8.0,127,72,59,56,12,59,112,52.7,53,80,26,54,69,196,89,1
41,22,8.0,117,79,56,52,9,64,117,54.7,53,79,27,52,69,186,150,1
42,21,7.0,135,82,65,53,17,73,152,48.0,79,104,33,71,77,212,140,2
43,23,9.0,183,104,89,73,21,88,178,49.4,90,88,27,61,75,258,168,2
44,20,8.0,118,78,61,44,13,60,140,42.9,80,87,30,57,76,194,123,3
45,22,8.0,144,77,73,61,10,66,148,44.6,82,93,36,57,88,232,140,2
46,23,8.0,137,88,60,67,10,69,128,53.9,59,114,30,84,67,204,155,0
47,25,8.0,117,65,40,62,15,68,126,54.0,58,88,16,72,60,177,94,2
48,21,7.0,97,60,40,41,16,46,89,51.7,43,86,16,70,60,157,92,1
49,22,8.0,139,100,52,64,23,66,147,44.9,81,73,15,58,60,199,120,3
50,21,8.0,138,87,59,52,27,69,167,41.3,98,103,27,76,72,210,167,5
51,27,8.0,123,68,74,37,12,60,141,42.6,81,92,36,56,85,208,180,2
52,20,8.0,153,93,87,51,15,80,140,57.1,60,92,27,65,70,223,166,4
53,27,8.0,138,78,50,56,32,60,173,34.7,113,83,24,59,71,209,106,3
54,23,7.0,107,66,48,50,9,48,100,48.0,52,114,44,70,66,173,172,0
55,22,7.0,102,58,52,40,10,52,109,47.7,57,83,16,67,89,191,129,1
56,21,9.0,185,110,91,77,17,88,165,53.3,77,80,30,50,84,269,168,3
57,24,8.0,113,68,52,43,18,54,96,56.3,42,64,16,48,42,155,88,4
58,25,8.0,135,80,60,50,25,71,160,44.4,89,101,28,73,56,191,143,1
59,22,8.0,121,72,57,47,17,56,122,45.9,66,89,27,62,80,201,169,1
60,28,8.0,127,78,65,38,24,46,116,39.7,70,97,32,65,93,220,178,0
61,23,8.0,96,55,52,32,12,44,88,50.0,44,78,30,48,61,157,106,1
62,19,8.0,150,92,44,83,23,71,147,48.3,76,87,16,71,94,244,116,1
63,22,7.9,129,99,69,43,17,74,167,44.3,93,79,20,59,71,200,136,0
64,24,8.0,135,78,69,53,13,59,111,53.2,52,73,27,46,66,201,114,3
65,26,8.0,127,75,66,51,10,58,117,49.6,59,93,29,64,77,204,187,0
66,21,8.0,144,84,65,56,23,70,149,47.0,79,66,14,52,56,200,84,0
67,20,8.0,123,77,57,51,15,55,135,40.7,80,94,30,64,42,165,112,3
68,21,8.0,128,82,58,53,17,66,134,49.3,68,91,23,68,64,192,109,3
69,25,8.0,147,86,92,41,14,65,124,52.4,59,92,39,53,74,221,211,2
70,22,9.0,118,72,50,50,18,57,130,43.8,73,91,25,66,71,189,195,3
71,21,8.0,134,82,50,51,33,65,130,50.0,65,82,21,61,64,198,80,4
72,22,9.0,137,80,61,57,19,62,144,43.1,82,85,22,63,59,196,205,2
73,21,7.0,127,74,58,59,10,55,119,46.2,64,97,13,84,54,181,100,1
74,21,9.0,135,84,63,60,12,57,105,54.3,48,83,29,54,82,217,126,3
75,24,9.0,135,85,62,54,19,59,135,43.7,76,93,25,68,62,197,141,4
76,21,8.0,160,93,81,59,20,86,186,46.2,100,107,33,74,88,248,174,1
77,24,8.0,110,69,46,43,21,59,112,52.7,53,91,30,61,78,188,134,2
78,23,8.0,143,87,60,66,17,64,124,51.6,60,71,18,53,53,196,93,2
79,23,8.0,108,67,61,34,13,58,119,48.7,61,77,32,45,67,175,133,4
80,26,8.0,99,57,54,37,8,46,103,44.7,57,77,24,53,70,169,145,3
81,27,8.0,158,109,74,58,26,78,144,54.2,66,79,22,57,70,228,143,0
82,25,8.0,146,81,79,46,21,57,143,39.9,86,137,48,89,78,224,240,4
83,20,8.0,143,81,70,60,13,76,152,50.0,76,93,26,67,76,219,131,4
84,22,7.0,105,59,48,47,10,58,103,56.3,45,67,21,46,58,163,130,1
85,23,8.0,91,56,36,44,11,35,84,41.7,49,69,20,49,66,157,113,2
86,21,8.0,160,101,76,56,28,78,144,54.2,66,95,30,65,72,232,159,2
87,22,8.0,120,78,64,47,9,62,137,45.3,75,120,43,77,65,185,209,2
88,25,8.0,119,67,71,36,12,57,120,47.5,63,76,23,53,61,180,136,5
89,24,7.0,108,71,40,45,23,56,98,57.1,42,80,21,59,66,174,144,0
90,24,9.0,166,98,76,71,19,80,162,49.4,82,94,17,77,69,235,181,3
91,23,9.0,150,96,75,55,20,63,131,48.1,68,89,30,59,62,212,168,3
92,24,7.0,131,77,57,63,11,63,127,49.6,64,90,29,61,44,175,157,2
93,19,8.0,146,96,80,49,17,68,136,50.0,68,121,49,72,89,235,228,1
94,21,7.0,104,60,57,34,13,49,108,45.4,59,103,19,84,64,168,164,1
95,21,8.0,148,87,86,49,13,65,127,51.2,62,102,44,58,69,217,177,2
